,gene,TSS,end,start,UTR_length,utr_counts,sample
0,C0343,2818676,2818728,2818676,52,4,utRho01
1,aaeB,6776526,6776526,6776376,150,20,utRho01
2,aaeR,6778762,6779040,6778762,278,136,utRho01
3,aaeX,6778860,6778860,6778674,186,170,utRho01
4,aat,1854920,1854920,1854864,56,32,utRho01
5,accA,416822,417242,416822,420,2390,utRho01
6,accB,6810280,6810872,6810280,592,13076,utRho01
7,accD,4868030,4868030,4867852,178,740,utRho01
8,aceB,8430804,8430956,8430804,152,102,utRho01
9,aceE,245938,246034,245938,96,764,utRho01
10,ackA,4826918,4826940,4826918,22,2578,utRho01
11,acnA,2670848,2671662,2670848,814,840,utRho01
12,acnB,263038,263230,263038,192,1182,utRho01
13,acpP,2303148,2303230,2303148,82,244,utRho01
14,acpS,5402324,5402324,5401996,328,144,utRho01
15,acrA,971396,971396,971238,158,436,utRho01
16,acrB,969370,969370,968806,564,2634,utRho01
17,acrD,5174950,5175190,5174950,240,98,utRho01
18,acrE,6827404,6827728,6827404,324,0,utRho01
19,acrR,971398,971522,971398,124,262,utRho01
20,acrZ,1589502,1589546,1589502,44,0,utRho01
21,acs,8575190,8575190,8574742,448,70,utRho01
22,actP,8569870,8569870,8569804,66,0,utRho01
23,ada,4620854,4620854,4620810,44,48,utRho01
24,add,3404404,3404466,3404404,62,22,utRho01
25,ade,7687802,7687928,7687802,126,0,utRho01
26,adhE,2596826,2596826,2596242,584,96,utRho01
27,adhP,3107988,3107988,3107676,312,1158,utRho01
28,adiA,8681112,8681112,8681042,70,48,utRho01
29,adiC,8674404,8674404,8674062,342,18,utRho01
30,adiY,8676084,8676084,8675858,226,4,utRho01
31,adk,994278,994350,994278,72,184,utRho01
32,adrA,807374,807406,807374,32,0,utRho01
33,aer,6438240,6438240,6438152,88,0,utRho01
34,aes,1000102,1000102,999946,156,42,utRho01
35,agaR,6557406,6557406,6557330,76,0,utRho01
36,agaS,6563778,6563952,6563778,174,32,utRho01
37,agp,2131118,2131170,2131118,52,0,utRho01
38,agrA,7296126,7296126,7296126,0,0,utRho01
39,agrB,7296588,7296588,7296588,0,0,utRho01
40,ahpC,1277386,1277890,1277386,504,1032,utRho01
41,ahpF,1278004,1279506,1278004,1502,67440,utRho01
42,ahr,8992698,8992698,8992418,280,0,utRho01
43,aidB,8828494,8828550,8828494,56,0,utRho01
44,ais,4731512,4731512,4731240,272,0,utRho01
45,alaA,4814816,4815122,4814816,306,0,utRho01
46,alaC,4996798,4996798,4996590,208,26,utRho01
47,alaE,5598140,5598328,5598140,188,152,utRho01
48,alaS,5644180,5644180,5644022,158,2446,utRho01
49,alaW,5036612,5036612,5036462,150,4,utRho01
50,aldA,2976380,2976464,2976380,84,60,utRho01
51,aldB,7513070,7513070,7513022,48,14,utRho01
52,alkA,4295118,4295118,4295080,38,10,utRho01
53,alkB,4618890,4618890,4618682,208,0,utRho01
54,allA,1064780,1064902,1064780,122,0,utRho01
55,allD,1092822,1092822,1092726,96,0,utRho01
56,allE,1088112,1088112,1088092,20,28,utRho01
57,allS,1064600,1064600,1064442,158,0,utRho01
58,alr,8531178,8531564,8531178,386,3874,utRho01
59,alsE,8617334,8617334,8616956,378,24,utRho01
60,alsK,8615990,8615990,8615598,392,128,utRho01
61,alx,6476740,6477160,6476740,420,40,utRho01
62,amiA,5104482,5104704,5104482,222,44,utRho01
63,amiC,5898378,5898378,5898020,358,18,utRho01
64,amn,4110062,4110122,4110062,60,14,utRho01
65,ampC,8758006,8758006,8757888,118,0,utRho01
66,ampD,237362,237466,237362,104,166,utRho01
67,ampG,907372,907372,907090,282,612,utRho01
68,ampH,792726,792726,792574,152,20,utRho01
69,amyA,4012230,4012312,4012230,82,32,utRho01
70,anmK,3439346,3439346,3439204,142,0,utRho01
71,ansB,6201580,6201580,6201456,124,110,utRho01
72,ansP,3052040,3052040,3051960,80,224,utRho01
73,apaG,104068,104068,103212,856,6758,utRho01
74,apaH,102586,102586,102444,142,6058,utRho01
75,apbE,4623188,4623188,4623068,120,106,utRho01
76,appA,2081198,2081234,2081198,36,0,utRho01
77,appC,2075420,2075480,2075420,60,0,utRho01
78,appY,1167134,1167362,1167134,228,0,utRho01
79,apt,982620,982824,982620,204,324,utRho01
80,aqpZ,1832424,1832424,1832094,330,0,utRho01
81,araB,140150,140150,140096,54,0,utRho01
82,araC,140482,140774,140482,292,4,utRho01
83,araE,5964416,5964416,5964364,52,0,utRho01
84,araF,3972476,3972476,3972256,220,0,utRho01
85,araH,3967120,3967120,3967086,34,0,utRho01
86,araJ,825058,825058,824962,96,46,utRho01
87,arcA,9281602,9281602,9280612,990,8770,utRho01
88,arcB,6706098,6706098,6706050,48,0,utRho01
89,arcZ,6701154,6701154,6701154,0,0,utRho01
90,arfA,6877346,6877346,6877298,48,508,utRho01
91,argA,5898312,5898484,5898312,172,10,utRho01
92,argC,8309770,8310002,8309770,232,68,utRho01
93,argD,6980442,6980442,6980360,82,0,utRho01
94,argE,8310156,8310156,8309694,462,152,utRho01
95,argF,580680,580680,580610,70,0,utRho01
96,argG,6637124,6637274,6637124,150,112,utRho01
97,argI,8956688,8956688,8956622,66,0,utRho01
98,argO,6137672,6137672,6137616,56,200,utRho01
99,argP,6119460,6119506,6119460,46,0,utRho01
100,argR,6769204,6769406,6769204,202,80,utRho01
101,argS,3920002,3920124,3920002,122,36,utRho01
102,argT,4855698,4855698,4855582,116,140,utRho01
103,argU,1129406,1129446,1129406,40,2,utRho01
104,argW,4932616,4932618,4932616,2,0,utRho01
105,argX,7964728,7964750,7964728,22,88,utRho01
106,aroF,5482402,5482402,5482300,102,56,utRho01
107,aroG,1571182,1571266,1571182,84,68,utRho01
108,aroH,3576636,3576870,3576636,234,384,utRho01
109,aroK,7038760,7038760,7038128,632,3152,utRho01
110,aroL,812560,812810,812560,250,146,utRho01
111,aroP,243342,243342,243102,240,0,utRho01
112,arpA,8445382,8445382,8444974,408,294,utRho01
113,arrS,7316108,7316108,7316108,0,0,utRho01
114,arsR,7297024,7297056,7297024,32,28,utRho01
115,artJ,1801252,1801252,1801150,102,0,utRho01
116,artP,1807686,1807686,1807468,218,108,utRho01
117,ascF,5678858,5679048,5678858,190,0,utRho01
118,ascG,5678574,5678574,5678528,46,0,utRho01
119,aslB,7965562,7965916,7965562,354,39482,utRho01
120,asnA,7854258,7854310,7854258,52,62,utRho01
121,asnB,1398444,1398444,1398354,90,886,utRho01
122,asnC,23562186,23562186,23562018,168,0,utRho01
123,asnS,1978088,1978088,1977970,118,11450,utRho01
124,asnT,4089082,4089098,4089082,16,86,utRho01
125,asnU,4119690,4119702,4119690,12,4,utRho01
126,asnV,4124504,4124520,4124504,16,12,utRho01
127,aspA,17473728,17473728,17473308,420,148,utRho01
128,aspC,1971486,1971486,1971418,68,416,utRho01
129,aspS,3901402,3901402,3901044,358,138,utRho01
130,aspT,7893560,7893744,7893560,184,120618,utRho01
131,aspV,473826,473862,473826,36,32,utRho01
132,asr,3342654,3342752,3342654,98,104,utRho01
133,astC,3664088,3664088,3663964,124,0,utRho01
134,astE,3654138,3654138,3653846,292,0,utRho01
135,atoD,4646824,4646894,4646824,70,18,utRho01
136,atpB,7844540,7844540,7844102,438,1124,utRho01
137,atpC,7832118,7832118,7831944,174,1434,utRho01
138,atpI,7845050,7845050,7844880,170,80,utRho01
139,avtA,7479348,7479410,7479348,62,224,utRho01
140,azoR,2965982,2965982,2965720,262,186,utRho01
141,azuC,3976002,3976002,3975918,84,70,utRho01
142,bacA,6408350,6408350,6408262,88,0,utRho01
143,bamA,394052,395856,394052,1804,1260,utRho01
144,bamB,5277950,5277950,5277304,646,2280,utRho01
145,bamC,5198028,5198028,5197730,298,760,utRho01
146,bamD,5471922,5472292,5471922,370,7700,utRho01
147,bamE,5506972,5507210,5506972,238,502,utRho01
148,basS,8666954,8666954,8666544,410,516,utRho01
149,bax,7474468,7474468,7474354,114,136,utRho01
150,bcp,5200874,5200956,5200874,82,1486,utRho01
151,bcsB,7385346,7385346,7385214,132,0,utRho01
152,bcsE,7392644,7392916,7392644,272,0,utRho01
153,bdcA,8948128,8948128,8948106,22,30,utRho01
154,bdcR,8948192,8948248,8948192,56,10,utRho01
155,bdm,3112680,3112680,3112560,120,0,utRho01
156,betA,654522,654522,654494,28,270,utRho01
157,betI,658722,658722,658668,54,18,utRho01
158,betT,658842,658926,658842,84,24,utRho01
159,bfr,6933498,6933498,6933450,48,8,utRho01
160,bglG,23440182,23440182,23439402,780,0,utRho01
161,bglX,4444240,4444240,4443978,262,0,utRho01
162,bhsA,2337962,2338146,2337962,184,52,utRho01
163,bioA,1618584,1618584,1618514,70,10,utRho01
164,bioB,1618604,1618688,1618604,84,20,utRho01
165,bioH,7089716,7089716,7089688,28,8,utRho01
166,bisC,7433026,7433026,7432788,238,18,utRho01
167,blc,8755490,8755490,8755444,46,20,utRho01
168,blr,3409024,3409102,3409024,78,102,utRho01
169,bluF,2431226,2431226,2430950,276,2436,utRho01
170,bluR,2428226,2428226,2428118,108,30,utRho01
171,bolA,908698,908944,908698,246,0,utRho01
172,borD,1157842,1157842,1157786,56,0,utRho01
173,brnQ,838976,839182,838976,206,2786,utRho01
174,bssR,1756492,1756496,1756492,4,0,utRho01
175,bssS,2242116,2242116,2241910,206,480,utRho01
176,btuB,8326798,8327278,8326798,480,3288,utRho01
177,cadB,8720212,8720212,8720062,150,0,utRho01
178,cadC,8723926,8723926,8723868,58,0,utRho01
179,caiE,70998,70998,70742,256,0,utRho01
180,caiF,68436,68600,68436,164,10,utRho01
181,caiT,84074,84074,83862,212,60,utRho01
182,can,285406,285406,285340,66,26,utRho01
183,carA,59102,59302,59102,200,8,utRho01
184,carB,61550,61634,61550,84,40,utRho01
185,cas2,5757830,5757830,5757706,124,12,utRho01
186,casA,5768638,5768638,5768276,362,0,utRho01
187,cbl,4121882,4121882,4121828,54,10,utRho01
188,cbpA,2128074,2128074,2127550,524,540,utRho01
189,cbrA,7738628,7738754,7738628,126,0,utRho01
190,cbrB,7794958,7795012,7794958,54,36,utRho01
191,ccmH,4585242,4585242,4584820,422,32,utRho01
192,cdaR,364894,364926,364894,32,42,utRho01
193,cdd,4463638,4463688,4463638,50,94,utRho01
194,cdh,8219814,8219860,8219814,46,152,utRho01
195,cdsA,391110,391354,391110,244,1932,utRho01
196,cedA,3627484,3627484,3627326,158,286,utRho01
197,cfa,3482402,3482826,3482402,424,714,utRho01
198,chaC,2544844,2544972,2544844,128,68,utRho01
199,chbB,3643452,3643452,3643238,214,0,utRho01
200,chbG,3634624,3634624,3634270,354,0,utRho01
201,cheW,3946924,3946924,3946678,246,470,utRho01
202,chiA,6939792,6939792,6939706,86,0,utRho01
203,chiP,1416472,1416668,1416472,196,0,utRho01
204,cho,3646984,3647030,3646984,46,106,utRho01
205,chpS,8896804,8896894,8896804,90,32,utRho01
206,cirA,4493884,4493884,4493538,346,710,utRho01
207,citC,1304078,1304078,1303712,366,10,utRho01
208,citT,1293264,1293264,1293160,104,0,utRho01
209,clcA,350104,350214,350104,110,0,utRho01
210,clpA,1846160,1846528,1846160,368,78,utRho01
211,clpB,5468410,5468410,5468346,64,54,utRho01
212,clpP,913154,913354,913154,200,816,utRho01
213,clpS,1845500,1845826,1845500,326,84,utRho01
214,clpX,914404,914852,914404,448,1784,utRho01
215,clsA,2617346,2617346,2617290,56,36,utRho01
216,clsC,2212584,2212710,2212584,126,398,utRho01
217,cmk,1922330,1922402,1922330,72,42,utRho01
218,cnu,3409522,3409898,3409522,376,678,utRho01
219,coaA,8350214,8350214,8350052,162,708,utRho01
220,cobC,1340092,1340092,1339814,278,862,utRho01
221,cobT,4129202,4129202,4128934,268,48,utRho01
222,cobU,4131944,4131944,4131528,416,652,utRho01
223,codB,709768,709844,709768,76,18,utRho01
224,comR,2337726,2337726,2337664,62,0,utRho01
225,copA,1022822,1022822,1022758,64,0,utRho01
226,corA,8002388,8002852,8002388,464,5526,utRho01
227,cpdB,8873258,8873258,8873130,128,88,utRho01
228,cptB,6082198,6082198,6082140,58,108,utRho01
229,cpxA,8210202,8210202,8209950,252,786,utRho01
230,cpxP,8211570,8211640,8211570,70,130,utRho01
231,cpxR,8211372,8211372,8211340,32,98,utRho01
232,cra,175894,176056,175894,162,0,utRho01
233,crcB,1316016,1316016,1315876,140,58,utRho01
234,creA,9270486,9271042,9270486,556,508,utRho01
235,creD,9276320,9276356,9276320,36,46,utRho01
236,crl,515620,515658,515620,38,1820,utRho01
237,crp,6971906,6972240,6971906,334,4586,utRho01
238,crr,5070960,5071668,5070960,708,7610,utRho01
239,csdA,5886414,5886674,5886414,260,160,utRho01
240,csgB,2207718,2207902,2207718,184,0,utRho01
241,csgD,2206688,2206688,2206392,296,8,utRho01
242,csgG,2203510,2203510,2203368,142,8,utRho01
243,csiD,5577854,5577970,5577854,116,6,utRho01
244,csiE,5330802,5330870,5330802,68,36,utRho01
245,csiR,5590942,5591348,5590942,406,4,utRho01
246,cspA,7439778,7440098,7439778,320,432866,utRho01
247,cspB,3283430,3283430,3283108,322,576,utRho01
248,cspC,3815018,3815018,3814870,148,508,utRho01
249,cspD,1845352,1845352,1845180,172,430,utRho01
250,cspE,1314294,1314584,1314294,290,60,utRho01
251,cspF,3283380,3283710,3283380,330,72,utRho01
252,cspG,2102610,2102922,2102610,312,289044,utRho01
253,cspH,2102746,2102746,2102350,396,704,utRho01
254,cspI,3277624,3277624,3277334,290,316,utRho01
255,csrA,5638746,5638746,5638292,454,1456,utRho01
256,csrB,5849048,5849048,5849048,0,0,utRho01
257,csrC,8102072,8102072,8102072,0,0,utRho01
258,csrD,6806850,6806850,6806664,186,108,utRho01
259,cstA,1259710,1259788,1259710,78,0,utRho01
260,cueO,274090,274166,274090,76,0,utRho01
261,cueR,1027948,1027986,1027948,38,30,utRho01
262,curA,3037784,3038054,3037784,270,74,utRho01
263,cusC,1191146,1191200,1191146,54,0,utRho01
264,cusR,1190924,1190924,1190886,38,70,utRho01
265,cutA,8730784,8730784,8730712,72,186,utRho01
266,cutC,3918534,3918534,3917920,614,186,utRho01
267,cvpA,4861600,4861600,4861526,74,74,utRho01
268,cvrA,2484328,2484328,2484142,186,78,utRho01
269,cyaA,7981548,7982306,7981548,758,1810,utRho01
270,cyaR,4334228,4334224,4334228,4,0,utRho01
271,cyaY,7988166,7988166,7988118,48,144,utRho01
272,cybB,2981522,2981804,2981522,282,250,utRho01
273,cycA,8859560,8859728,8859560,168,578,utRho01
274,cydA,1542340,1542916,1542340,576,114,utRho01
275,cydC,1858800,1858800,1858390,410,266,utRho01
276,cydD,1862062,1862062,1861924,138,150,utRho01
277,cydX,1548300,1548392,1548300,92,426,utRho01
278,cynR,717418,717418,717380,38,0,utRho01
279,cynT,1435092,1435196,1435092,104,0,utRho01
280,cyoA,903306,903306,903220,86,2508,utRho01
281,cyoE,895540,895540,895410,130,588,utRho01
282,cysB,2667576,2667710,2667576,134,454,utRho01
283,cysC,5748056,5748056,5747984,72,32,utRho01
284,cysD,5752736,5752736,5752658,78,16,utRho01
285,cysE,7565362,7565362,7565124,238,586,utRho01
286,cysG,6995508,6995656,6995508,148,78,utRho01
287,cysJ,5783928,5783928,5783796,132,1446,utRho01
288,cysK,5064688,5064818,5064688,130,10,utRho01
289,cysP,5087114,5087114,5087056,58,168,utRho01
290,cysS,1109154,1109222,1109154,68,74,utRho01
291,cysT,3984100,3984100,3983974,126,248,utRho01
292,cysZ,5062766,5062926,5062766,160,264,utRho01
293,cytR,8249018,8249018,8248912,106,164,utRho01
294,dacA,1328002,1328002,1327926,76,62,utRho01
295,dacB,6657714,6657926,6657714,212,54,utRho01
296,dacC,1761306,1761454,1761306,148,28,utRho01
297,dadA,2475018,2475142,2475018,124,0,utRho01
298,dam,7032504,7032504,7031826,678,1956,utRho01
299,damX,7035200,7035200,7034612,588,698,utRho01
300,dapA,5199568,5199568,5199520,48,2,utRho01
301,dapB,56576,56748,56576,172,44,utRho01
302,dapD,371954,371954,371894,60,110,utRho01
303,dapE,5183120,5183214,5183120,94,246,utRho01
304,dcp,3254844,3254844,3254760,84,110,utRho01
305,dcrB,7219534,7219910,7219534,376,100,utRho01
306,dctA,7366996,7366996,7366894,102,590,utRho01
307,dcuA,8733686,8733686,8733546,140,34,utRho01
308,dcuB,8698182,8698182,8697488,694,62,utRho01
309,dcuC,1312166,1312166,1311936,230,24,utRho01
310,dcuD,6749166,6749738,6749166,572,0,utRho01
311,dcuR,8701130,8701130,8700068,1062,544,utRho01
312,dcuS,8703370,8703370,8703324,46,68,utRho01
313,dcyD,3999016,3999016,3998960,56,0,utRho01
314,ddpX,3126498,3126498,3126152,346,0,utRho01
315,deaD,6615818,6615818,6615720,98,6370,utRho01
316,dedA,4869880,4869880,4869482,398,13274,utRho01
317,dedD,4863750,4863750,4863368,382,242,utRho01
318,def,6867300,6867380,6867300,80,156,utRho01
319,degP,361690,361768,361690,78,44,utRho01
320,degQ,6761308,6761486,6761308,178,4562,utRho01
321,deoB,9239134,9239206,9239134,72,4,utRho01
322,deoC,9233358,9234646,9233358,1288,258,utRho01
323,dfp,7625406,7625462,7625406,56,34,utRho01
324,dgcZ,3247758,3247758,3247700,58,0,utRho01
325,dgkA,8512914,8513274,8512914,360,426,utRho01
326,dgt,358392,358474,358392,82,0,utRho01
327,dhaK,2501888,2501888,2501676,212,144,utRho01
328,dhaR,2502006,2502132,2502006,126,106,utRho01
329,dicB,3299194,3299218,3299194,24,0,utRho01
330,dicC,3295752,3295752,3295700,52,0,utRho01
331,dinB,501760,501796,501760,36,0,utRho01
332,dinD,7635398,7635520,7635398,122,534,utRho01
333,dinG,1666146,1666140,1666146,6,14,utRho01
334,dinI,2243018,2243018,2242974,44,22,utRho01
335,dinJ,493230,493230,493004,226,62,utRho01
336,dinQ,7295964,7295964,7295576,388,1046,utRho01
337,djlA,114536,114728,114536,192,60,utRho01
338,dkgA,6313142,6313246,6313142,104,4,utRho01
339,dkgB,458196,458334,458196,138,616,utRho01
340,dksA,321502,321502,321208,294,134,utRho01
341,dld,4444164,4444370,4444164,206,36,utRho01
342,dmlA,3763424,3763824,3763424,400,14,utRho01
343,dmlR,3763710,3763710,3763618,92,12,utRho01
344,dmsA,1881646,1881918,1881646,272,192,utRho01
345,dnaA,7767922,7767922,7767458,464,6092,utRho01
346,dnaB,8528566,8528628,8528566,62,234,utRho01
347,dnaK,24096,24326,24096,230,410,utRho01
348,dnaN,7765466,7765466,7764642,824,1096,utRho01
349,dnaQ,471868,472134,471868,266,1130,utRho01
350,dnaT,18406460,18406460,18406068,392,580,utRho01
351,dnaX,984112,984184,984112,72,592,utRho01
352,dosP,3131486,3131486,3131466,20,0,utRho01
353,dpiB,1303968,1304470,1303968,502,20,utRho01
354,dppA,7415740,7415740,7415410,330,1364,utRho01
355,dps,1697900,1697900,1697822,78,18,utRho01
356,dsbA,8086754,8086836,8086754,82,2954,utRho01
357,dsbB,2466294,2466294,2466060,234,36,utRho01
358,dsbC,6079266,6079266,6077644,1622,1306,utRho01
359,dsbG,1277600,1277600,1277146,454,416,utRho01
360,dsdA,4958242,4958404,4958242,162,2,utRho01
361,dsdC,4955492,4955492,4955258,234,0,utRho01
362,dsdX,4955642,4955694,4955642,52,0,utRho01
363,dsrA,4050626,4050626,4050626,0,0,utRho01
364,dsrB,4049686,4049686,4049646,40,136,utRho01
365,dtpD,1485340,1485340,1485112,228,36,utRho01
366,dusA,8523200,8523338,8523200,138,4592,utRho01
367,dusB,6820492,6820560,6820492,68,134,utRho01
368,dusC,4460790,4460790,4460770,20,0,utRho01
369,dut,7627704,7627864,7627704,160,1520,utRho01
370,dxr,386670,387042,386670,372,1018,utRho01
371,ebgA,6445102,6445266,6445102,164,20,utRho01
372,ebgR,6442874,6442932,6442874,58,116,utRho01
373,ecnB,8753018,8753106,8753018,88,396,utRho01
374,eco,4607594,4607810,4607594,216,0,utRho01
375,ecpA,621594,621594,621342,252,48,utRho01
376,ecpB,620238,620238,620052,186,0,utRho01
377,ecpR,622964,622964,622672,292,0,utRho01
378,eda,3866218,3866218,3865512,706,238,utRho01
379,edd,3869426,3869426,3869208,218,96,utRho01
380,efeO,2164308,2164486,2164308,178,92,utRho01
381,efeU_1,2162614,2162712,2162614,98,144,utRho01
382,efp,8751134,8751398,8751134,264,9146,utRho01
383,elaA,4763372,4763372,4763086,286,12,utRho01
384,elaD,4765308,4765426,4765308,118,34,utRho01
385,elfA,1995530,1995736,1995530,206,0,utRho01
386,elfD,1996642,1996980,1996642,338,4,utRho01
387,emrD,7707690,7707844,7707690,154,44,utRho01
388,emrK,4966896,4966896,4966678,218,0,utRho01
389,emrY,4964668,4964668,4964352,316,126,utRho01
390,emtA,2486250,2486360,2486250,110,14,utRho01
391,endA,12361100,12361388,12361100,288,104,utRho01
392,eno,5817692,5817692,5815882,1810,6160,utRho01
393,entC,1249662,1249770,1249662,108,16,utRho01
394,entD,1220508,1220508,1220158,350,292,utRho01
395,entH,1258584,1258600,1258584,16,64,utRho01
396,entS,1244506,1244600,1244506,94,36,utRho01
397,envR,6827266,6827266,6826930,336,0,utRho01
398,epd,12295292,12295292,12294764,528,48,utRho01
399,epmA,8765236,8765286,8765236,50,18,utRho01
400,epmB,8751406,8751406,8751314,92,4776,utRho01
401,eptB,7421162,7421162,7420950,212,92,utRho01
402,eptC,8300622,8300622,8300530,92,246,utRho01
403,erfK,4126708,4126708,4126646,62,1566,utRho01
404,erpA,353122,353220,353122,98,172,utRho01
405,esrE,8039956,8039956,8039956,0,0,utRho01
406,essD,1153746,1154796,1153746,1050,274,utRho01
407,etk,2088606,2088606,2088420,186,0,utRho01
408,evgA,4967262,4967510,4967262,248,0,utRho01
409,exbB,6304028,6304028,6303968,60,0,utRho01
410,exbD,6302780,6302780,6302486,294,502,utRho01
411,exuR,6493016,6493304,6493016,288,262,utRho01
412,exuT,6490004,6490208,6490004,204,0,utRho01
413,fabA,2032996,2032996,2032940,56,218,utRho01
414,fabB,4883282,4883282,4883210,72,54,utRho01
415,fabH,2297032,2297518,2297032,486,4348,utRho01
416,fabI,2702236,2702236,2702078,158,122,utRho01
417,fadB,8062026,8062026,8061942,84,0,utRho01
418,fadD,3779614,3779614,3779492,122,0,utRho01
419,fadE,486812,486812,486606,206,42,utRho01
420,fadH,6463248,6463330,6463248,82,0,utRho01
421,fadI,4921022,4921022,4920938,84,0,utRho01
422,fadL,4922410,4922600,4922410,190,6,utRho01
423,fadM,928720,928804,928720,84,0,utRho01
424,fadR,2469810,2469876,2469810,66,0,utRho01
425,fbaB,4357334,4357334,4357128,206,38,utRho01
426,fdhE,8162722,8162722,8162456,266,1244,utRho01
427,fdhF,8598814,8598814,8598732,82,20,utRho01
428,fdnG,3094744,3094802,3094744,58,4,utRho01
429,fdrA,1093012,1093360,1093012,348,0,utRho01
430,feaB,2894994,2895038,2894994,44,0,utRho01
431,feaR,2894734,2894734,2894566,168,14,utRho01
432,fecA,9033454,9033454,9033354,100,792,utRho01
433,fecE,9023288,9023288,9022914,374,7464,utRho01
434,fecI,9036564,9036564,9036470,94,16,utRho01
435,feoA,7080114,7080326,7080114,212,176,utRho01
436,fepA,1225334,1225334,1224988,346,82,utRho01
437,fepB,1249454,1249454,1249020,434,240,utRho01
438,fepD,1244468,1244468,1244378,90,86,utRho01
439,fes,1225374,1225630,1225374,256,460,utRho01
440,ffh,5495706,5495706,5495590,116,1982,utRho01
441,ffs,952576,952848,952576,272,60,utRho01
442,fhuA,334884,334968,334884,84,420,utRho01
443,fhuE,2323294,2323294,2323102,192,358,utRho01
444,fhuF,9211504,9211504,9211326,178,2738,utRho01
445,fic,6983296,6983296,6982926,370,512,utRho01
446,fieF,8212864,8212938,8212864,74,46,utRho01
447,fimA,9085388,9086230,9085388,842,272,utRho01
448,fimB,9081334,9081914,9081334,580,588,utRho01
449,fimE,9083742,9084074,9083742,332,16,utRho01
450,fimZ,1129214,1129214,1128960,254,54,utRho01
451,fiu,1683296,1683296,1683062,234,112,utRho01
452,fixA,84650,84806,84650,156,0,utRho01
453,fkpA,6955050,6955050,6954838,212,9644,utRho01
454,fldA,2846084,2846084,2845860,224,5172,utRho01
455,fldB,6079644,6079710,6079644,66,96,utRho01
456,flgA,2261770,2261770,2261726,44,40,utRho01
457,flgB,2261986,2262036,2261986,50,46,utRho01
458,flgK,2276702,2276756,2276702,54,2334,utRho01
459,flgM,2260330,2260330,2260256,74,686,utRho01
460,flgN,2259828,2259828,2259660,168,346,utRho01
461,flhB,3932432,3932432,3932382,50,102,utRho01
462,flhC,3955864,3955864,3955688,176,182,utRho01
463,flhD,3957154,3957154,3956394,760,928,utRho01
464,fliA,4003638,4003638,4003578,60,152,utRho01
465,fliC,4007352,4007352,4007212,140,146,utRho01
466,fliD,4007634,4007744,4007634,110,170,utRho01
467,fliE,4026186,4026186,4026028,158,32,utRho01
468,fliF,4026292,4026458,4026292,166,410,utRho01
469,fliL,4039168,4039236,4039168,68,112,utRho01
470,flk,4875824,4875900,4875824,76,46,utRho01
471,flu,4142634,4143078,4142634,444,48,utRho01
472,flxA,3292776,3292810,3292776,34,48,utRho01
473,fnr,2799104,2799104,2799052,52,158,utRho01
474,fnrS,2818258,2818258,2818258,0,0,utRho01
475,focA,1909628,1909628,1908932,696,384,utRho01
476,folA,99598,99646,99598,48,2,utRho01
477,folB,6409296,6409296,6409178,118,0,utRho01
478,folD,1115562,1115562,1115482,80,248,utRho01
479,folE,4487696,4487696,4487304,392,4002,utRho01
480,fpr,8228998,8228998,8228944,54,0,utRho01
481,frc,4986878,4986878,4986508,370,0,utRho01
482,frdA,8764824,8764824,8764636,188,4,utRho01
483,frdD,8758948,8758948,8758732,216,152,utRho01
484,fre,8052886,8053054,8052886,168,2440,utRho01
485,frlA,6999518,6999820,6999518,302,0,utRho01
486,frr,385624,385744,385624,120,1542,utRho01
487,frsA,513004,513054,513004,50,208,utRho01
488,fruB,4527194,4527194,4526990,204,0,utRho01
489,frvR,8179804,8179804,8179710,94,0,utRho01
490,fryA,5008986,5008986,5008970,16,64,utRho01
491,fsaA,1727060,1727284,1727060,224,24,utRho01
492,fsr,1009710,1009710,1009392,318,44,utRho01
493,ftnA,3977364,3977432,3977364,68,0,utRho01
494,ftnB,3973550,3973850,3973550,300,32,utRho01
495,ftsA,207122,207964,207122,842,1370,utRho01
496,ftsB,5745802,5745802,5745640,162,128,utRho01
497,ftsH,6654204,6654204,6653870,334,1420,utRho01
498,ftsK,1865858,1866448,1865858,590,2430,utRho01
499,ftsL,181376,182064,181376,688,2294,utRho01
500,ftsP,6325732,6325732,6325338,394,456,utRho01
501,ftsQ,205484,206310,205484,826,598,utRho01
502,ftsX,7204512,7204512,7204172,340,652,utRho01
503,ftsZ,209272,210610,209272,1338,204,utRho01
504,fucA,5867708,5867708,5867376,332,40,utRho01
505,fucP,5868238,5868470,5868238,232,0,utRho01
506,fumA,6753760,6753760,6753508,252,1136,utRho01
507,fumB,8694696,8694696,8694652,44,28,utRho01
508,fumC,3373418,3373418,3373176,242,0,utRho01
509,fur,2842892,2842892,2842584,308,10168,utRho01
510,fusA,6947370,6947370,6947028,342,26834,utRho01
511,fxsA,8737206,8737328,8737206,122,116,utRho01
512,gabD,5581824,5582546,5581824,722,452,utRho01
513,gadA,7335214,7335214,7335160,54,0,utRho01
514,gadB,3144144,3144144,3144090,54,0,utRho01
515,gadC,3141168,3141168,3140978,190,36,utRho01
516,gadE,7315600,7316732,7315600,1132,4,utRho01
517,gadW,7329562,7329562,7329236,326,0,utRho01
518,gadX,14663356,14663356,14663240,116,4,utRho01
519,gadY,7329728,7329728,7329728,0,0,utRho01
520,galE,1584354,1584354,1584110,244,14,utRho01
521,galF,4228702,4228702,4228654,48,154,utRho01
522,galM,1577796,1577796,1577674,122,450,utRho01
523,galP,6176510,6176568,6176510,58,0,utRho01
524,galR,5953138,5953198,5953138,60,86,utRho01
525,galS,4483420,4483420,4483336,84,0,utRho01
526,galU,2582810,2582914,2582810,104,366,utRho01
527,gapA,3724480,3725542,3724480,1062,3406,utRho01
528,garP,6549868,6549868,6549814,54,0,utRho01
529,gatY,4354468,4354468,4354408,60,0,utRho01
530,gatZ,4352864,4352864,4352642,222,4608,utRho01
531,gcd,282558,282558,282450,108,66,utRho01
532,gcl,1067814,1067832,1067814,18,0,utRho01
533,gcvA,5885278,5885278,5885134,144,2,utRho01
534,gcvB,5885392,5885392,5885392,0,0,utRho01
535,gcvR,5199758,5199812,5199758,54,98,utRho01
536,gcvT,6101544,6101544,6101334,210,490,utRho01
537,gdhA,3684616,3684742,3684616,126,28,utRho01
538,gfcA,2099668,2099668,2099488,180,436,utRho01
539,gfcD,2096236,2096236,2095890,346,52,utRho01
540,ghrA,2195648,2195772,2195648,124,114,utRho01
541,ghrB,7434378,7434620,7434378,242,268,utRho01
542,glcA,6242728,6242728,6242558,170,52,utRho01
543,glcC,6256412,6256544,6256412,132,2,utRho01
544,glcD,6256152,6256152,6256042,110,2,utRho01
545,gldA,8278092,8278092,8278070,22,22,utRho01
546,glgA,7136784,7136784,7136066,718,218,utRho01
547,glgB,7147314,7147314,7147004,310,186,utRho01
548,glgC,7139142,7139142,7138656,486,90,utRho01
549,glgP,7133546,7133546,7133162,384,224,utRho01
550,glgS,6384024,6384024,6383878,146,0,utRho01
551,glgX,7142838,7142838,7142638,200,58,utRho01
552,glk,5018922,5018922,5018852,70,90,utRho01
553,glmS,7827622,7827622,7827336,286,8128,utRho01
554,glmU,7830652,7830652,7830400,252,744,utRho01
555,glmY,10765360,10765360,10765360,0,0,utRho01
556,glmZ,7972864,7972864,7972864,0,0,utRho01
557,glnA,16232888,16232888,16232136,752,420,utRho01
558,glnB,5375052,5375052,5374816,236,216,utRho01
559,glnD,377310,377310,377300,10,92,utRho01
560,glnE,6399602,6399602,6399282,320,4,utRho01
561,glnH,1696396,1696396,1696008,388,34,utRho01
562,glnK,945112,945196,945112,84,0,utRho01
563,glnL,8112742,8112742,8112678,64,26,utRho01
564,glnQ,1693262,1693262,1692926,336,390,utRho01
565,glnS,1411998,1412186,1411998,188,352,utRho01
566,gloA,3455602,3455674,3455602,72,56,utRho01
567,gloB,469852,469852,469564,288,1184,utRho01
568,glpA,4705166,4705294,4705166,128,14,utRho01
569,glpD,7123942,7124026,7123942,84,16,utRho01
570,glpE,7123698,7123698,7123646,52,224,utRho01
571,glpF,8236322,8236322,8236180,142,64,utRho01
572,glpG,7122960,7122960,7122904,56,582,utRho01
573,glpR,7121782,7121782,7121210,572,276,utRho01
574,glpT,4704902,4704902,4704748,154,16,utRho01
575,glpX,8231212,8231212,8231158,54,2622,utRho01
576,glrK,5382246,5382246,5382196,50,418,utRho01
577,gltA,1509534,1509534,1508936,598,20454,utRho01
578,gltB,6709018,6709264,6709018,246,380,utRho01
579,gltI,1375792,1375792,1375494,298,1628,utRho01
580,gltP,8588536,8588962,8588536,426,1766,utRho01
581,gltS,7657382,7657382,7657330,52,200,utRho01
582,gltX,5041568,5041568,5041344,224,132,utRho01
583,gluQ,320286,320286,320224,62,86,utRho01
584,glyA,5371148,5371148,5371014,134,2,utRho01
585,glyQ,7450708,7450708,7450636,72,176,utRho01
586,glyS,7448990,7448990,7448794,196,1938,utRho01
587,glyU,5998128,5998128,5998114,14,32,utRho01
588,glyV,8784626,8784720,8784626,94,186,utRho01
589,glyW,3984360,3984360,3984234,126,6,utRho01
590,gmhB,445612,445666,445612,54,4,utRho01
591,gmk,7642776,7642856,7642776,80,162,utRho01
592,gmr,2693686,2693686,2693484,202,194,utRho01
593,gnd,4202648,4202648,4202536,112,426,utRho01
594,gnsB,3275692,3275692,3275564,128,344,utRho01
595,gntK,14310580,14310580,14310368,212,504,utRho01
596,gntP,9102668,9102668,9102592,76,12,utRho01
597,gntR,7157760,7157760,7157452,308,346,utRho01
598,gntT,7092810,7093118,7092810,308,58,utRho01
599,gntU,7154170,7154170,7154122,48,0,utRho01
600,gntX,7089334,7089764,7089334,430,16,utRho01
601,gor,7292224,7292598,7292224,374,1252,utRho01
602,gpmA,1575340,1575340,1575190,150,0,utRho01
603,gpmM,7570374,7570520,7570374,146,0,utRho01
604,gpsA,7567620,7567620,7567322,298,6496,utRho01
605,gpt,511828,511954,511828,126,530,utRho01
606,grcA,5433046,5433046,5432898,148,150,utRho01
607,greA,6657728,6657728,6657430,298,1812,utRho01
608,greB,7073488,7073624,7073488,136,90,utRho01
609,groL,8741566,8742050,8741566,484,976,utRho01
610,groS,8741232,8741376,8741232,144,614,utRho01
611,grpE,5501494,5501494,5501416,78,150,utRho01
612,grxA,1781552,1781552,1781506,46,0,utRho01
613,grxB,2248206,2248206,2248108,98,142,utRho01
614,grxC,7569152,7569152,7568884,268,5160,utRho01
615,grxD,3468324,3468324,3468202,122,5634,utRho01
616,gspA,6911268,6911268,6910796,472,0,utRho01
617,gspC,6910964,6911156,6910964,192,0,utRho01
618,gss,6277220,6277220,6277044,176,0,utRho01
619,gstA,3428654,3428754,3428654,100,0,utRho01
620,gstB,1761038,1761038,1760960,78,8,utRho01
621,guaB,5268214,5268214,5268140,74,24,utRho01
622,gudD,5839026,5839026,5838770,256,0,utRho01
623,gyrA,4678914,4678914,4678840,74,34,utRho01
624,gyrB,7760300,7760300,7760238,62,514,utRho01
625,hcaE,5337964,5338064,5337964,100,22,utRho01
626,hcaR,5337928,5337928,5337792,136,46,utRho01
627,hcaT,5336106,5336106,5335692,414,24,utRho01
628,hchA,4071260,4071670,4071260,410,0,utRho01
629,hcp,1828258,1828258,1827628,630,88,utRho01
630,hcr,1824400,1824400,1824300,100,32,utRho01
631,hdeA,7313582,7313582,7313480,102,0,utRho01
632,hdeD,7313920,7313990,7313920,70,0,utRho01
633,hdfR,7896320,7896320,7895934,386,644,utRho01
634,hdhA,3396244,3396244,3396080,164,126,utRho01
635,helD,2048876,2048942,2048876,66,0,utRho01
636,hemA,2527166,2527428,2527166,262,222,utRho01
637,hemB,779722,779722,779454,268,46,utRho01
638,hemF,5106410,5106450,5106410,40,100,utRho01
639,hemH,996062,996110,996062,48,132,utRho01
640,hemL,349882,349882,349764,118,68,utRho01
641,hemN,8103886,8104090,8103886,204,18,utRho01
642,hepA,127176,127176,126528,648,4542,utRho01
643,hflD,2385372,2385372,2385262,110,1346,utRho01
644,hfq,8799602,8800576,8799602,974,2868,utRho01
645,hha,961006,961006,960616,390,552,utRho01
646,hicA,3018442,3018572,3018442,130,0,utRho01
647,higA,6468682,6468682,6468288,394,74,utRho01
648,higB,6468960,6468960,6468910,50,0,utRho01
649,hinT,2323642,2323770,2323642,128,0,utRho01
650,hipB,3184964,3184964,3184884,80,0,utRho01
651,hisB,4186720,4186936,4186720,216,576,utRho01
652,hisJ,4853674,4853674,4853576,98,38,utRho01
653,hisL,8359856,8359984,8359856,128,796,utRho01
654,hisS,5281284,5281284,5281150,134,430,utRho01
655,hlpA,400910,400964,400910,54,220,utRho01
656,hlyE,2460932,2460932,2460788,144,36,utRho01
657,hmp,5371594,5371670,5371594,76,0,utRho01
658,hns,2585916,2585916,2585844,72,1446,utRho01
659,hofM,7045856,7045856,7045502,354,0,utRho01
660,hokA,7441620,7441620,7441200,420,4420,utRho01
661,hokC,33902,33902,33806,96,206,utRho01
662,hokE,1215462,1215672,1215462,210,10,utRho01
663,holC,8968546,8968546,8968560,14,802,utRho01
664,holD,9215562,9215606,9215562,44,36,utRho01
665,holE,3850040,3850216,3850040,176,882,utRho01
666,hpt,282720,282862,282720,142,66,utRho01
667,hrpB,324150,324210,324150,60,150,utRho01
668,hscB,5319048,5319048,5318934,114,810,utRho01
669,hscC,1367188,1367188,1366786,402,142,utRho01
670,hsdS,9163004,9163004,9162924,80,0,utRho01
671,hslJ,2883560,2883560,2883486,74,212,utRho01
672,hslO,7059344,7059548,7059344,204,7948,utRho01
673,hslR,7058220,7058696,7058220,476,1050,utRho01
674,hslV,8244708,8244708,8244574,134,122,utRho01
675,hsrA,7881412,7881412,7881224,188,36,utRho01
676,htgA,21286,21660,21286,374,648,utRho01
677,htpG,989634,990240,989634,606,8290,utRho01
678,htpX,3825236,3825236,3825152,84,38,utRho01
679,htrE,311036,311036,310852,184,22,utRho01
680,htrL,7587668,7587668,7587366,302,74,utRho01
681,hupA,8400352,8400562,8400352,210,394,utRho01
682,hupB,1845220,1845804,1845220,584,380,utRho01
683,hyaA,2063968,2064278,2063968,310,8,utRho01
684,hybO,6292726,6292726,6292522,204,474,utRho01
685,hycA,5700922,5700922,5700870,52,30,utRho01
686,hycI,5686204,5686204,5686086,118,14,utRho01
687,hydN,5676264,5676264,5676210,54,0,utRho01
688,hyfA,5202342,5202402,5202342,60,0,utRho01
689,hypA,11402508,11402588,11402508,80,0,utRho01
690,hypB,11403356,11404004,11403356,648,120,utRho01
691,hypF,5676210,5676210,5674850,1360,1268,utRho01
692,hypT,9116634,9116634,9116578,56,12,utRho01
693,hyuA,6019660,6020056,6019660,396,0,utRho01
694,iaaA,1733074,1733136,1733074,62,36,utRho01
695,iadA,9119074,9119074,9119052,22,6,utRho01
696,iap,5753072,5753162,5753072,90,54,utRho01
697,ibaG,6673966,6673966,6673606,360,48,utRho01
698,ibpA,7735036,7735036,7734844,192,400,utRho01
699,ibpB,7733962,7733962,7733794,168,282,utRho01
700,icd,2389922,2390246,2389922,324,210,utRho01
701,iclR,8447304,8447304,8447256,48,60,utRho01
702,idi,6065876,6066130,6065876,254,0,utRho01
703,idnD,8988870,8988870,8988812,58,0,utRho01
704,idnK,8989194,8989246,8989194,52,0,utRho01
705,ihfA,3591442,3591442,3591104,338,1536,utRho01
706,ihfB,1927498,1927656,1927498,158,1784,utRho01
707,ileS,43666,44782,43666,1116,4362,utRho01
708,ileX,6431194,6431196,6431194,2,14,utRho01
709,ilvA,15820940,15821324,15820940,384,16,utRho01
710,ilvC,7915824,7915940,7915824,116,0,utRho01
711,ilvE,15809552,15809936,15809552,384,916,utRho01
712,ilvI,170840,171260,170840,420,8,utRho01
713,ilvL,23701308,23701932,23701308,624,234,utRho01
714,ilvY,7915734,7915734,7915640,94,0,utRho01
715,inaA,4698998,4698998,4698944,54,48,utRho01
716,infA,1853370,1853370,1852886,484,3728,utRho01
717,infC,3602692,3602692,3601276,1416,6982,utRho01
718,insA-5,3958452,3958452,3958430,22,10,utRho01
719,insA-7,9036758,9037054,9036758,296,154,utRho01
720,insC-5,6372080,6372284,6372080,204,126,utRho01
721,insEF-2,785238,785238,785820,582,494,utRho01
722,insEF-4,2190310,2190310,2190892,582,470,utRho01
723,insG,9007098,9007098,9006862,236,0,utRho01
724,insH-1,550596,550596,550234,362,134,utRho01
725,insH-11,7306538,7306538,7306396,142,80,utRho01
726,insH-2,1151548,1151548,1151506,42,64,utRho01
727,insH-3,1378444,1378444,1378026,418,176,utRho01
728,insH-4,2791942,2792152,2791942,210,62,utRho01
729,insH-5,2857852,2857852,2857452,400,0,utRho01
730,insH-6,4135022,4135022,4134642,380,178,utRho01
731,insH-7,4206186,4206186,4205822,364,8164,utRho01
732,insH-9,6260050,6260356,6260050,306,118,utRho01
733,insI-3,9017372,9017372,9017234,138,8,utRho01
734,insJ,7441188,7441360,7441188,172,1912,utRho01
735,insK,7442130,7442308,7442130,178,0,utRho01
736,insL-1,30760,30890,30760,130,636,utRho01
737,insL-2,1216112,1216130,1216112,18,50,utRho01
738,insL-3,5028644,5028662,5028644,18,130,utRho01
739,insN-1,540452,540484,540452,32,0,utRho01
740,intD,1132202,1132202,1131956,246,32,utRho01
741,intR,2826520,2826520,2826470,50,0,utRho01
742,intS,4933026,4933090,4933026,64,718,utRho01
743,intZ,5117386,5117542,5117386,156,140,utRho01
744,iraD,9113152,9113986,9113152,834,92,utRho01
745,iraM,2424246,2424246,2424006,240,20,utRho01
746,iraP,802638,802772,802638,134,0,utRho01
747,iscA,5319924,5319924,5319772,152,1700,utRho01
748,iscR,5324398,5324398,5324262,136,27170,utRho01
749,iscX,5313834,5313834,5313472,362,2702,utRho01
750,ispF,5743968,5743968,5743560,408,1558,utRho01
751,ispG,5283908,5283908,5283608,300,966,utRho01
752,ispU,389568,389806,389568,238,204,utRho01
753,isrA,2811502,2811502,2811618,116,0,utRho01
754,istr-1,7706384,7706384,7706384,0,0,utRho01
755,istr-2,7706514,7706514,7706514,0,0,utRho01
756,ivbL,15412092,15412092,15411952,140,552,utRho01
757,ivy,480638,480686,480638,48,0,utRho01
758,katE,3627628,3627734,3627628,106,4,utRho01
759,katG,8267624,8267670,8267624,46,124,utRho01
760,kbaZ,6557732,6557828,6557732,96,0,utRho01
761,kbl,7585154,7585154,7585102,52,640,utRho01
762,kch,2621046,2621046,2620538,508,72,utRho01
763,kdgR,3820506,3820506,3820198,308,8,utRho01
764,kdpE,1443788,1443788,1443466,322,0,utRho01
765,kdpF,1457698,1457698,1457642,56,0,utRho01
766,kdsA,2535708,2536330,2535708,622,4138,utRho01
767,kdsC,6683438,6684546,6683438,1108,4292,utRho01
768,kduI,5968388,5968388,5968248,140,406,utRho01
769,kefF,94160,94492,94160,332,40,utRho01
770,kgtP,5451624,5451624,5451492,132,1344,utRho01
771,kup,7862206,7862632,7862206,426,148,utRho01
772,lacI,735076,735076,735020,56,4,utRho01
773,lacZ,1465508,1465508,1465220,288,308,utRho01
774,ldcA,2486394,2486394,2486160,234,26,utRho01
775,ldhA,2885830,2885830,2885686,144,0,utRho01
776,ldrA,2538954,2538954,2538550,404,1812,utRho01
777,ldrB,2540024,2540024,2539620,404,968,utRho01
778,ldrC,2541092,2541092,2540690,402,1900,utRho01
779,ldrD,7400544,7400544,7400174,370,2366,utRho01
780,lepA,5414392,5414392,5414248,144,202,utRho01
781,lepB,5410928,5410928,5410618,310,902,utRho01
782,leuD,159188,159188,158906,282,28,utRho01
783,leuE,3761600,3761600,3761518,82,0,utRho01
784,leuL,168048,168048,167416,632,0,utRho01
785,leuO,168308,168736,168308,428,0,utRho01
786,leuQ,9212864,9212864,9212802,62,0,utRho01
787,leuU,6644556,6644556,6644316,240,5362,utRho01
788,leuV,9212546,9212546,9212330,216,968,utRho01
789,leuX,8992772,8992810,8992772,38,2,utRho01
790,lexA,8514174,8514230,8514174,56,66,utRho01
791,lhr,3456706,3458174,3456706,1468,2592,utRho01
792,ligA,5060402,5060402,5060352,50,8,utRho01
793,ligB,7642576,7642576,7642340,236,0,utRho01
794,lipA,1320602,1320602,1320432,170,198,utRho01
795,lipB,1324802,1324802,1324556,246,2146,utRho01
796,lit,2397032,2397390,2397032,358,122,utRho01
797,livJ,7199524,7199524,7199316,208,2370,utRho01
798,livK,7195510,7195510,7195120,390,36,utRho01
799,lldP,7554578,7554798,7554578,220,720,utRho01
800,lnt,1381968,1381968,1381762,206,462,utRho01
801,loiP,6163784,6163826,6163784,42,0,utRho01
802,lolA,1874656,1874738,1874656,82,1106,utRho01
803,lolB,2527112,2527112,2527000,112,98,utRho01
804,lolC,2350748,2350854,2350748,106,0,utRho01
805,lon,917630,917776,917630,146,584,utRho01
806,lpcA,486936,487086,486936,150,32,utRho01
807,lpd,255434,255824,255434,390,3880,utRho01
808,lplA,9248476,9248476,9248234,242,1210,utRho01
809,lplT,5947878,5947878,5947724,154,0,utRho01
810,lpoA,6586422,6586800,6586422,378,366,utRho01
811,lpp,3514592,3514842,3514592,250,102,utRho01
812,lptA,6686598,6686760,6686598,162,1866,utRho01
813,lptB,6686792,6687888,6686792,1096,2300,utRho01
814,lptD,114672,114672,114218,454,2888,utRho01
815,lptF,8972244,8972436,8972244,192,90,utRho01
816,lpxC,213016,213114,213016,98,29622,utRho01
817,lpxD,401920,401942,401920,22,68,utRho01
818,lpxL,2233418,2233418,2233164,254,80,utRho01
819,lpxM,3880456,3880456,3880386,70,44,utRho01
820,lpxP,4991156,4991290,4991156,134,696,utRho01
821,lrhA,4813312,4813312,4813282,30,0,utRho01
822,lrp,1864656,1865190,1864656,534,1206,utRho01
823,lspA,50028,50414,50028,386,908,utRho01
824,lsrA,3202920,3202980,3202920,60,0,utRho01
825,lsrR,3202514,3202514,3202482,32,0,utRho01
826,ltaE,1818640,1818640,1818588,52,10,utRho01
827,luxS,5630130,5630130,5629466,664,2598,utRho01
828,lysA,5957902,5957902,5957798,104,0,utRho01
829,lysC,8467232,8467232,8466466,766,826,utRho01
830,lysP,4497120,4497120,4497064,56,112,utRho01
831,lysR,5957900,5958042,5957900,142,0,utRho01
832,lysT,1561028,1561108,1561028,80,212,utRho01
833,lysU,8709610,8709610,8709434,176,46,utRho01
834,macB,1840188,1840694,1840188,506,282,utRho01
835,maeA,3111484,3111484,3111338,146,3108,utRho01
836,mak,820236,820288,820236,52,0,utRho01
837,malE,8492928,8492928,8492838,90,0,utRho01
838,malI,3398456,3398456,3398360,96,0,utRho01
839,malK,8493472,8493568,8493472,96,0,utRho01
840,malP,7105020,7105020,7104946,74,302,utRho01
841,malQ,7100798,7100798,7100140,658,254,utRho01
842,malS,14949880,14949988,14949880,108,40,utRho01
843,malT,7106048,7106170,7106048,122,0,utRho01
844,malX,3398626,3398710,3398626,84,46,utRho01
845,malZ,1689980,1690072,1689980,92,1860,utRho01
846,manA,3377102,3377152,3377102,50,40,utRho01
847,manX,3803866,3804096,3803866,230,12,utRho01
848,marC,3237882,3237882,3237816,66,72,utRho01
849,marR,3238186,3238240,3238186,54,176,utRho01
850,matP,2036918,2036970,2036918,52,110,utRho01
851,mazE,5822736,5822736,5822678,58,36,utRho01
852,mazG,5821720,5821720,5821370,350,2808,utRho01
853,mcbA,1684306,1684306,1684112,194,104,utRho01
854,mcbR,3040192,3040524,3040192,332,72,utRho01
855,mcrA,2420278,2420692,2420278,414,16,utRho01
856,mcrC,9156124,9156124,9155916,208,146,utRho01
857,mdaB,6344814,6345060,6344814,246,68,utRho01
858,mdfA,1767138,1767346,1767138,208,0,utRho01
859,mdh,6768940,6768940,6768536,404,326,utRho01
860,mdoB,9198988,9198988,9198882,106,1056,utRho01
861,mdoD,2993290,2993712,2993290,422,0,utRho01
862,mdoG,2218514,2218670,2218514,156,102,utRho01
863,mdtA,4307958,4308032,4307958,74,60,utRho01
864,mdtE,7318168,7318464,7318168,296,8,utRho01
865,mdtK,3486538,3486914,3486538,376,162,utRho01
866,mdtP,8602472,8602472,8602060,412,36,utRho01
867,melA,8683774,8683822,8683774,48,0,utRho01
868,melR,8683300,8683300,8683256,44,46,utRho01
869,menA,8240812,8240812,8240698,114,16,utRho01
870,menB,4753774,4753774,4753638,136,262,utRho01
871,mepH,3468714,3468870,3468714,156,16,utRho01
872,mepM,3883666,3883666,3883270,396,1118,utRho01
873,mepS,4539840,4539958,4539840,118,890,utRho01
874,metA,8428318,8428560,8428318,242,560,utRho01
875,metB,8257272,8257344,8257272,72,612,utRho01
876,metC,6304150,6304472,6304150,322,318,utRho01
877,metE,8025768,8026106,8025768,338,80,utRho01
878,metF,8265092,8265232,8265092,140,124,utRho01
879,metG,4388538,4388600,4388538,62,74,utRho01
880,metH,8447010,8447656,8447010,646,7424,utRho01
881,metJ,8257116,8257116,8256790,326,272,utRho01
882,metK,6173154,6173412,6173154,258,186,utRho01
883,metN,445428,445428,445290,138,6,utRho01
884,metR,8025710,8025710,8025632,78,0,utRho01
885,metT,1394326,1394326,1394266,60,332,utRho01
886,metY,19910250,19910250,19909734,516,9882,utRho01
887,metZ,11789528,11789548,11789528,20,52,utRho01
888,mfd,2348056,2348056,2347928,128,96,utRho01
889,mglA,4478782,4478782,4478578,204,32,utRho01
890,mglB,4481132,4481132,4480696,436,1330,utRho01
891,mglC,4475918,4475918,4475506,412,26,utRho01
892,mgrB,3817584,3817584,3817532,52,0,utRho01
893,mgrR,3245828,3245828,3245828,0,0,utRho01
894,mgsA,2054082,2054082,2054030,52,96,utRho01
895,mgtL,8934560,8934862,8934560,302,262,utRho01
896,mhpA,737038,737222,737038,184,0,utRho01
897,mhpR,737072,737072,736840,232,30,utRho01
898,mhpT,750772,750918,750772,146,0,utRho01
899,miaA,8797964,8798504,8797964,540,1066,utRho01
900,micA,5629604,5629604,5629604,0,0,utRho01
901,micC,2874242,2874238,2874242,4,0,utRho01
902,micF,4626168,4626168,4626168,0,0,utRho01
903,micM,1014408,1014408,1014408,0,0,utRho01
904,minE,2449422,2449422,2449090,332,992,utRho01
905,mioC,7852950,7852950,7852910,40,0,utRho01
906,mipA,3733012,3733012,3732944,68,3904,utRho01
907,mlaA,4930270,4930270,4930014,256,24,utRho01
908,mlc,3337206,3337206,3337128,78,68,utRho01
909,mlrA,4429498,4429732,4429498,234,8,utRho01
910,mltA,5894546,5894546,5894356,190,94,utRho01
911,mltD,468050,468050,467910,140,0,utRho01
912,mltF,5391534,5391602,5391534,68,0,utRho01
913,mmuP,550238,550650,550238,412,134,utRho01
914,mngA,1531622,1531968,1531622,346,0,utRho01
915,mngR,1531852,1531852,1531750,102,0,utRho01
916,mnmG,7851348,7851348,7851266,82,9442,utRho01
917,mntH,5025470,5025470,5025412,58,44,utRho01
918,mntP,3810918,3811376,3810918,458,978,utRho01
919,mntR,1706160,1706366,1706160,206,18,utRho01
920,mntS,1706128,1706128,1705994,134,18,utRho01
921,moaA,1633654,1634088,1633654,434,1674,utRho01
922,moaB,1635954,1636110,1635954,156,848,utRho01
923,mobA,8084242,8084242,8083998,244,362,utRho01
924,mocA,6030112,6030320,6030112,208,0,utRho01
925,modA,1589990,1590178,1589990,188,140,utRho01
926,moeA,1732788,1732788,1732728,60,72,utRho01
927,mokB,2984610,2984610,2984258,352,540,utRho01
928,molR_1,4392888,4392948,4392888,60,186,utRho01
929,motA,3954604,3954604,3954278,326,52,utRho01
930,mpaA,2781278,2781278,2781196,82,74,utRho01
931,mpl,8911456,8911570,8911456,114,0,utRho01
932,mppA,2786108,2786454,2786108,346,0,utRho01
933,mprA,5621494,5621540,5621494,46,470,utRho01
934,mqo,4613848,4613848,4613508,340,880,utRho01
935,mqsA,6336742,6336742,6336492,250,198,utRho01
936,mqsR,6337306,6337306,6337088,218,188,utRho01
937,mraZ,179192,179268,179192,76,30,utRho01
938,mrcA,7045652,7045742,7045652,90,0,utRho01
939,mrcB,329442,329460,329442,18,0,utRho01
940,mreB,13605424,13605424,13604348,1076,2244,utRho01
941,mreD,6798166,6798166,6797750,416,350,utRho01
942,mrp,4388360,4388360,4388336,24,0,utRho01
943,mscK,972984,973072,972984,88,44,utRho01
944,mscL,6876002,6876048,6876002,46,138,utRho01
945,mscS,6139742,6139742,6139614,128,50,utRho01
946,msrA,8884522,8884522,8884352,170,50,utRho01
947,msrB,3725168,3725168,3724858,310,0,utRho01
948,msyB,2228426,2228426,2228362,64,298,utRho01
949,mtfA,4087236,4087302,4087236,66,414,utRho01
950,mtgA,6699662,6699662,6699618,44,280,utRho01
951,mtlA,30177504,30178248,30177504,744,392,utRho01
952,mtn,358366,358366,358306,60,0,utRho01
953,mtr,6611864,6611864,6611634,230,88,utRho01
954,mug,6430992,6430992,6430946,46,112,utRho01
955,murQ,5091466,5091546,5091466,80,0,utRho01
956,murR,5091586,5091586,5091218,368,60,utRho01
957,mutH,5939164,5939324,5939164,160,494,utRho01
958,mutL,8794092,8794824,8794092,732,1150,utRho01
959,mutM,7622554,7622554,7622304,250,1972,utRho01
960,mutS,5714038,5714186,5714038,148,346,utRho01
961,mutY,18617466,18618078,18617466,612,222,utRho01
962,nac,4123956,4123956,4123866,90,0,utRho01
963,nadA,1564122,1564170,1564122,48,20,utRho01
964,nadB,5420714,5420840,5420714,126,16,utRho01
965,nadC,237326,237326,237290,36,30,utRho01
966,nadE,3644604,3644916,3644604,312,34,utRho01
967,nadK,5501526,5501662,5501526,136,108,utRho01
968,nagA,1406350,1406350,1405502,848,1734,utRho01
969,nagB,1407416,1407416,1407222,194,108,utRho01
970,nagC,1404016,1404016,1403188,828,202,utRho01
971,nagE,1407680,1407888,1407680,208,82,utRho01
972,nagK,2357080,2357186,2357080,106,140,utRho01
973,nanA,6747240,6747240,6747152,88,14,utRho01
974,nanC,9079856,9079856,9079002,854,2,utRho01
975,nanR,6749406,6749406,6748978,428,88,utRho01
976,nanS,9075406,9075406,9075188,218,0,utRho01
977,napF,4607390,4607390,4606994,396,4,utRho01
978,narG,2559614,2559728,2559614,114,0,utRho01
979,narK,2555642,2555914,2555642,272,0,utRho01
980,narP,4580844,4581000,4580844,156,26,utRho01
981,narQ,5171154,5171462,5171154,308,8,utRho01
982,narU,3088326,3088326,3088120,206,0,utRho01
983,narW,3077374,3077374,3074618,2756,0,utRho01
984,narX,2555554,2555554,2555236,318,18,utRho01
985,narZ,3085380,3085380,3085180,200,0,utRho01
986,ndh,2331984,2332170,2331984,186,50,utRho01
987,ndk,5289920,5289920,5289728,192,262,utRho01
988,nemR,6904084,6904092,6904084,8,52,utRho01
989,nepI,7683542,7683542,7683478,64,340,utRho01
990,nfo,4501612,4501680,4501612,68,70,utRho01
991,nfsB,1210906,1210906,1210848,58,42,utRho01
992,nfuA,7090916,7091248,7090916,332,874,utRho01
993,nhaA,34634,34978,34634,344,202,utRho01
994,nhaB,2469534,2469534,2469434,100,18,utRho01
995,nhoA,3067926,3068048,3067926,122,30,utRho01
996,nikA,7226878,7227334,7226878,456,2622,utRho01
997,nikR,7237074,7237176,7237074,102,64,utRho01
998,nirB,6987974,6988022,6987974,48,24,utRho01
999,nlpA,7680034,7680034,7679986,48,0,utRho01
1000,nlpC,3585654,3585654,3585462,192,10,utRho01
1001,nlpD,5737658,5737658,5737506,152,118,utRho01
1002,nlpI,6618080,6618080,6617848,232,32,utRho01
1003,nmpC,1153740,1153740,1153650,90,0,utRho01
1004,nohA,3273206,3273206,3272734,472,88,utRho01
1005,norR,5664614,5664614,5664578,36,0,utRho01
1006,norV,5664878,5664952,5664878,74,0,utRho01
1007,nrdA,4689510,4689730,4689510,220,14584,utRho01
1008,nrdD,8925676,8925676,8925320,356,1770,utRho01
1009,nrdH,5601312,5601446,5601312,134,794,utRho01
1010,nrdR,865954,866004,865954,50,18,utRho01
1011,nrfA,8575342,8575528,8575342,186,44,utRho01
1012,nsrR,8812088,8812380,8812088,292,52516,utRho01
1013,nudB,3897348,3897348,3897264,84,32,utRho01
1014,nudC,8393428,8393806,8393428,378,98,utRho01
1015,nudE,7052658,7052658,7052298,360,6958,utRho01
1016,nudG,3682876,3682980,3682876,104,0,utRho01
1017,nudI,4729050,4729108,4729050,58,0,utRho01
1018,nudJ,2388874,2388874,2388576,298,2280,utRho01
1019,nuoA,4810670,4810670,4810144,526,2262,utRho01
1020,nuoN,4783434,4783434,4783010,424,2016,utRho01
1021,nupC,5026018,5026084,5026018,66,26,utRho01
1022,nupG,6211302,6211428,6211302,126,38,utRho01
1023,ogrK,4335096,4335096,4335040,56,0,utRho01
1024,ogt,2800568,2800568,2800472,96,182,utRho01
1025,ohsC,5401036,5401040,5401036,4,18,utRho01
1026,ompA,2040382,2040382,2040106,276,21384,utRho01
1027,ompC,4625774,4625774,4625498,276,98,utRho01
1028,ompF,1974184,1974184,1973964,220,206,utRho01
1029,ompL,8128958,8128958,8128590,368,0,utRho01
1030,ompN,2874158,2874158,2873786,372,0,utRho01
1031,ompR,7073510,7073510,7073168,342,208,utRho01
1032,ompT,1171330,1171330,1171266,64,50,utRho01
1033,ompW,2627982,2628040,2627982,58,0,utRho01
1034,ompX,1700418,1700900,1700418,482,1152,utRho01
1035,omrA,5952378,5952378,5952378,0,0,utRho01
1036,omrB,5952770,5952770,5952770,0,0,utRho01
1037,oppA,2602170,2602364,2602170,194,23324,utRho01
1038,orn,8783168,8783208,8783168,40,26,utRho01
1039,osmB,2686952,2686952,2686656,296,36,utRho01
1040,osmC,3113192,3113250,3113192,58,34,utRho01
1041,osmE,3644566,3644566,3644512,54,22,utRho01
1042,osmF,4439046,4439046,4438962,84,478,utRho01
1043,osmY,9222306,9222792,9222306,486,206,utRho01
1044,otsA,3963302,3963302,3963224,78,12,utRho01
1045,otsB,3964930,3964930,3964774,156,22,utRho01
1046,oxc,4984288,4984288,4983900,388,12,utRho01
1047,oxyR,8316914,8316980,8316914,66,50,utRho01
1048,oxyS,8316788,8316788,8316788,0,0,utRho01
1049,paaA,2907730,2907854,2907730,124,0,utRho01
1050,paaX,2927018,2927078,2927018,60,0,utRho01
1051,paaZ,2907340,2907340,2907284,56,0,utRho01
1052,pabA,6981702,6981702,6981658,44,0,utRho01
1053,pabB,3789256,3789610,3789256,354,364,utRho01
1054,pabC,2306186,2306600,2306186,414,506,utRho01
1055,pagP,1313052,1313114,1313052,62,0,utRho01
1056,panB,299260,299260,299202,58,140,utRho01
1057,panC,297840,297840,297590,250,290,utRho01
1058,panD,293490,293490,293388,102,74,utRho01
1059,panZ,7195656,7195968,7195656,312,26,utRho01
1060,parC,6332060,6332060,6331946,114,218,utRho01
1061,patA,6438916,6438988,6438916,72,0,utRho01
1062,patD,3030830,3031156,3030830,326,2,utRho01
1063,pbpC,5294986,5294986,5294650,336,0,utRho01
1064,pbpG,4450132,4450132,4449740,392,68,utRho01
1065,pck,7065358,7065636,7065358,278,2128,utRho01
1066,pcnB,318782,318782,318252,530,1028,utRho01
1067,pdhR,244068,244184,244068,116,378,utRho01
1068,pdxB,4875768,4875768,4875702,66,0,utRho01
1069,pdxH,3436068,3436068,3436014,54,218,utRho01
1070,pdxJ,5403626,5403626,5403458,168,230,utRho01
1071,pdxK,5074638,5074638,5074474,164,50,utRho01
1072,pepA,8972278,8972278,8971902,376,222,utRho01
1073,pepD,511618,511618,511432,186,3396,utRho01
1074,pepN,1981182,1981244,1981182,62,42,utRho01
1075,pepQ,8062294,8062322,8062294,28,22,utRho01
1076,pepT,2371646,2371688,2371646,42,30,utRho01
1077,pfkA,8214948,8215104,8214948,156,206,utRho01
1078,pfkB,3612646,3612740,3612646,94,0,utRho01
1079,pflA,1902456,1902456,1902160,296,0,utRho01
1080,pflB,1907850,1907850,1907108,742,1102,utRho01
1081,pflD,8287716,8287990,8287716,274,0,utRho01
1082,pgaA,2185046,2185046,2184578,468,80,utRho01
1083,pgi,8467444,8467516,8467444,72,38,utRho01
1084,pgk,12291428,12291428,12290488,940,5048,utRho01
1085,pgl,1597078,1597172,1597078,94,62,utRho01
1086,pgpB,2678324,2678660,2678324,336,78,utRho01
1087,pgpC,5397276,5397276,5397100,176,52,utRho01
1088,pgrR,2783744,2783982,2783744,238,48,utRho01
1089,pheL,5475158,5475198,5475158,40,66,utRho01
1090,pheM,7197204,7197204,7197080,124,36,utRho01
1091,pheP,1203858,1203918,1203858,60,4,utRho01
1092,pheU,8725254,8725254,8725252,2,0,utRho01
1093,pheV,6220730,6220732,6220730,2,0,utRho01
1094,phnC,8650412,8650412,8650330,82,0,utRho01
1095,phoA,803414,803494,803414,80,18,utRho01
1096,phoB,834202,834284,834202,82,0,utRho01
1097,phoE,520316,520316,520200,116,12,utRho01
1098,phoH,2169730,2169984,2169730,254,558,utRho01
1099,phoP,2381016,2381016,2380894,122,920,utRho01
1100,phoQ,2379880,2379880,2379552,328,1608,utRho01
1101,phoU,7815330,7815330,7815156,174,216,utRho01
1102,phr,1478842,1479014,1478842,172,90,utRho01
1103,pinE,2419054,2419370,2419054,316,38,utRho01
1104,pinQ,3267168,3267244,3267168,76,1480,utRho01
1105,pinR,2867424,2867424,2867348,76,1712,utRho01
1106,pitA,7275224,7275284,7275224,60,18,utRho01
1107,pitB,6272806,6272806,6272742,64,0,utRho01
1108,pka,5439862,5439906,5439862,44,52,utRho01
1109,plaP,4174476,4174476,4174124,352,746,utRho01
1110,pldA,8009628,8009724,8009628,96,42,utRho01
1111,pldB,8018028,8018340,8018028,312,238,utRho01
1112,plsB,8513196,8513196,8512932,264,376,utRho01
1113,pmbA,8915890,8915918,8915890,28,56,utRho01
1114,pmrD,4747148,4747148,4747076,72,28,utRho01
1115,pncB,1980828,1980828,1980712,116,60,utRho01
1116,pncC,5648788,5648788,5648692,96,4,utRho01
1117,pnp,6622652,6622652,6622336,316,110,utRho01
1118,pntA,3355950,3355950,3355806,144,0,utRho01
1119,pntB,3353096,3353096,3352720,376,20,utRho01
1120,polA,8093880,8093932,8093880,52,50,utRho01
1121,polB,131606,131606,131560,46,0,utRho01
1122,potD,2365700,2365700,2365658,42,52,utRho01
1123,potE,1436688,1436688,1436530,158,16,utRho01
1124,potF,1787268,1787568,1787268,300,156,utRho01
1125,poxB,1822152,1822152,1822098,54,0,utRho01
1126,ppa,8899372,8899372,8899304,68,286,utRho01
1127,ppc,8306380,8306380,8306196,184,636,utRho01
1128,ppdA,5928440,5928440,5928354,86,1270,utRho01
1129,ppdD,235410,235410,235098,312,398,utRho01
1130,pphA,3846770,3846770,3845938,832,2272,utRho01
1131,pphB,5719474,5719520,5719474,46,0,utRho01
1132,ppiA,6984898,6984898,6984594,304,62,utRho01
1133,ppiC,7919682,7919682,7919626,56,144,utRho01
1134,ppiD,923638,923830,923638,192,690,utRho01
1135,ppk,5245748,5246088,5245748,340,186,utRho01
1136,pppA,6228958,6228958,6228704,254,8,utRho01
1137,ppsA,3574322,3574322,3574224,98,0,utRho01
1138,ppsR,3574678,3574890,3574678,212,32,utRho01
1139,pptA,3065716,3066104,3065716,388,36,utRho01
1140,pqiA,2023318,2024002,2023318,684,76,utRho01
1141,prc,3830054,3830054,3829632,422,26348,utRho01
1142,preT,4467978,4468066,4467978,88,60,utRho01
1143,prfC,9218688,9218828,9218688,140,1038,utRho01
1144,prkB,6968622,6968980,6968622,358,1116,utRho01
1145,prlC,7290476,7290476,7290364,112,262,utRho01
1146,prlF,6553944,6554004,6553944,60,88,utRho01
1147,proB,520432,520776,520432,344,102,utRho01
1148,proC,811372,811372,811288,84,0,utRho01
1149,proK,7417388,7417388,7417384,4,12,utRho01
1150,proL,4572414,4572422,4572414,8,18,utRho01
1151,proP,8660640,8661004,8660640,364,5608,utRho01
1152,proS,437674,437674,437550,124,390,utRho01
1153,proV,5609126,5609630,5609126,504,232,utRho01
1154,prpB,697292,697364,697292,72,8,utRho01
1155,prpR,696942,696942,696886,56,0,utRho01
1156,prs,2524354,2524354,2523750,604,59308,utRho01
1157,psd,8781276,8781276,8780720,556,5310,utRho01
1158,psiE,8480600,8480650,8480600,50,30,utRho01
1159,pspA,2736076,2736158,2736076,82,0,utRho01
1160,pspF,2736080,2736080,2735824,256,0,utRho01
1161,pspG,8525632,8525680,8525632,48,4,utRho01
1162,pssA,5445156,5445454,5445156,298,1678,utRho01
1163,pstB,7817112,7817112,7816732,380,146,utRho01
1164,pstC,7821084,7821084,7820796,288,46,utRho01
1165,pstS,23469408,23469408,23469150,258,12,utRho01
1166,psuG,4517114,4517114,4516734,380,32,utRho01
1167,psuT,4514992,4514992,4514670,322,0,utRho01
1168,pth,2517084,2517084,2517026,58,82,utRho01
1169,ptrA,5918022,5918022,5917768,254,34,utRho01
1170,ptrB,3857730,3857730,3857678,52,4352,utRho01
1171,ptsG,2315252,2315738,2315252,486,2376,utRho01
1172,ptsH,5066996,5067528,5066996,532,2748,utRho01
1173,purA,8809328,8809374,8809328,46,32,utRho01
1174,purC,5195562,5195562,5195236,326,28,utRho01
1175,purD,8411972,8411972,8411862,110,40,utRho01
1176,purE,1106284,1106284,1106200,84,1202,utRho01
1177,purH,8415254,8415254,8415064,190,74,utRho01
1178,purL,5391178,5391178,5391086,92,206,utRho01
1179,purM,5242306,5242394,5242306,88,76,utRho01
1180,purR,3475378,3475688,3475378,310,1406,utRho01
1181,purT,3861438,3861762,3861438,324,80,utRho01
1182,purU,2577512,2577512,2577248,264,896,utRho01
1183,putA,2157850,2157850,2157764,86,0,utRho01
1184,putP,2158336,2158610,2158336,274,420,utRho01
1185,puuA,2721936,2721936,2721816,120,0,utRho01
1186,puuC,2725456,2725486,2725456,30,0,utRho01
1187,puuD,2722104,2722240,2722104,136,46,utRho01
1188,puuP,2718746,2718746,2718374,372,460,utRho01
1189,pykA,3874988,3875298,3874988,310,382,utRho01
1190,pykF,3510934,3511396,3510934,462,1732,utRho01
1191,pyrC,2245286,2245286,2245214,72,164,utRho01
1192,pyrD,2009464,2009536,2009464,72,160,utRho01
1193,pyrE,7631970,7631970,7631536,434,76,utRho01
1194,pyrF,2683740,2683842,2683740,102,260,utRho01
1195,pyrG,5819594,5819594,5819332,262,3362,utRho01
1196,pyrH,383624,383710,383624,86,1626,utRho01
1197,pyrL,8945490,8945490,8945066,424,54,utRho01
1198,qmcA,1031646,1031646,1031546,100,46,utRho01
1199,qor,8528608,8528608,8528462,146,258,utRho01
1200,qseB,6339502,6339656,6339502,154,8,utRho01
1201,queA,849970,850022,849970,52,772,utRho01
1202,queE,5811212,5811212,5810836,376,86,utRho01
1203,queF,5850642,5850696,5850642,54,0,utRho01
1204,queG,8788184,8788184,8788134,50,820,utRho01
1205,racC,2835630,2835630,2835526,104,0,utRho01
1206,racR,2840898,2840898,2840482,416,44,utRho01
1207,raiA,5474208,5474308,5474208,100,294,utRho01
1208,rarD,8008594,8008594,8008356,238,146,utRho01
1209,ravA,7862256,7862256,7862186,70,46,utRho01
1210,rayT,495088,495274,495088,186,0,utRho01
1211,rbn,4763162,4763216,4763162,54,2,utRho01
1212,rbsD,7866644,7866702,7866644,58,0,utRho01
1213,rcnA,4371654,4371834,4371654,180,6,utRho01
1214,rcnB,4373768,4373920,4373768,152,80,utRho01
1215,rcnR,4371806,4371806,4371592,214,24,utRho01
1216,rcsA,4047672,4047936,4047672,264,304,utRho01
1217,rcsB,4631390,4632354,4631390,964,1314,utRho01
1218,rcsC,4640162,4640162,4639656,506,588,utRho01
1219,rcsD,4626904,4626976,4626904,72,462,utRho01
1220,rdgB,6193240,6193362,6193240,122,500,utRho01
1221,rdlA,2538646,2538646,2538646,0,0,utRho01
1222,rdlB,2539712,2539716,2539712,4,0,utRho01
1223,rdlC,2540782,2540786,2540782,4,0,utRho01
1224,rdlD,7400272,7400272,7400272,0,0,utRho01
1225,rdoA,8084782,8084830,8084782,48,92,utRho01
1226,recA,11295276,11295276,11295076,200,1600,utRho01
1227,recC,5925014,5925014,5924856,158,70,utRho01
1228,recF,7763722,7763722,7762442,1280,12374,utRho01
1229,recN,5503518,5503590,5503518,72,0,utRho01
1230,recQ,8011666,8011728,8011666,62,18,utRho01
1231,relA,5828554,5828554,5827302,1252,378,utRho01
1232,relB,3291806,3291806,3291744,62,36,utRho01
1233,rem,3289950,3289950,3289804,146,24,utRho01
1234,rep,7921294,7921354,7921294,60,94,utRho01
1235,rfaD,7587730,7587974,7587730,244,326,utRho01
1236,rfaE,6393852,6393852,6393506,346,0,utRho01
1237,rfaH,8049930,8049930,8049642,288,2372,utRho01
1238,rfbX,4219436,4219436,4219168,268,3056,utRho01
1239,rfe,7935600,7935832,7935600,232,48,utRho01
1240,rhaB,8194944,8194944,8194896,48,0,utRho01
1241,rhaD,8188770,8188770,8188544,226,0,utRho01
1242,rhaS,8195422,8195472,8195422,50,0,utRho01
1243,rhaT,8201132,8201132,8201050,82,0,utRho01
1244,rhlE,1661566,1661744,1661566,178,840,utRho01
1245,rhoL,47593944,47594772,47593944,828,449292,utRho01
1246,rhsB,7238006,7238384,7238006,378,232,utRho01
1247,rhsC,1458758,1459166,1458758,408,0,utRho01
1248,rhsD,1046132,1046522,1046132,390,0,utRho01
1249,rhtA,1700608,1700608,1700194,414,16,utRho01
1250,rhtC,8015478,8015514,8015478,36,2632,utRho01
1251,ribA,2678468,2678468,2678320,148,78,utRho01
1252,ribC,3486916,3486916,3486484,432,178,utRho01
1253,ribE,869008,869294,869008,286,8442,utRho01
1254,ribF,42766,42814,42766,48,14,utRho01
1255,ridA,8941892,8941892,8941826,66,14,utRho01
1256,rihA,1369204,1369204,1368824,380,476,utRho01
1257,rihB,4510504,4510504,4510372,132,0,utRho01
1258,rimJ,2251044,2251124,2251044,80,4,utRho01
1259,rimK,1783752,1783934,1783752,182,208,utRho01
1260,rimL,2997486,2997876,2997486,390,118,utRho01
1261,rimO,1756140,1756140,1756070,70,8,utRho01
1262,rimP,6636350,6636350,6636012,338,1078,utRho01
1263,rlmA,3814172,3814172,3814120,52,284,utRho01
1264,rlmD,5830086,5830086,5830000,86,22,utRho01
1265,rlmE,6655520,6655520,6655328,192,3394,utRho01
1266,rlmF,1684384,1684664,1684384,280,102,utRho01
1267,rlmG,6471784,6471784,6471750,34,24,utRho01
1268,rlmI,2060002,2060002,2059938,64,98,utRho01
1269,rlmJ,7290700,7290770,7290700,70,86,utRho01
1270,rlmL,2015344,2015688,2015344,344,1068,utRho01
1271,rlpA,1330444,1330444,1330380,64,242,utRho01
1272,rluA,120900,120900,120692,208,440,utRho01
1273,rluF,8460324,8460708,8460324,384,56,utRho01
1274,rmf,2031006,2031430,2031006,424,1874,utRho01
1275,rna,1290068,1290068,1290006,62,52,utRho01
1276,rnb,2698258,2698258,2697824,434,3018,utRho01
1277,rnc,10816892,10816892,10816252,640,12144,utRho01
1278,rnd,3776122,3776122,3775982,140,294,utRho01
1279,rne,2289746,2289746,2288734,1012,11162,utRho01
1280,rnhA,472082,472082,472004,78,418,utRho01
1281,rnk,1288360,1288360,1287934,426,110,utRho01
1282,rnlA,5531788,5531836,5531788,48,36,utRho01
1283,rnlB,5533414,5533968,5533414,554,2706,utRho01
1284,rnpB,19623552,19623552,19623552,0,0,utRho01
1285,rob,9270706,9270706,9270620,86,18,utRho01
1286,rodZ,5285868,5285868,5285688,180,202,utRho01
1287,rpe,7030306,7030306,7030118,188,206,utRho01
1288,rph,15266320,15266320,15266196,124,104,utRho01
1289,rpiA,6118706,6118706,6118650,56,0,utRho01
1290,rpiB,8626514,8626700,8626514,186,4,utRho01
1291,rpiR,8626274,8626274,8625982,292,0,utRho01
1292,rplJ,8359246,8359992,8359246,746,9826,utRho01
1293,rplK,8356708,8356894,8356708,186,832,utRho01
1294,rplM,6757344,6757344,6757302,42,13348,utRho01
1295,rplN,6896444,6896444,6896298,146,6274,utRho01
1296,rplS,5489284,5489284,5489060,224,16734,utRho01
1297,rplT,7199052,7199052,7198996,56,912,utRho01
1298,rplU,6667036,6667036,6666902,134,198,utRho01
1299,rplY,4564866,4565034,4564866,168,78,utRho01
1300,rpmA,6666450,6666450,6666238,212,710,utRho01
1301,rpmB,15247980,15247980,15246696,1284,130128,utRho01
1302,rpmE,8253816,8254026,8253816,210,690,utRho01
1303,rpmF,2294676,2294734,2294676,58,67760,utRho01
1304,rpmH,7768130,7768672,7768130,542,8248,utRho01
1305,rpmI,3600854,3600854,3599998,856,16930,utRho01
1306,rpoB,8362126,8362490,8362126,364,672,utRho01
1307,rpoD,6424946,6426094,6424946,1148,23030,utRho01
1308,rpoE,5420372,5420372,5420024,348,28,utRho01
1309,rpoH,7202006,7202006,7201566,440,25568,utRho01
1310,rpoN,6689324,6689434,6689324,110,38,utRho01
1311,rpoS,5736236,5736236,5735102,1134,3572,utRho01
1312,rpoZ,7644154,7644212,7644154,58,1080,utRho01
1313,rppH,5937986,5937986,5937954,32,6,utRho01
1314,rprA,3540744,3540744,3540744,0,0,utRho01
1315,rpsA,1923434,1923990,1923434,556,182504,utRho01
1316,rpsF,8850050,8850236,8850050,186,45588,utRho01
1317,rpsI,6756580,6756580,6756414,166,12872,utRho01
1318,rpsJ,6906884,6906884,6906540,344,10430,utRho01
1319,rpsL,6949242,6949242,6949104,138,220,utRho01
1320,rpsM,6885130,6885130,6884942,188,2300,utRho01
1321,rpsO,13247144,13247144,13246736,408,1628,utRho01
1322,rpsP,5492508,5492508,5492370,138,38,utRho01
1323,rpsT,42420,42420,42156,264,1098,utRho01
1324,rpsU,12842584,12843124,12842584,540,1932,utRho01
1325,rraA,8238716,8238716,8238660,56,88,utRho01
1326,rraB,8956768,8956946,8956768,178,0,utRho01
1327,rrsA,8070478,8071062,8070478,584,10182,utRho01
1328,rrsB,16665468,16666636,16665468,1168,21780,utRho01
1329,rrsC,7883032,7883616,7883032,584,11690,utRho01
1330,rrsD,6858094,6858094,6857524,570,610,utRho01
1331,rrsE,8415726,8416294,8415726,568,1474,utRho01
1332,rrsG,5462896,5462896,5462314,582,8510,utRho01
1333,rrsH,446970,447542,446970,572,1324,utRho01
1334,rsd,8393908,8393908,8393616,292,124,utRho01
1335,rseA,5419264,5419264,5418808,456,880,utRho01
1336,rseP,392940,393092,392940,152,164,utRho01
1337,rseX,4067298,4067298,4067298,0,0,utRho01
1338,rsfS,1338144,1338144,1338072,72,346,utRho01
1339,rsgA,8783132,8783132,8783018,114,92,utRho01
1340,rsmA,105176,105176,104860,316,4690,utRho01
1341,rsmB,6869982,6870414,6869982,432,672,utRho01
1342,rsmC,9215736,9215736,9215400,336,714,utRho01
1343,rsmD,7208594,7208786,7208594,192,4,utRho01
1344,rsmE,6182036,6182268,6182036,232,306,utRho01
1345,rsmG,7847512,7847512,7847360,152,3032,utRho01
1346,rsmH,180020,180188,180020,168,460,utRho01
1347,rsmI,6587106,6587106,6586670,436,1154,utRho01
1348,rssA,2578212,2578412,2578212,200,458,utRho01
1349,rssB,2580440,2580484,2580440,44,492,utRho01
1350,rstA,3364276,3364300,3364276,24,0,utRho01
1351,rsuA,4561096,4561096,4560966,130,400,utRho01
1352,rsxA,3411510,3411534,3411510,24,8,utRho01
1353,rtcA,7114004,7114004,7113698,306,72,utRho01
1354,rtcB,7116214,7116214,7116158,56,0,utRho01
1355,rtn,4541356,4541452,4541356,96,158,utRho01
1356,rutA,2148052,2148052,2148022,30,0,utRho01
1357,rutG,2140090,2140090,2139678,412,70,utRho01
1358,rutR,2148226,2148484,2148226,258,4,utRho01
1359,ruvA,7784096,7784096,7783904,192,64,utRho01
1360,ruvB,7782176,7782176,7781424,752,760,utRho01
1361,ruvC,3894878,3894878,3894752,126,38,utRho01
1362,rybB,1776114,1776114,1776114,0,0,utRho01
1363,rydB,3529860,3529860,3529322,538,358,utRho01
1364,rydC,2983012,2983012,2983012,0,0,utRho01
1365,ryfA,5307398,5307710,5307398,312,26,utRho01
1366,ryfD,5468590,5468590,5468590,0,0,utRho01
1367,ryhB,7162032,7162032,7162032,0,0,utRho01
1368,ryjA,8556132,8556132,8556132,0,0,utRho01
1369,ryjB,9055954,9055954,9055954,0,0,utRho01
1370,sad,3229598,3229598,3229406,192,88,utRho01
1371,safA,3168056,3168056,3167918,138,0,utRho01
1372,sanA,4465368,4465756,4465368,388,128,utRho01
1373,sapF,2705314,2705314,2705268,46,120,utRho01
1374,sbcB,4165456,4165512,4165456,56,0,utRho01
1375,sbcC,831694,831694,831506,188,178,utRho01
1376,sbcD,833954,833954,833904,50,18,utRho01
1377,sbmA,793106,793278,793106,172,38,utRho01
1378,sbmC,4162650,4162650,4162524,126,24,utRho01
1379,sdaA,3793618,3793864,3793618,246,196,utRho01
1380,sdaC,5856070,5856458,5856070,388,618,utRho01
1381,sdhC,1509916,1510354,1509916,438,22968,utRho01
1382,sdhD,1510808,1511120,1510808,312,5748,utRho01
1383,sdiA,3993834,3993834,3993664,170,64,utRho01
1384,secE,8354354,8354716,8354354,362,494,utRho01
1385,secG,6645180,6645180,6645010,170,3860,utRho01
1386,selA,7522594,7522594,7522498,96,624,utRho01
1387,selB,7519850,7519850,7519722,128,156,utRho01
1388,selC,7672396,7672444,7672396,48,0,utRho01
1389,selD,3696058,3696058,3696016,42,4982,utRho01
1390,seqA,1425884,1425974,1425884,90,688,utRho01
1391,serA,6117098,6117098,6116820,278,76,utRho01
1392,serB,9249712,9249790,9249712,78,20,utRho01
1393,serC,3830380,3830612,3830380,232,0,utRho01
1394,serS,1878730,1878856,1878730,126,3996,utRho01
1395,serT,2063438,2063438,2063424,14,0,utRho01
1396,serU,4087124,4087124,4087114,10,56,utRho01
1397,serV,5637394,5637394,5637290,104,236,utRho01
1398,serW,1852014,1852014,1851942,72,346,utRho01
1399,serX,2195352,2195352,2195304,48,20,utRho01
1400,setB,4527426,4527726,4527426,300,0,utRho01
1401,setC,7673488,7673906,7673488,418,0,utRho01
1402,sfmA,1116124,1116424,1116124,300,0,utRho01
1403,sfmC,1117606,1117948,1117606,342,0,utRho01
1404,sfsA,323030,323030,322972,58,246,utRho01
1405,sfsB,6669592,6669818,6669592,226,482,utRho01
1406,sgrR,154676,154676,154598,78,14,utRho01
1407,sgrS,154734,154734,154734,0,0,utRho01
1408,shiA,4107068,4107286,4107068,218,16,utRho01
1409,sibA,4306622,4306622,4306622,0,0,utRho01
1410,sibB,4307292,4307292,4307292,0,0,utRho01
1411,sibC,6113702,6113702,6113702,0,0,utRho01
1412,sibD,6389730,6389730,6389730,0,0,utRho01
1413,sibE,6390480,6390480,6390480,0,0,utRho01
1414,sixA,4913998,4913998,4913624,374,2,utRho01
1415,slp,7307872,7307922,7307872,50,0,utRho01
1416,slt,9261400,9261466,9261400,66,42,utRho01
1417,slyA,3442028,3442028,3441648,380,132,utRho01
1418,slyB,3439496,3439752,3439496,256,134,utRho01
1419,slyD,6957398,6957398,6956994,404,406,utRho01
1420,slyX,6954862,6955280,6954862,418,10132,utRho01
1421,smf,6867372,6867372,6867120,252,224,utRho01
1422,smpB,5509534,5509792,5509534,258,1696,utRho01
1423,smrA,2811872,2811958,2811872,86,132,utRho01
1424,smrB,4896872,4897212,4896872,340,70,utRho01
1425,smtA,1946808,1947074,1946808,266,58,utRho01
1426,sodA,8201518,8201620,8201518,102,7842,utRho01
1427,sodB,3470646,3470756,3470646,110,38,utRho01
1428,sodC,3449358,3449358,3449310,48,90,utRho01
1429,sohB,2658568,2658664,2658568,96,84,utRho01
1430,sokB,2984232,2984238,2984232,6,30,utRho01
1431,solA,2241218,2241218,2241172,46,34,utRho01
1432,soxR,8554894,8554938,8554894,44,20,utRho01
1433,soxS,8554846,8554846,8554766,80,12,utRho01
1434,speA,6172096,6172096,6171822,274,278,utRho01
1435,speB,6167892,6167892,6167594,298,124,utRho01
1436,speC,6218350,6218350,6218310,40,26,utRho01
1437,spf,8099798,8099798,8099798,0,0,utRho01
1438,sppA,3697422,3697674,3697422,252,26,utRho01
1439,spy,3651376,3651376,3651250,126,0,utRho01
1440,sra,3112092,3112092,3111926,166,0,utRho01
1441,sraB,2293178,2293178,2293178,0,0,utRho01
1442,sraC,3846132,3846132,3846132,0,0,utRho01
1443,srlA,5651582,5651664,5651582,82,0,utRho01
1444,srlR,5657720,5658094,5657720,374,472,utRho01
1445,srmB,5425752,5425792,5425752,40,88,utRho01
1446,sroA,151216,151216,151216,0,0,utRho01
1447,sroG,6369436,6369436,6369436,0,0,utRho01
1448,sroH,8380974,8380974,8380974,0,0,utRho01
1449,ssb,8548022,8548250,8548022,228,428,utRho01
1450,sseA,5304782,5304988,5304782,206,4888,utRho01
1451,sspA,6755138,6755138,6754840,298,1082,utRho01
1452,ssrA,5511014,5511186,5511014,172,290,utRho01
1453,ssrS,12223036,12223932,12223036,896,1308,utRho01
1454,sstT,6479726,6479888,6479726,162,132,utRho01
1455,ssuB,1988282,1988282,1988088,194,0,utRho01
1456,ssuE,1995126,1995126,1995024,102,0,utRho01
1457,sthA,8321604,8321604,8321580,24,2292,utRho01
1458,stpA,5597156,5597156,5596990,166,6,utRho01
1459,sucA,3034344,3034824,3034344,480,1696,utRho01
1460,sufA,3528836,3528836,3528772,64,24,utRho01
1461,sufE,3518962,3518962,3518580,382,1728,utRho01
1462,sugE,8753588,8753750,8753588,162,1078,utRho01
1463,sulA,2041894,2041894,2041838,56,328,utRho01
1464,syd,5850738,5850738,5850560,178,86,utRho01
1465,symE,9159834,9159834,9159680,154,250,utRho01
1466,symR,9159670,9159670,9159670,0,0,utRho01
1467,tabA,8949566,8949724,8949566,158,0,utRho01
1468,talA,5157140,5157332,5157140,192,2,utRho01
1469,talB,16382,16476,16382,94,6034,utRho01
1470,tam,3214442,3214692,3214442,250,0,utRho01
1471,tamA,8884540,8884764,8884540,224,8,utRho01
1472,tar,3945432,3945432,3945382,50,0,utRho01
1473,tas,5943138,5943194,5943138,56,228,utRho01
1474,tatA,16087636,16087780,16087636,144,196,utRho01
1475,tatE,1317742,1317894,1317742,152,60,utRho01
1476,tauA,770410,770464,770410,54,0,utRho01
1477,tdcA,6534186,6534186,6534130,56,0,utRho01
1478,tdcG,6519652,6519652,6519298,354,14,utRho01
1479,tdcR,6534380,6534760,6534380,380,0,utRho01
1480,tdk,2586986,2587054,2586986,68,50,utRho01
1481,tehA,3001072,3001146,3001072,74,0,utRho01
1482,tesA,1039898,1039898,1039530,368,294,utRho01
1483,tesB,950402,950402,950322,80,0,utRho01
1484,tfaE,2418532,2418532,2418238,294,44,utRho01
1485,tfaQ,3269912,3269912,3269770,142,48,utRho01
1486,tff,379424,379256,379424,168,28,utRho01
1487,tgt,852110,852274,852110,164,12,utRho01
1488,thiD,4369346,4369346,4369032,314,48,utRho01
1489,thiI,882936,883098,882936,162,306,utRho01
1490,thiM,4370902,4370902,4370602,300,566,utRho01
1491,thiQ,146170,146170,145854,316,216,utRho01
1492,thrL,592,760,592,168,1180,utRho01
1493,thrS,7210932,7210932,7210280,652,4564,utRho01
1494,thrU,8350762,8350776,8350762,14,60,utRho01
1495,thrV,6847414,6847414,6847310,104,158516,utRho01
1496,thrW,525682,525742,525682,60,794,utRho01
1497,thyA,5930696,5930696,5930310,386,3208,utRho01
1498,tig,909986,910266,909986,280,700,utRho01
1499,tisB,7706674,7707106,7706674,432,298,utRho01
1500,tktA,6163414,6163414,6163270,144,74,utRho01
1501,tktB,5158616,5159272,5158616,656,860,utRho01
1502,tldD,6784368,6784368,6784056,312,56,utRho01
1503,tmcA,5191876,5191876,5191718,158,0,utRho01
1504,tnaC,15553644,15553740,15553644,96,436,utRho01
1505,tolB,1555074,1555480,1555074,406,676,utRho01
1506,tolC,6356008,6356230,6356008,222,1000,utRho01
1507,tomB,961588,961588,961416,172,8422,utRho01
1508,tonB,2622108,2622178,2622108,70,42,utRho01
1509,topA,2661578,2662096,2661578,518,1530,utRho01
1510,torC,2116112,2116168,2116112,56,136,utRho01
1511,torR,2115968,2115968,2115908,60,100,utRho01
1512,torS,2112364,2112364,2112356,8,0,utRho01
1513,torT,2112414,2112522,2112414,108,0,utRho01
1514,tpiA,8223138,8223138,8223014,124,130,utRho01
1515,tppB,3425342,3425538,3425342,196,5170,utRho01
1516,tpr,2574376,2574376,2574376,0,0,utRho01
1517,tpx,2777688,2777688,2777622,66,906,utRho01
1518,tqsA,3347780,3347826,3347780,46,0,utRho01
1519,treA,2494850,2494850,2494752,98,36,utRho01
1520,treB,8932420,8932420,8932360,60,76,utRho01
1521,treF,7339102,7339184,7339102,82,72,utRho01
1522,treR,8934694,8934694,8934492,202,12,utRho01
1523,trg,2984878,2984940,2984878,62,150,utRho01
1524,trkG,2847342,2847564,2847342,222,16,utRho01
1525,trmA,8326590,8326590,8326540,50,66,utRho01
1526,trpA,2634678,2634678,2634444,234,1210,utRho01
1527,trpC,2639888,2639888,2639570,318,80,utRho01
1528,trpL,5292432,5292432,5292328,104,0,utRho01
1529,trpR,9265408,9265520,9265408,112,134,utRho01
1530,trpS,7027394,7027394,7027276,118,1088,utRho01
1531,trpT,7893560,7893914,7893560,354,121108,utRho01
1532,trxA,7931294,7931522,7931294,228,950,utRho01
1533,trxB,1864156,1864156,1864100,56,64,utRho01
1534,trxC,5437350,5437470,5437350,120,376,utRho01
1535,tsaD,6421256,6421256,6421086,170,0,utRho01
1536,tsgA,6985038,6985136,6985038,98,110,utRho01
1537,tsr,9182824,9183314,9182824,490,156,utRho01
1538,tsx,864490,864490,864026,464,566,utRho01
1539,ttcA,2823970,2823970,2823896,74,3960,utRho01
1540,ttdA,6412848,6412926,6412848,78,0,utRho01
1541,ttdR,6412760,6412760,6412512,248,0,utRho01
1542,tufA,6943448,6943448,6942658,790,160226,utRho01
1543,tus,3368346,3368518,3368346,172,46,utRho01
1544,tusA,7218040,7218040,7217992,48,56,utRho01
1545,tusB,6950218,6950218,6949930,288,870,utRho01
1546,tynA,2902996,2902996,2902698,298,0,utRho01
1547,typA,8116460,8116814,8116460,354,8114,utRho01
1548,tyrB,8534164,8534228,8534164,64,1872,utRho01
1549,tyrP,3979004,3979362,3979004,358,32,utRho01
1550,tyrR,2773384,2773440,2773384,56,26,utRho01
1551,tyrS,3434566,3434566,3434444,122,8,utRho01
1552,tyrT,2575330,2575330,2575244,86,98,utRho01
1553,uacT,6062378,6062734,6062378,356,0,utRho01
1554,ubiC,8504886,8505012,8504886,126,160,utRho01
1555,ubiD,8049618,8049976,8049618,358,2462,utRho01
1556,ubiE,8037494,8037710,8037494,216,172,utRho01
1557,ubiG,4679078,4679134,4679078,56,4,utRho01
1558,ucpA,5089342,5089342,5089246,96,0,utRho01
1559,udp,8032782,8032862,8032782,80,138,utRho01
1560,ugd,4199470,4199470,4199226,244,20,utRho01
1561,ugpB,7184852,7184852,7184650,202,144,utRho01
1562,ugpQ,7176600,7176600,7176226,374,0,utRho01
1563,uhpT,7694396,7694396,7694334,62,52,utRho01
1564,uidA,3392304,3392304,3392142,162,0,utRho01
1565,uidC,3386012,3386012,3385702,310,0,utRho01
1566,uidR,3394150,3394150,3394104,46,112,utRho01
1567,ulaA,8839854,8839960,8839854,106,190,utRho01
1568,ulaG,8839350,8839350,8839250,100,0,utRho01
1569,ulaR,8837124,8837124,8836906,218,38,utRho01
1570,umpG,5741372,5741372,5740548,824,152,utRho01
1571,umpH,1400704,1400704,1400652,52,56,utRho01
1572,umuD,2461476,2461534,2461476,58,0,utRho01
1573,ung,5433476,5433508,5433476,32,26,utRho01
1574,uof,2843316,2843316,2842900,416,10740,utRho01
1575,upp,5241818,5241818,5241744,74,412,utRho01
1576,usg,4873780,4873780,4873298,482,318,utRho01
1577,ushA,1009772,1009828,1009772,56,0,utRho01
1578,uspA,7279966,7280222,7279966,256,884,utRho01
1579,uspB,7279696,7279696,7279440,256,898,utRho01
1580,uspC,3959172,3959506,3959172,334,4,utRho01
1581,uspE,2797318,2797318,2797244,74,48,utRho01
1582,uspF,2871282,2871282,2871238,44,66,utRho01
1583,uspG,1283806,1283806,1283734,72,504,utRho01
1584,uvrA,8547872,8547872,8547742,130,416,utRho01
1585,uvrB,1626304,1627052,1626304,748,2222,utRho01
1586,uvrC,3989758,3989758,3989412,346,474,utRho01
1587,uvrD,7995814,7995966,7995814,152,136,utRho01
1588,uvrY,3990812,3990812,3990718,94,28,utRho01
1589,uxaB,3221474,3221474,3221360,114,38,utRho01
1590,uxaC,6489714,6489714,6489482,232,0,utRho01
1591,uxuA,9103036,9103272,9103036,236,116,utRho01
1592,uxuR,9108916,9109152,9108916,236,8,utRho01
1593,valS,8967854,8967854,8967674,180,468,utRho01
1594,valU,5041848,5041862,5041848,14,14,utRho01
1595,valV,3492830,3492870,3492830,40,10,utRho01
1596,ves,3649968,3649968,3649874,94,0,utRho01
1597,waaA,7616512,7617080,7616512,568,688,utRho01
1598,waaH,7580298,7580298,7580162,136,60,utRho01
1599,waaQ,7616476,7616476,7616196,280,142,utRho01
1600,waaU,7598996,7598996,7598624,372,310,utRho01
1601,waaY,7602272,7602272,7601930,342,7096,utRho01
1602,wbbH,4214888,4214888,4214452,436,7248,utRho01
1603,wbbK,4209212,4209212,4209018,194,374,utRho01
1604,wcaM,4231868,4231868,4231792,76,56,utRho01
1605,wrbA,2135516,2135516,2135416,100,0,utRho01
1606,wza,4275166,4275166,4274486,680,0,utRho01
1607,wzxC,4240674,4240674,4240316,358,0,utRho01
1608,wzzB,4196950,4196950,4196602,348,336,utRho01
1609,xanP,7657642,7657890,7657642,248,0,utRho01
1610,xanQ,6048520,6048702,6048520,182,0,utRho01
1611,xapA,5049820,5049820,5049756,64,0,utRho01
1612,xapR,10090252,10090252,10089908,344,68,utRho01
1613,xdhA,6000514,6000690,6000514,176,160,utRho01
1614,xerD,6079702,6079702,6079486,216,84,utRho01
1615,xseA,5268394,5268464,5268394,70,758,utRho01
1616,xseB,882746,882746,882686,60,332,utRho01
1617,xthA,3664798,3664856,3664798,58,12,utRho01
1618,xylA,7461614,7461614,7461530,84,204,utRho01
1619,xylE,8484540,8484540,8484508,32,0,utRho01
1620,xylF,7462138,7462262,7462138,124,0,utRho01
1621,xylR,7469812,7469958,7469812,146,0,utRho01
1622,yaaA,13230,13230,12918,312,100,utRho01
1623,yaaI,23876,23876,23572,304,56,utRho01
1624,yaaJ,16034,16034,15918,116,204,utRho01
1625,yaaU,91184,91614,91184,430,0,utRho01
1626,yaaW,23084,23084,22712,372,60,utRho01
1627,yaaX,10060,10468,10060,408,128,utRho01
1628,yabI,142542,142702,142542,160,12,utRho01
1629,yacC,273880,273880,273834,46,4944,utRho01
1630,yacH,262932,262932,262520,412,80,utRho01
1631,yacL,268678,268776,268678,98,4,utRho01
1632,yadD,293796,293936,293796,140,20,utRho01
1633,yadE,289930,290162,289930,232,758,utRho01
1634,yadN,314110,314110,313766,344,42,utRho01
1635,yadS,355572,355572,355248,324,268,utRho01
1636,yadV,312470,312470,312402,68,2,utRho01
1637,yaeF,434270,434270,434006,264,110,utRho01
1638,yaeP,428374,428374,428250,124,12,utRho01
1639,yaeQ,428176,428582,428176,406,64,utRho01
1640,yaeR,423716,423754,423716,38,0,utRho01
1641,yafC,462166,462166,461762,404,450,utRho01
1642,yafD,462128,462244,462128,116,312,utRho01
1643,yafK,491986,491986,491610,376,2686,utRho01
1644,yafL,493282,493424,493282,142,56,utRho01
1645,yafN,503938,504010,503938,72,0,utRho01
1646,yafS,469568,469632,469568,64,378,utRho01
1647,yafT,474470,474670,474470,200,12,utRho01
1648,yafV,480432,480432,480378,54,54,utRho01
1649,yafZ,536052,536052,536010,42,152,utRho01
1650,yagE,564446,564556,564446,110,2,utRho01
1651,yagG,570414,570790,570414,376,20,utRho01
1652,yagI,578384,578384,578324,60,26,utRho01
1653,yagK,586236,586236,585896,340,110,utRho01
1654,yagL,588062,588062,587836,226,0,utRho01
1655,yagN,591342,591342,591158,184,954,utRho01
1656,yahA,663746,664742,663746,996,492,utRho01
1657,yahC,670136,670136,670044,92,0,utRho01
1658,yahE,671478,671850,671478,372,0,utRho01
1659,yahM,690504,690808,690504,304,80,utRho01
1660,yahN,692872,692872,692674,198,62,utRho01
1661,yahO,692864,692968,692864,104,10,utRho01
1662,yaiE,816296,816354,816296,58,78,utRho01
1663,yaiI,811396,811528,811396,132,0,utRho01
1664,yaiO,761946,761946,761684,262,8,utRho01
1665,yaiP,767970,767970,767870,100,0,utRho01
1666,yaiS,769660,769660,769232,428,0,utRho01
1667,yaiV,788922,788922,788922,0,0,utRho01
1668,yaiY,799094,799094,798666,428,586,utRho01
1669,yaiZ,798888,799186,798888,298,1242,utRho01
1670,yajC,854410,854574,854410,164,1900,utRho01
1671,yajD,860938,861210,860938,272,690,utRho01
1672,yajI,866068,866068,865702,366,194,utRho01
1673,yajL,887496,887496,887282,214,270,utRho01
1674,yajQ,889316,889366,889316,50,32,utRho01
1675,yajR,893374,893374,893332,42,724,utRho01
1676,ybaB,987418,988152,987418,734,2688,utRho01
1677,ybaL,1006590,1006590,1006476,114,122,utRho01
1678,ybaM,980648,980648,980542,106,1086,utRho01
1679,ybaN,981436,981764,981436,328,376,utRho01
1680,ybaO,936704,936766,936704,62,0,utRho01
1681,ybaP,1016568,1016568,1016160,408,1370,utRho01
1682,ybaQ,1016348,1016436,1016348,88,134,utRho01
1683,ybaS,1023146,1023282,1023146,136,76,utRho01
1684,ybaV,927504,927874,927504,370,84,utRho01
1685,ybaY,950490,950758,950490,268,24,utRho01
1686,ybbB,1062724,1062724,1062452,272,46,utRho01
1687,ybbJ,1030154,1030154,1029718,436,1034,utRho01
1688,ybbL,1031784,1031838,1031784,54,34,utRho01
1689,ybbN,1037136,1037136,1036558,578,1336,utRho01
1690,ybbO,1038658,1038658,1038298,360,1526,utRho01
1691,ybbY,1080718,1081130,1080718,412,0,utRho01
1692,ybcH,1176140,1176140,1175962,178,78,utRho01
1693,ybcI,1113264,1113264,1113106,158,1198,utRho01
1694,ybcJ,1114050,1114050,1113746,304,200,utRho01
1695,ybcK,1137502,1137804,1137502,302,22,utRho01
1696,ybcL,1141690,1141786,1141690,96,0,utRho01
1697,ybcN,1144628,1144932,1144628,304,0,utRho01
1698,ybcQ,1147548,1147912,1147548,364,0,utRho01
1699,ybcW,1159610,1159760,1159610,150,0,utRho01
1700,ybdD,1263982,1264364,1263982,382,134,utRho01
1701,ybdF,1212106,1212106,1211772,334,236,utRho01
1702,ybdH,1267048,1267048,1266954,94,8,utRho01
1703,ybdJ,1212822,1212822,1212398,424,72,utRho01
1704,ybdK,1215122,1215122,1214766,356,160,utRho01
1705,ybdL,1267114,1267172,1267114,58,30,utRho01
1706,ybdM,1271110,1271110,1270752,358,160,utRho01
1707,ybdN,1273372,1273372,1273138,234,26,utRho01
1708,ybdR,1283844,1284176,1283844,332,756,utRho01
1709,ybeD,1325412,1325412,1325284,128,116,utRho01
1710,ybeF,1323090,1323090,1322756,334,16,utRho01
1711,ybeL,1349986,1350036,1349986,50,36,utRho01
1712,ybeQ,1353412,1353412,1353094,318,2,utRho01
1713,ybeR,1353120,1353422,1353120,302,2,utRho01
1714,ybeT,1358832,1358832,1358812,20,0,utRho01
1715,ybeU,1358924,1359016,1358924,92,0,utRho01
1716,ybeZ,1386938,1386938,1386834,104,2632,utRho01
1717,ybfA,1458074,1458268,1458074,194,18,utRho01
1718,ybfE,1423878,1423878,1423796,82,708,utRho01
1719,ybfF,1425692,1425692,1425604,88,706,utRho01
1720,ybfH,1433282,1433282,1433194,88,0,utRho01
1721,ybgA,1477840,1478002,1477840,162,0,utRho01
1722,ybgC,1549288,1549504,1549288,216,14,utRho01
1723,ybgD,1505916,1505916,1505590,326,522,utRho01
1724,ybgI,1485238,1485654,1485238,416,0,utRho01
1725,ybgO,1498370,1498370,1497964,406,42,utRho01
1726,ybgS,1570992,1570992,1570634,358,24,utRho01
1727,ybhA,1597184,1597184,1596862,322,134,utRho01
1728,ybhB,1616070,1616070,1615818,252,320,utRho01
1729,ybhC,1614642,1614642,1614562,80,842,utRho01
1730,ybhD,1601418,1601418,1601276,142,0,utRho01
1731,ybhH,1601104,1601518,1601104,414,42,utRho01
1732,ybhK,1633384,1633384,1633294,90,10,utRho01
1733,ybhM,1641556,1641586,1641556,30,0,utRho01
1734,ybhN,1645296,1645296,1644996,300,82,utRho01
1735,ybhQ,1649202,1649260,1649202,58,76,utRho01
1736,ybiA,1665920,1665920,1665900,20,0,utRho01
1737,ybiI,1676968,1676968,1676912,56,146,utRho01
1738,ybiO,1691328,1691328,1690960,368,350,utRho01
1739,ybiP,1705252,1705252,1705194,58,2032,utRho01
1740,ybiS,1711572,1711572,1711488,84,958,utRho01
1741,ybiT,1711894,1711926,1711894,32,0,utRho01
1742,ybiU,1718212,1718212,1718122,90,28,utRho01
1743,ybiV,1720176,1720176,1720056,120,0,utRho01
1744,ybiW,1725566,1725566,1725212,354,52,utRho01
1745,ybiX,1678548,1678548,1678414,134,1518,utRho01
1746,ybjC,1781784,1781826,1781784,42,0,utRho01
1747,ybjE,1830154,1830154,1829714,440,200,utRho01
1748,ybjG,1767016,1767016,1766776,240,866,utRho01
1749,ybjL,1779882,1779882,1779638,244,172,utRho01
1750,ybjM,1779770,1780178,1779770,408,100,utRho01
1751,ybjO,1795704,1795978,1795704,274,4,utRho01
1752,ybjP,1809046,1809046,1808934,112,0,utRho01
1753,ybjQ,1809034,1809186,1809034,152,12,utRho01
1754,ybjS,1813796,1813796,1813506,290,232,utRho01
1755,ybjX,1838206,1838206,1838168,38,0,utRho01
1756,ycaD,1891438,1891742,1891438,304,0,utRho01
1757,ycaI,1928210,1928640,1928210,430,416,utRho01
1758,ycaK,1899094,1899336,1899094,242,0,utRho01
1759,ycaL,1920264,1920528,1920264,264,28,utRho01
1760,ycaM,1894240,1894458,1894240,218,0,utRho01
1761,ycaR,1941284,1941346,1941284,62,2482,utRho01
1762,ycbB,1961862,1962094,1961862,232,94,utRho01
1763,ycbJ,1943344,1943504,1943344,160,10,utRho01
1764,ycbK,1966046,1966150,1966046,104,496,utRho01
1765,ycbZ,2036920,2036920,2036598,322,100,utRho01
1766,yccA,2062886,2062886,2062836,50,734,utRho01
1767,yccF,2048730,2048730,2048696,34,0,utRho01
1768,yccS,2047988,2047988,2047766,222,52,utRho01
1769,yccT,2055674,2055674,2055546,128,20,utRho01
1770,yccX,2059960,2060128,2059960,168,278,utRho01
1771,ycdT,2185682,2185752,2185682,70,0,utRho01
1772,ycdU,2191266,2191686,2191266,420,0,utRho01
1773,ycdZ,2200504,2200592,2200504,88,44,utRho01
1774,yceA,2233544,2233614,2233544,70,178,utRho01
1775,yceD,2293298,2293588,2293298,290,4366,utRho01
1776,yceF,2293522,2293522,2293190,332,2766,utRho01
1777,yceH,2252154,2252314,2252154,160,440,utRho01
1778,yceI,2237282,2237282,2236952,330,122,utRho01
1779,yceJ,2238142,2238142,2238092,50,136,utRho01
1780,yceM,2253208,2253612,2253208,404,132,utRho01
1781,yceO,2239264,2239264,2238894,370,362,utRho01
1782,yceQ,2288760,2289004,2288760,244,9498,utRho01
1783,ycfD,2376540,2376540,2376480,60,546,utRho01
1784,ycfJ,2334814,2335198,2334814,384,1240,utRho01
1785,ycfS,2340834,2340834,2340748,86,0,utRho01
1786,ycfT,2350658,2350658,2350330,328,18,utRho01
1787,ycfZ,2362760,2362760,2362534,226,614,utRho01
1788,ycgB,2474570,2474570,2474482,88,0,utRho01
1789,ycgG,2434614,2434656,2434614,42,38,utRho01
1790,ycgJ,2452956,2453200,2452956,244,34,utRho01
1791,ycgL,2455218,2455362,2455218,144,58,utRho01
1792,ycgN,2457366,2457660,2457366,294,92,utRho01
1793,ycgR,2489112,2489112,2489054,58,0,utRho01
1794,ycgV,2512222,2512222,2511904,318,288,utRho01
1795,ycgX,2426568,2426568,2426214,354,23172,utRho01
1796,ycgY,2490166,2490320,2490166,154,6,utRho01
1797,ycgZ,2431504,2431578,2431504,74,44,utRho01
1798,ychE,2596904,2597196,2596904,292,112,utRho01
1799,ychF,2515764,2515764,2515624,140,186,utRho01
1800,ychH,2517476,2517582,2517476,106,520,utRho01
1801,ychJ,2578354,2578354,2578264,90,12,utRho01
1802,ychN,2547310,2547310,2547198,112,132,utRho01
1803,ychO,2547520,2547850,2547520,330,288,utRho01
1804,ychQ,2533798,2533848,2533798,50,34,utRho01
1805,yciA,2624828,2624828,2624492,336,214,utRho01
1806,yciB,2626110,2626110,2625780,330,3658,utRho01
1807,yciC,2627396,2627396,2627326,70,34,utRho01
1808,yciE,2630794,2630794,2630448,346,4,utRho01
1809,yciG,5264368,5264368,5264140,228,0,utRho01
1810,yciI,2621784,2621784,2621730,54,4,utRho01
1811,yciN,2661606,2661606,2661336,270,156,utRho01
1812,yciS,2680270,2680486,2680270,216,184,utRho01
1813,yciT,2689088,2689088,2688692,396,620,utRho01
1814,yciU,2614718,2614718,2614300,418,4658,utRho01
1815,yciV,2646376,2646440,2646376,64,0,utRho01
1816,yciW,2700472,2700472,2700214,258,598,utRho01
1817,yciZ,2689276,2689276,2689218,58,370,utRho01
1818,ycjD,2703792,2703792,2703520,272,144,utRho01
1819,ycjG,2777748,2777860,2777748,112,78,utRho01
1820,ycjM,2740006,2740432,2740006,426,92,utRho01
1821,ycjW,2767982,2767982,2767922,60,80,utRho01
1822,ycjX,2768138,2768234,2768138,96,146,utRho01
1823,ycjY,5568288,5568288,5567460,828,100,utRho01
1824,ydaE,2836438,2836438,2836016,422,20,utRho01
1825,ydaN,2816048,2816100,2816048,52,20,utRho01
1826,ydaS,2840340,2840730,2840340,390,290,utRho01
1827,ydbC,2948376,2948442,2948376,66,0,utRho01
1828,ydbD,2950132,2950288,2950132,156,0,utRho01
1829,ydbH,2885800,2886102,2885800,302,0,utRho01
1830,ydbJ,2881712,2882116,2881712,404,90,utRho01
1831,ydbK,2881692,2881692,2881568,124,38,utRho01
1832,ydcA,2983294,2983354,2983294,60,12,utRho01
1833,ydcF,2974404,2974470,2974404,66,38,utRho01
1834,ydcI,2990268,2990268,2990142,126,40,utRho01
1835,ydcJ,2990266,2990576,2990266,310,0,utRho01
1836,ydcK,3001280,3001280,3000898,382,0,utRho01
1837,ydcL,3004646,3004914,3004646,268,4,utRho01
1838,ydcN,3012308,3012344,3012308,36,0,utRho01
1839,ydcP,3013508,3013562,3013508,54,8,utRho01
1840,ydcR,3019956,3020006,3019956,50,0,utRho01
1841,ydcS,3022906,3023308,3022906,402,76,utRho01
1842,ydcX,3034442,3034778,3034442,336,72,utRho01
1843,ydcY,3035220,3035296,3035220,76,146,utRho01
1844,ydcZ,3036750,3036750,3036662,88,268,utRho01
1845,yddB,3155332,3155332,3155238,94,38,utRho01
1846,yddE,3071738,3071738,3071716,22,0,utRho01
1847,yddG,3094410,3094410,3094338,72,0,utRho01
1848,yddJ,3089732,3089732,3089438,294,0,utRho01
1849,yddW,3137704,3137704,3137646,58,10,utRho01
1850,ydeA,3233910,3234056,3233910,146,224,utRho01
1851,ydeE,3242528,3242664,3242528,136,0,utRho01
1852,ydeI,3249118,3249118,3248994,124,0,utRho01
1853,ydeJ,3249376,3249546,3249376,170,0,utRho01
1854,ydeN,3165458,3165458,3165048,410,0,utRho01
1855,ydeP,3173328,3173328,3172972,356,0,utRho01
1856,ydeR,3176596,3176596,3176592,4,0,utRho01
1857,ydfA,3296872,3297016,3296872,144,86,utRho01
1858,ydfG,3254982,3255034,3254982,52,2,utRho01
1859,ydfH,3256652,3256704,3256652,52,130,utRho01
1860,ydfK,3265446,3266144,3265446,698,57910,utRho01
1861,ydgA,3379588,3379704,3379588,116,48,utRho01
1862,ydgC,3364124,3364124,3364060,64,92,utRho01
1863,ydgD,3343906,3343920,3343906,14,78,utRho01
1864,ydgH,3356754,3356854,3356754,100,106,utRho01
1865,ydgJ,3408798,3408798,3408616,182,14,utRho01
1866,ydgK,3410414,3410500,3410414,86,244,utRho01
1867,ydhB,3479618,3479618,3479596,22,0,utRho01
1868,ydhC,3479698,3479822,3479698,124,0,utRho01
1869,ydhF,3451310,3451310,3451264,46,14,utRho01
1870,ydhI,3441996,3442050,3441996,54,0,utRho01
1871,ydhL,3451864,3451864,3451840,24,50,utRho01
1872,ydhQ,3492404,3492404,3492254,150,0,utRho01
1873,ydhS,3494136,3494262,3494136,126,564,utRho01
1874,ydhT,3499138,3499138,3499118,20,0,utRho01
1875,ydhY,3509284,3509284,3508954,330,0,utRho01
1876,ydhZ,3510418,3510418,3510282,136,0,utRho01
1877,ydiE,3579206,3579226,3579206,20,44,utRho01
1878,ydiH,3530582,3530582,3530406,176,10,utRho01
1879,ydiM,3541852,3542142,3541852,290,0,utRho01
1880,ydiN,3544818,3545024,3544818,206,0,utRho01
1881,ydiP,3558656,3558656,3558602,54,0,utRho01
1882,ydiU,3582508,3582508,3582488,20,36,utRho01
1883,ydiV,3584174,3584174,3584040,134,66,utRho01
1884,ydiY,3612500,3612500,3612166,334,18,utRho01
1885,ydjA,3697400,3697400,3697352,48,52,utRho01
1886,ydjE,3708082,3708082,3707958,124,0,utRho01
1887,ydjF,3709848,3709848,3709708,140,0,utRho01
1888,ydjM,3620340,3620422,3620340,82,0,utRho01
1889,ydjO,3626696,3626696,3626288,408,0,utRho01
1890,ydjX,3666434,3666802,3666434,368,1952,utRho01
1891,yeaE,3731448,3731448,3731272,176,132,utRho01
1892,yeaG,3733530,3733816,3733530,286,0,utRho01
1893,yeaI,3740486,3740770,3740486,284,0,utRho01
1894,yeaJ,3743874,3744082,3743874,208,146,utRho01
1895,yeaL,3748646,3748704,3748646,58,572,utRho01
1896,yeaM,3751296,3751296,3751152,144,0,utRho01
1897,yeaN,3750926,3751346,3750926,420,60,utRho01
1898,yeaO,3753554,3753818,3753554,264,118,utRho01
1899,yeaP,3755314,3755430,3755314,116,1136,utRho01
1900,yeaQ,3758780,3758780,3758510,270,144,utRho01
1901,yeaR,3759988,3759988,3759896,92,92,utRho01
1902,yeaY,3781122,3781122,3781064,58,110,utRho01
1903,yebB,3892220,3892502,3892220,282,0,utRho01
1904,yebC,3896370,3896370,3896302,68,26,utRho01
1905,yebE,3859464,3859464,3859414,50,416,utRho01
1906,yebG,3861530,3861530,3861494,36,16,utRho01
1907,yebK,3873180,3873304,3873180,124,0,utRho01
1908,yebQ,3820314,3820552,3820314,238,8,utRho01
1909,yebS,3832238,3832516,3832238,278,10,utRho01
1910,yebV,3843430,3843560,3843430,130,32,utRho01
1911,yebW,3843914,3844242,3843914,328,1648,utRho01
1912,yecC,3995646,3995646,3995628,18,10,utRho01
1913,yecD,3901272,3901664,3901272,392,34,utRho01
1914,yecF,3991434,3991636,3991434,202,206,utRho01
1915,yecH,3979304,3979304,3978980,324,34,utRho01
1916,yecJ,3975604,3975604,3975516,88,22,utRho01
1917,yecM,3919968,3919968,3919692,276,32,utRho01
1918,yecR,3976400,3976444,3976400,44,54,utRho01
1919,yecT,3923862,3923944,3923862,82,278,utRho01
1920,yedD,4016522,4016522,4016180,342,66,utRho01
1921,yedE,4016310,4016554,4016310,244,82,utRho01
1922,yedI,4058922,4058922,4058732,190,0,utRho01
1923,yedJ,4066446,4066446,4066158,288,56,utRho01
1924,yedV,4076404,4076404,4076304,100,112,utRho01
1925,yedX,4077680,4077912,4077680,232,26,utRho01
1926,yedY,4078572,4078956,4078572,384,56,utRho01
1927,yeeA,4161322,4161322,4161182,140,12,utRho01
1928,yeeE,4171104,4171104,4171050,54,0,utRho01
1929,yeeJ,4089526,4089822,4089526,296,612,utRho01
1930,yeeN,4113508,4113716,4113508,208,30,utRho01
1931,yeeO,4119444,4119444,4119692,248,16,utRho01
1932,yeeX,4158834,4158834,4158722,112,512,utRho01
1933,yeeZ,4178422,4178422,4178256,166,54,utRho01
1934,yefM,4179466,4179466,4179426,40,16,utRho01
1935,yegD,4295288,4295348,4295288,60,66,utRho01
1936,yegH,4275726,4275804,4275726,78,0,utRho01
1937,yegI,4302154,4302154,4301970,184,0,utRho01
1938,yegJ,4302032,4302370,4302032,338,20,utRho01
1939,yegQ,4331182,4331336,4331182,154,10,utRho01
1940,yegR,4336698,4336698,4336612,86,0,utRho01
1941,yegS,4337086,4337424,4337086,338,64,utRho01
1942,yegT,4357562,4357642,4357562,80,0,utRho01
1943,yegX,4367640,4367640,4367302,338,24,utRho01
1944,yehA,4376944,4376944,4376828,116,2,utRho01
1945,yehE,4385818,4385818,4385592,226,2,utRho01
1946,yehK,4407568,4407944,4407568,376,16,utRho01
1947,yehL,4408804,4409192,4408804,388,0,utRho01
1948,yeiB,4486146,4486146,4485934,212,28,utRho01
1949,yeiE,4499422,4499422,4499236,186,0,utRho01
1950,yeiG,4487776,4487820,4487776,44,452,utRho01
1951,yeiH,4499332,4499434,4499332,102,16,utRho01
1952,yeiI,4503306,4503400,4503306,94,144,utRho01
1953,yeiL,4510580,4510710,4510580,130,0,utRho01
1954,yeiP,4530834,4530900,4530834,66,664,utRho01
1955,yeiQ,4532328,4532490,4532328,162,100,utRho01
1956,yeiR,4535484,4535658,4535484,174,80,utRho01
1957,yeiW,4530840,4530840,4530590,250,978,utRho01
1958,yejA,4544624,4544728,4544624,104,86,utRho01
1959,yejG,4556892,4556892,4556474,418,5934,utRho01
1960,yejH,4561244,4561264,4561244,20,2,utRho01
1961,yejK,4568218,4568218,4567894,324,482,utRho01
1962,yejO,4578352,4578352,4577800,552,148,utRho01
1963,yfaD,4713380,4713808,4713380,428,272,utRho01
1964,yfaE,4696676,4697028,4696676,352,1666,utRho01
1965,yfaL,4688568,4688568,4688338,230,0,utRho01
1966,yfaP,4656398,4656398,4656286,112,12,utRho01
1967,yfaU,4717892,4717892,4717690,202,0,utRho01
1968,yfaY,4727310,4727310,4727266,44,86,utRho01
1969,yfaZ,4728744,4728744,4728550,194,4,utRho01
1970,yfbK,4771810,4771810,4771444,366,34,utRho01
1971,yfbL,4771500,4771720,4771500,220,34,utRho01
1972,yfbN,4777174,4777174,4776852,322,0,utRho01
1973,yfbO,4776916,4777162,4776916,246,0,utRho01
1974,yfbP,4777990,4778232,4777990,242,918,utRho01
1975,yfbR,4817662,4817724,4817662,62,68,utRho01
1976,yfcI,4847424,4847424,4847078,346,66,utRho01
1977,yfcJ,4880482,4880482,4880240,242,178,utRho01
1978,yfcL,4888502,4888502,4888338,164,82,utRho01
1979,yfcV,4911642,4911642,4911292,350,0,utRho01
1980,yfcZ,4921958,4921958,4921868,90,96,utRho01
1981,yfdF,4925604,4926024,4925604,420,604,utRho01
1982,yfdG,4935474,4935710,4935474,236,20,utRho01
1983,yfdP,4946844,4947040,4946844,196,0,utRho01
1984,yfdX,4988866,4988866,4988804,62,4,utRho01
1985,yfdY,4990672,4990672,4990584,88,20,utRho01
1986,yfeA,5035784,5035784,5035664,120,42560,utRho01
1987,yfeC,5036668,5036934,5036668,266,228,utRho01
1988,yfeH,5053818,5053892,5053818,74,0,utRho01
1989,yfeK,5074630,5074684,5074630,54,12,utRho01
1990,yfeO,5018906,5019260,5018906,354,260,utRho01
1991,yfeR,5054078,5054078,5053712,366,24,utRho01
1992,yfeX,5101356,5101356,5101090,266,0,utRho01
1993,yfeY,5102486,5102486,5102432,54,34,utRho01
1994,yfeZ,5103842,5103842,5103452,390,32,utRho01
1995,yffO,5123804,5124222,5123804,418,30,utRho01
1996,yffQ,5126778,5127154,5126778,376,56,utRho01
1997,yffS,5128800,5128986,5128800,186,66,utRho01
1998,yfgC,5232052,5232188,5232052,136,0,utRho01
1999,yfgF,5258062,5258062,5257876,186,44,utRho01
2000,yfgG,5258170,5258580,5258170,410,304,utRho01
2001,yfgH,5259344,5259584,5259344,240,34,utRho01
2002,yfgM,5278866,5278866,5278566,300,712,utRho01
2003,yfhH,5397414,5397518,5397414,104,32,utRho01
2004,yfhM,5304648,5304648,5304574,74,62,utRho01
2005,yfhR,5328408,5328726,5328408,318,5960,utRho01
2006,yfiC,5425610,5425610,5425528,82,6,utRho01
2007,yfiE,5430688,5430688,5430640,48,0,utRho01
2008,yfiL,5482630,5482720,5482630,90,0,utRho01
2009,yfiM,5448066,5448358,5448066,292,23296,utRho01
2010,yfiR,5483354,5483750,5483354,396,236,utRho01
2011,yfjH,5517326,5517326,5517200,126,0,utRho01
2012,yfjI,5517710,5517970,5517710,260,84,utRho01
2013,yfjJ,5521014,5521094,5521014,80,0,utRho01
2014,yfjM,5531970,5531970,5531552,418,974,utRho01
2015,yfjP,5535080,5535420,5535080,340,184,utRho01
2016,yfjW,5546570,5546636,5546570,66,0,utRho01
2017,yfjX,5551776,5551838,5551776,62,0,utRho01
2018,ygaC,5601180,5601180,5599988,1192,1486,utRho01
2019,ygaM,5600242,5600292,5600242,50,274,utRho01
2020,ygaU,5593628,5593628,5593572,56,50,utRho01
2021,ygaZ,5619190,5619234,5619190,44,1328,utRho01
2022,ygbA,5713656,5713656,5713612,44,0,utRho01
2023,ygbE,5746784,5746784,5746674,110,192,utRho01
2024,ygbI,5722882,5722882,5722528,354,70,utRho01
2025,ygbK,5724394,5724670,5724394,276,40,utRho01
2026,ygbL,5727074,5727186,5727074,112,2,utRho01
2027,ygbN,5729814,5730202,5729814,388,14,utRho01
2028,ygcG,5811210,5811422,5811210,212,62,utRho01
2029,ygcN,5785144,5785314,5785144,170,28,utRho01
2030,ygcU,5799214,5799214,5798836,378,0,utRho01
2031,ygcW,5800942,5800942,5800546,396,0,utRho01
2032,ygdD,5883442,5883442,5883262,180,92,utRho01
2033,ygdG,5861746,5861930,5861746,184,596,utRho01
2034,ygdI,5886526,5886526,5886290,236,116,utRho01
2035,ygdQ,5940784,5940840,5940784,56,0,utRho01
2036,ygdR,5942494,5942542,5942494,48,34,utRho01
2037,ygeA,5961606,5961606,5961270,336,0,utRho01
2038,ygeH,5983758,5984188,5983758,430,0,utRho01
2039,ygeI,5987162,5987276,5987162,114,0,utRho01
2040,ygeR,6000078,6000078,5999782,296,588,utRho01
2041,ygeV,6011694,6011694,6011572,122,0,utRho01
2042,ygeW,6012234,6012524,6012234,290,0,utRho01
2043,ygfB,6110946,6110946,6110888,58,72,utRho01
2044,ygfK,6031984,6032120,6031984,136,0,utRho01
2045,ygfS,6058328,6058328,6058024,304,0,utRho01
2046,ygfZ,6082564,6082626,6082564,62,210,utRho01
2047,yggC,6149512,6149512,6149378,134,0,utRho01
2048,yggE,6136370,6136370,6136160,210,2,utRho01
2049,yggI,6179176,6179510,6179176,334,280,utRho01
2050,yggL,6204508,6204508,6204266,242,4,utRho01
2051,yggM,6199514,6199514,6199130,384,314,utRho01
2052,yggN,6203596,6203596,6203246,350,0,utRho01
2053,yggX,18623958,18624558,18623958,600,744,utRho01
2054,yghA,6298966,6299324,6298966,358,30,utRho01
2055,yghB,6307058,6307126,6307058,68,56,utRho01
2056,yghD,6222614,6222614,6222252,362,172,utRho01
2057,yghF,6225798,6225798,6225840,42,0,utRho01
2058,yghJ,6238640,6238640,6238224,416,0,utRho01
2059,yghQ,6265186,6265186,6264816,370,0,utRho01
2060,yghT,6267830,6268262,6267830,432,0,utRho01
2061,yghU,6277400,6277454,6277400,54,2,utRho01
2062,yghW,6293506,6293506,6293474,32,16,utRho01
2063,yghZ,6295562,6295794,6295562,232,60,utRho01
2064,ygiD,6365122,6365122,6364868,254,446,utRho01
2065,ygiH,6409066,6409388,6409066,322,10,utRho01
2066,ygiL,6370622,6370828,6370622,206,0,utRho01
2067,ygiM,6402084,6402414,6402084,330,184,utRho01
2068,ygiN,6346156,6346284,6346156,128,1008,utRho01
2069,ygiQ,6322620,6322620,6322292,328,938,utRho01
2070,ygiS,6335462,6335462,6335436,26,18,utRho01
2071,ygiV,6338582,6338582,6338462,120,18,utRho01
2072,ygiW,6339774,6339774,6339352,422,30,utRho01
2073,ygiZ,6344506,6344506,6344422,84,0,utRho01
2074,ygjH,6442528,6442528,6442494,34,0,utRho01
2075,ygjI,6452140,6452468,6452140,328,0,utRho01
2076,ygjQ,6472730,6473080,6472730,350,208,utRho01
2077,ygjR,6474564,6474586,6474564,22,34,utRho01
2078,ygjV,6483638,6483638,6483488,150,8,utRho01
2079,yhaB,6535632,6535708,6535632,76,46,utRho01
2080,yhaH,6504498,6504608,6504498,110,10,utRho01
2081,yhaI,6505400,6505822,6505400,422,2,utRho01
2082,yhaJ,6508560,6508560,6508428,132,92,utRho01
2083,yhaK,6508538,6508638,6508538,100,102,utRho01
2084,yhbQ,6599878,6599932,6599878,54,102,utRho01
2085,yhbT,6602736,6602736,6602552,184,34,utRho01
2086,yhbU,6602558,6602970,6602558,412,34,utRho01
2087,yhbX,6643302,6643302,6643226,76,0,utRho01
2088,yhbY,6655518,6655580,6655518,62,2244,utRho01
2089,yhcA,6723956,6724224,6723956,268,0,utRho01
2090,yhcB,6760364,6760382,6760364,18,234,utRho01
2091,yhcC,6708470,6708470,6708100,370,654,utRho01
2092,yhcF,6733440,6733852,6733440,412,140,utRho01
2093,yhcH,6739124,6739124,6738956,168,82,utRho01
2094,yhcM,6760312,6760312,6759994,318,156,utRho01
2095,yhcN,6770812,6771076,6770812,264,1168,utRho01
2096,yhcO,6772606,6772606,6772258,348,0,utRho01
2097,yhdH,6806560,6806968,6806560,408,224,utRho01
2098,yhdJ,6823234,6823306,6823234,72,0,utRho01
2099,yhdN,6879092,6879092,6879018,74,2966,utRho01
2100,yhdT,6814702,6814750,6814702,48,554,utRho01
2101,yhdU,6824994,6825242,6824994,248,136,utRho01
2102,yhdV,6836392,6836780,6836392,388,0,utRho01
2103,yhdW,6837944,6838298,6837944,354,36,utRho01
2104,yheO,6953082,6953082,6952880,202,1586,utRho01
2105,yheV,6957970,6957970,6957584,386,198,utRho01
2106,yhfA,6971902,6971902,6971636,266,114,utRho01
2107,yhfG,6983294,6983294,6983240,54,248,utRho01
2108,yhfL,6998622,6998896,6998622,274,60,utRho01
2109,yhfY,7023244,7023244,7022844,400,0,utRho01
2110,yhgA,7086294,7086334,7086294,40,0,utRho01
2111,yhgE,7065176,7065176,7064878,298,150,utRho01
2112,yhgF,7074352,7074770,7074352,418,1652,utRho01
2113,yhhA,7173458,7173886,7173458,428,8,utRho01
2114,yhhI,7248346,7248756,7248346,410,0,utRho01
2115,yhhJ,7253696,7253696,7253606,90,10,utRho01
2116,yhhM,7211588,7211588,7211220,368,346,utRho01
2117,yhhN,7211150,7211502,7211150,352,320,utRho01
2118,yhhQ,7218238,7218434,7218238,196,870,utRho01
2119,yhhT,7223682,7223730,7223682,48,2,utRho01
2120,yhhX,7162032,7162032,7161610,422,1172,utRho01
2121,yhhY,7162222,7162276,7162222,54,0,utRho01
2122,yhhZ,7163516,7163726,7163516,210,0,utRho01
2123,yhiD,7312220,7312220,7311804,416,2724,utRho01
2124,yhiJ,7265190,7265190,7265180,10,0,utRho01
2125,yhiM,7269270,7269682,7269270,412,216,utRho01
2126,yhiN,7275000,7275000,7274820,180,150,utRho01
2127,yhjA,7338522,7338522,7338376,146,0,utRho01
2128,yhjB,7344090,7344090,7343788,302,32,utRho01
2129,yhjC,7344272,7344684,7344272,412,0,utRho01
2130,yhjD,7346660,7346724,7346660,64,0,utRho01
2131,yhjE,7349274,7349572,7349274,298,48,utRho01
2132,yhjG,7356824,7356824,7356730,94,0,utRho01
2133,yhjH,7358458,7358458,7358374,84,12,utRho01
2134,yhjJ,7364032,7364032,7363880,152,80,utRho01
2135,yhjK,7371296,7371296,7371158,138,16,utRho01
2136,yhjR,7392750,7392750,7392370,380,26,utRho01
2137,yhjV,7400796,7401126,7400796,330,1060,utRho01
2138,yhjX,7424194,7424194,7424014,180,24,utRho01
2139,yhjY,7425966,7425966,7425868,98,24,utRho01
2140,yiaB,7455654,7455654,7455496,158,0,utRho01
2141,yiaD,7432712,7433094,7432712,382,98,utRho01
2142,yiaF,7438194,7438194,7438088,106,36,utRho01
2143,yiaG,7438862,7438956,7438862,94,100,utRho01
2144,yiaJ,7485236,7485236,7485064,172,0,utRho01
2145,yiaK,7485348,7485466,7485348,118,0,utRho01
2146,yiaT,7503924,7503924,7503736,188,0,utRho01
2147,yiaU,7503792,7503984,7503792,192,0,utRho01
2148,yiaY,7515856,7515856,7515654,202,80,utRho01
2149,yibF,7523950,7523950,7523910,40,0,utRho01
2150,yibG,7536128,7536354,7536128,226,2,utRho01
2151,yibL,7553194,7553330,7553194,136,206,utRho01
2152,yibN,7570112,7570112,7570030,82,276,utRho01
2153,yibT,7552848,7552848,7552760,88,24,utRho01
2154,yicC,7633290,7633352,7633290,62,82,utRho01
2155,yicH,7660862,7660914,7660862,52,26,utRho01
2156,yicJ,7673328,7673328,7671858,1470,710,utRho01
2157,yicN,7685018,7685018,7684804,214,2,utRho01
2158,yicO,7687914,7687914,7687578,336,0,utRho01
2159,yicR,15250308,15250308,15250236,72,0,utRho01
2160,yidB,7755230,7755230,7754930,300,12,utRho01
2161,yidE,7732780,7732780,7732546,234,2,utRho01
2162,yidF,7711580,7711580,7711222,358,134,utRho01
2163,yidQ,7735088,7735456,7735088,368,470,utRho01
2164,yidR,7738824,7738824,7738618,206,0,utRho01
2165,yieE,7787658,7787738,7787658,80,416,utRho01
2166,yieH,7793314,7793548,7793314,234,0,utRho01
2167,yieK,7798928,7798928,7798786,142,0,utRho01
2168,yifB,7900350,7900350,7899998,352,358,utRho01
2169,yifL,7988984,7989044,7988984,60,182,utRho01
2170,yigF,8005750,8005750,8005598,152,56,utRho01
2171,yigI,8009448,8009448,8009394,54,0,utRho01
2172,yigM,8022100,8022152,8022100,52,88,utRho01
2173,yihA,8101970,8101970,8101458,512,198,utRho01
2174,yihD,8084098,8084138,8084098,40,90,utRho01
2175,yihF,8088110,8088398,8088110,288,0,utRho01
2176,yihG,8093304,8093304,8093204,100,56,utRho01
2177,yihI,8102616,8102694,8102616,78,0,utRho01
2178,yihL,8120506,8120894,8120506,388,50,utRho01
2179,yihN,8124332,8124494,8124332,162,0,utRho01
2180,yihO,8131942,8131942,8131532,410,96,utRho01
2181,yihQ,8138892,8138892,8138552,340,0,utRho01
2182,yihV,8147064,8147478,8147064,414,8,utRho01
2183,yihX,8151096,8151106,8151096,10,78,utRho01
2184,yiiE,8158192,8158582,8158192,390,0,utRho01
2185,yiiF,8159124,8159502,8159124,378,32,utRho01
2186,yiiG,8173762,8174004,8173762,242,0,utRho01
2187,yiiM,8205506,8205644,8205506,138,42,utRho01
2188,yiiQ,8224624,8224624,8224428,196,32,utRho01
2189,yiiS,8225738,8225934,8225738,196,12,utRho01
2190,yijE,8272178,8272216,8272178,38,36,utRho01
2191,yijF,8275728,8275728,8275314,414,38,utRho01
2192,yijO,8296858,8296858,8296634,224,8,utRho01
2193,yjaA,8426240,8426468,8426240,228,114164,utRho01
2194,yjaB,8428312,8428312,8428246,66,690,utRho01
2195,yjaG,8398746,8399008,8398746,262,1420,utRho01
2196,yjaH,8401022,8401132,8401022,110,124,utRho01
2197,yjaZ,8379506,8379572,8379506,66,4,utRho01
2198,yjbB,8455204,8455462,8455204,258,0,utRho01
2199,yjbE,16943432,16943624,16943432,192,0,utRho01
2200,yjbL,8520318,8520642,8520318,324,0,utRho01
2201,yjbQ,8540428,8540476,8540428,48,0,utRho01
2202,yjcB,8550328,8550328,8550082,246,9468,utRho01
2203,yjcC,8550836,8550942,8550836,106,106,utRho01
2204,yjcD,8556628,8556958,8556628,330,52,utRho01
2205,yjcE,8559658,8559960,8559658,302,40,utRho01
2206,yjcF,8566212,8566212,8566150,62,0,utRho01
2207,yjcO,8594660,8594660,8594250,410,0,utRho01
2208,yjdA,8654128,8654270,8654128,142,14,utRho01
2209,yjdC,8726660,8726660,8726616,44,0,utRho01
2210,yjdK,8704780,8705168,8704780,388,160,utRho01
2211,yjdL,8713034,8713034,8712822,212,14,utRho01
2212,yjdM,8653672,8653672,8653468,204,160,utRho01
2213,yjeF,8787354,8788132,8787354,778,11196,utRho01
2214,yjeI,8745522,8745618,8745522,96,2,utRho01
2215,yjeJ,8748806,8748806,8748468,338,68,utRho01
2216,yjeV,8785472,8785784,8785472,312,396,utRho01
2217,yjfP,8833512,8833904,8833512,392,32,utRho01
2218,yjfY,8849656,8849656,8849582,74,30,utRho01
2219,yjfZ,8855052,8855052,8854844,208,0,utRho01
2220,yjgA,8916162,8916162,8915730,432,176,utRho01
2221,yjgL,8950802,8950874,8950802,72,0,utRho01
2222,yjgM,8959342,8959342,8959074,268,0,utRho01
2223,yjgN,8959132,8959460,8959132,328,0,utRho01
2224,yjgR,8980170,8980170,8980126,44,164,utRho01
2225,yjgZ,9002116,9002520,9002116,404,576,utRho01
2226,yjhB,9007764,9008116,9007764,352,4,utRho01
2227,yjhG,9048452,9048452,9048188,264,392,utRho01
2228,yjhU,9041080,9041080,9040648,432,418,utRho01
2229,yjiA,9178096,9178096,9177730,366,218,utRho01
2230,yjiJ,9125364,9125364,9125350,14,0,utRho01
2231,yjiK,9127270,9127270,9127422,152,146,utRho01
2232,yjiL,9129604,9129604,9129378,226,0,utRho01
2233,yjiS,9143410,9143502,9143410,92,0,utRho01
2234,yjiY,9182734,9182734,9182558,176,10,utRho01
2235,yjjA,9200674,9200674,9200378,296,342,utRho01
2236,yjjB,18408708,18408708,18407800,908,104,utRho01
2237,yjjJ,9243314,9243538,9243314,224,26,utRho01
2238,yjjK,9261132,9261132,9261044,88,172,utRho01
2239,yjjL,9189764,9189764,9189444,320,0,utRho01
2240,yjjM,9191894,9191894,9191702,192,0,utRho01
2241,yjjP,9206068,9206068,9205716,352,88,utRho01
2242,yjjQ,9206638,9206954,9206638,316,84,utRho01
2243,yjjX,9267798,9267798,9267490,308,534,utRho01
2244,yjjY,9280716,9280804,9280716,88,456,utRho01
2245,yjjZ,9211554,9211608,9211554,54,1208,utRho01
2246,yjtD,9281676,9281884,9281676,208,2,utRho01
2247,ykfB,532454,532454,532174,280,324,utRho01
2248,ykfI,527636,527636,527338,298,18,utRho01
2249,ykgB,637050,637050,636638,412,0,utRho01
2250,ykgC,640430,640430,640002,428,0,utRho01
2251,ykgD,640232,640454,640232,222,0,utRho01
2252,ykgE,642962,643216,642962,254,40,utRho01
2253,ykgJ,608524,608524,608364,160,154,utRho01
2254,ykgL,623878,624224,623878,346,128,utRho01
2255,ykgM,625610,625610,625554,56,8,utRho01
2256,ykgR,626570,626570,626484,86,0,utRho01
2257,ylaC,958576,958576,958502,74,1396,utRho01
2258,yliE,1745938,1745958,1745938,20,0,utRho01
2259,ymcE,2103660,2103694,2103660,34,868,utRho01
2260,ymdA,2210450,2210828,2210450,378,244,utRho01
2261,ymdB,2211428,2211640,2211428,212,114,utRho01
2262,ymfD,2395322,2395322,2395064,258,172,utRho01
2263,ymfI,2402880,2402994,2402880,114,0,utRho01
2264,ymfJ,2404518,2404518,2404168,350,122,utRho01
2265,ymfK,2406176,2406176,2405866,310,108,utRho01
2266,ymfT,2405766,2406048,2405766,282,108,utRho01
2267,ymgE,2489110,2489456,2489110,346,80,utRho01
2268,ymgF,2437628,2437966,2437628,338,0,utRho01
2269,ymiA,2670112,2670320,2670112,208,106,utRho01
2270,ymjA,2715620,2715620,2715336,284,576,utRho01
2271,ynaI,2791946,2791946,2791844,102,0,utRho01
2272,ynaK,2850438,2850754,2850438,316,42,utRho01
2273,ynbA,2954924,2955242,2954924,318,0,utRho01
2274,yncD,3046552,3046552,3046130,422,196,utRho01
2275,yncE,3046454,3046614,3046454,160,0,utRho01
2276,yncG,3052456,3052494,3052456,38,28,utRho01
2277,yncL,3034492,3034492,3034388,104,4,utRho01
2278,yneE,3218364,3218364,3218044,320,82,utRho01
2279,yneF,3223748,3223748,3223708,40,0,utRho01
2280,yneJ,3229560,3229608,3229560,48,110,utRho01
2281,yneK,3231100,3231526,3231100,426,0,utRho01
2282,yneM,3245176,3245292,3245176,116,294,utRho01
2283,ynfA,3311398,3311398,3311346,52,28,utRho01
2284,ynfB,3311418,3311616,3311418,198,240,utRho01
2285,ynfC,3315094,3315094,3314914,180,0,utRho01
2286,ynfD,3314828,3315130,3314828,302,0,utRho01
2287,ynfE,3316006,3316138,3316006,132,14,utRho01
2288,ynfK,3334670,3334670,3334438,232,228,utRho01
2289,ynfL,3339304,3339304,3339184,120,0,utRho01
2290,ynfM,3339260,3339398,3339260,138,50,utRho01
2291,ynfN,3276598,3276598,3276218,380,2202,utRho01
2292,ynfO,3273454,3273512,3273454,58,18,utRho01
2293,ynhG,3517890,3517890,3517450,440,520,utRho01
2294,yniA,3615158,3615592,3615158,434,80,utRho01
2295,yniB,3618526,3618526,3618466,60,0,utRho01
2296,yniC,3618652,3618760,3618652,108,0,utRho01
2297,yniD,3610202,3610330,3610202,128,0,utRho01
2298,ynjE,3678880,3678934,3678880,54,42,utRho01
2299,ynjF,3683222,3683222,3682806,416,10,utRho01
2300,ynjH,3684376,3684376,3684270,106,24,utRho01
2301,ynjI,3690022,3690022,3689742,280,0,utRho01
2302,yoaB,3786642,3786734,3786642,92,206,utRho01
2303,yoaC,3787932,3788146,3787932,214,310,utRho01
2304,yoaE,3803544,3803544,3803170,374,134,utRho01
2305,yoaF,3755444,3755444,3755064,380,1258,utRho01
2306,yoaH,3789866,3789866,3789462,404,518,utRho01
2307,yobB,3850418,3850880,3850418,462,1012,utRho01
2308,yobF,3815586,3815586,3815182,404,218,utRho01
2309,yobH,3817800,3817850,3817800,50,50,utRho01
2310,yodB,4084352,4084736,4084352,384,88,utRho01
2311,yodC,4057008,4057008,4056740,268,28,utRho01
2312,yohC,4451358,4451358,4451262,96,16,utRho01
2313,yohD,4451526,4451602,4451526,76,8,utRho01
2314,yohJ,4460986,4461248,4460986,262,36,utRho01
2315,yohO,4431172,4431314,4431172,142,84,utRho01
2316,yojI,4617282,4617282,4617230,52,0,utRho01
2317,ypdI,4988988,4989396,4988988,408,108,utRho01
2318,ypfG,5165786,5165786,5165554,232,0,utRho01
2319,ypfM,5182140,5182140,5181732,408,30,utRho01
2320,yphB,5349590,5349590,5349376,214,42,utRho01
2321,ypjA,5565644,5565644,5565452,192,56,utRho01
2322,ypjB,5569636,5569636,5568858,778,0,utRho01
2323,ypjD,5495860,5495774,5495860,86,0,utRho01
2324,yqaE,5594170,5594170,5594056,114,120,utRho01
2325,yqcA,5846100,5846100,5845968,132,60,utRho01
2326,yqcE,5800944,5801184,5800944,240,0,utRho01
2327,yqeC,6030468,6030468,6030114,354,0,utRho01
2328,yqeF,5971618,5971618,5971184,434,48,utRho01
2329,yqeG,5971438,5971694,5971438,256,26,utRho01
2330,yqeH,5975016,5975072,5975016,56,0,utRho01
2331,yqeI,5976688,5977004,5976688,316,0,utRho01
2332,yqeK,5981140,5981140,5980720,420,12,utRho01
2333,yqfA,6086728,6086728,6086296,432,904,utRho01
2334,yqgA,6219042,6219106,6219042,64,0,utRho01
2335,yqgB,6172500,6172500,6172102,398,1964,utRho01
2336,yqgE,6185768,6185874,6185768,106,490,utRho01
2337,yqhA,6299150,6299150,6298942,208,30,utRho01
2338,yqhC,6310768,6310768,6310436,332,74,utRho01
2339,yqhD,6310604,6310710,6310604,106,72,utRho01
2340,yqhH,6316842,6317254,6316842,412,650,utRho01
2341,yqiC,6369662,6369680,6369662,18,54,utRho01
2342,yqiJ,6384108,6384416,6384108,308,216,utRho01
2343,yqjA,6495096,6495546,6495096,450,10398,utRho01
2344,yqjF,6500932,6501124,6500932,192,40,utRho01
2345,yqjG,6501948,6502048,6501948,100,0,utRho01
2346,yqjH,6433078,6433078,6432982,96,44,utRho01
2347,yqjI,6433506,6433558,6433506,52,0,utRho01
2348,yraH,6574552,6574852,6574552,300,0,utRho01
2349,yraP,6592144,6592818,6592144,674,296,utRho01
2350,yraQ,6596414,6596414,6596276,138,0,utRho01
2351,yraR,6598024,6598024,6597692,332,34,utRho01
2352,yrbG,13360844,13361100,13360844,256,224,utRho01
2353,yrbL,6696842,6696904,6696842,62,858,utRho01
2354,yrbN,6616172,6616172,6615866,306,22678,utRho01
2355,yrdB,6860176,6860176,6860046,130,378,utRho01
2356,yrfF,7052548,7052938,7052548,390,320,utRho01
2357,yrhB,7169440,7169518,7169440,78,0,utRho01
2358,ysaB,7451804,7451804,7451424,380,26,utRho01
2359,ysgA,8032686,8032686,8032338,348,254,utRho01
2360,ytfB,8857638,8857638,8857434,204,106,utRho01
2361,ytfE,8864018,8864018,8863966,52,30,utRho01
2362,ytfF,8866296,8866296,8866130,166,90,utRho01
2363,ytfH,8868164,8868226,8868164,62,0,utRho01
2364,ytfI,8875234,8875414,8875234,180,32,utRho01
2365,ytfJ,8878572,8878572,8878524,48,0,utRho01
2366,ytfK,8879022,8879174,8879022,152,192,utRho01
2367,ytfL,8882642,8882642,8882430,212,150,utRho01
2368,ytfQ,8899634,8899924,8899634,290,152,utRho01
2369,ytjB,9249598,9249598,9249578,20,20,utRho01
2370,yzfA,8896588,8896588,8896490,98,68,utRho01
2371,zapA,6111102,6111224,6111102,122,6998,utRho01
2372,zapB,8236772,8237030,8236772,258,130,utRho01
2373,zapC,2011700,2011904,2011700,204,44,utRho01
2374,zinT,4082692,4082750,4082692,58,0,utRho01
2375,zipA,5062814,5062814,5062466,348,56,utRho01
2376,zitB,1569716,1569716,1569646,70,0,utRho01
2377,zntA,7212844,7212902,7212844,58,108,utRho01
2378,zntR,6878336,6878336,6878260,76,30,utRho01
2379,znuA,3885322,3885322,3885166,156,0,utRho01
2380,znuC,3885268,3885324,3885268,56,0,utRho01
2381,zraP,8403424,8403424,8403376,48,20,utRho01
2382,zraS,8403810,8403852,8403810,42,0,utRho01
2383,zupT,6364866,6365100,6364866,234,446,utRho01
2384,zur,8520282,8520282,8520006,276,1736,utRho01
2385,zwf,3872752,3872752,3872628,124,98,utRho01
0,C0343,2818676,2818728,2818676,52,0,utRho02
1,aaeB,6776526,6776526,6776376,150,0,utRho02
2,aaeR,6778762,6779040,6778762,278,126,utRho02
3,aaeX,6778860,6778860,6778674,186,254,utRho02
4,aat,1854920,1854920,1854864,56,12,utRho02
5,accA,416822,417242,416822,420,2200,utRho02
6,accB,6810280,6810872,6810280,592,12592,utRho02
7,accD,4868030,4868030,4867852,178,584,utRho02
8,aceB,8430804,8430956,8430804,152,0,utRho02
9,aceE,245938,246034,245938,96,716,utRho02
10,ackA,4826918,4826940,4826918,22,2808,utRho02
11,acnA,2670848,2671662,2670848,814,874,utRho02
12,acnB,263038,263230,263038,192,1892,utRho02
13,acpP,2303148,2303230,2303148,82,374,utRho02
14,acpS,5402324,5402324,5401996,328,282,utRho02
15,acrA,971396,971396,971238,158,536,utRho02
16,acrB,969370,969370,968806,564,2146,utRho02
17,acrD,5174950,5175190,5174950,240,24,utRho02
18,acrE,6827404,6827728,6827404,324,4,utRho02
19,acrR,971398,971522,971398,124,314,utRho02
20,acrZ,1589502,1589546,1589502,44,90,utRho02
21,acs,8575190,8575190,8574742,448,20,utRho02
22,actP,8569870,8569870,8569804,66,0,utRho02
23,ada,4620854,4620854,4620810,44,0,utRho02
24,add,3404404,3404466,3404404,62,58,utRho02
25,ade,7687802,7687928,7687802,126,0,utRho02
26,adhE,2596826,2596826,2596242,584,132,utRho02
27,adhP,3107988,3107988,3107676,312,1022,utRho02
28,adiA,8681112,8681112,8681042,70,0,utRho02
29,adiC,8674404,8674404,8674062,342,4,utRho02
30,adiY,8676084,8676084,8675858,226,0,utRho02
31,adk,994278,994350,994278,72,92,utRho02
32,adrA,807374,807406,807374,32,0,utRho02
33,aer,6438240,6438240,6438152,88,48,utRho02
34,aes,1000102,1000102,999946,156,24,utRho02
35,agaR,6557406,6557406,6557330,76,0,utRho02
36,agaS,6563778,6563952,6563778,174,0,utRho02
37,agp,2131118,2131170,2131118,52,0,utRho02
38,agrA,7296126,7296126,7296126,0,0,utRho02
39,agrB,7296588,7296588,7296588,0,0,utRho02
40,ahpC,1277386,1277890,1277386,504,1648,utRho02
41,ahpF,1278004,1279506,1278004,1502,60080,utRho02
42,ahr,8992698,8992698,8992418,280,0,utRho02
43,aidB,8828494,8828550,8828494,56,0,utRho02
44,ais,4731512,4731512,4731240,272,0,utRho02
45,alaA,4814816,4815122,4814816,306,44,utRho02
46,alaC,4996798,4996798,4996590,208,32,utRho02
47,alaE,5598140,5598328,5598140,188,296,utRho02
48,alaS,5644180,5644180,5644022,158,2292,utRho02
49,alaW,5036612,5036612,5036462,150,0,utRho02
50,aldA,2976380,2976464,2976380,84,116,utRho02
51,aldB,7513070,7513070,7513022,48,0,utRho02
52,alkA,4295118,4295118,4295080,38,124,utRho02
53,alkB,4618890,4618890,4618682,208,112,utRho02
54,allA,1064780,1064902,1064780,122,0,utRho02
55,allD,1092822,1092822,1092726,96,0,utRho02
56,allE,1088112,1088112,1088092,20,110,utRho02
57,allS,1064600,1064600,1064442,158,0,utRho02
58,alr,8531178,8531564,8531178,386,3596,utRho02
59,alsE,8617334,8617334,8616956,378,16,utRho02
60,alsK,8615990,8615990,8615598,392,342,utRho02
61,alx,6476740,6477160,6476740,420,8,utRho02
62,amiA,5104482,5104704,5104482,222,6,utRho02
63,amiC,5898378,5898378,5898020,358,10,utRho02
64,amn,4110062,4110122,4110062,60,0,utRho02
65,ampC,8758006,8758006,8757888,118,0,utRho02
66,ampD,237362,237466,237362,104,54,utRho02
67,ampG,907372,907372,907090,282,602,utRho02
68,ampH,792726,792726,792574,152,40,utRho02
69,amyA,4012230,4012312,4012230,82,78,utRho02
70,anmK,3439346,3439346,3439204,142,0,utRho02
71,ansB,6201580,6201580,6201456,124,178,utRho02
72,ansP,3052040,3052040,3051960,80,386,utRho02
73,apaG,104068,104068,103212,856,9550,utRho02
74,apaH,102586,102586,102444,142,6478,utRho02
75,apbE,4623188,4623188,4623068,120,50,utRho02
76,appA,2081198,2081234,2081198,36,0,utRho02
77,appC,2075420,2075480,2075420,60,0,utRho02
78,appY,1167134,1167362,1167134,228,0,utRho02
79,apt,982620,982824,982620,204,450,utRho02
80,aqpZ,1832424,1832424,1832094,330,4,utRho02
81,araB,140150,140150,140096,54,0,utRho02
82,araC,140482,140774,140482,292,0,utRho02
83,araE,5964416,5964416,5964364,52,0,utRho02
84,araF,3972476,3972476,3972256,220,0,utRho02
85,araH,3967120,3967120,3967086,34,0,utRho02
86,araJ,825058,825058,824962,96,152,utRho02
87,arcA,9281602,9281602,9280612,990,12920,utRho02
88,arcB,6706098,6706098,6706050,48,0,utRho02
89,arcZ,6701154,6701154,6701154,0,0,utRho02
90,arfA,6877346,6877346,6877298,48,770,utRho02
91,argA,5898312,5898484,5898312,172,0,utRho02
92,argC,8309770,8310002,8309770,232,64,utRho02
93,argD,6980442,6980442,6980360,82,0,utRho02
94,argE,8310156,8310156,8309694,462,84,utRho02
95,argF,580680,580680,580610,70,0,utRho02
96,argG,6637124,6637274,6637124,150,0,utRho02
97,argI,8956688,8956688,8956622,66,2,utRho02
98,argO,6137672,6137672,6137616,56,372,utRho02
99,argP,6119460,6119506,6119460,46,0,utRho02
100,argR,6769204,6769406,6769204,202,80,utRho02
101,argS,3920002,3920124,3920002,122,0,utRho02
102,argT,4855698,4855698,4855582,116,336,utRho02
103,argU,1129406,1129446,1129406,40,16,utRho02
104,argW,4932616,4932618,4932616,2,0,utRho02
105,argX,7964728,7964750,7964728,22,0,utRho02
106,aroF,5482402,5482402,5482300,102,0,utRho02
107,aroG,1571182,1571266,1571182,84,40,utRho02
108,aroH,3576636,3576870,3576636,234,462,utRho02
109,aroK,7038760,7038760,7038128,632,2476,utRho02
110,aroL,812560,812810,812560,250,112,utRho02
111,aroP,243342,243342,243102,240,0,utRho02
112,arpA,8445382,8445382,8444974,408,296,utRho02
113,arrS,7316108,7316108,7316108,0,0,utRho02
114,arsR,7297024,7297056,7297024,32,2,utRho02
115,artJ,1801252,1801252,1801150,102,60,utRho02
116,artP,1807686,1807686,1807468,218,4,utRho02
117,ascF,5678858,5679048,5678858,190,0,utRho02
118,ascG,5678574,5678574,5678528,46,0,utRho02
119,aslB,7965562,7965916,7965562,354,49752,utRho02
120,asnA,7854258,7854310,7854258,52,34,utRho02
121,asnB,1398444,1398444,1398354,90,1162,utRho02
122,asnC,23562186,23562186,23562018,168,0,utRho02
123,asnS,1978088,1978088,1977970,118,12350,utRho02
124,asnT,4089082,4089098,4089082,16,8,utRho02
125,asnU,4119690,4119702,4119690,12,0,utRho02
126,asnV,4124504,4124520,4124504,16,0,utRho02
127,aspA,17473728,17473728,17473308,420,64,utRho02
128,aspC,1971486,1971486,1971418,68,510,utRho02
129,aspS,3901402,3901402,3901044,358,104,utRho02
130,aspT,7893560,7893744,7893560,184,101626,utRho02
131,aspV,473826,473862,473826,36,8,utRho02
132,asr,3342654,3342752,3342654,98,82,utRho02
133,astC,3664088,3664088,3663964,124,0,utRho02
134,astE,3654138,3654138,3653846,292,0,utRho02
135,atoD,4646824,4646894,4646824,70,0,utRho02
136,atpB,7844540,7844540,7844102,438,1096,utRho02
137,atpC,7832118,7832118,7831944,174,1504,utRho02
138,atpI,7845050,7845050,7844880,170,82,utRho02
139,avtA,7479348,7479410,7479348,62,326,utRho02
140,azoR,2965982,2965982,2965720,262,224,utRho02
141,azuC,3976002,3976002,3975918,84,106,utRho02
142,bacA,6408350,6408350,6408262,88,4,utRho02
143,bamA,394052,395856,394052,1804,1488,utRho02
144,bamB,5277950,5277950,5277304,646,2390,utRho02
145,bamC,5198028,5198028,5197730,298,1498,utRho02
146,bamD,5471922,5472292,5471922,370,9314,utRho02
147,bamE,5506972,5507210,5506972,238,444,utRho02
148,basS,8666954,8666954,8666544,410,322,utRho02
149,bax,7474468,7474468,7474354,114,168,utRho02
150,bcp,5200874,5200956,5200874,82,1800,utRho02
151,bcsB,7385346,7385346,7385214,132,0,utRho02
152,bcsE,7392644,7392916,7392644,272,150,utRho02
153,bdcA,8948128,8948128,8948106,22,70,utRho02
154,bdcR,8948192,8948248,8948192,56,0,utRho02
155,bdm,3112680,3112680,3112560,120,0,utRho02
156,betA,654522,654522,654494,28,192,utRho02
157,betI,658722,658722,658668,54,50,utRho02
158,betT,658842,658926,658842,84,50,utRho02
159,bfr,6933498,6933498,6933450,48,0,utRho02
160,bglG,23440182,23440182,23439402,780,0,utRho02
161,bglX,4444240,4444240,4443978,262,0,utRho02
162,bhsA,2337962,2338146,2337962,184,152,utRho02
163,bioA,1618584,1618584,1618514,70,26,utRho02
164,bioB,1618604,1618688,1618604,84,4,utRho02
165,bioH,7089716,7089716,7089688,28,0,utRho02
166,bisC,7433026,7433026,7432788,238,140,utRho02
167,blc,8755490,8755490,8755444,46,22,utRho02
168,blr,3409024,3409102,3409024,78,0,utRho02
169,bluF,2431226,2431226,2430950,276,2724,utRho02
170,bluR,2428226,2428226,2428118,108,0,utRho02
171,bolA,908698,908944,908698,246,0,utRho02
172,borD,1157842,1157842,1157786,56,4,utRho02
173,brnQ,838976,839182,838976,206,3166,utRho02
174,bssR,1756492,1756496,1756492,4,0,utRho02
175,bssS,2242116,2242116,2241910,206,954,utRho02
176,btuB,8326798,8327278,8326798,480,3832,utRho02
177,cadB,8720212,8720212,8720062,150,40,utRho02
178,cadC,8723926,8723926,8723868,58,0,utRho02
179,caiE,70998,70998,70742,256,0,utRho02
180,caiF,68436,68600,68436,164,0,utRho02
181,caiT,84074,84074,83862,212,0,utRho02
182,can,285406,285406,285340,66,96,utRho02
183,carA,59102,59302,59102,200,66,utRho02
184,carB,61550,61634,61550,84,86,utRho02
185,cas2,5757830,5757830,5757706,124,0,utRho02
186,casA,5768638,5768638,5768276,362,0,utRho02
187,cbl,4121882,4121882,4121828,54,0,utRho02
188,cbpA,2128074,2128074,2127550,524,862,utRho02
189,cbrA,7738628,7738754,7738628,126,0,utRho02
190,cbrB,7794958,7795012,7794958,54,34,utRho02
191,ccmH,4585242,4585242,4584820,422,220,utRho02
192,cdaR,364894,364926,364894,32,22,utRho02
193,cdd,4463638,4463688,4463638,50,94,utRho02
194,cdh,8219814,8219860,8219814,46,0,utRho02
195,cdsA,391110,391354,391110,244,2630,utRho02
196,cedA,3627484,3627484,3627326,158,62,utRho02
197,cfa,3482402,3482826,3482402,424,598,utRho02
198,chaC,2544844,2544972,2544844,128,0,utRho02
199,chbB,3643452,3643452,3643238,214,0,utRho02
200,chbG,3634624,3634624,3634270,354,0,utRho02
201,cheW,3946924,3946924,3946678,246,240,utRho02
202,chiA,6939792,6939792,6939706,86,0,utRho02
203,chiP,1416472,1416668,1416472,196,42,utRho02
204,cho,3646984,3647030,3646984,46,0,utRho02
205,chpS,8896804,8896894,8896804,90,0,utRho02
206,cirA,4493884,4493884,4493538,346,842,utRho02
207,citC,1304078,1304078,1303712,366,0,utRho02
208,citT,1293264,1293264,1293160,104,0,utRho02
209,clcA,350104,350214,350104,110,44,utRho02
210,clpA,1846160,1846528,1846160,368,4,utRho02
211,clpB,5468410,5468410,5468346,64,38,utRho02
212,clpP,913154,913354,913154,200,718,utRho02
213,clpS,1845500,1845826,1845500,326,76,utRho02
214,clpX,914404,914852,914404,448,1750,utRho02
215,clsA,2617346,2617346,2617290,56,86,utRho02
216,clsC,2212584,2212710,2212584,126,342,utRho02
217,cmk,1922330,1922402,1922330,72,202,utRho02
218,cnu,3409522,3409898,3409522,376,1000,utRho02
219,coaA,8350214,8350214,8350052,162,1152,utRho02
220,cobC,1340092,1340092,1339814,278,828,utRho02
221,cobT,4129202,4129202,4128934,268,36,utRho02
222,cobU,4131944,4131944,4131528,416,534,utRho02
223,codB,709768,709844,709768,76,2,utRho02
224,comR,2337726,2337726,2337664,62,0,utRho02
225,copA,1022822,1022822,1022758,64,0,utRho02
226,corA,8002388,8002852,8002388,464,5530,utRho02
227,cpdB,8873258,8873258,8873130,128,48,utRho02
228,cptB,6082198,6082198,6082140,58,56,utRho02
229,cpxA,8210202,8210202,8209950,252,1162,utRho02
230,cpxP,8211570,8211640,8211570,70,116,utRho02
231,cpxR,8211372,8211372,8211340,32,40,utRho02
232,cra,175894,176056,175894,162,52,utRho02
233,crcB,1316016,1316016,1315876,140,118,utRho02
234,creA,9270486,9271042,9270486,556,706,utRho02
235,creD,9276320,9276356,9276320,36,28,utRho02
236,crl,515620,515658,515620,38,1848,utRho02
237,crp,6971906,6972240,6971906,334,5510,utRho02
238,crr,5070960,5071668,5070960,708,8470,utRho02
239,csdA,5886414,5886674,5886414,260,242,utRho02
240,csgB,2207718,2207902,2207718,184,0,utRho02
241,csgD,2206688,2206688,2206392,296,0,utRho02
242,csgG,2203510,2203510,2203368,142,38,utRho02
243,csiD,5577854,5577970,5577854,116,0,utRho02
244,csiE,5330802,5330870,5330802,68,0,utRho02
245,csiR,5590942,5591348,5590942,406,0,utRho02
246,cspA,7439778,7440098,7439778,320,500838,utRho02
247,cspB,3283430,3283430,3283108,322,792,utRho02
248,cspC,3815018,3815018,3814870,148,422,utRho02
249,cspD,1845352,1845352,1845180,172,442,utRho02
250,cspE,1314294,1314584,1314294,290,166,utRho02
251,cspF,3283380,3283710,3283380,330,44,utRho02
252,cspG,2102610,2102922,2102610,312,284208,utRho02
253,cspH,2102746,2102746,2102350,396,676,utRho02
254,cspI,3277624,3277624,3277334,290,836,utRho02
255,csrA,5638746,5638746,5638292,454,2122,utRho02
256,csrB,5849048,5849048,5849048,0,0,utRho02
257,csrC,8102072,8102072,8102072,0,0,utRho02
258,csrD,6806850,6806850,6806664,186,226,utRho02
259,cstA,1259710,1259788,1259710,78,48,utRho02
260,cueO,274090,274166,274090,76,0,utRho02
261,cueR,1027948,1027986,1027948,38,44,utRho02
262,curA,3037784,3038054,3037784,270,124,utRho02
263,cusC,1191146,1191200,1191146,54,0,utRho02
264,cusR,1190924,1190924,1190886,38,0,utRho02
265,cutA,8730784,8730784,8730712,72,196,utRho02
266,cutC,3918534,3918534,3917920,614,30,utRho02
267,cvpA,4861600,4861600,4861526,74,14,utRho02
268,cvrA,2484328,2484328,2484142,186,116,utRho02
269,cyaA,7981548,7982306,7981548,758,2170,utRho02
270,cyaR,4334228,4334224,4334228,4,14,utRho02
271,cyaY,7988166,7988166,7988118,48,104,utRho02
272,cybB,2981522,2981804,2981522,282,106,utRho02
273,cycA,8859560,8859728,8859560,168,606,utRho02
274,cydA,1542340,1542916,1542340,576,68,utRho02
275,cydC,1858800,1858800,1858390,410,68,utRho02
276,cydD,1862062,1862062,1861924,138,44,utRho02
277,cydX,1548300,1548392,1548300,92,478,utRho02
278,cynR,717418,717418,717380,38,50,utRho02
279,cynT,1435092,1435196,1435092,104,0,utRho02
280,cyoA,903306,903306,903220,86,2464,utRho02
281,cyoE,895540,895540,895410,130,578,utRho02
282,cysB,2667576,2667710,2667576,134,412,utRho02
283,cysC,5748056,5748056,5747984,72,12,utRho02
284,cysD,5752736,5752736,5752658,78,0,utRho02
285,cysE,7565362,7565362,7565124,238,560,utRho02
286,cysG,6995508,6995656,6995508,148,88,utRho02
287,cysJ,5783928,5783928,5783796,132,1898,utRho02
288,cysK,5064688,5064818,5064688,130,136,utRho02
289,cysP,5087114,5087114,5087056,58,424,utRho02
290,cysS,1109154,1109222,1109154,68,140,utRho02
291,cysT,3984100,3984100,3983974,126,106,utRho02
292,cysZ,5062766,5062926,5062766,160,376,utRho02
293,cytR,8249018,8249018,8248912,106,190,utRho02
294,dacA,1328002,1328002,1327926,76,50,utRho02
295,dacB,6657714,6657926,6657714,212,2,utRho02
296,dacC,1761306,1761454,1761306,148,0,utRho02
297,dadA,2475018,2475142,2475018,124,0,utRho02
298,dam,7032504,7032504,7031826,678,1984,utRho02
299,damX,7035200,7035200,7034612,588,338,utRho02
300,dapA,5199568,5199568,5199520,48,0,utRho02
301,dapB,56576,56748,56576,172,70,utRho02
302,dapD,371954,371954,371894,60,142,utRho02
303,dapE,5183120,5183214,5183120,94,260,utRho02
304,dcp,3254844,3254844,3254760,84,8,utRho02
305,dcrB,7219534,7219910,7219534,376,114,utRho02
306,dctA,7366996,7366996,7366894,102,1366,utRho02
307,dcuA,8733686,8733686,8733546,140,0,utRho02
308,dcuB,8698182,8698182,8697488,694,70,utRho02
309,dcuC,1312166,1312166,1311936,230,0,utRho02
310,dcuD,6749166,6749738,6749166,572,2,utRho02
311,dcuR,8701130,8701130,8700068,1062,436,utRho02
312,dcuS,8703370,8703370,8703324,46,110,utRho02
313,dcyD,3999016,3999016,3998960,56,0,utRho02
314,ddpX,3126498,3126498,3126152,346,0,utRho02
315,deaD,6615818,6615818,6615720,98,7948,utRho02
316,dedA,4869880,4869880,4869482,398,11724,utRho02
317,dedD,4863750,4863750,4863368,382,42,utRho02
318,def,6867300,6867380,6867300,80,414,utRho02
319,degP,361690,361768,361690,78,36,utRho02
320,degQ,6761308,6761486,6761308,178,5960,utRho02
321,deoB,9239134,9239206,9239134,72,0,utRho02
322,deoC,9233358,9234646,9233358,1288,152,utRho02
323,dfp,7625406,7625462,7625406,56,48,utRho02
324,dgcZ,3247758,3247758,3247700,58,0,utRho02
325,dgkA,8512914,8513274,8512914,360,220,utRho02
326,dgt,358392,358474,358392,82,0,utRho02
327,dhaK,2501888,2501888,2501676,212,4,utRho02
328,dhaR,2502006,2502132,2502006,126,22,utRho02
329,dicB,3299194,3299218,3299194,24,0,utRho02
330,dicC,3295752,3295752,3295700,52,0,utRho02
331,dinB,501760,501796,501760,36,0,utRho02
332,dinD,7635398,7635520,7635398,122,374,utRho02
333,dinG,1666146,1666140,1666146,6,0,utRho02
334,dinI,2243018,2243018,2242974,44,50,utRho02
335,dinJ,493230,493230,493004,226,42,utRho02
336,dinQ,7295964,7295964,7295576,388,1778,utRho02
337,djlA,114536,114728,114536,192,0,utRho02
338,dkgA,6313142,6313246,6313142,104,112,utRho02
339,dkgB,458196,458334,458196,138,808,utRho02
340,dksA,321502,321502,321208,294,412,utRho02
341,dld,4444164,4444370,4444164,206,0,utRho02
342,dmlA,3763424,3763824,3763424,400,0,utRho02
343,dmlR,3763710,3763710,3763618,92,0,utRho02
344,dmsA,1881646,1881918,1881646,272,0,utRho02
345,dnaA,7767922,7767922,7767458,464,8388,utRho02
346,dnaB,8528566,8528628,8528566,62,158,utRho02
347,dnaK,24096,24326,24096,230,488,utRho02
348,dnaN,7765466,7765466,7764642,824,2134,utRho02
349,dnaQ,471868,472134,471868,266,914,utRho02
350,dnaT,18406460,18406460,18406068,392,308,utRho02
351,dnaX,984112,984184,984112,72,776,utRho02
352,dosP,3131486,3131486,3131466,20,0,utRho02
353,dpiB,1303968,1304470,1303968,502,0,utRho02
354,dppA,7415740,7415740,7415410,330,984,utRho02
355,dps,1697900,1697900,1697822,78,30,utRho02
356,dsbA,8086754,8086836,8086754,82,3030,utRho02
357,dsbB,2466294,2466294,2466060,234,0,utRho02
358,dsbC,6079266,6079266,6077644,1622,1290,utRho02
359,dsbG,1277600,1277600,1277146,454,1008,utRho02
360,dsdA,4958242,4958404,4958242,162,2,utRho02
361,dsdC,4955492,4955492,4955258,234,0,utRho02
362,dsdX,4955642,4955694,4955642,52,0,utRho02
363,dsrA,4050626,4050626,4050626,0,0,utRho02
364,dsrB,4049686,4049686,4049646,40,36,utRho02
365,dtpD,1485340,1485340,1485112,228,30,utRho02
366,dusA,8523200,8523338,8523200,138,5306,utRho02
367,dusB,6820492,6820560,6820492,68,188,utRho02
368,dusC,4460790,4460790,4460770,20,0,utRho02
369,dut,7627704,7627864,7627704,160,1802,utRho02
370,dxr,386670,387042,386670,372,1118,utRho02
371,ebgA,6445102,6445266,6445102,164,50,utRho02
372,ebgR,6442874,6442932,6442874,58,48,utRho02
373,ecnB,8753018,8753106,8753018,88,300,utRho02
374,eco,4607594,4607810,4607594,216,22,utRho02
375,ecpA,621594,621594,621342,252,0,utRho02
376,ecpB,620238,620238,620052,186,0,utRho02
377,ecpR,622964,622964,622672,292,0,utRho02
378,eda,3866218,3866218,3865512,706,188,utRho02
379,edd,3869426,3869426,3869208,218,96,utRho02
380,efeO,2164308,2164486,2164308,178,134,utRho02
381,efeU_1,2162614,2162712,2162614,98,72,utRho02
382,efp,8751134,8751398,8751134,264,8714,utRho02
383,elaA,4763372,4763372,4763086,286,0,utRho02
384,elaD,4765308,4765426,4765308,118,4,utRho02
385,elfA,1995530,1995736,1995530,206,0,utRho02
386,elfD,1996642,1996980,1996642,338,0,utRho02
387,emrD,7707690,7707844,7707690,154,50,utRho02
388,emrK,4966896,4966896,4966678,218,0,utRho02
389,emrY,4964668,4964668,4964352,316,0,utRho02
390,emtA,2486250,2486360,2486250,110,0,utRho02
391,endA,12361100,12361388,12361100,288,16,utRho02
392,eno,5817692,5817692,5815882,1810,6212,utRho02
393,entC,1249662,1249770,1249662,108,46,utRho02
394,entD,1220508,1220508,1220158,350,278,utRho02
395,entH,1258584,1258600,1258584,16,72,utRho02
396,entS,1244506,1244600,1244506,94,30,utRho02
397,envR,6827266,6827266,6826930,336,0,utRho02
398,epd,12295292,12295292,12294764,528,264,utRho02
399,epmA,8765236,8765286,8765236,50,32,utRho02
400,epmB,8751406,8751406,8751314,92,5000,utRho02
401,eptB,7421162,7421162,7420950,212,422,utRho02
402,eptC,8300622,8300622,8300530,92,390,utRho02
403,erfK,4126708,4126708,4126646,62,1328,utRho02
404,erpA,353122,353220,353122,98,0,utRho02
405,esrE,8039956,8039956,8039956,0,0,utRho02
406,essD,1153746,1154796,1153746,1050,274,utRho02
407,etk,2088606,2088606,2088420,186,84,utRho02
408,evgA,4967262,4967510,4967262,248,0,utRho02
409,exbB,6304028,6304028,6303968,60,46,utRho02
410,exbD,6302780,6302780,6302486,294,114,utRho02
411,exuR,6493016,6493304,6493016,288,164,utRho02
412,exuT,6490004,6490208,6490004,204,0,utRho02
413,fabA,2032996,2032996,2032940,56,278,utRho02
414,fabB,4883282,4883282,4883210,72,68,utRho02
415,fabH,2297032,2297518,2297032,486,3788,utRho02
416,fabI,2702236,2702236,2702078,158,14,utRho02
417,fadB,8062026,8062026,8061942,84,0,utRho02
418,fadD,3779614,3779614,3779492,122,0,utRho02
419,fadE,486812,486812,486606,206,44,utRho02
420,fadH,6463248,6463330,6463248,82,22,utRho02
421,fadI,4921022,4921022,4920938,84,0,utRho02
422,fadL,4922410,4922600,4922410,190,24,utRho02
423,fadM,928720,928804,928720,84,84,utRho02
424,fadR,2469810,2469876,2469810,66,0,utRho02
425,fbaB,4357334,4357334,4357128,206,0,utRho02
426,fdhE,8162722,8162722,8162456,266,890,utRho02
427,fdhF,8598814,8598814,8598732,82,0,utRho02
428,fdnG,3094744,3094802,3094744,58,0,utRho02
429,fdrA,1093012,1093360,1093012,348,0,utRho02
430,feaB,2894994,2895038,2894994,44,0,utRho02
431,feaR,2894734,2894734,2894566,168,0,utRho02
432,fecA,9033454,9033454,9033354,100,346,utRho02
433,fecE,9023288,9023288,9022914,374,8416,utRho02
434,fecI,9036564,9036564,9036470,94,178,utRho02
435,feoA,7080114,7080326,7080114,212,260,utRho02
436,fepA,1225334,1225334,1224988,346,132,utRho02
437,fepB,1249454,1249454,1249020,434,924,utRho02
438,fepD,1244468,1244468,1244378,90,0,utRho02
439,fes,1225374,1225630,1225374,256,308,utRho02
440,ffh,5495706,5495706,5495590,116,2552,utRho02
441,ffs,952576,952848,952576,272,68,utRho02
442,fhuA,334884,334968,334884,84,288,utRho02
443,fhuE,2323294,2323294,2323102,192,300,utRho02
444,fhuF,9211504,9211504,9211326,178,3712,utRho02
445,fic,6983296,6983296,6982926,370,404,utRho02
446,fieF,8212864,8212938,8212864,74,48,utRho02
447,fimA,9085388,9086230,9085388,842,202,utRho02
448,fimB,9081334,9081914,9081334,580,662,utRho02
449,fimE,9083742,9084074,9083742,332,20,utRho02
450,fimZ,1129214,1129214,1128960,254,182,utRho02
451,fiu,1683296,1683296,1683062,234,178,utRho02
452,fixA,84650,84806,84650,156,0,utRho02
453,fkpA,6955050,6955050,6954838,212,8636,utRho02
454,fldA,2846084,2846084,2845860,224,4516,utRho02
455,fldB,6079644,6079710,6079644,66,54,utRho02
456,flgA,2261770,2261770,2261726,44,16,utRho02
457,flgB,2261986,2262036,2261986,50,0,utRho02
458,flgK,2276702,2276756,2276702,54,2286,utRho02
459,flgM,2260330,2260330,2260256,74,788,utRho02
460,flgN,2259828,2259828,2259660,168,414,utRho02
461,flhB,3932432,3932432,3932382,50,204,utRho02
462,flhC,3955864,3955864,3955688,176,126,utRho02
463,flhD,3957154,3957154,3956394,760,848,utRho02
464,fliA,4003638,4003638,4003578,60,64,utRho02
465,fliC,4007352,4007352,4007212,140,72,utRho02
466,fliD,4007634,4007744,4007634,110,194,utRho02
467,fliE,4026186,4026186,4026028,158,0,utRho02
468,fliF,4026292,4026458,4026292,166,564,utRho02
469,fliL,4039168,4039236,4039168,68,120,utRho02
470,flk,4875824,4875900,4875824,76,0,utRho02
471,flu,4142634,4143078,4142634,444,0,utRho02
472,flxA,3292776,3292810,3292776,34,0,utRho02
473,fnr,2799104,2799104,2799052,52,126,utRho02
474,fnrS,2818258,2818258,2818258,0,0,utRho02
475,focA,1909628,1909628,1908932,696,810,utRho02
476,folA,99598,99646,99598,48,26,utRho02
477,folB,6409296,6409296,6409178,118,0,utRho02
478,folD,1115562,1115562,1115482,80,94,utRho02
479,folE,4487696,4487696,4487304,392,4644,utRho02
480,fpr,8228998,8228998,8228944,54,44,utRho02
481,frc,4986878,4986878,4986508,370,0,utRho02
482,frdA,8764824,8764824,8764636,188,194,utRho02
483,frdD,8758948,8758948,8758732,216,210,utRho02
484,fre,8052886,8053054,8052886,168,1858,utRho02
485,frlA,6999518,6999820,6999518,302,0,utRho02
486,frr,385624,385744,385624,120,1024,utRho02
487,frsA,513004,513054,513004,50,148,utRho02
488,fruB,4527194,4527194,4526990,204,0,utRho02
489,frvR,8179804,8179804,8179710,94,0,utRho02
490,fryA,5008986,5008986,5008970,16,0,utRho02
491,fsaA,1727060,1727284,1727060,224,2,utRho02
492,fsr,1009710,1009710,1009392,318,276,utRho02
493,ftnA,3977364,3977432,3977364,68,0,utRho02
494,ftnB,3973550,3973850,3973550,300,136,utRho02
495,ftsA,207122,207964,207122,842,1368,utRho02
496,ftsB,5745802,5745802,5745640,162,214,utRho02
497,ftsH,6654204,6654204,6653870,334,1844,utRho02
498,ftsK,1865858,1866448,1865858,590,2816,utRho02
499,ftsL,181376,182064,181376,688,2294,utRho02
500,ftsP,6325732,6325732,6325338,394,608,utRho02
501,ftsQ,205484,206310,205484,826,970,utRho02
502,ftsX,7204512,7204512,7204172,340,1642,utRho02
503,ftsZ,209272,210610,209272,1338,92,utRho02
504,fucA,5867708,5867708,5867376,332,0,utRho02
505,fucP,5868238,5868470,5868238,232,0,utRho02
506,fumA,6753760,6753760,6753508,252,1248,utRho02
507,fumB,8694696,8694696,8694652,44,0,utRho02
508,fumC,3373418,3373418,3373176,242,0,utRho02
509,fur,2842892,2842892,2842584,308,9232,utRho02
510,fusA,6947370,6947370,6947028,342,24336,utRho02
511,fxsA,8737206,8737328,8737206,122,86,utRho02
512,gabD,5581824,5582546,5581824,722,780,utRho02
513,gadA,7335214,7335214,7335160,54,0,utRho02
514,gadB,3144144,3144144,3144090,54,0,utRho02
515,gadC,3141168,3141168,3140978,190,60,utRho02
516,gadE,7315600,7316732,7315600,1132,0,utRho02
517,gadW,7329562,7329562,7329236,326,0,utRho02
518,gadX,14663356,14663356,14663240,116,0,utRho02
519,gadY,7329728,7329728,7329728,0,0,utRho02
520,galE,1584354,1584354,1584110,244,44,utRho02
521,galF,4228702,4228702,4228654,48,24,utRho02
522,galM,1577796,1577796,1577674,122,232,utRho02
523,galP,6176510,6176568,6176510,58,0,utRho02
524,galR,5953138,5953198,5953138,60,94,utRho02
525,galS,4483420,4483420,4483336,84,0,utRho02
526,galU,2582810,2582914,2582810,104,356,utRho02
527,gapA,3724480,3725542,3724480,1062,3584,utRho02
528,garP,6549868,6549868,6549814,54,0,utRho02
529,gatY,4354468,4354468,4354408,60,0,utRho02
530,gatZ,4352864,4352864,4352642,222,6278,utRho02
531,gcd,282558,282558,282450,108,180,utRho02
532,gcl,1067814,1067832,1067814,18,0,utRho02
533,gcvA,5885278,5885278,5885134,144,62,utRho02
534,gcvB,5885392,5885392,5885392,0,0,utRho02
535,gcvR,5199758,5199812,5199758,54,352,utRho02
536,gcvT,6101544,6101544,6101334,210,752,utRho02
537,gdhA,3684616,3684742,3684616,126,0,utRho02
538,gfcA,2099668,2099668,2099488,180,628,utRho02
539,gfcD,2096236,2096236,2095890,346,26,utRho02
540,ghrA,2195648,2195772,2195648,124,504,utRho02
541,ghrB,7434378,7434620,7434378,242,750,utRho02
542,glcA,6242728,6242728,6242558,170,26,utRho02
543,glcC,6256412,6256544,6256412,132,0,utRho02
544,glcD,6256152,6256152,6256042,110,0,utRho02
545,gldA,8278092,8278092,8278070,22,0,utRho02
546,glgA,7136784,7136784,7136066,718,354,utRho02
547,glgB,7147314,7147314,7147004,310,290,utRho02
548,glgC,7139142,7139142,7138656,486,176,utRho02
549,glgP,7133546,7133546,7133162,384,180,utRho02
550,glgS,6384024,6384024,6383878,146,0,utRho02
551,glgX,7142838,7142838,7142638,200,54,utRho02
552,glk,5018922,5018922,5018852,70,4,utRho02
553,glmS,7827622,7827622,7827336,286,6320,utRho02
554,glmU,7830652,7830652,7830400,252,462,utRho02
555,glmY,10765360,10765360,10765360,0,0,utRho02
556,glmZ,7972864,7972864,7972864,0,0,utRho02
557,glnA,16232888,16232888,16232136,752,288,utRho02
558,glnB,5375052,5375052,5374816,236,108,utRho02
559,glnD,377310,377310,377300,10,16,utRho02
560,glnE,6399602,6399602,6399282,320,128,utRho02
561,glnH,1696396,1696396,1696008,388,0,utRho02
562,glnK,945112,945196,945112,84,0,utRho02
563,glnL,8112742,8112742,8112678,64,60,utRho02
564,glnQ,1693262,1693262,1692926,336,426,utRho02
565,glnS,1411998,1412186,1411998,188,458,utRho02
566,gloA,3455602,3455674,3455602,72,30,utRho02
567,gloB,469852,469852,469564,288,880,utRho02
568,glpA,4705166,4705294,4705166,128,0,utRho02
569,glpD,7123942,7124026,7123942,84,0,utRho02
570,glpE,7123698,7123698,7123646,52,124,utRho02
571,glpF,8236322,8236322,8236180,142,170,utRho02
572,glpG,7122960,7122960,7122904,56,338,utRho02
573,glpR,7121782,7121782,7121210,572,170,utRho02
574,glpT,4704902,4704902,4704748,154,30,utRho02
575,glpX,8231212,8231212,8231158,54,3314,utRho02
576,glrK,5382246,5382246,5382196,50,396,utRho02
577,gltA,1509534,1509534,1508936,598,17182,utRho02
578,gltB,6709018,6709264,6709018,246,240,utRho02
579,gltI,1375792,1375792,1375494,298,1950,utRho02
580,gltP,8588536,8588962,8588536,426,2352,utRho02
581,gltS,7657382,7657382,7657330,52,334,utRho02
582,gltX,5041568,5041568,5041344,224,72,utRho02
583,gluQ,320286,320286,320224,62,220,utRho02
584,glyA,5371148,5371148,5371014,134,40,utRho02
585,glyQ,7450708,7450708,7450636,72,556,utRho02
586,glyS,7448990,7448990,7448794,196,1578,utRho02
587,glyU,5998128,5998128,5998114,14,0,utRho02
588,glyV,8784626,8784720,8784626,94,258,utRho02
589,glyW,3984360,3984360,3984234,126,70,utRho02
590,gmhB,445612,445666,445612,54,0,utRho02
591,gmk,7642776,7642856,7642776,80,150,utRho02
592,gmr,2693686,2693686,2693484,202,78,utRho02
593,gnd,4202648,4202648,4202536,112,774,utRho02
594,gnsB,3275692,3275692,3275564,128,120,utRho02
595,gntK,14310580,14310580,14310368,212,1380,utRho02
596,gntP,9102668,9102668,9102592,76,0,utRho02
597,gntR,7157760,7157760,7157452,308,196,utRho02
598,gntT,7092810,7093118,7092810,308,86,utRho02
599,gntU,7154170,7154170,7154122,48,0,utRho02
600,gntX,7089334,7089764,7089334,430,76,utRho02
601,gor,7292224,7292598,7292224,374,524,utRho02
602,gpmA,1575340,1575340,1575190,150,0,utRho02
603,gpmM,7570374,7570520,7570374,146,0,utRho02
604,gpsA,7567620,7567620,7567322,298,5162,utRho02
605,gpt,511828,511954,511828,126,534,utRho02
606,grcA,5433046,5433046,5432898,148,138,utRho02
607,greA,6657728,6657728,6657430,298,1778,utRho02
608,greB,7073488,7073624,7073488,136,54,utRho02
609,groL,8741566,8742050,8741566,484,820,utRho02
610,groS,8741232,8741376,8741232,144,362,utRho02
611,grpE,5501494,5501494,5501416,78,248,utRho02
612,grxA,1781552,1781552,1781506,46,0,utRho02
613,grxB,2248206,2248206,2248108,98,118,utRho02
614,grxC,7569152,7569152,7568884,268,3648,utRho02
615,grxD,3468324,3468324,3468202,122,6374,utRho02
616,gspA,6911268,6911268,6910796,472,142,utRho02
617,gspC,6910964,6911156,6910964,192,68,utRho02
618,gss,6277220,6277220,6277044,176,40,utRho02
619,gstA,3428654,3428754,3428654,100,0,utRho02
620,gstB,1761038,1761038,1760960,78,0,utRho02
621,guaB,5268214,5268214,5268140,74,68,utRho02
622,gudD,5839026,5839026,5838770,256,92,utRho02
623,gyrA,4678914,4678914,4678840,74,24,utRho02
624,gyrB,7760300,7760300,7760238,62,530,utRho02
625,hcaE,5337964,5338064,5337964,100,0,utRho02
626,hcaR,5337928,5337928,5337792,136,0,utRho02
627,hcaT,5336106,5336106,5335692,414,0,utRho02
628,hchA,4071260,4071670,4071260,410,0,utRho02
629,hcp,1828258,1828258,1827628,630,30,utRho02
630,hcr,1824400,1824400,1824300,100,0,utRho02
631,hdeA,7313582,7313582,7313480,102,0,utRho02
632,hdeD,7313920,7313990,7313920,70,0,utRho02
633,hdfR,7896320,7896320,7895934,386,562,utRho02
634,hdhA,3396244,3396244,3396080,164,112,utRho02
635,helD,2048876,2048942,2048876,66,0,utRho02
636,hemA,2527166,2527428,2527166,262,240,utRho02
637,hemB,779722,779722,779454,268,98,utRho02
638,hemF,5106410,5106450,5106410,40,0,utRho02
639,hemH,996062,996110,996062,48,102,utRho02
640,hemL,349882,349882,349764,118,2,utRho02
641,hemN,8103886,8104090,8103886,204,78,utRho02
642,hepA,127176,127176,126528,648,4330,utRho02
643,hflD,2385372,2385372,2385262,110,1684,utRho02
644,hfq,8799602,8800576,8799602,974,2178,utRho02
645,hha,961006,961006,960616,390,434,utRho02
646,hicA,3018442,3018572,3018442,130,0,utRho02
647,higA,6468682,6468682,6468288,394,142,utRho02
648,higB,6468960,6468960,6468910,50,2,utRho02
649,hinT,2323642,2323770,2323642,128,58,utRho02
650,hipB,3184964,3184964,3184884,80,0,utRho02
651,hisB,4186720,4186936,4186720,216,502,utRho02
652,hisJ,4853674,4853674,4853576,98,78,utRho02
653,hisL,8359856,8359984,8359856,128,728,utRho02
654,hisS,5281284,5281284,5281150,134,342,utRho02
655,hlpA,400910,400964,400910,54,64,utRho02
656,hlyE,2460932,2460932,2460788,144,0,utRho02
657,hmp,5371594,5371670,5371594,76,0,utRho02
658,hns,2585916,2585916,2585844,72,980,utRho02
659,hofM,7045856,7045856,7045502,354,0,utRho02
660,hokA,7441620,7441620,7441200,420,5430,utRho02
661,hokC,33902,33902,33806,96,98,utRho02
662,hokE,1215462,1215672,1215462,210,0,utRho02
663,holC,8968546,8968546,8968560,14,590,utRho02
664,holD,9215562,9215606,9215562,44,30,utRho02
665,holE,3850040,3850216,3850040,176,1190,utRho02
666,hpt,282720,282862,282720,142,150,utRho02
667,hrpB,324150,324210,324150,60,34,utRho02
668,hscB,5319048,5319048,5318934,114,1484,utRho02
669,hscC,1367188,1367188,1366786,402,268,utRho02
670,hsdS,9163004,9163004,9162924,80,0,utRho02
671,hslJ,2883560,2883560,2883486,74,98,utRho02
672,hslO,7059344,7059548,7059344,204,7674,utRho02
673,hslR,7058220,7058696,7058220,476,2274,utRho02
674,hslV,8244708,8244708,8244574,134,12,utRho02
675,hsrA,7881412,7881412,7881224,188,278,utRho02
676,htgA,21286,21660,21286,374,416,utRho02
677,htpG,989634,990240,989634,606,8884,utRho02
678,htpX,3825236,3825236,3825152,84,0,utRho02
679,htrE,311036,311036,310852,184,38,utRho02
680,htrL,7587668,7587668,7587366,302,16,utRho02
681,hupA,8400352,8400562,8400352,210,202,utRho02
682,hupB,1845220,1845804,1845220,584,584,utRho02
683,hyaA,2063968,2064278,2063968,310,0,utRho02
684,hybO,6292726,6292726,6292522,204,564,utRho02
685,hycA,5700922,5700922,5700870,52,0,utRho02
686,hycI,5686204,5686204,5686086,118,130,utRho02
687,hydN,5676264,5676264,5676210,54,0,utRho02
688,hyfA,5202342,5202402,5202342,60,0,utRho02
689,hypA,11402508,11402588,11402508,80,0,utRho02
690,hypB,11403356,11404004,11403356,648,0,utRho02
691,hypF,5676210,5676210,5674850,1360,608,utRho02
692,hypT,9116634,9116634,9116578,56,0,utRho02
693,hyuA,6019660,6020056,6019660,396,78,utRho02
694,iaaA,1733074,1733136,1733074,62,0,utRho02
695,iadA,9119074,9119074,9119052,22,46,utRho02
696,iap,5753072,5753162,5753072,90,36,utRho02
697,ibaG,6673966,6673966,6673606,360,80,utRho02
698,ibpA,7735036,7735036,7734844,192,304,utRho02
699,ibpB,7733962,7733962,7733794,168,234,utRho02
700,icd,2389922,2390246,2389922,324,564,utRho02
701,iclR,8447304,8447304,8447256,48,82,utRho02
702,idi,6065876,6066130,6065876,254,0,utRho02
703,idnD,8988870,8988870,8988812,58,0,utRho02
704,idnK,8989194,8989246,8989194,52,0,utRho02
705,ihfA,3591442,3591442,3591104,338,1024,utRho02
706,ihfB,1927498,1927656,1927498,158,1470,utRho02
707,ileS,43666,44782,43666,1116,5608,utRho02
708,ileX,6431194,6431196,6431194,2,50,utRho02
709,ilvA,15820940,15821324,15820940,384,80,utRho02
710,ilvC,7915824,7915940,7915824,116,0,utRho02
711,ilvE,15809552,15809936,15809552,384,624,utRho02
712,ilvI,170840,171260,170840,420,0,utRho02
713,ilvL,23701308,23701932,23701308,624,12,utRho02
714,ilvY,7915734,7915734,7915640,94,0,utRho02
715,inaA,4698998,4698998,4698944,54,160,utRho02
716,infA,1853370,1853370,1852886,484,4664,utRho02
717,infC,3602692,3602692,3601276,1416,9616,utRho02
718,insA-5,3958452,3958452,3958430,22,0,utRho02
719,insA-7,9036758,9037054,9036758,296,238,utRho02
720,insC-5,6372080,6372284,6372080,204,252,utRho02
721,insEF-2,785238,785238,785820,582,700,utRho02
722,insEF-4,2190310,2190310,2190892,582,670,utRho02
723,insG,9007098,9007098,9006862,236,20,utRho02
724,insH-1,550596,550596,550234,362,236,utRho02
725,insH-11,7306538,7306538,7306396,142,32,utRho02
726,insH-2,1151548,1151548,1151506,42,262,utRho02
727,insH-3,1378444,1378444,1378026,418,434,utRho02
728,insH-4,2791942,2792152,2791942,210,42,utRho02
729,insH-5,2857852,2857852,2857452,400,0,utRho02
730,insH-6,4135022,4135022,4134642,380,114,utRho02
731,insH-7,4206186,4206186,4205822,364,8136,utRho02
732,insH-9,6260050,6260356,6260050,306,42,utRho02
733,insI-3,9017372,9017372,9017234,138,62,utRho02
734,insJ,7441188,7441360,7441188,172,2556,utRho02
735,insK,7442130,7442308,7442130,178,0,utRho02
736,insL-1,30760,30890,30760,130,740,utRho02
737,insL-2,1216112,1216130,1216112,18,78,utRho02
738,insL-3,5028644,5028662,5028644,18,102,utRho02
739,insN-1,540452,540484,540452,32,0,utRho02
740,intD,1132202,1132202,1131956,246,62,utRho02
741,intR,2826520,2826520,2826470,50,0,utRho02
742,intS,4933026,4933090,4933026,64,1272,utRho02
743,intZ,5117386,5117542,5117386,156,164,utRho02
744,iraD,9113152,9113986,9113152,834,0,utRho02
745,iraM,2424246,2424246,2424006,240,14,utRho02
746,iraP,802638,802772,802638,134,0,utRho02
747,iscA,5319924,5319924,5319772,152,1700,utRho02
748,iscR,5324398,5324398,5324262,136,28260,utRho02
749,iscX,5313834,5313834,5313472,362,3472,utRho02
750,ispF,5743968,5743968,5743560,408,1490,utRho02
751,ispG,5283908,5283908,5283608,300,1108,utRho02
752,ispU,389568,389806,389568,238,380,utRho02
753,isrA,2811502,2811502,2811618,116,0,utRho02
754,istr-1,7706384,7706384,7706384,0,0,utRho02
755,istr-2,7706514,7706514,7706514,0,0,utRho02
756,ivbL,15412092,15412092,15411952,140,496,utRho02
757,ivy,480638,480686,480638,48,0,utRho02
758,katE,3627628,3627734,3627628,106,20,utRho02
759,katG,8267624,8267670,8267624,46,40,utRho02
760,kbaZ,6557732,6557828,6557732,96,0,utRho02
761,kbl,7585154,7585154,7585102,52,386,utRho02
762,kch,2621046,2621046,2620538,508,0,utRho02
763,kdgR,3820506,3820506,3820198,308,40,utRho02
764,kdpE,1443788,1443788,1443466,322,250,utRho02
765,kdpF,1457698,1457698,1457642,56,0,utRho02
766,kdsA,2535708,2536330,2535708,622,3338,utRho02
767,kdsC,6683438,6684546,6683438,1108,3932,utRho02
768,kduI,5968388,5968388,5968248,140,364,utRho02
769,kefF,94160,94492,94160,332,64,utRho02
770,kgtP,5451624,5451624,5451492,132,1796,utRho02
771,kup,7862206,7862632,7862206,426,80,utRho02
772,lacI,735076,735076,735020,56,0,utRho02
773,lacZ,1465508,1465508,1465220,288,852,utRho02
774,ldcA,2486394,2486394,2486160,234,0,utRho02
775,ldhA,2885830,2885830,2885686,144,0,utRho02
776,ldrA,2538954,2538954,2538550,404,1664,utRho02
777,ldrB,2540024,2540024,2539620,404,694,utRho02
778,ldrC,2541092,2541092,2540690,402,1596,utRho02
779,ldrD,7400544,7400544,7400174,370,2304,utRho02
780,lepA,5414392,5414392,5414248,144,184,utRho02
781,lepB,5410928,5410928,5410618,310,696,utRho02
782,leuD,159188,159188,158906,282,68,utRho02
783,leuE,3761600,3761600,3761518,82,0,utRho02
784,leuL,168048,168048,167416,632,34,utRho02
785,leuO,168308,168736,168308,428,176,utRho02
786,leuQ,9212864,9212864,9212802,62,0,utRho02
787,leuU,6644556,6644556,6644316,240,6052,utRho02
788,leuV,9212546,9212546,9212330,216,730,utRho02
789,leuX,8992772,8992810,8992772,38,36,utRho02
790,lexA,8514174,8514230,8514174,56,172,utRho02
791,lhr,3456706,3458174,3456706,1468,3852,utRho02
792,ligA,5060402,5060402,5060352,50,0,utRho02
793,ligB,7642576,7642576,7642340,236,0,utRho02
794,lipA,1320602,1320602,1320432,170,8,utRho02
795,lipB,1324802,1324802,1324556,246,2860,utRho02
796,lit,2397032,2397390,2397032,358,64,utRho02
797,livJ,7199524,7199524,7199316,208,3892,utRho02
798,livK,7195510,7195510,7195120,390,0,utRho02
799,lldP,7554578,7554798,7554578,220,804,utRho02
800,lnt,1381968,1381968,1381762,206,382,utRho02
801,loiP,6163784,6163826,6163784,42,0,utRho02
802,lolA,1874656,1874738,1874656,82,992,utRho02
803,lolB,2527112,2527112,2527000,112,44,utRho02
804,lolC,2350748,2350854,2350748,106,28,utRho02
805,lon,917630,917776,917630,146,1090,utRho02
806,lpcA,486936,487086,486936,150,0,utRho02
807,lpd,255434,255824,255434,390,3908,utRho02
808,lplA,9248476,9248476,9248234,242,1380,utRho02
809,lplT,5947878,5947878,5947724,154,0,utRho02
810,lpoA,6586422,6586800,6586422,378,480,utRho02
811,lpp,3514592,3514842,3514592,250,300,utRho02
812,lptA,6686598,6686760,6686598,162,958,utRho02
813,lptB,6686792,6687888,6686792,1096,2312,utRho02
814,lptD,114672,114672,114218,454,3738,utRho02
815,lptF,8972244,8972436,8972244,192,40,utRho02
816,lpxC,213016,213114,213016,98,27696,utRho02
817,lpxD,401920,401942,401920,22,0,utRho02
818,lpxL,2233418,2233418,2233164,254,294,utRho02
819,lpxM,3880456,3880456,3880386,70,60,utRho02
820,lpxP,4991156,4991290,4991156,134,746,utRho02
821,lrhA,4813312,4813312,4813282,30,36,utRho02
822,lrp,1864656,1865190,1864656,534,942,utRho02
823,lspA,50028,50414,50028,386,492,utRho02
824,lsrA,3202920,3202980,3202920,60,0,utRho02
825,lsrR,3202514,3202514,3202482,32,0,utRho02
826,ltaE,1818640,1818640,1818588,52,0,utRho02
827,luxS,5630130,5630130,5629466,664,2212,utRho02
828,lysA,5957902,5957902,5957798,104,0,utRho02
829,lysC,8467232,8467232,8466466,766,532,utRho02
830,lysP,4497120,4497120,4497064,56,88,utRho02
831,lysR,5957900,5958042,5957900,142,0,utRho02
832,lysT,1561028,1561108,1561028,80,216,utRho02
833,lysU,8709610,8709610,8709434,176,0,utRho02
834,macB,1840188,1840694,1840188,506,32,utRho02
835,maeA,3111484,3111484,3111338,146,3906,utRho02
836,mak,820236,820288,820236,52,0,utRho02
837,malE,8492928,8492928,8492838,90,2,utRho02
838,malI,3398456,3398456,3398360,96,0,utRho02
839,malK,8493472,8493568,8493472,96,0,utRho02
840,malP,7105020,7105020,7104946,74,136,utRho02
841,malQ,7100798,7100798,7100140,658,300,utRho02
842,malS,14949880,14949988,14949880,108,0,utRho02
843,malT,7106048,7106170,7106048,122,0,utRho02
844,malX,3398626,3398710,3398626,84,0,utRho02
845,malZ,1689980,1690072,1689980,92,2564,utRho02
846,manA,3377102,3377152,3377102,50,40,utRho02
847,manX,3803866,3804096,3803866,230,154,utRho02
848,marC,3237882,3237882,3237816,66,36,utRho02
849,marR,3238186,3238240,3238186,54,0,utRho02
850,matP,2036918,2036970,2036918,52,188,utRho02
851,mazE,5822736,5822736,5822678,58,0,utRho02
852,mazG,5821720,5821720,5821370,350,3092,utRho02
853,mcbA,1684306,1684306,1684112,194,2,utRho02
854,mcbR,3040192,3040524,3040192,332,0,utRho02
855,mcrA,2420278,2420692,2420278,414,0,utRho02
856,mcrC,9156124,9156124,9155916,208,130,utRho02
857,mdaB,6344814,6345060,6344814,246,0,utRho02
858,mdfA,1767138,1767346,1767138,208,0,utRho02
859,mdh,6768940,6768940,6768536,404,68,utRho02
860,mdoB,9198988,9198988,9198882,106,890,utRho02
861,mdoD,2993290,2993712,2993290,422,0,utRho02
862,mdoG,2218514,2218670,2218514,156,220,utRho02
863,mdtA,4307958,4308032,4307958,74,108,utRho02
864,mdtE,7318168,7318464,7318168,296,24,utRho02
865,mdtK,3486538,3486914,3486538,376,192,utRho02
866,mdtP,8602472,8602472,8602060,412,66,utRho02
867,melA,8683774,8683822,8683774,48,0,utRho02
868,melR,8683300,8683300,8683256,44,36,utRho02
869,menA,8240812,8240812,8240698,114,38,utRho02
870,menB,4753774,4753774,4753638,136,468,utRho02
871,mepH,3468714,3468870,3468714,156,0,utRho02
872,mepM,3883666,3883666,3883270,396,1386,utRho02
873,mepS,4539840,4539958,4539840,118,968,utRho02
874,metA,8428318,8428560,8428318,242,684,utRho02
875,metB,8257272,8257344,8257272,72,804,utRho02
876,metC,6304150,6304472,6304150,322,86,utRho02
877,metE,8025768,8026106,8025768,338,216,utRho02
878,metF,8265092,8265232,8265092,140,138,utRho02
879,metG,4388538,4388600,4388538,62,70,utRho02
880,metH,8447010,8447656,8447010,646,9656,utRho02
881,metJ,8257116,8257116,8256790,326,76,utRho02
882,metK,6173154,6173412,6173154,258,388,utRho02
883,metN,445428,445428,445290,138,104,utRho02
884,metR,8025710,8025710,8025632,78,0,utRho02
885,metT,1394326,1394326,1394266,60,382,utRho02
886,metY,19910250,19910250,19909734,516,9282,utRho02
887,metZ,11789528,11789548,11789528,20,40,utRho02
888,mfd,2348056,2348056,2347928,128,100,utRho02
889,mglA,4478782,4478782,4478578,204,6,utRho02
890,mglB,4481132,4481132,4480696,436,1050,utRho02
891,mglC,4475918,4475918,4475506,412,50,utRho02
892,mgrB,3817584,3817584,3817532,52,6,utRho02
893,mgrR,3245828,3245828,3245828,0,0,utRho02
894,mgsA,2054082,2054082,2054030,52,40,utRho02
895,mgtL,8934560,8934862,8934560,302,94,utRho02
896,mhpA,737038,737222,737038,184,0,utRho02
897,mhpR,737072,737072,736840,232,0,utRho02
898,mhpT,750772,750918,750772,146,0,utRho02
899,miaA,8797964,8798504,8797964,540,1564,utRho02
900,micA,5629604,5629604,5629604,0,0,utRho02
901,micC,2874242,2874238,2874242,4,0,utRho02
902,micF,4626168,4626168,4626168,0,0,utRho02
903,micM,1014408,1014408,1014408,0,0,utRho02
904,minE,2449422,2449422,2449090,332,778,utRho02
905,mioC,7852950,7852950,7852910,40,110,utRho02
906,mipA,3733012,3733012,3732944,68,3804,utRho02
907,mlaA,4930270,4930270,4930014,256,54,utRho02
908,mlc,3337206,3337206,3337128,78,0,utRho02
909,mlrA,4429498,4429732,4429498,234,14,utRho02
910,mltA,5894546,5894546,5894356,190,70,utRho02
911,mltD,468050,468050,467910,140,110,utRho02
912,mltF,5391534,5391602,5391534,68,0,utRho02
913,mmuP,550238,550650,550238,412,244,utRho02
914,mngA,1531622,1531968,1531622,346,0,utRho02
915,mngR,1531852,1531852,1531750,102,0,utRho02
916,mnmG,7851348,7851348,7851266,82,8114,utRho02
917,mntH,5025470,5025470,5025412,58,74,utRho02
918,mntP,3810918,3811376,3810918,458,1036,utRho02
919,mntR,1706160,1706366,1706160,206,0,utRho02
920,mntS,1706128,1706128,1705994,134,0,utRho02
921,moaA,1633654,1634088,1633654,434,1172,utRho02
922,moaB,1635954,1636110,1635954,156,976,utRho02
923,mobA,8084242,8084242,8083998,244,386,utRho02
924,mocA,6030112,6030320,6030112,208,46,utRho02
925,modA,1589990,1590178,1589990,188,256,utRho02
926,moeA,1732788,1732788,1732728,60,150,utRho02
927,mokB,2984610,2984610,2984258,352,926,utRho02
928,molR_1,4392888,4392948,4392888,60,374,utRho02
929,motA,3954604,3954604,3954278,326,0,utRho02
930,mpaA,2781278,2781278,2781196,82,78,utRho02
931,mpl,8911456,8911570,8911456,114,0,utRho02
932,mppA,2786108,2786454,2786108,346,2,utRho02
933,mprA,5621494,5621540,5621494,46,380,utRho02
934,mqo,4613848,4613848,4613508,340,728,utRho02
935,mqsA,6336742,6336742,6336492,250,74,utRho02
936,mqsR,6337306,6337306,6337088,218,208,utRho02
937,mraZ,179192,179268,179192,76,4,utRho02
938,mrcA,7045652,7045742,7045652,90,0,utRho02
939,mrcB,329442,329460,329442,18,0,utRho02
940,mreB,13605424,13605424,13604348,1076,2552,utRho02
941,mreD,6798166,6798166,6797750,416,276,utRho02
942,mrp,4388360,4388360,4388336,24,62,utRho02
943,mscK,972984,973072,972984,88,0,utRho02
944,mscL,6876002,6876048,6876002,46,358,utRho02
945,mscS,6139742,6139742,6139614,128,94,utRho02
946,msrA,8884522,8884522,8884352,170,152,utRho02
947,msrB,3725168,3725168,3724858,310,0,utRho02
948,msyB,2228426,2228426,2228362,64,204,utRho02
949,mtfA,4087236,4087302,4087236,66,242,utRho02
950,mtgA,6699662,6699662,6699618,44,290,utRho02
951,mtlA,30177504,30178248,30177504,744,840,utRho02
952,mtn,358366,358366,358306,60,0,utRho02
953,mtr,6611864,6611864,6611634,230,170,utRho02
954,mug,6430992,6430992,6430946,46,0,utRho02
955,murQ,5091466,5091546,5091466,80,0,utRho02
956,murR,5091586,5091586,5091218,368,56,utRho02
957,mutH,5939164,5939324,5939164,160,518,utRho02
958,mutL,8794092,8794824,8794092,732,1378,utRho02
959,mutM,7622554,7622554,7622304,250,2118,utRho02
960,mutS,5714038,5714186,5714038,148,276,utRho02
961,mutY,18617466,18618078,18617466,612,0,utRho02
962,nac,4123956,4123956,4123866,90,0,utRho02
963,nadA,1564122,1564170,1564122,48,52,utRho02
964,nadB,5420714,5420840,5420714,126,66,utRho02
965,nadC,237326,237326,237290,36,134,utRho02
966,nadE,3644604,3644916,3644604,312,44,utRho02
967,nadK,5501526,5501662,5501526,136,200,utRho02
968,nagA,1406350,1406350,1405502,848,2528,utRho02
969,nagB,1407416,1407416,1407222,194,32,utRho02
970,nagC,1404016,1404016,1403188,828,282,utRho02
971,nagE,1407680,1407888,1407680,208,118,utRho02
972,nagK,2357080,2357186,2357080,106,64,utRho02
973,nanA,6747240,6747240,6747152,88,108,utRho02
974,nanC,9079856,9079856,9079002,854,60,utRho02
975,nanR,6749406,6749406,6748978,428,16,utRho02
976,nanS,9075406,9075406,9075188,218,0,utRho02
977,napF,4607390,4607390,4606994,396,0,utRho02
978,narG,2559614,2559728,2559614,114,34,utRho02
979,narK,2555642,2555914,2555642,272,0,utRho02
980,narP,4580844,4581000,4580844,156,24,utRho02
981,narQ,5171154,5171462,5171154,308,0,utRho02
982,narU,3088326,3088326,3088120,206,0,utRho02
983,narW,3077374,3077374,3074618,2756,24,utRho02
984,narX,2555554,2555554,2555236,318,20,utRho02
985,narZ,3085380,3085380,3085180,200,0,utRho02
986,ndh,2331984,2332170,2331984,186,208,utRho02
987,ndk,5289920,5289920,5289728,192,590,utRho02
988,nemR,6904084,6904092,6904084,8,44,utRho02
989,nepI,7683542,7683542,7683478,64,176,utRho02
990,nfo,4501612,4501680,4501612,68,70,utRho02
991,nfsB,1210906,1210906,1210848,58,88,utRho02
992,nfuA,7090916,7091248,7090916,332,884,utRho02
993,nhaA,34634,34978,34634,344,176,utRho02
994,nhaB,2469534,2469534,2469434,100,0,utRho02
995,nhoA,3067926,3068048,3067926,122,0,utRho02
996,nikA,7226878,7227334,7226878,456,2822,utRho02
997,nikR,7237074,7237176,7237074,102,158,utRho02
998,nirB,6987974,6988022,6987974,48,154,utRho02
999,nlpA,7680034,7680034,7679986,48,0,utRho02
1000,nlpC,3585654,3585654,3585462,192,72,utRho02
1001,nlpD,5737658,5737658,5737506,152,116,utRho02
1002,nlpI,6618080,6618080,6617848,232,98,utRho02
1003,nmpC,1153740,1153740,1153650,90,12,utRho02
1004,nohA,3273206,3273206,3272734,472,0,utRho02
1005,norR,5664614,5664614,5664578,36,0,utRho02
1006,norV,5664878,5664952,5664878,74,0,utRho02
1007,nrdA,4689510,4689730,4689510,220,12202,utRho02
1008,nrdD,8925676,8925676,8925320,356,2378,utRho02
1009,nrdH,5601312,5601446,5601312,134,1076,utRho02
1010,nrdR,865954,866004,865954,50,12,utRho02
1011,nrfA,8575342,8575528,8575342,186,0,utRho02
1012,nsrR,8812088,8812380,8812088,292,53212,utRho02
1013,nudB,3897348,3897348,3897264,84,0,utRho02
1014,nudC,8393428,8393806,8393428,378,288,utRho02
1015,nudE,7052658,7052658,7052298,360,7158,utRho02
1016,nudG,3682876,3682980,3682876,104,0,utRho02
1017,nudI,4729050,4729108,4729050,58,0,utRho02
1018,nudJ,2388874,2388874,2388576,298,1248,utRho02
1019,nuoA,4810670,4810670,4810144,526,2356,utRho02
1020,nuoN,4783434,4783434,4783010,424,1826,utRho02
1021,nupC,5026018,5026084,5026018,66,0,utRho02
1022,nupG,6211302,6211428,6211302,126,16,utRho02
1023,ogrK,4335096,4335096,4335040,56,0,utRho02
1024,ogt,2800568,2800568,2800472,96,0,utRho02
1025,ohsC,5401036,5401040,5401036,4,0,utRho02
1026,ompA,2040382,2040382,2040106,276,21752,utRho02
1027,ompC,4625774,4625774,4625498,276,100,utRho02
1028,ompF,1974184,1974184,1973964,220,172,utRho02
1029,ompL,8128958,8128958,8128590,368,0,utRho02
1030,ompN,2874158,2874158,2873786,372,0,utRho02
1031,ompR,7073510,7073510,7073168,342,300,utRho02
1032,ompT,1171330,1171330,1171266,64,72,utRho02
1033,ompW,2627982,2628040,2627982,58,0,utRho02
1034,ompX,1700418,1700900,1700418,482,1596,utRho02
1035,omrA,5952378,5952378,5952378,0,0,utRho02
1036,omrB,5952770,5952770,5952770,0,0,utRho02
1037,oppA,2602170,2602364,2602170,194,23176,utRho02
1038,orn,8783168,8783208,8783168,40,0,utRho02
1039,osmB,2686952,2686952,2686656,296,208,utRho02
1040,osmC,3113192,3113250,3113192,58,60,utRho02
1041,osmE,3644566,3644566,3644512,54,70,utRho02
1042,osmF,4439046,4439046,4438962,84,644,utRho02
1043,osmY,9222306,9222792,9222306,486,238,utRho02
1044,otsA,3963302,3963302,3963224,78,60,utRho02
1045,otsB,3964930,3964930,3964774,156,4,utRho02
1046,oxc,4984288,4984288,4983900,388,92,utRho02
1047,oxyR,8316914,8316980,8316914,66,0,utRho02
1048,oxyS,8316788,8316788,8316788,0,0,utRho02
1049,paaA,2907730,2907854,2907730,124,0,utRho02
1050,paaX,2927018,2927078,2927018,60,0,utRho02
1051,paaZ,2907340,2907340,2907284,56,0,utRho02
1052,pabA,6981702,6981702,6981658,44,0,utRho02
1053,pabB,3789256,3789610,3789256,354,0,utRho02
1054,pabC,2306186,2306600,2306186,414,194,utRho02
1055,pagP,1313052,1313114,1313052,62,0,utRho02
1056,panB,299260,299260,299202,58,128,utRho02
1057,panC,297840,297840,297590,250,186,utRho02
1058,panD,293490,293490,293388,102,92,utRho02
1059,panZ,7195656,7195968,7195656,312,0,utRho02
1060,parC,6332060,6332060,6331946,114,162,utRho02
1061,patA,6438916,6438988,6438916,72,0,utRho02
1062,patD,3030830,3031156,3030830,326,0,utRho02
1063,pbpC,5294986,5294986,5294650,336,0,utRho02
1064,pbpG,4450132,4450132,4449740,392,248,utRho02
1065,pck,7065358,7065636,7065358,278,2106,utRho02
1066,pcnB,318782,318782,318252,530,704,utRho02
1067,pdhR,244068,244184,244068,116,222,utRho02
1068,pdxB,4875768,4875768,4875702,66,0,utRho02
1069,pdxH,3436068,3436068,3436014,54,358,utRho02
1070,pdxJ,5403626,5403626,5403458,168,188,utRho02
1071,pdxK,5074638,5074638,5074474,164,0,utRho02
1072,pepA,8972278,8972278,8971902,376,160,utRho02
1073,pepD,511618,511618,511432,186,4394,utRho02
1074,pepN,1981182,1981244,1981182,62,16,utRho02
1075,pepQ,8062294,8062322,8062294,28,0,utRho02
1076,pepT,2371646,2371688,2371646,42,46,utRho02
1077,pfkA,8214948,8215104,8214948,156,288,utRho02
1078,pfkB,3612646,3612740,3612646,94,0,utRho02
1079,pflA,1902456,1902456,1902160,296,18,utRho02
1080,pflB,1907850,1907850,1907108,742,926,utRho02
1081,pflD,8287716,8287990,8287716,274,0,utRho02
1082,pgaA,2185046,2185046,2184578,468,0,utRho02
1083,pgi,8467444,8467516,8467444,72,34,utRho02
1084,pgk,12291428,12291428,12290488,940,5276,utRho02
1085,pgl,1597078,1597172,1597078,94,64,utRho02
1086,pgpB,2678324,2678660,2678324,336,90,utRho02
1087,pgpC,5397276,5397276,5397100,176,60,utRho02
1088,pgrR,2783744,2783982,2783744,238,0,utRho02
1089,pheL,5475158,5475198,5475158,40,0,utRho02
1090,pheM,7197204,7197204,7197080,124,152,utRho02
1091,pheP,1203858,1203918,1203858,60,0,utRho02
1092,pheU,8725254,8725254,8725252,2,0,utRho02
1093,pheV,6220730,6220732,6220730,2,10,utRho02
1094,phnC,8650412,8650412,8650330,82,0,utRho02
1095,phoA,803414,803494,803414,80,2,utRho02
1096,phoB,834202,834284,834202,82,0,utRho02
1097,phoE,520316,520316,520200,116,6,utRho02
1098,phoH,2169730,2169984,2169730,254,624,utRho02
1099,phoP,2381016,2381016,2380894,122,1232,utRho02
1100,phoQ,2379880,2379880,2379552,328,1300,utRho02
1101,phoU,7815330,7815330,7815156,174,0,utRho02
1102,phr,1478842,1479014,1478842,172,0,utRho02
1103,pinE,2419054,2419370,2419054,316,0,utRho02
1104,pinQ,3267168,3267244,3267168,76,1176,utRho02
1105,pinR,2867424,2867424,2867348,76,1450,utRho02
1106,pitA,7275224,7275284,7275224,60,0,utRho02
1107,pitB,6272806,6272806,6272742,64,0,utRho02
1108,pka,5439862,5439906,5439862,44,0,utRho02
1109,plaP,4174476,4174476,4174124,352,994,utRho02
1110,pldA,8009628,8009724,8009628,96,90,utRho02
1111,pldB,8018028,8018340,8018028,312,366,utRho02
1112,plsB,8513196,8513196,8512932,264,162,utRho02
1113,pmbA,8915890,8915918,8915890,28,64,utRho02
1114,pmrD,4747148,4747148,4747076,72,0,utRho02
1115,pncB,1980828,1980828,1980712,116,0,utRho02
1116,pncC,5648788,5648788,5648692,96,0,utRho02
1117,pnp,6622652,6622652,6622336,316,120,utRho02
1118,pntA,3355950,3355950,3355806,144,0,utRho02
1119,pntB,3353096,3353096,3352720,376,0,utRho02
1120,polA,8093880,8093932,8093880,52,326,utRho02
1121,polB,131606,131606,131560,46,0,utRho02
1122,potD,2365700,2365700,2365658,42,0,utRho02
1123,potE,1436688,1436688,1436530,158,0,utRho02
1124,potF,1787268,1787568,1787268,300,188,utRho02
1125,poxB,1822152,1822152,1822098,54,28,utRho02
1126,ppa,8899372,8899372,8899304,68,114,utRho02
1127,ppc,8306380,8306380,8306196,184,742,utRho02
1128,ppdA,5928440,5928440,5928354,86,1544,utRho02
1129,ppdD,235410,235410,235098,312,710,utRho02
1130,pphA,3846770,3846770,3845938,832,2238,utRho02
1131,pphB,5719474,5719520,5719474,46,0,utRho02
1132,ppiA,6984898,6984898,6984594,304,20,utRho02
1133,ppiC,7919682,7919682,7919626,56,74,utRho02
1134,ppiD,923638,923830,923638,192,1204,utRho02
1135,ppk,5245748,5246088,5245748,340,386,utRho02
1136,pppA,6228958,6228958,6228704,254,30,utRho02
1137,ppsA,3574322,3574322,3574224,98,8,utRho02
1138,ppsR,3574678,3574890,3574678,212,0,utRho02
1139,pptA,3065716,3066104,3065716,388,8,utRho02
1140,pqiA,2023318,2024002,2023318,684,138,utRho02
1141,prc,3830054,3830054,3829632,422,22264,utRho02
1142,preT,4467978,4468066,4467978,88,78,utRho02
1143,prfC,9218688,9218828,9218688,140,1140,utRho02
1144,prkB,6968622,6968980,6968622,358,1350,utRho02
1145,prlC,7290476,7290476,7290364,112,46,utRho02
1146,prlF,6553944,6554004,6553944,60,0,utRho02
1147,proB,520432,520776,520432,344,490,utRho02
1148,proC,811372,811372,811288,84,0,utRho02
1149,proK,7417388,7417388,7417384,4,0,utRho02
1150,proL,4572414,4572422,4572414,8,0,utRho02
1151,proP,8660640,8661004,8660640,364,7014,utRho02
1152,proS,437674,437674,437550,124,594,utRho02
1153,proV,5609126,5609630,5609126,504,20,utRho02
1154,prpB,697292,697364,697292,72,0,utRho02
1155,prpR,696942,696942,696886,56,0,utRho02
1156,prs,2524354,2524354,2523750,604,57028,utRho02
1157,psd,8781276,8781276,8780720,556,5668,utRho02
1158,psiE,8480600,8480650,8480600,50,0,utRho02
1159,pspA,2736076,2736158,2736076,82,0,utRho02
1160,pspF,2736080,2736080,2735824,256,0,utRho02
1161,pspG,8525632,8525680,8525632,48,32,utRho02
1162,pssA,5445156,5445454,5445156,298,2194,utRho02
1163,pstB,7817112,7817112,7816732,380,94,utRho02
1164,pstC,7821084,7821084,7820796,288,0,utRho02
1165,pstS,23469408,23469408,23469150,258,180,utRho02
1166,psuG,4517114,4517114,4516734,380,48,utRho02
1167,psuT,4514992,4514992,4514670,322,0,utRho02
1168,pth,2517084,2517084,2517026,58,10,utRho02
1169,ptrA,5918022,5918022,5917768,254,0,utRho02
1170,ptrB,3857730,3857730,3857678,52,4570,utRho02
1171,ptsG,2315252,2315738,2315252,486,2274,utRho02
1172,ptsH,5066996,5067528,5066996,532,3546,utRho02
1173,purA,8809328,8809374,8809328,46,70,utRho02
1174,purC,5195562,5195562,5195236,326,96,utRho02
1175,purD,8411972,8411972,8411862,110,106,utRho02
1176,purE,1106284,1106284,1106200,84,1042,utRho02
1177,purH,8415254,8415254,8415064,190,144,utRho02
1178,purL,5391178,5391178,5391086,92,176,utRho02
1179,purM,5242306,5242394,5242306,88,0,utRho02
1180,purR,3475378,3475688,3475378,310,838,utRho02
1181,purT,3861438,3861762,3861438,324,26,utRho02
1182,purU,2577512,2577512,2577248,264,1166,utRho02
1183,putA,2157850,2157850,2157764,86,0,utRho02
1184,putP,2158336,2158610,2158336,274,98,utRho02
1185,puuA,2721936,2721936,2721816,120,0,utRho02
1186,puuC,2725456,2725486,2725456,30,0,utRho02
1187,puuD,2722104,2722240,2722104,136,0,utRho02
1188,puuP,2718746,2718746,2718374,372,1300,utRho02
1189,pykA,3874988,3875298,3874988,310,100,utRho02
1190,pykF,3510934,3511396,3510934,462,1666,utRho02
1191,pyrC,2245286,2245286,2245214,72,292,utRho02
1192,pyrD,2009464,2009536,2009464,72,56,utRho02
1193,pyrE,7631970,7631970,7631536,434,0,utRho02
1194,pyrF,2683740,2683842,2683740,102,706,utRho02
1195,pyrG,5819594,5819594,5819332,262,2886,utRho02
1196,pyrH,383624,383710,383624,86,2318,utRho02
1197,pyrL,8945490,8945490,8945066,424,300,utRho02
1198,qmcA,1031646,1031646,1031546,100,4,utRho02
1199,qor,8528608,8528608,8528462,146,164,utRho02
1200,qseB,6339502,6339656,6339502,154,40,utRho02
1201,queA,849970,850022,849970,52,794,utRho02
1202,queE,5811212,5811212,5810836,376,80,utRho02
1203,queF,5850642,5850696,5850642,54,12,utRho02
1204,queG,8788184,8788184,8788134,50,954,utRho02
1205,racC,2835630,2835630,2835526,104,0,utRho02
1206,racR,2840898,2840898,2840482,416,56,utRho02
1207,raiA,5474208,5474308,5474208,100,216,utRho02
1208,rarD,8008594,8008594,8008356,238,340,utRho02
1209,ravA,7862256,7862256,7862186,70,40,utRho02
1210,rayT,495088,495274,495088,186,40,utRho02
1211,rbn,4763162,4763216,4763162,54,0,utRho02
1212,rbsD,7866644,7866702,7866644,58,0,utRho02
1213,rcnA,4371654,4371834,4371654,180,6,utRho02
1214,rcnB,4373768,4373920,4373768,152,6,utRho02
1215,rcnR,4371806,4371806,4371592,214,6,utRho02
1216,rcsA,4047672,4047936,4047672,264,206,utRho02
1217,rcsB,4631390,4632354,4631390,964,1412,utRho02
1218,rcsC,4640162,4640162,4639656,506,534,utRho02
1219,rcsD,4626904,4626976,4626904,72,34,utRho02
1220,rdgB,6193240,6193362,6193240,122,472,utRho02
1221,rdlA,2538646,2538646,2538646,0,0,utRho02
1222,rdlB,2539712,2539716,2539712,4,0,utRho02
1223,rdlC,2540782,2540786,2540782,4,0,utRho02
1224,rdlD,7400272,7400272,7400272,0,0,utRho02
1225,rdoA,8084782,8084830,8084782,48,70,utRho02
1226,recA,11295276,11295276,11295076,200,1864,utRho02
1227,recC,5925014,5925014,5924856,158,238,utRho02
1228,recF,7763722,7763722,7762442,1280,16080,utRho02
1229,recN,5503518,5503590,5503518,72,0,utRho02
1230,recQ,8011666,8011728,8011666,62,0,utRho02
1231,relA,5828554,5828554,5827302,1252,1060,utRho02
1232,relB,3291806,3291806,3291744,62,0,utRho02
1233,rem,3289950,3289950,3289804,146,84,utRho02
1234,rep,7921294,7921354,7921294,60,88,utRho02
1235,rfaD,7587730,7587974,7587730,244,402,utRho02
1236,rfaE,6393852,6393852,6393506,346,4,utRho02
1237,rfaH,8049930,8049930,8049642,288,1306,utRho02
1238,rfbX,4219436,4219436,4219168,268,3164,utRho02
1239,rfe,7935600,7935832,7935600,232,390,utRho02
1240,rhaB,8194944,8194944,8194896,48,0,utRho02
1241,rhaD,8188770,8188770,8188544,226,0,utRho02
1242,rhaS,8195422,8195472,8195422,50,0,utRho02
1243,rhaT,8201132,8201132,8201050,82,48,utRho02
1244,rhlE,1661566,1661744,1661566,178,878,utRho02
1245,rhoL,47593944,47594772,47593944,828,460824,utRho02
1246,rhsB,7238006,7238384,7238006,378,96,utRho02
1247,rhsC,1458758,1459166,1458758,408,0,utRho02
1248,rhsD,1046132,1046522,1046132,390,0,utRho02
1249,rhtA,1700608,1700608,1700194,414,82,utRho02
1250,rhtC,8015478,8015514,8015478,36,2604,utRho02
1251,ribA,2678468,2678468,2678320,148,90,utRho02
1252,ribC,3486916,3486916,3486484,432,194,utRho02
1253,ribE,869008,869294,869008,286,9074,utRho02
1254,ribF,42766,42814,42766,48,202,utRho02
1255,ridA,8941892,8941892,8941826,66,116,utRho02
1256,rihA,1369204,1369204,1368824,380,592,utRho02
1257,rihB,4510504,4510504,4510372,132,0,utRho02
1258,rimJ,2251044,2251124,2251044,80,0,utRho02
1259,rimK,1783752,1783934,1783752,182,330,utRho02
1260,rimL,2997486,2997876,2997486,390,20,utRho02
1261,rimO,1756140,1756140,1756070,70,0,utRho02
1262,rimP,6636350,6636350,6636012,338,1516,utRho02
1263,rlmA,3814172,3814172,3814120,52,284,utRho02
1264,rlmD,5830086,5830086,5830000,86,68,utRho02
1265,rlmE,6655520,6655520,6655328,192,3774,utRho02
1266,rlmF,1684384,1684664,1684384,280,2,utRho02
1267,rlmG,6471784,6471784,6471750,34,10,utRho02
1268,rlmI,2060002,2060002,2059938,64,66,utRho02
1269,rlmJ,7290700,7290770,7290700,70,270,utRho02
1270,rlmL,2015344,2015688,2015344,344,472,utRho02
1271,rlpA,1330444,1330444,1330380,64,236,utRho02
1272,rluA,120900,120900,120692,208,560,utRho02
1273,rluF,8460324,8460708,8460324,384,118,utRho02
1274,rmf,2031006,2031430,2031006,424,1858,utRho02
1275,rna,1290068,1290068,1290006,62,0,utRho02
1276,rnb,2698258,2698258,2697824,434,2990,utRho02
1277,rnc,10816892,10816892,10816252,640,12380,utRho02
1278,rnd,3776122,3776122,3775982,140,430,utRho02
1279,rne,2289746,2289746,2288734,1012,10200,utRho02
1280,rnhA,472082,472082,472004,78,354,utRho02
1281,rnk,1288360,1288360,1287934,426,154,utRho02
1282,rnlA,5531788,5531836,5531788,48,112,utRho02
1283,rnlB,5533414,5533968,5533414,554,3124,utRho02
1284,rnpB,19623552,19623552,19623552,0,0,utRho02
1285,rob,9270706,9270706,9270620,86,76,utRho02
1286,rodZ,5285868,5285868,5285688,180,196,utRho02
1287,rpe,7030306,7030306,7030118,188,124,utRho02
1288,rph,15266320,15266320,15266196,124,20,utRho02
1289,rpiA,6118706,6118706,6118650,56,0,utRho02
1290,rpiB,8626514,8626700,8626514,186,48,utRho02
1291,rpiR,8626274,8626274,8625982,292,0,utRho02
1292,rplJ,8359246,8359992,8359246,746,12528,utRho02
1293,rplK,8356708,8356894,8356708,186,930,utRho02
1294,rplM,6757344,6757344,6757302,42,15222,utRho02
1295,rplN,6896444,6896444,6896298,146,7784,utRho02
1296,rplS,5489284,5489284,5489060,224,15628,utRho02
1297,rplT,7199052,7199052,7198996,56,1452,utRho02
1298,rplU,6667036,6667036,6666902,134,160,utRho02
1299,rplY,4564866,4565034,4564866,168,218,utRho02
1300,rpmA,6666450,6666450,6666238,212,1186,utRho02
1301,rpmB,15247980,15247980,15246696,1284,143264,utRho02
1302,rpmE,8253816,8254026,8253816,210,834,utRho02
1303,rpmF,2294676,2294734,2294676,58,72738,utRho02
1304,rpmH,7768130,7768672,7768130,542,9384,utRho02
1305,rpmI,3600854,3600854,3599998,856,19424,utRho02
1306,rpoB,8362126,8362490,8362126,364,1234,utRho02
1307,rpoD,6424946,6426094,6424946,1148,24614,utRho02
1308,rpoE,5420372,5420372,5420024,348,0,utRho02
1309,rpoH,7202006,7202006,7201566,440,29660,utRho02
1310,rpoN,6689324,6689434,6689324,110,110,utRho02
1311,rpoS,5736236,5736236,5735102,1134,4274,utRho02
1312,rpoZ,7644154,7644212,7644154,58,1464,utRho02
1313,rppH,5937986,5937986,5937954,32,0,utRho02
1314,rprA,3540744,3540744,3540744,0,0,utRho02
1315,rpsA,1923434,1923990,1923434,556,210096,utRho02
1316,rpsF,8850050,8850236,8850050,186,50442,utRho02
1317,rpsI,6756580,6756580,6756414,166,11880,utRho02
1318,rpsJ,6906884,6906884,6906540,344,16334,utRho02
1319,rpsL,6949242,6949242,6949104,138,190,utRho02
1320,rpsM,6885130,6885130,6884942,188,3382,utRho02
1321,rpsO,13247144,13247144,13246736,408,2912,utRho02
1322,rpsP,5492508,5492508,5492370,138,154,utRho02
1323,rpsT,42420,42420,42156,264,1662,utRho02
1324,rpsU,12842584,12843124,12842584,540,1772,utRho02
1325,rraA,8238716,8238716,8238660,56,196,utRho02
1326,rraB,8956768,8956946,8956768,178,0,utRho02
1327,rrsA,8070478,8071062,8070478,584,9206,utRho02
1328,rrsB,16665468,16666636,16665468,1168,19820,utRho02
1329,rrsC,7883032,7883616,7883032,584,9944,utRho02
1330,rrsD,6858094,6858094,6857524,570,308,utRho02
1331,rrsE,8415726,8416294,8415726,568,1838,utRho02
1332,rrsG,5462896,5462896,5462314,582,8150,utRho02
1333,rrsH,446970,447542,446970,572,2212,utRho02
1334,rsd,8393908,8393908,8393616,292,198,utRho02
1335,rseA,5419264,5419264,5418808,456,826,utRho02
1336,rseP,392940,393092,392940,152,154,utRho02
1337,rseX,4067298,4067298,4067298,0,0,utRho02
1338,rsfS,1338144,1338144,1338072,72,374,utRho02
1339,rsgA,8783132,8783132,8783018,114,116,utRho02
1340,rsmA,105176,105176,104860,316,5486,utRho02
1341,rsmB,6869982,6870414,6869982,432,546,utRho02
1342,rsmC,9215736,9215736,9215400,336,692,utRho02
1343,rsmD,7208594,7208786,7208594,192,64,utRho02
1344,rsmE,6182036,6182268,6182036,232,140,utRho02
1345,rsmG,7847512,7847512,7847360,152,4062,utRho02
1346,rsmH,180020,180188,180020,168,612,utRho02
1347,rsmI,6587106,6587106,6586670,436,1496,utRho02
1348,rssA,2578212,2578412,2578212,200,782,utRho02
1349,rssB,2580440,2580484,2580440,44,282,utRho02
1350,rstA,3364276,3364300,3364276,24,0,utRho02
1351,rsuA,4561096,4561096,4560966,130,506,utRho02
1352,rsxA,3411510,3411534,3411510,24,112,utRho02
1353,rtcA,7114004,7114004,7113698,306,44,utRho02
1354,rtcB,7116214,7116214,7116158,56,0,utRho02
1355,rtn,4541356,4541452,4541356,96,122,utRho02
1356,rutA,2148052,2148052,2148022,30,0,utRho02
1357,rutG,2140090,2140090,2139678,412,0,utRho02
1358,rutR,2148226,2148484,2148226,258,2,utRho02
1359,ruvA,7784096,7784096,7783904,192,0,utRho02
1360,ruvB,7782176,7782176,7781424,752,440,utRho02
1361,ruvC,3894878,3894878,3894752,126,24,utRho02
1362,rybB,1776114,1776114,1776114,0,0,utRho02
1363,rydB,3529860,3529860,3529322,538,48,utRho02
1364,rydC,2983012,2983012,2983012,0,0,utRho02
1365,ryfA,5307398,5307710,5307398,312,90,utRho02
1366,ryfD,5468590,5468590,5468590,0,0,utRho02
1367,ryhB,7162032,7162032,7162032,0,0,utRho02
1368,ryjA,8556132,8556132,8556132,0,0,utRho02
1369,ryjB,9055954,9055954,9055954,0,0,utRho02
1370,sad,3229598,3229598,3229406,192,124,utRho02
1371,safA,3168056,3168056,3167918,138,0,utRho02
1372,sanA,4465368,4465756,4465368,388,244,utRho02
1373,sapF,2705314,2705314,2705268,46,378,utRho02
1374,sbcB,4165456,4165512,4165456,56,112,utRho02
1375,sbcC,831694,831694,831506,188,202,utRho02
1376,sbcD,833954,833954,833904,50,40,utRho02
1377,sbmA,793106,793278,793106,172,52,utRho02
1378,sbmC,4162650,4162650,4162524,126,0,utRho02
1379,sdaA,3793618,3793864,3793618,246,120,utRho02
1380,sdaC,5856070,5856458,5856070,388,886,utRho02
1381,sdhC,1509916,1510354,1509916,438,24662,utRho02
1382,sdhD,1510808,1511120,1510808,312,8308,utRho02
1383,sdiA,3993834,3993834,3993664,170,56,utRho02
1384,secE,8354354,8354716,8354354,362,444,utRho02
1385,secG,6645180,6645180,6645010,170,3724,utRho02
1386,selA,7522594,7522594,7522498,96,938,utRho02
1387,selB,7519850,7519850,7519722,128,100,utRho02
1388,selC,7672396,7672444,7672396,48,102,utRho02
1389,selD,3696058,3696058,3696016,42,5570,utRho02
1390,seqA,1425884,1425974,1425884,90,470,utRho02
1391,serA,6117098,6117098,6116820,278,46,utRho02
1392,serB,9249712,9249790,9249712,78,110,utRho02
1393,serC,3830380,3830612,3830380,232,0,utRho02
1394,serS,1878730,1878856,1878730,126,3324,utRho02
1395,serT,2063438,2063438,2063424,14,0,utRho02
1396,serU,4087124,4087124,4087114,10,28,utRho02
1397,serV,5637394,5637394,5637290,104,156,utRho02
1398,serW,1852014,1852014,1851942,72,202,utRho02
1399,serX,2195352,2195352,2195304,48,16,utRho02
1400,setB,4527426,4527726,4527426,300,0,utRho02
1401,setC,7673488,7673906,7673488,418,34,utRho02
1402,sfmA,1116124,1116424,1116124,300,0,utRho02
1403,sfmC,1117606,1117948,1117606,342,0,utRho02
1404,sfsA,323030,323030,322972,58,436,utRho02
1405,sfsB,6669592,6669818,6669592,226,694,utRho02
1406,sgrR,154676,154676,154598,78,40,utRho02
1407,sgrS,154734,154734,154734,0,0,utRho02
1408,shiA,4107068,4107286,4107068,218,4,utRho02
1409,sibA,4306622,4306622,4306622,0,0,utRho02
1410,sibB,4307292,4307292,4307292,0,0,utRho02
1411,sibC,6113702,6113702,6113702,0,0,utRho02
1412,sibD,6389730,6389730,6389730,0,0,utRho02
1413,sibE,6390480,6390480,6390480,0,0,utRho02
1414,sixA,4913998,4913998,4913624,374,56,utRho02
1415,slp,7307872,7307922,7307872,50,0,utRho02
1416,slt,9261400,9261466,9261400,66,64,utRho02
1417,slyA,3442028,3442028,3441648,380,122,utRho02
1418,slyB,3439496,3439752,3439496,256,286,utRho02
1419,slyD,6957398,6957398,6956994,404,36,utRho02
1420,slyX,6954862,6955280,6954862,418,9108,utRho02
1421,smf,6867372,6867372,6867120,252,530,utRho02
1422,smpB,5509534,5509792,5509534,258,1418,utRho02
1423,smrA,2811872,2811958,2811872,86,258,utRho02
1424,smrB,4896872,4897212,4896872,340,140,utRho02
1425,smtA,1946808,1947074,1946808,266,12,utRho02
1426,sodA,8201518,8201620,8201518,102,8292,utRho02
1427,sodB,3470646,3470756,3470646,110,0,utRho02
1428,sodC,3449358,3449358,3449310,48,0,utRho02
1429,sohB,2658568,2658664,2658568,96,104,utRho02
1430,sokB,2984232,2984238,2984232,6,52,utRho02
1431,solA,2241218,2241218,2241172,46,4,utRho02
1432,soxR,8554894,8554938,8554894,44,0,utRho02
1433,soxS,8554846,8554846,8554766,80,0,utRho02
1434,speA,6172096,6172096,6171822,274,462,utRho02
1435,speB,6167892,6167892,6167594,298,118,utRho02
1436,speC,6218350,6218350,6218310,40,28,utRho02
1437,spf,8099798,8099798,8099798,0,0,utRho02
1438,sppA,3697422,3697674,3697422,252,36,utRho02
1439,spy,3651376,3651376,3651250,126,0,utRho02
1440,sra,3112092,3112092,3111926,166,0,utRho02
1441,sraB,2293178,2293178,2293178,0,0,utRho02
1442,sraC,3846132,3846132,3846132,0,0,utRho02
1443,srlA,5651582,5651664,5651582,82,10,utRho02
1444,srlR,5657720,5658094,5657720,374,84,utRho02
1445,srmB,5425752,5425792,5425752,40,124,utRho02
1446,sroA,151216,151216,151216,0,0,utRho02
1447,sroG,6369436,6369436,6369436,0,0,utRho02
1448,sroH,8380974,8380974,8380974,0,0,utRho02
1449,ssb,8548022,8548250,8548022,228,218,utRho02
1450,sseA,5304782,5304988,5304782,206,5314,utRho02
1451,sspA,6755138,6755138,6754840,298,1306,utRho02
1452,ssrA,5511014,5511186,5511014,172,256,utRho02
1453,ssrS,12223036,12223932,12223036,896,3968,utRho02
1454,sstT,6479726,6479888,6479726,162,266,utRho02
1455,ssuB,1988282,1988282,1988088,194,2,utRho02
1456,ssuE,1995126,1995126,1995024,102,0,utRho02
1457,sthA,8321604,8321604,8321580,24,2068,utRho02
1458,stpA,5597156,5597156,5596990,166,142,utRho02
1459,sucA,3034344,3034824,3034344,480,1848,utRho02
1460,sufA,3528836,3528836,3528772,64,60,utRho02
1461,sufE,3518962,3518962,3518580,382,960,utRho02
1462,sugE,8753588,8753750,8753588,162,608,utRho02
1463,sulA,2041894,2041894,2041838,56,404,utRho02
1464,syd,5850738,5850738,5850560,178,12,utRho02
1465,symE,9159834,9159834,9159680,154,60,utRho02
1466,symR,9159670,9159670,9159670,0,0,utRho02
1467,tabA,8949566,8949724,8949566,158,0,utRho02
1468,talA,5157140,5157332,5157140,192,0,utRho02
1469,talB,16382,16476,16382,94,6246,utRho02
1470,tam,3214442,3214692,3214442,250,0,utRho02
1471,tamA,8884540,8884764,8884540,224,10,utRho02
1472,tar,3945432,3945432,3945382,50,0,utRho02
1473,tas,5943138,5943194,5943138,56,260,utRho02
1474,tatA,16087636,16087780,16087636,144,452,utRho02
1475,tatE,1317742,1317894,1317742,152,0,utRho02
1476,tauA,770410,770464,770410,54,0,utRho02
1477,tdcA,6534186,6534186,6534130,56,0,utRho02
1478,tdcG,6519652,6519652,6519298,354,0,utRho02
1479,tdcR,6534380,6534760,6534380,380,130,utRho02
1480,tdk,2586986,2587054,2586986,68,140,utRho02
1481,tehA,3001072,3001146,3001072,74,0,utRho02
1482,tesA,1039898,1039898,1039530,368,276,utRho02
1483,tesB,950402,950402,950322,80,0,utRho02
1484,tfaE,2418532,2418532,2418238,294,62,utRho02
1485,tfaQ,3269912,3269912,3269770,142,26,utRho02
1486,tff,379424,379256,379424,168,0,utRho02
1487,tgt,852110,852274,852110,164,110,utRho02
1488,thiD,4369346,4369346,4369032,314,0,utRho02
1489,thiI,882936,883098,882936,162,598,utRho02
1490,thiM,4370902,4370902,4370602,300,906,utRho02
1491,thiQ,146170,146170,145854,316,596,utRho02
1492,thrL,592,760,592,168,1380,utRho02
1493,thrS,7210932,7210932,7210280,652,4120,utRho02
1494,thrU,8350762,8350776,8350762,14,0,utRho02
1495,thrV,6847414,6847414,6847310,104,177612,utRho02
1496,thrW,525682,525742,525682,60,1248,utRho02
1497,thyA,5930696,5930696,5930310,386,3352,utRho02
1498,tig,909986,910266,909986,280,862,utRho02
1499,tisB,7706674,7707106,7706674,432,424,utRho02
1500,tktA,6163414,6163414,6163270,144,76,utRho02
1501,tktB,5158616,5159272,5158616,656,652,utRho02
1502,tldD,6784368,6784368,6784056,312,136,utRho02
1503,tmcA,5191876,5191876,5191718,158,0,utRho02
1504,tnaC,15553644,15553740,15553644,96,156,utRho02
1505,tolB,1555074,1555480,1555074,406,1010,utRho02
1506,tolC,6356008,6356230,6356008,222,720,utRho02
1507,tomB,961588,961588,961416,172,7882,utRho02
1508,tonB,2622108,2622178,2622108,70,0,utRho02
1509,topA,2661578,2662096,2661578,518,1496,utRho02
1510,torC,2116112,2116168,2116112,56,62,utRho02
1511,torR,2115968,2115968,2115908,60,62,utRho02
1512,torS,2112364,2112364,2112356,8,0,utRho02
1513,torT,2112414,2112522,2112414,108,0,utRho02
1514,tpiA,8223138,8223138,8223014,124,56,utRho02
1515,tppB,3425342,3425538,3425342,196,5134,utRho02
1516,tpr,2574376,2574376,2574376,0,0,utRho02
1517,tpx,2777688,2777688,2777622,66,1122,utRho02
1518,tqsA,3347780,3347826,3347780,46,0,utRho02
1519,treA,2494850,2494850,2494752,98,136,utRho02
1520,treB,8932420,8932420,8932360,60,80,utRho02
1521,treF,7339102,7339184,7339102,82,168,utRho02
1522,treR,8934694,8934694,8934492,202,0,utRho02
1523,trg,2984878,2984940,2984878,62,208,utRho02
1524,trkG,2847342,2847564,2847342,222,0,utRho02
1525,trmA,8326590,8326590,8326540,50,328,utRho02
1526,trpA,2634678,2634678,2634444,234,856,utRho02
1527,trpC,2639888,2639888,2639570,318,296,utRho02
1528,trpL,5292432,5292432,5292328,104,0,utRho02
1529,trpR,9265408,9265520,9265408,112,360,utRho02
1530,trpS,7027394,7027394,7027276,118,1430,utRho02
1531,trpT,7893560,7893914,7893560,354,102272,utRho02
1532,trxA,7931294,7931522,7931294,228,842,utRho02
1533,trxB,1864156,1864156,1864100,56,0,utRho02
1534,trxC,5437350,5437470,5437350,120,342,utRho02
1535,tsaD,6421256,6421256,6421086,170,40,utRho02
1536,tsgA,6985038,6985136,6985038,98,0,utRho02
1537,tsr,9182824,9183314,9182824,490,50,utRho02
1538,tsx,864490,864490,864026,464,870,utRho02
1539,ttcA,2823970,2823970,2823896,74,3614,utRho02
1540,ttdA,6412848,6412926,6412848,78,0,utRho02
1541,ttdR,6412760,6412760,6412512,248,0,utRho02
1542,tufA,6943448,6943448,6942658,790,156748,utRho02
1543,tus,3368346,3368518,3368346,172,20,utRho02
1544,tusA,7218040,7218040,7217992,48,96,utRho02
1545,tusB,6950218,6950218,6949930,288,1094,utRho02
1546,tynA,2902996,2902996,2902698,298,0,utRho02
1547,typA,8116460,8116814,8116460,354,8586,utRho02
1548,tyrB,8534164,8534228,8534164,64,2040,utRho02
1549,tyrP,3979004,3979362,3979004,358,0,utRho02
1550,tyrR,2773384,2773440,2773384,56,0,utRho02
1551,tyrS,3434566,3434566,3434444,122,0,utRho02
1552,tyrT,2575330,2575330,2575244,86,114,utRho02
1553,uacT,6062378,6062734,6062378,356,54,utRho02
1554,ubiC,8504886,8505012,8504886,126,298,utRho02
1555,ubiD,8049618,8049976,8049618,358,1356,utRho02
1556,ubiE,8037494,8037710,8037494,216,124,utRho02
1557,ubiG,4679078,4679134,4679078,56,26,utRho02
1558,ucpA,5089342,5089342,5089246,96,0,utRho02
1559,udp,8032782,8032862,8032782,80,64,utRho02
1560,ugd,4199470,4199470,4199226,244,6,utRho02
1561,ugpB,7184852,7184852,7184650,202,164,utRho02
1562,ugpQ,7176600,7176600,7176226,374,0,utRho02
1563,uhpT,7694396,7694396,7694334,62,0,utRho02
1564,uidA,3392304,3392304,3392142,162,26,utRho02
1565,uidC,3386012,3386012,3385702,310,0,utRho02
1566,uidR,3394150,3394150,3394104,46,134,utRho02
1567,ulaA,8839854,8839960,8839854,106,0,utRho02
1568,ulaG,8839350,8839350,8839250,100,50,utRho02
1569,ulaR,8837124,8837124,8836906,218,96,utRho02
1570,umpG,5741372,5741372,5740548,824,160,utRho02
1571,umpH,1400704,1400704,1400652,52,46,utRho02
1572,umuD,2461476,2461534,2461476,58,0,utRho02
1573,ung,5433476,5433508,5433476,32,44,utRho02
1574,uof,2843316,2843316,2842900,416,9288,utRho02
1575,upp,5241818,5241818,5241744,74,56,utRho02
1576,usg,4873780,4873780,4873298,482,608,utRho02
1577,ushA,1009772,1009828,1009772,56,0,utRho02
1578,uspA,7279966,7280222,7279966,256,1150,utRho02
1579,uspB,7279696,7279696,7279440,256,768,utRho02
1580,uspC,3959172,3959506,3959172,334,0,utRho02
1581,uspE,2797318,2797318,2797244,74,204,utRho02
1582,uspF,2871282,2871282,2871238,44,0,utRho02
1583,uspG,1283806,1283806,1283734,72,728,utRho02
1584,uvrA,8547872,8547872,8547742,130,288,utRho02
1585,uvrB,1626304,1627052,1626304,748,2124,utRho02
1586,uvrC,3989758,3989758,3989412,346,80,utRho02
1587,uvrD,7995814,7995966,7995814,152,206,utRho02
1588,uvrY,3990812,3990812,3990718,94,58,utRho02
1589,uxaB,3221474,3221474,3221360,114,64,utRho02
1590,uxaC,6489714,6489714,6489482,232,60,utRho02
1591,uxuA,9103036,9103272,9103036,236,104,utRho02
1592,uxuR,9108916,9109152,9108916,236,40,utRho02
1593,valS,8967854,8967854,8967674,180,854,utRho02
1594,valU,5041848,5041862,5041848,14,8,utRho02
1595,valV,3492830,3492870,3492830,40,0,utRho02
1596,ves,3649968,3649968,3649874,94,2,utRho02
1597,waaA,7616512,7617080,7616512,568,538,utRho02
1598,waaH,7580298,7580298,7580162,136,0,utRho02
1599,waaQ,7616476,7616476,7616196,280,116,utRho02
1600,waaU,7598996,7598996,7598624,372,292,utRho02
1601,waaY,7602272,7602272,7601930,342,8156,utRho02
1602,wbbH,4214888,4214888,4214452,436,7494,utRho02
1603,wbbK,4209212,4209212,4209018,194,354,utRho02
1604,wcaM,4231868,4231868,4231792,76,0,utRho02
1605,wrbA,2135516,2135516,2135416,100,10,utRho02
1606,wza,4275166,4275166,4274486,680,0,utRho02
1607,wzxC,4240674,4240674,4240316,358,120,utRho02
1608,wzzB,4196950,4196950,4196602,348,358,utRho02
1609,xanP,7657642,7657890,7657642,248,10,utRho02
1610,xanQ,6048520,6048702,6048520,182,16,utRho02
1611,xapA,5049820,5049820,5049756,64,0,utRho02
1612,xapR,10090252,10090252,10089908,344,0,utRho02
1613,xdhA,6000514,6000690,6000514,176,84,utRho02
1614,xerD,6079702,6079702,6079486,216,128,utRho02
1615,xseA,5268394,5268464,5268394,70,626,utRho02
1616,xseB,882746,882746,882686,60,162,utRho02
1617,xthA,3664798,3664856,3664798,58,0,utRho02
1618,xylA,7461614,7461614,7461530,84,160,utRho02
1619,xylE,8484540,8484540,8484508,32,0,utRho02
1620,xylF,7462138,7462262,7462138,124,0,utRho02
1621,xylR,7469812,7469958,7469812,146,0,utRho02
1622,yaaA,13230,13230,12918,312,74,utRho02
1623,yaaI,23876,23876,23572,304,0,utRho02
1624,yaaJ,16034,16034,15918,116,308,utRho02
1625,yaaU,91184,91614,91184,430,0,utRho02
1626,yaaW,23084,23084,22712,372,0,utRho02
1627,yaaX,10060,10468,10060,408,158,utRho02
1628,yabI,142542,142702,142542,160,0,utRho02
1629,yacC,273880,273880,273834,46,5434,utRho02
1630,yacH,262932,262932,262520,412,0,utRho02
1631,yacL,268678,268776,268678,98,40,utRho02
1632,yadD,293796,293936,293796,140,0,utRho02
1633,yadE,289930,290162,289930,232,428,utRho02
1634,yadN,314110,314110,313766,344,98,utRho02
1635,yadS,355572,355572,355248,324,684,utRho02
1636,yadV,312470,312470,312402,68,0,utRho02
1637,yaeF,434270,434270,434006,264,24,utRho02
1638,yaeP,428374,428374,428250,124,332,utRho02
1639,yaeQ,428176,428582,428176,406,382,utRho02
1640,yaeR,423716,423754,423716,38,96,utRho02
1641,yafC,462166,462166,461762,404,516,utRho02
1642,yafD,462128,462244,462128,116,168,utRho02
1643,yafK,491986,491986,491610,376,3442,utRho02
1644,yafL,493282,493424,493282,142,50,utRho02
1645,yafN,503938,504010,503938,72,2,utRho02
1646,yafS,469568,469632,469568,64,224,utRho02
1647,yafT,474470,474670,474470,200,0,utRho02
1648,yafV,480432,480432,480378,54,94,utRho02
1649,yafZ,536052,536052,536010,42,28,utRho02
1650,yagE,564446,564556,564446,110,30,utRho02
1651,yagG,570414,570790,570414,376,0,utRho02
1652,yagI,578384,578384,578324,60,0,utRho02
1653,yagK,586236,586236,585896,340,4,utRho02
1654,yagL,588062,588062,587836,226,24,utRho02
1655,yagN,591342,591342,591158,184,1516,utRho02
1656,yahA,663746,664742,663746,996,290,utRho02
1657,yahC,670136,670136,670044,92,0,utRho02
1658,yahE,671478,671850,671478,372,84,utRho02
1659,yahM,690504,690808,690504,304,124,utRho02
1660,yahN,692872,692872,692674,198,0,utRho02
1661,yahO,692864,692968,692864,104,0,utRho02
1662,yaiE,816296,816354,816296,58,100,utRho02
1663,yaiI,811396,811528,811396,132,0,utRho02
1664,yaiO,761946,761946,761684,262,0,utRho02
1665,yaiP,767970,767970,767870,100,0,utRho02
1666,yaiS,769660,769660,769232,428,0,utRho02
1667,yaiV,788922,788922,788922,0,0,utRho02
1668,yaiY,799094,799094,798666,428,856,utRho02
1669,yaiZ,798888,799186,798888,298,1488,utRho02
1670,yajC,854410,854574,854410,164,1586,utRho02
1671,yajD,860938,861210,860938,272,658,utRho02
1672,yajI,866068,866068,865702,366,310,utRho02
1673,yajL,887496,887496,887282,214,342,utRho02
1674,yajQ,889316,889366,889316,50,24,utRho02
1675,yajR,893374,893374,893332,42,430,utRho02
1676,ybaB,987418,988152,987418,734,2330,utRho02
1677,ybaL,1006590,1006590,1006476,114,38,utRho02
1678,ybaM,980648,980648,980542,106,2002,utRho02
1679,ybaN,981436,981764,981436,328,212,utRho02
1680,ybaO,936704,936766,936704,62,0,utRho02
1681,ybaP,1016568,1016568,1016160,408,1370,utRho02
1682,ybaQ,1016348,1016436,1016348,88,68,utRho02
1683,ybaS,1023146,1023282,1023146,136,0,utRho02
1684,ybaV,927504,927874,927504,370,40,utRho02
1685,ybaY,950490,950758,950490,268,92,utRho02
1686,ybbB,1062724,1062724,1062452,272,2,utRho02
1687,ybbJ,1030154,1030154,1029718,436,1022,utRho02
1688,ybbL,1031784,1031838,1031784,54,0,utRho02
1689,ybbN,1037136,1037136,1036558,578,1530,utRho02
1690,ybbO,1038658,1038658,1038298,360,1416,utRho02
1691,ybbY,1080718,1081130,1080718,412,70,utRho02
1692,ybcH,1176140,1176140,1175962,178,0,utRho02
1693,ybcI,1113264,1113264,1113106,158,1140,utRho02
1694,ybcJ,1114050,1114050,1113746,304,464,utRho02
1695,ybcK,1137502,1137804,1137502,302,0,utRho02
1696,ybcL,1141690,1141786,1141690,96,0,utRho02
1697,ybcN,1144628,1144932,1144628,304,0,utRho02
1698,ybcQ,1147548,1147912,1147548,364,2,utRho02
1699,ybcW,1159610,1159760,1159610,150,0,utRho02
1700,ybdD,1263982,1264364,1263982,382,266,utRho02
1701,ybdF,1212106,1212106,1211772,334,218,utRho02
1702,ybdH,1267048,1267048,1266954,94,38,utRho02
1703,ybdJ,1212822,1212822,1212398,424,4,utRho02
1704,ybdK,1215122,1215122,1214766,356,274,utRho02
1705,ybdL,1267114,1267172,1267114,58,0,utRho02
1706,ybdM,1271110,1271110,1270752,358,504,utRho02
1707,ybdN,1273372,1273372,1273138,234,2,utRho02
1708,ybdR,1283844,1284176,1283844,332,648,utRho02
1709,ybeD,1325412,1325412,1325284,128,168,utRho02
1710,ybeF,1323090,1323090,1322756,334,80,utRho02
1711,ybeL,1349986,1350036,1349986,50,0,utRho02
1712,ybeQ,1353412,1353412,1353094,318,0,utRho02
1713,ybeR,1353120,1353422,1353120,302,0,utRho02
1714,ybeT,1358832,1358832,1358812,20,0,utRho02
1715,ybeU,1358924,1359016,1358924,92,0,utRho02
1716,ybeZ,1386938,1386938,1386834,104,4024,utRho02
1717,ybfA,1458074,1458268,1458074,194,36,utRho02
1718,ybfE,1423878,1423878,1423796,82,322,utRho02
1719,ybfF,1425692,1425692,1425604,88,698,utRho02
1720,ybfH,1433282,1433282,1433194,88,0,utRho02
1721,ybgA,1477840,1478002,1477840,162,0,utRho02
1722,ybgC,1549288,1549504,1549288,216,42,utRho02
1723,ybgD,1505916,1505916,1505590,326,422,utRho02
1724,ybgI,1485238,1485654,1485238,416,0,utRho02
1725,ybgO,1498370,1498370,1497964,406,76,utRho02
1726,ybgS,1570992,1570992,1570634,358,16,utRho02
1727,ybhA,1597184,1597184,1596862,322,112,utRho02
1728,ybhB,1616070,1616070,1615818,252,132,utRho02
1729,ybhC,1614642,1614642,1614562,80,1030,utRho02
1730,ybhD,1601418,1601418,1601276,142,0,utRho02
1731,ybhH,1601104,1601518,1601104,414,0,utRho02
1732,ybhK,1633384,1633384,1633294,90,32,utRho02
1733,ybhM,1641556,1641586,1641556,30,0,utRho02
1734,ybhN,1645296,1645296,1644996,300,0,utRho02
1735,ybhQ,1649202,1649260,1649202,58,138,utRho02
1736,ybiA,1665920,1665920,1665900,20,0,utRho02
1737,ybiI,1676968,1676968,1676912,56,186,utRho02
1738,ybiO,1691328,1691328,1690960,368,86,utRho02
1739,ybiP,1705252,1705252,1705194,58,2714,utRho02
1740,ybiS,1711572,1711572,1711488,84,644,utRho02
1741,ybiT,1711894,1711926,1711894,32,0,utRho02
1742,ybiU,1718212,1718212,1718122,90,0,utRho02
1743,ybiV,1720176,1720176,1720056,120,0,utRho02
1744,ybiW,1725566,1725566,1725212,354,68,utRho02
1745,ybiX,1678548,1678548,1678414,134,1746,utRho02
1746,ybjC,1781784,1781826,1781784,42,0,utRho02
1747,ybjE,1830154,1830154,1829714,440,196,utRho02
1748,ybjG,1767016,1767016,1766776,240,1252,utRho02
1749,ybjL,1779882,1779882,1779638,244,196,utRho02
1750,ybjM,1779770,1780178,1779770,408,270,utRho02
1751,ybjO,1795704,1795978,1795704,274,2,utRho02
1752,ybjP,1809046,1809046,1808934,112,0,utRho02
1753,ybjQ,1809034,1809186,1809034,152,0,utRho02
1754,ybjS,1813796,1813796,1813506,290,298,utRho02
1755,ybjX,1838206,1838206,1838168,38,0,utRho02
1756,ycaD,1891438,1891742,1891438,304,0,utRho02
1757,ycaI,1928210,1928640,1928210,430,292,utRho02
1758,ycaK,1899094,1899336,1899094,242,0,utRho02
1759,ycaL,1920264,1920528,1920264,264,0,utRho02
1760,ycaM,1894240,1894458,1894240,218,0,utRho02
1761,ycaR,1941284,1941346,1941284,62,1874,utRho02
1762,ycbB,1961862,1962094,1961862,232,60,utRho02
1763,ycbJ,1943344,1943504,1943344,160,0,utRho02
1764,ycbK,1966046,1966150,1966046,104,554,utRho02
1765,ycbZ,2036920,2036920,2036598,322,198,utRho02
1766,yccA,2062886,2062886,2062836,50,1030,utRho02
1767,yccF,2048730,2048730,2048696,34,32,utRho02
1768,yccS,2047988,2047988,2047766,222,40,utRho02
1769,yccT,2055674,2055674,2055546,128,138,utRho02
1770,yccX,2059960,2060128,2059960,168,356,utRho02
1771,ycdT,2185682,2185752,2185682,70,0,utRho02
1772,ycdU,2191266,2191686,2191266,420,0,utRho02
1773,ycdZ,2200504,2200592,2200504,88,106,utRho02
1774,yceA,2233544,2233614,2233544,70,96,utRho02
1775,yceD,2293298,2293588,2293298,290,4804,utRho02
1776,yceF,2293522,2293522,2293190,332,2824,utRho02
1777,yceH,2252154,2252314,2252154,160,780,utRho02
1778,yceI,2237282,2237282,2236952,330,138,utRho02
1779,yceJ,2238142,2238142,2238092,50,288,utRho02
1780,yceM,2253208,2253612,2253208,404,20,utRho02
1781,yceO,2239264,2239264,2238894,370,94,utRho02
1782,yceQ,2288760,2289004,2288760,244,8458,utRho02
1783,ycfD,2376540,2376540,2376480,60,100,utRho02
1784,ycfJ,2334814,2335198,2334814,384,1500,utRho02
1785,ycfS,2340834,2340834,2340748,86,0,utRho02
1786,ycfT,2350658,2350658,2350330,328,84,utRho02
1787,ycfZ,2362760,2362760,2362534,226,578,utRho02
1788,ycgB,2474570,2474570,2474482,88,0,utRho02
1789,ycgG,2434614,2434656,2434614,42,4,utRho02
1790,ycgJ,2452956,2453200,2452956,244,44,utRho02
1791,ycgL,2455218,2455362,2455218,144,0,utRho02
1792,ycgN,2457366,2457660,2457366,294,142,utRho02
1793,ycgR,2489112,2489112,2489054,58,0,utRho02
1794,ycgV,2512222,2512222,2511904,318,328,utRho02
1795,ycgX,2426568,2426568,2426214,354,27396,utRho02
1796,ycgY,2490166,2490320,2490166,154,36,utRho02
1797,ycgZ,2431504,2431578,2431504,74,0,utRho02
1798,ychE,2596904,2597196,2596904,292,216,utRho02
1799,ychF,2515764,2515764,2515624,140,0,utRho02
1800,ychH,2517476,2517582,2517476,106,600,utRho02
1801,ychJ,2578354,2578354,2578264,90,0,utRho02
1802,ychN,2547310,2547310,2547198,112,74,utRho02
1803,ychO,2547520,2547850,2547520,330,412,utRho02
1804,ychQ,2533798,2533848,2533798,50,60,utRho02
1805,yciA,2624828,2624828,2624492,336,342,utRho02
1806,yciB,2626110,2626110,2625780,330,3430,utRho02
1807,yciC,2627396,2627396,2627326,70,62,utRho02
1808,yciE,2630794,2630794,2630448,346,0,utRho02
1809,yciG,5264368,5264368,5264140,228,0,utRho02
1810,yciI,2621784,2621784,2621730,54,0,utRho02
1811,yciN,2661606,2661606,2661336,270,136,utRho02
1812,yciS,2680270,2680486,2680270,216,132,utRho02
1813,yciT,2689088,2689088,2688692,396,226,utRho02
1814,yciU,2614718,2614718,2614300,418,5222,utRho02
1815,yciV,2646376,2646440,2646376,64,0,utRho02
1816,yciW,2700472,2700472,2700214,258,1118,utRho02
1817,yciZ,2689276,2689276,2689218,58,212,utRho02
1818,ycjD,2703792,2703792,2703520,272,32,utRho02
1819,ycjG,2777748,2777860,2777748,112,98,utRho02
1820,ycjM,2740006,2740432,2740006,426,56,utRho02
1821,ycjW,2767982,2767982,2767922,60,110,utRho02
1822,ycjX,2768138,2768234,2768138,96,0,utRho02
1823,ycjY,5568288,5568288,5567460,828,44,utRho02
1824,ydaE,2836438,2836438,2836016,422,66,utRho02
1825,ydaN,2816048,2816100,2816048,52,0,utRho02
1826,ydaS,2840340,2840730,2840340,390,320,utRho02
1827,ydbC,2948376,2948442,2948376,66,0,utRho02
1828,ydbD,2950132,2950288,2950132,156,60,utRho02
1829,ydbH,2885800,2886102,2885800,302,0,utRho02
1830,ydbJ,2881712,2882116,2881712,404,124,utRho02
1831,ydbK,2881692,2881692,2881568,124,70,utRho02
1832,ydcA,2983294,2983354,2983294,60,10,utRho02
1833,ydcF,2974404,2974470,2974404,66,44,utRho02
1834,ydcI,2990268,2990268,2990142,126,46,utRho02
1835,ydcJ,2990266,2990576,2990266,310,0,utRho02
1836,ydcK,3001280,3001280,3000898,382,0,utRho02
1837,ydcL,3004646,3004914,3004646,268,106,utRho02
1838,ydcN,3012308,3012344,3012308,36,2,utRho02
1839,ydcP,3013508,3013562,3013508,54,24,utRho02
1840,ydcR,3019956,3020006,3019956,50,0,utRho02
1841,ydcS,3022906,3023308,3022906,402,0,utRho02
1842,ydcX,3034442,3034778,3034442,336,384,utRho02
1843,ydcY,3035220,3035296,3035220,76,172,utRho02
1844,ydcZ,3036750,3036750,3036662,88,232,utRho02
1845,yddB,3155332,3155332,3155238,94,0,utRho02
1846,yddE,3071738,3071738,3071716,22,0,utRho02
1847,yddG,3094410,3094410,3094338,72,0,utRho02
1848,yddJ,3089732,3089732,3089438,294,0,utRho02
1849,yddW,3137704,3137704,3137646,58,0,utRho02
1850,ydeA,3233910,3234056,3233910,146,398,utRho02
1851,ydeE,3242528,3242664,3242528,136,0,utRho02
1852,ydeI,3249118,3249118,3248994,124,0,utRho02
1853,ydeJ,3249376,3249546,3249376,170,4,utRho02
1854,ydeN,3165458,3165458,3165048,410,0,utRho02
1855,ydeP,3173328,3173328,3172972,356,0,utRho02
1856,ydeR,3176596,3176596,3176592,4,0,utRho02
1857,ydfA,3296872,3297016,3296872,144,258,utRho02
1858,ydfG,3254982,3255034,3254982,52,0,utRho02
1859,ydfH,3256652,3256704,3256652,52,346,utRho02
1860,ydfK,3265446,3266144,3265446,698,63712,utRho02
1861,ydgA,3379588,3379704,3379588,116,0,utRho02
1862,ydgC,3364124,3364124,3364060,64,260,utRho02
1863,ydgD,3343906,3343920,3343906,14,0,utRho02
1864,ydgH,3356754,3356854,3356754,100,50,utRho02
1865,ydgJ,3408798,3408798,3408616,182,18,utRho02
1866,ydgK,3410414,3410500,3410414,86,252,utRho02
1867,ydhB,3479618,3479618,3479596,22,0,utRho02
1868,ydhC,3479698,3479822,3479698,124,0,utRho02
1869,ydhF,3451310,3451310,3451264,46,0,utRho02
1870,ydhI,3441996,3442050,3441996,54,0,utRho02
1871,ydhL,3451864,3451864,3451840,24,2,utRho02
1872,ydhQ,3492404,3492404,3492254,150,0,utRho02
1873,ydhS,3494136,3494262,3494136,126,602,utRho02
1874,ydhT,3499138,3499138,3499118,20,0,utRho02
1875,ydhY,3509284,3509284,3508954,330,44,utRho02
1876,ydhZ,3510418,3510418,3510282,136,0,utRho02
1877,ydiE,3579206,3579226,3579206,20,0,utRho02
1878,ydiH,3530582,3530582,3530406,176,88,utRho02
1879,ydiM,3541852,3542142,3541852,290,0,utRho02
1880,ydiN,3544818,3545024,3544818,206,0,utRho02
1881,ydiP,3558656,3558656,3558602,54,0,utRho02
1882,ydiU,3582508,3582508,3582488,20,64,utRho02
1883,ydiV,3584174,3584174,3584040,134,68,utRho02
1884,ydiY,3612500,3612500,3612166,334,72,utRho02
1885,ydjA,3697400,3697400,3697352,48,30,utRho02
1886,ydjE,3708082,3708082,3707958,124,0,utRho02
1887,ydjF,3709848,3709848,3709708,140,0,utRho02
1888,ydjM,3620340,3620422,3620340,82,0,utRho02
1889,ydjO,3626696,3626696,3626288,408,0,utRho02
1890,ydjX,3666434,3666802,3666434,368,2484,utRho02
1891,yeaE,3731448,3731448,3731272,176,120,utRho02
1892,yeaG,3733530,3733816,3733530,286,0,utRho02
1893,yeaI,3740486,3740770,3740486,284,0,utRho02
1894,yeaJ,3743874,3744082,3743874,208,352,utRho02
1895,yeaL,3748646,3748704,3748646,58,166,utRho02
1896,yeaM,3751296,3751296,3751152,144,0,utRho02
1897,yeaN,3750926,3751346,3750926,420,22,utRho02
1898,yeaO,3753554,3753818,3753554,264,0,utRho02
1899,yeaP,3755314,3755430,3755314,116,666,utRho02
1900,yeaQ,3758780,3758780,3758510,270,96,utRho02
1901,yeaR,3759988,3759988,3759896,92,72,utRho02
1902,yeaY,3781122,3781122,3781064,58,120,utRho02
1903,yebB,3892220,3892502,3892220,282,0,utRho02
1904,yebC,3896370,3896370,3896302,68,38,utRho02
1905,yebE,3859464,3859464,3859414,50,438,utRho02
1906,yebG,3861530,3861530,3861494,36,0,utRho02
1907,yebK,3873180,3873304,3873180,124,134,utRho02
1908,yebQ,3820314,3820552,3820314,238,40,utRho02
1909,yebS,3832238,3832516,3832238,278,28,utRho02
1910,yebV,3843430,3843560,3843430,130,0,utRho02
1911,yebW,3843914,3844242,3843914,328,1570,utRho02
1912,yecC,3995646,3995646,3995628,18,0,utRho02
1913,yecD,3901272,3901664,3901272,392,0,utRho02
1914,yecF,3991434,3991636,3991434,202,290,utRho02
1915,yecH,3979304,3979304,3978980,324,2,utRho02
1916,yecJ,3975604,3975604,3975516,88,0,utRho02
1917,yecM,3919968,3919968,3919692,276,68,utRho02
1918,yecR,3976400,3976444,3976400,44,20,utRho02
1919,yecT,3923862,3923944,3923862,82,268,utRho02
1920,yedD,4016522,4016522,4016180,342,126,utRho02
1921,yedE,4016310,4016554,4016310,244,146,utRho02
1922,yedI,4058922,4058922,4058732,190,76,utRho02
1923,yedJ,4066446,4066446,4066158,288,30,utRho02
1924,yedV,4076404,4076404,4076304,100,96,utRho02
1925,yedX,4077680,4077912,4077680,232,0,utRho02
1926,yedY,4078572,4078956,4078572,384,0,utRho02
1927,yeeA,4161322,4161322,4161182,140,136,utRho02
1928,yeeE,4171104,4171104,4171050,54,0,utRho02
1929,yeeJ,4089526,4089822,4089526,296,606,utRho02
1930,yeeN,4113508,4113716,4113508,208,34,utRho02
1931,yeeO,4119444,4119444,4119692,248,0,utRho02
1932,yeeX,4158834,4158834,4158722,112,340,utRho02
1933,yeeZ,4178422,4178422,4178256,166,0,utRho02
1934,yefM,4179466,4179466,4179426,40,0,utRho02
1935,yegD,4295288,4295348,4295288,60,122,utRho02
1936,yegH,4275726,4275804,4275726,78,68,utRho02
1937,yegI,4302154,4302154,4301970,184,0,utRho02
1938,yegJ,4302032,4302370,4302032,338,0,utRho02
1939,yegQ,4331182,4331336,4331182,154,0,utRho02
1940,yegR,4336698,4336698,4336612,86,0,utRho02
1941,yegS,4337086,4337424,4337086,338,0,utRho02
1942,yegT,4357562,4357642,4357562,80,36,utRho02
1943,yegX,4367640,4367640,4367302,338,58,utRho02
1944,yehA,4376944,4376944,4376828,116,0,utRho02
1945,yehE,4385818,4385818,4385592,226,0,utRho02
1946,yehK,4407568,4407944,4407568,376,84,utRho02
1947,yehL,4408804,4409192,4408804,388,0,utRho02
1948,yeiB,4486146,4486146,4485934,212,124,utRho02
1949,yeiE,4499422,4499422,4499236,186,0,utRho02
1950,yeiG,4487776,4487820,4487776,44,412,utRho02
1951,yeiH,4499332,4499434,4499332,102,44,utRho02
1952,yeiI,4503306,4503400,4503306,94,62,utRho02
1953,yeiL,4510580,4510710,4510580,130,0,utRho02
1954,yeiP,4530834,4530900,4530834,66,734,utRho02
1955,yeiQ,4532328,4532490,4532328,162,40,utRho02
1956,yeiR,4535484,4535658,4535484,174,50,utRho02
1957,yeiW,4530840,4530840,4530590,250,1066,utRho02
1958,yejA,4544624,4544728,4544624,104,2,utRho02
1959,yejG,4556892,4556892,4556474,418,5646,utRho02
1960,yejH,4561244,4561264,4561244,20,0,utRho02
1961,yejK,4568218,4568218,4567894,324,116,utRho02
1962,yejO,4578352,4578352,4577800,552,336,utRho02
1963,yfaD,4713380,4713808,4713380,428,258,utRho02
1964,yfaE,4696676,4697028,4696676,352,3694,utRho02
1965,yfaL,4688568,4688568,4688338,230,0,utRho02
1966,yfaP,4656398,4656398,4656286,112,12,utRho02
1967,yfaU,4717892,4717892,4717690,202,0,utRho02
1968,yfaY,4727310,4727310,4727266,44,0,utRho02
1969,yfaZ,4728744,4728744,4728550,194,0,utRho02
1970,yfbK,4771810,4771810,4771444,366,0,utRho02
1971,yfbL,4771500,4771720,4771500,220,0,utRho02
1972,yfbN,4777174,4777174,4776852,322,0,utRho02
1973,yfbO,4776916,4777162,4776916,246,0,utRho02
1974,yfbP,4777990,4778232,4777990,242,916,utRho02
1975,yfbR,4817662,4817724,4817662,62,56,utRho02
1976,yfcI,4847424,4847424,4847078,346,12,utRho02
1977,yfcJ,4880482,4880482,4880240,242,252,utRho02
1978,yfcL,4888502,4888502,4888338,164,50,utRho02
1979,yfcV,4911642,4911642,4911292,350,0,utRho02
1980,yfcZ,4921958,4921958,4921868,90,86,utRho02
1981,yfdF,4925604,4926024,4925604,420,578,utRho02
1982,yfdG,4935474,4935710,4935474,236,98,utRho02
1983,yfdP,4946844,4947040,4946844,196,0,utRho02
1984,yfdX,4988866,4988866,4988804,62,0,utRho02
1985,yfdY,4990672,4990672,4990584,88,0,utRho02
1986,yfeA,5035784,5035784,5035664,120,53058,utRho02
1987,yfeC,5036668,5036934,5036668,266,234,utRho02
1988,yfeH,5053818,5053892,5053818,74,10,utRho02
1989,yfeK,5074630,5074684,5074630,54,0,utRho02
1990,yfeO,5018906,5019260,5018906,354,328,utRho02
1991,yfeR,5054078,5054078,5053712,366,56,utRho02
1992,yfeX,5101356,5101356,5101090,266,0,utRho02
1993,yfeY,5102486,5102486,5102432,54,0,utRho02
1994,yfeZ,5103842,5103842,5103452,390,62,utRho02
1995,yffO,5123804,5124222,5123804,418,0,utRho02
1996,yffQ,5126778,5127154,5126778,376,0,utRho02
1997,yffS,5128800,5128986,5128800,186,132,utRho02
1998,yfgC,5232052,5232188,5232052,136,4,utRho02
1999,yfgF,5258062,5258062,5257876,186,4,utRho02
2000,yfgG,5258170,5258580,5258170,410,448,utRho02
2001,yfgH,5259344,5259584,5259344,240,80,utRho02
2002,yfgM,5278866,5278866,5278566,300,686,utRho02
2003,yfhH,5397414,5397518,5397414,104,68,utRho02
2004,yfhM,5304648,5304648,5304574,74,18,utRho02
2005,yfhR,5328408,5328726,5328408,318,7032,utRho02
2006,yfiC,5425610,5425610,5425528,82,0,utRho02
2007,yfiE,5430688,5430688,5430640,48,0,utRho02
2008,yfiL,5482630,5482720,5482630,90,0,utRho02
2009,yfiM,5448066,5448358,5448066,292,23930,utRho02
2010,yfiR,5483354,5483750,5483354,396,626,utRho02
2011,yfjH,5517326,5517326,5517200,126,0,utRho02
2012,yfjI,5517710,5517970,5517710,260,0,utRho02
2013,yfjJ,5521014,5521094,5521014,80,0,utRho02
2014,yfjM,5531970,5531970,5531552,418,1202,utRho02
2015,yfjP,5535080,5535420,5535080,340,148,utRho02
2016,yfjW,5546570,5546636,5546570,66,0,utRho02
2017,yfjX,5551776,5551838,5551776,62,0,utRho02
2018,ygaC,5601180,5601180,5599988,1192,1456,utRho02
2019,ygaM,5600242,5600292,5600242,50,322,utRho02
2020,ygaU,5593628,5593628,5593572,56,60,utRho02
2021,ygaZ,5619190,5619234,5619190,44,1630,utRho02
2022,ygbA,5713656,5713656,5713612,44,0,utRho02
2023,ygbE,5746784,5746784,5746674,110,222,utRho02
2024,ygbI,5722882,5722882,5722528,354,44,utRho02
2025,ygbK,5724394,5724670,5724394,276,16,utRho02
2026,ygbL,5727074,5727186,5727074,112,0,utRho02
2027,ygbN,5729814,5730202,5729814,388,150,utRho02
2028,ygcG,5811210,5811422,5811210,212,40,utRho02
2029,ygcN,5785144,5785314,5785144,170,310,utRho02
2030,ygcU,5799214,5799214,5798836,378,40,utRho02
2031,ygcW,5800942,5800942,5800546,396,0,utRho02
2032,ygdD,5883442,5883442,5883262,180,122,utRho02
2033,ygdG,5861746,5861930,5861746,184,736,utRho02
2034,ygdI,5886526,5886526,5886290,236,228,utRho02
2035,ygdQ,5940784,5940840,5940784,56,0,utRho02
2036,ygdR,5942494,5942542,5942494,48,156,utRho02
2037,ygeA,5961606,5961606,5961270,336,0,utRho02
2038,ygeH,5983758,5984188,5983758,430,0,utRho02
2039,ygeI,5987162,5987276,5987162,114,2,utRho02
2040,ygeR,6000078,6000078,5999782,296,486,utRho02
2041,ygeV,6011694,6011694,6011572,122,0,utRho02
2042,ygeW,6012234,6012524,6012234,290,0,utRho02
2043,ygfB,6110946,6110946,6110888,58,26,utRho02
2044,ygfK,6031984,6032120,6031984,136,0,utRho02
2045,ygfS,6058328,6058328,6058024,304,12,utRho02
2046,ygfZ,6082564,6082626,6082564,62,100,utRho02
2047,yggC,6149512,6149512,6149378,134,188,utRho02
2048,yggE,6136370,6136370,6136160,210,34,utRho02
2049,yggI,6179176,6179510,6179176,334,164,utRho02
2050,yggL,6204508,6204508,6204266,242,64,utRho02
2051,yggM,6199514,6199514,6199130,384,314,utRho02
2052,yggN,6203596,6203596,6203246,350,0,utRho02
2053,yggX,18623958,18624558,18623958,600,1332,utRho02
2054,yghA,6298966,6299324,6298966,358,22,utRho02
2055,yghB,6307058,6307126,6307058,68,0,utRho02
2056,yghD,6222614,6222614,6222252,362,202,utRho02
2057,yghF,6225798,6225798,6225840,42,0,utRho02
2058,yghJ,6238640,6238640,6238224,416,0,utRho02
2059,yghQ,6265186,6265186,6264816,370,76,utRho02
2060,yghT,6267830,6268262,6267830,432,0,utRho02
2061,yghU,6277400,6277454,6277400,54,90,utRho02
2062,yghW,6293506,6293506,6293474,32,16,utRho02
2063,yghZ,6295562,6295794,6295562,232,0,utRho02
2064,ygiD,6365122,6365122,6364868,254,258,utRho02
2065,ygiH,6409066,6409388,6409066,322,0,utRho02
2066,ygiL,6370622,6370828,6370622,206,66,utRho02
2067,ygiM,6402084,6402414,6402084,330,240,utRho02
2068,ygiN,6346156,6346284,6346156,128,870,utRho02
2069,ygiQ,6322620,6322620,6322292,328,1128,utRho02
2070,ygiS,6335462,6335462,6335436,26,0,utRho02
2071,ygiV,6338582,6338582,6338462,120,40,utRho02
2072,ygiW,6339774,6339774,6339352,422,78,utRho02
2073,ygiZ,6344506,6344506,6344422,84,26,utRho02
2074,ygjH,6442528,6442528,6442494,34,0,utRho02
2075,ygjI,6452140,6452468,6452140,328,0,utRho02
2076,ygjQ,6472730,6473080,6472730,350,304,utRho02
2077,ygjR,6474564,6474586,6474564,22,36,utRho02
2078,ygjV,6483638,6483638,6483488,150,90,utRho02
2079,yhaB,6535632,6535708,6535632,76,0,utRho02
2080,yhaH,6504498,6504608,6504498,110,2,utRho02
2081,yhaI,6505400,6505822,6505400,422,60,utRho02
2082,yhaJ,6508560,6508560,6508428,132,70,utRho02
2083,yhaK,6508538,6508638,6508538,100,58,utRho02
2084,yhbQ,6599878,6599932,6599878,54,58,utRho02
2085,yhbT,6602736,6602736,6602552,184,0,utRho02
2086,yhbU,6602558,6602970,6602558,412,0,utRho02
2087,yhbX,6643302,6643302,6643226,76,0,utRho02
2088,yhbY,6655518,6655580,6655518,62,2410,utRho02
2089,yhcA,6723956,6724224,6723956,268,0,utRho02
2090,yhcB,6760364,6760382,6760364,18,120,utRho02
2091,yhcC,6708470,6708470,6708100,370,584,utRho02
2092,yhcF,6733440,6733852,6733440,412,86,utRho02
2093,yhcH,6739124,6739124,6738956,168,28,utRho02
2094,yhcM,6760312,6760312,6759994,318,118,utRho02
2095,yhcN,6770812,6771076,6770812,264,976,utRho02
2096,yhcO,6772606,6772606,6772258,348,0,utRho02
2097,yhdH,6806560,6806968,6806560,408,330,utRho02
2098,yhdJ,6823234,6823306,6823234,72,0,utRho02
2099,yhdN,6879092,6879092,6879018,74,3572,utRho02
2100,yhdT,6814702,6814750,6814702,48,364,utRho02
2101,yhdU,6824994,6825242,6824994,248,132,utRho02
2102,yhdV,6836392,6836780,6836392,388,0,utRho02
2103,yhdW,6837944,6838298,6837944,354,0,utRho02
2104,yheO,6953082,6953082,6952880,202,1576,utRho02
2105,yheV,6957970,6957970,6957584,386,76,utRho02
2106,yhfA,6971902,6971902,6971636,266,20,utRho02
2107,yhfG,6983294,6983294,6983240,54,280,utRho02
2108,yhfL,6998622,6998896,6998622,274,18,utRho02
2109,yhfY,7023244,7023244,7022844,400,82,utRho02
2110,yhgA,7086294,7086334,7086294,40,0,utRho02
2111,yhgE,7065176,7065176,7064878,298,126,utRho02
2112,yhgF,7074352,7074770,7074352,418,2688,utRho02
2113,yhhA,7173458,7173886,7173458,428,78,utRho02
2114,yhhI,7248346,7248756,7248346,410,0,utRho02
2115,yhhJ,7253696,7253696,7253606,90,30,utRho02
2116,yhhM,7211588,7211588,7211220,368,512,utRho02
2117,yhhN,7211150,7211502,7211150,352,516,utRho02
2118,yhhQ,7218238,7218434,7218238,196,854,utRho02
2119,yhhT,7223682,7223730,7223682,48,2,utRho02
2120,yhhX,7162032,7162032,7161610,422,1808,utRho02
2121,yhhY,7162222,7162276,7162222,54,74,utRho02
2122,yhhZ,7163516,7163726,7163516,210,0,utRho02
2123,yhiD,7312220,7312220,7311804,416,2682,utRho02
2124,yhiJ,7265190,7265190,7265180,10,0,utRho02
2125,yhiM,7269270,7269682,7269270,412,240,utRho02
2126,yhiN,7275000,7275000,7274820,180,144,utRho02
2127,yhjA,7338522,7338522,7338376,146,0,utRho02
2128,yhjB,7344090,7344090,7343788,302,106,utRho02
2129,yhjC,7344272,7344684,7344272,412,0,utRho02
2130,yhjD,7346660,7346724,7346660,64,0,utRho02
2131,yhjE,7349274,7349572,7349274,298,214,utRho02
2132,yhjG,7356824,7356824,7356730,94,0,utRho02
2133,yhjH,7358458,7358458,7358374,84,70,utRho02
2134,yhjJ,7364032,7364032,7363880,152,134,utRho02
2135,yhjK,7371296,7371296,7371158,138,108,utRho02
2136,yhjR,7392750,7392750,7392370,380,136,utRho02
2137,yhjV,7400796,7401126,7400796,330,1454,utRho02
2138,yhjX,7424194,7424194,7424014,180,0,utRho02
2139,yhjY,7425966,7425966,7425868,98,0,utRho02
2140,yiaB,7455654,7455654,7455496,158,0,utRho02
2141,yiaD,7432712,7433094,7432712,382,156,utRho02
2142,yiaF,7438194,7438194,7438088,106,40,utRho02
2143,yiaG,7438862,7438956,7438862,94,160,utRho02
2144,yiaJ,7485236,7485236,7485064,172,0,utRho02
2145,yiaK,7485348,7485466,7485348,118,0,utRho02
2146,yiaT,7503924,7503924,7503736,188,0,utRho02
2147,yiaU,7503792,7503984,7503792,192,0,utRho02
2148,yiaY,7515856,7515856,7515654,202,102,utRho02
2149,yibF,7523950,7523950,7523910,40,4,utRho02
2150,yibG,7536128,7536354,7536128,226,0,utRho02
2151,yibL,7553194,7553330,7553194,136,130,utRho02
2152,yibN,7570112,7570112,7570030,82,230,utRho02
2153,yibT,7552848,7552848,7552760,88,164,utRho02
2154,yicC,7633290,7633352,7633290,62,76,utRho02
2155,yicH,7660862,7660914,7660862,52,20,utRho02
2156,yicJ,7673328,7673328,7671858,1470,1010,utRho02
2157,yicN,7685018,7685018,7684804,214,0,utRho02
2158,yicO,7687914,7687914,7687578,336,0,utRho02
2159,yicR,15250308,15250308,15250236,72,0,utRho02
2160,yidB,7755230,7755230,7754930,300,2,utRho02
2161,yidE,7732780,7732780,7732546,234,0,utRho02
2162,yidF,7711580,7711580,7711222,358,388,utRho02
2163,yidQ,7735088,7735456,7735088,368,550,utRho02
2164,yidR,7738824,7738824,7738618,206,0,utRho02
2165,yieE,7787658,7787738,7787658,80,298,utRho02
2166,yieH,7793314,7793548,7793314,234,0,utRho02
2167,yieK,7798928,7798928,7798786,142,0,utRho02
2168,yifB,7900350,7900350,7899998,352,440,utRho02
2169,yifL,7988984,7989044,7988984,60,532,utRho02
2170,yigF,8005750,8005750,8005598,152,52,utRho02
2171,yigI,8009448,8009448,8009394,54,0,utRho02
2172,yigM,8022100,8022152,8022100,52,104,utRho02
2173,yihA,8101970,8101970,8101458,512,72,utRho02
2174,yihD,8084098,8084138,8084098,40,100,utRho02
2175,yihF,8088110,8088398,8088110,288,0,utRho02
2176,yihG,8093304,8093304,8093204,100,0,utRho02
2177,yihI,8102616,8102694,8102616,78,24,utRho02
2178,yihL,8120506,8120894,8120506,388,0,utRho02
2179,yihN,8124332,8124494,8124332,162,4,utRho02
2180,yihO,8131942,8131942,8131532,410,48,utRho02
2181,yihQ,8138892,8138892,8138552,340,0,utRho02
2182,yihV,8147064,8147478,8147064,414,48,utRho02
2183,yihX,8151096,8151106,8151096,10,8,utRho02
2184,yiiE,8158192,8158582,8158192,390,36,utRho02
2185,yiiF,8159124,8159502,8159124,378,116,utRho02
2186,yiiG,8173762,8174004,8173762,242,0,utRho02
2187,yiiM,8205506,8205644,8205506,138,22,utRho02
2188,yiiQ,8224624,8224624,8224428,196,0,utRho02
2189,yiiS,8225738,8225934,8225738,196,64,utRho02
2190,yijE,8272178,8272216,8272178,38,0,utRho02
2191,yijF,8275728,8275728,8275314,414,80,utRho02
2192,yijO,8296858,8296858,8296634,224,4,utRho02
2193,yjaA,8426240,8426468,8426240,228,99432,utRho02
2194,yjaB,8428312,8428312,8428246,66,986,utRho02
2195,yjaG,8398746,8399008,8398746,262,1954,utRho02
2196,yjaH,8401022,8401132,8401022,110,264,utRho02
2197,yjaZ,8379506,8379572,8379506,66,30,utRho02
2198,yjbB,8455204,8455462,8455204,258,0,utRho02
2199,yjbE,16943432,16943624,16943432,192,76,utRho02
2200,yjbL,8520318,8520642,8520318,324,0,utRho02
2201,yjbQ,8540428,8540476,8540428,48,74,utRho02
2202,yjcB,8550328,8550328,8550082,246,9026,utRho02
2203,yjcC,8550836,8550942,8550836,106,266,utRho02
2204,yjcD,8556628,8556958,8556628,330,52,utRho02
2205,yjcE,8559658,8559960,8559658,302,0,utRho02
2206,yjcF,8566212,8566212,8566150,62,0,utRho02
2207,yjcO,8594660,8594660,8594250,410,56,utRho02
2208,yjdA,8654128,8654270,8654128,142,0,utRho02
2209,yjdC,8726660,8726660,8726616,44,68,utRho02
2210,yjdK,8704780,8705168,8704780,388,104,utRho02
2211,yjdL,8713034,8713034,8712822,212,18,utRho02
2212,yjdM,8653672,8653672,8653468,204,58,utRho02
2213,yjeF,8787354,8788132,8787354,778,10740,utRho02
2214,yjeI,8745522,8745618,8745522,96,0,utRho02
2215,yjeJ,8748806,8748806,8748468,338,36,utRho02
2216,yjeV,8785472,8785784,8785472,312,782,utRho02
2217,yjfP,8833512,8833904,8833512,392,0,utRho02
2218,yjfY,8849656,8849656,8849582,74,0,utRho02
2219,yjfZ,8855052,8855052,8854844,208,64,utRho02
2220,yjgA,8916162,8916162,8915730,432,296,utRho02
2221,yjgL,8950802,8950874,8950802,72,0,utRho02
2222,yjgM,8959342,8959342,8959074,268,0,utRho02
2223,yjgN,8959132,8959460,8959132,328,0,utRho02
2224,yjgR,8980170,8980170,8980126,44,136,utRho02
2225,yjgZ,9002116,9002520,9002116,404,838,utRho02
2226,yjhB,9007764,9008116,9007764,352,84,utRho02
2227,yjhG,9048452,9048452,9048188,264,860,utRho02
2228,yjhU,9041080,9041080,9040648,432,312,utRho02
2229,yjiA,9178096,9178096,9177730,366,468,utRho02
2230,yjiJ,9125364,9125364,9125350,14,0,utRho02
2231,yjiK,9127270,9127270,9127422,152,70,utRho02
2232,yjiL,9129604,9129604,9129378,226,0,utRho02
2233,yjiS,9143410,9143502,9143410,92,0,utRho02
2234,yjiY,9182734,9182734,9182558,176,30,utRho02
2235,yjjA,9200674,9200674,9200378,296,734,utRho02
2236,yjjB,18408708,18408708,18407800,908,40,utRho02
2237,yjjJ,9243314,9243538,9243314,224,48,utRho02
2238,yjjK,9261132,9261132,9261044,88,60,utRho02
2239,yjjL,9189764,9189764,9189444,320,0,utRho02
2240,yjjM,9191894,9191894,9191702,192,0,utRho02
2241,yjjP,9206068,9206068,9205716,352,52,utRho02
2242,yjjQ,9206638,9206954,9206638,316,212,utRho02
2243,yjjX,9267798,9267798,9267490,308,628,utRho02
2244,yjjY,9280716,9280804,9280716,88,794,utRho02
2245,yjjZ,9211554,9211608,9211554,54,2008,utRho02
2246,yjtD,9281676,9281884,9281676,208,0,utRho02
2247,ykfB,532454,532454,532174,280,232,utRho02
2248,ykfI,527636,527636,527338,298,2,utRho02
2249,ykgB,637050,637050,636638,412,0,utRho02
2250,ykgC,640430,640430,640002,428,0,utRho02
2251,ykgD,640232,640454,640232,222,0,utRho02
2252,ykgE,642962,643216,642962,254,4,utRho02
2253,ykgJ,608524,608524,608364,160,12,utRho02
2254,ykgL,623878,624224,623878,346,28,utRho02
2255,ykgM,625610,625610,625554,56,0,utRho02
2256,ykgR,626570,626570,626484,86,0,utRho02
2257,ylaC,958576,958576,958502,74,1166,utRho02
2258,yliE,1745938,1745958,1745938,20,0,utRho02
2259,ymcE,2103660,2103694,2103660,34,714,utRho02
2260,ymdA,2210450,2210828,2210450,378,48,utRho02
2261,ymdB,2211428,2211640,2211428,212,108,utRho02
2262,ymfD,2395322,2395322,2395064,258,138,utRho02
2263,ymfI,2402880,2402994,2402880,114,0,utRho02
2264,ymfJ,2404518,2404518,2404168,350,84,utRho02
2265,ymfK,2406176,2406176,2405866,310,188,utRho02
2266,ymfT,2405766,2406048,2405766,282,224,utRho02
2267,ymgE,2489110,2489456,2489110,346,32,utRho02
2268,ymgF,2437628,2437966,2437628,338,0,utRho02
2269,ymiA,2670112,2670320,2670112,208,308,utRho02
2270,ymjA,2715620,2715620,2715336,284,450,utRho02
2271,ynaI,2791946,2791946,2791844,102,0,utRho02
2272,ynaK,2850438,2850754,2850438,316,128,utRho02
2273,ynbA,2954924,2955242,2954924,318,0,utRho02
2274,yncD,3046552,3046552,3046130,422,184,utRho02
2275,yncE,3046454,3046614,3046454,160,0,utRho02
2276,yncG,3052456,3052494,3052456,38,0,utRho02
2277,yncL,3034492,3034492,3034388,104,178,utRho02
2278,yneE,3218364,3218364,3218044,320,0,utRho02
2279,yneF,3223748,3223748,3223708,40,0,utRho02
2280,yneJ,3229560,3229608,3229560,48,62,utRho02
2281,yneK,3231100,3231526,3231100,426,0,utRho02
2282,yneM,3245176,3245292,3245176,116,178,utRho02
2283,ynfA,3311398,3311398,3311346,52,0,utRho02
2284,ynfB,3311418,3311616,3311418,198,156,utRho02
2285,ynfC,3315094,3315094,3314914,180,0,utRho02
2286,ynfD,3314828,3315130,3314828,302,0,utRho02
2287,ynfE,3316006,3316138,3316006,132,0,utRho02
2288,ynfK,3334670,3334670,3334438,232,132,utRho02
2289,ynfL,3339304,3339304,3339184,120,0,utRho02
2290,ynfM,3339260,3339398,3339260,138,46,utRho02
2291,ynfN,3276598,3276598,3276218,380,2268,utRho02
2292,ynfO,3273454,3273512,3273454,58,0,utRho02
2293,ynhG,3517890,3517890,3517450,440,774,utRho02
2294,yniA,3615158,3615592,3615158,434,0,utRho02
2295,yniB,3618526,3618526,3618466,60,90,utRho02
2296,yniC,3618652,3618760,3618652,108,0,utRho02
2297,yniD,3610202,3610330,3610202,128,0,utRho02
2298,ynjE,3678880,3678934,3678880,54,0,utRho02
2299,ynjF,3683222,3683222,3682806,416,126,utRho02
2300,ynjH,3684376,3684376,3684270,106,0,utRho02
2301,ynjI,3690022,3690022,3689742,280,44,utRho02
2302,yoaB,3786642,3786734,3786642,92,76,utRho02
2303,yoaC,3787932,3788146,3787932,214,336,utRho02
2304,yoaE,3803544,3803544,3803170,374,308,utRho02
2305,yoaF,3755444,3755444,3755064,380,822,utRho02
2306,yoaH,3789866,3789866,3789462,404,302,utRho02
2307,yobB,3850418,3850880,3850418,462,844,utRho02
2308,yobF,3815586,3815586,3815182,404,192,utRho02
2309,yobH,3817800,3817850,3817800,50,304,utRho02
2310,yodB,4084352,4084736,4084352,384,0,utRho02
2311,yodC,4057008,4057008,4056740,268,24,utRho02
2312,yohC,4451358,4451358,4451262,96,0,utRho02
2313,yohD,4451526,4451602,4451526,76,72,utRho02
2314,yohJ,4460986,4461248,4460986,262,36,utRho02
2315,yohO,4431172,4431314,4431172,142,0,utRho02
2316,yojI,4617282,4617282,4617230,52,0,utRho02
2317,ypdI,4988988,4989396,4988988,408,58,utRho02
2318,ypfG,5165786,5165786,5165554,232,136,utRho02
2319,ypfM,5182140,5182140,5181732,408,16,utRho02
2320,yphB,5349590,5349590,5349376,214,76,utRho02
2321,ypjA,5565644,5565644,5565452,192,30,utRho02
2322,ypjB,5569636,5569636,5568858,778,0,utRho02
2323,ypjD,5495860,5495774,5495860,86,0,utRho02
2324,yqaE,5594170,5594170,5594056,114,124,utRho02
2325,yqcA,5846100,5846100,5845968,132,116,utRho02
2326,yqcE,5800944,5801184,5800944,240,0,utRho02
2327,yqeC,6030468,6030468,6030114,354,92,utRho02
2328,yqeF,5971618,5971618,5971184,434,70,utRho02
2329,yqeG,5971438,5971694,5971438,256,110,utRho02
2330,yqeH,5975016,5975072,5975016,56,2,utRho02
2331,yqeI,5976688,5977004,5976688,316,0,utRho02
2332,yqeK,5981140,5981140,5980720,420,0,utRho02
2333,yqfA,6086728,6086728,6086296,432,240,utRho02
2334,yqgA,6219042,6219106,6219042,64,0,utRho02
2335,yqgB,6172500,6172500,6172102,398,2272,utRho02
2336,yqgE,6185768,6185874,6185768,106,556,utRho02
2337,yqhA,6299150,6299150,6298942,208,18,utRho02
2338,yqhC,6310768,6310768,6310436,332,96,utRho02
2339,yqhD,6310604,6310710,6310604,106,96,utRho02
2340,yqhH,6316842,6317254,6316842,412,402,utRho02
2341,yqiC,6369662,6369680,6369662,18,52,utRho02
2342,yqiJ,6384108,6384416,6384108,308,500,utRho02
2343,yqjA,6495096,6495546,6495096,450,12204,utRho02
2344,yqjF,6500932,6501124,6500932,192,84,utRho02
2345,yqjG,6501948,6502048,6501948,100,0,utRho02
2346,yqjH,6433078,6433078,6432982,96,0,utRho02
2347,yqjI,6433506,6433558,6433506,52,0,utRho02
2348,yraH,6574552,6574852,6574552,300,4,utRho02
2349,yraP,6592144,6592818,6592144,674,282,utRho02
2350,yraQ,6596414,6596414,6596276,138,0,utRho02
2351,yraR,6598024,6598024,6597692,332,12,utRho02
2352,yrbG,13360844,13361100,13360844,256,96,utRho02
2353,yrbL,6696842,6696904,6696842,62,694,utRho02
2354,yrbN,6616172,6616172,6615866,306,23192,utRho02
2355,yrdB,6860176,6860176,6860046,130,234,utRho02
2356,yrfF,7052548,7052938,7052548,390,240,utRho02
2357,yrhB,7169440,7169518,7169440,78,0,utRho02
2358,ysaB,7451804,7451804,7451424,380,0,utRho02
2359,ysgA,8032686,8032686,8032338,348,202,utRho02
2360,ytfB,8857638,8857638,8857434,204,152,utRho02
2361,ytfE,8864018,8864018,8863966,52,0,utRho02
2362,ytfF,8866296,8866296,8866130,166,16,utRho02
2363,ytfH,8868164,8868226,8868164,62,0,utRho02
2364,ytfI,8875234,8875414,8875234,180,0,utRho02
2365,ytfJ,8878572,8878572,8878524,48,0,utRho02
2366,ytfK,8879022,8879174,8879022,152,126,utRho02
2367,ytfL,8882642,8882642,8882430,212,70,utRho02
2368,ytfQ,8899634,8899924,8899634,290,312,utRho02
2369,ytjB,9249598,9249598,9249578,20,2,utRho02
2370,yzfA,8896588,8896588,8896490,98,38,utRho02
2371,zapA,6111102,6111224,6111102,122,8170,utRho02
2372,zapB,8236772,8237030,8236772,258,494,utRho02
2373,zapC,2011700,2011904,2011700,204,156,utRho02
2374,zinT,4082692,4082750,4082692,58,0,utRho02
2375,zipA,5062814,5062814,5062466,348,72,utRho02
2376,zitB,1569716,1569716,1569646,70,0,utRho02
2377,zntA,7212844,7212902,7212844,58,30,utRho02
2378,zntR,6878336,6878336,6878260,76,0,utRho02
2379,znuA,3885322,3885322,3885166,156,0,utRho02
2380,znuC,3885268,3885324,3885268,56,0,utRho02
2381,zraP,8403424,8403424,8403376,48,68,utRho02
2382,zraS,8403810,8403852,8403810,42,0,utRho02
2383,zupT,6364866,6365100,6364866,234,258,utRho02
2384,zur,8520282,8520282,8520006,276,1242,utRho02
2385,zwf,3872752,3872752,3872628,124,38,utRho02
0,C0343,2818676,2818728,2818676,52,0,utRho03
1,aaeB,6776526,6776526,6776376,150,0,utRho03
2,aaeR,6778762,6779040,6778762,278,164,utRho03
3,aaeX,6778860,6778860,6778674,186,134,utRho03
4,aat,1854920,1854920,1854864,56,16,utRho03
5,accA,416822,417242,416822,420,2004,utRho03
6,accB,6810280,6810872,6810280,592,8436,utRho03
7,accD,4868030,4868030,4867852,178,788,utRho03
8,aceB,8430804,8430956,8430804,152,42,utRho03
9,aceE,245938,246034,245938,96,444,utRho03
10,ackA,4826918,4826940,4826918,22,1902,utRho03
11,acnA,2670848,2671662,2670848,814,596,utRho03
12,acnB,263038,263230,263038,192,740,utRho03
13,acpP,2303148,2303230,2303148,82,186,utRho03
14,acpS,5402324,5402324,5401996,328,238,utRho03
15,acrA,971396,971396,971238,158,242,utRho03
16,acrB,969370,969370,968806,564,2280,utRho03
17,acrD,5174950,5175190,5174950,240,8,utRho03
18,acrE,6827404,6827728,6827404,324,14,utRho03
19,acrR,971398,971522,971398,124,242,utRho03
20,acrZ,1589502,1589546,1589502,44,0,utRho03
21,acs,8575190,8575190,8574742,448,102,utRho03
22,actP,8569870,8569870,8569804,66,0,utRho03
23,ada,4620854,4620854,4620810,44,0,utRho03
24,add,3404404,3404466,3404404,62,60,utRho03
25,ade,7687802,7687928,7687802,126,18,utRho03
26,adhE,2596826,2596826,2596242,584,10,utRho03
27,adhP,3107988,3107988,3107676,312,558,utRho03
28,adiA,8681112,8681112,8681042,70,60,utRho03
29,adiC,8674404,8674404,8674062,342,0,utRho03
30,adiY,8676084,8676084,8675858,226,0,utRho03
31,adk,994278,994350,994278,72,104,utRho03
32,adrA,807374,807406,807374,32,0,utRho03
33,aer,6438240,6438240,6438152,88,20,utRho03
34,aes,1000102,1000102,999946,156,76,utRho03
35,agaR,6557406,6557406,6557330,76,0,utRho03
36,agaS,6563778,6563952,6563778,174,0,utRho03
37,agp,2131118,2131170,2131118,52,0,utRho03
38,agrA,7296126,7296126,7296126,0,0,utRho03
39,agrB,7296588,7296588,7296588,0,0,utRho03
40,ahpC,1277386,1277890,1277386,504,818,utRho03
41,ahpF,1278004,1279506,1278004,1502,43410,utRho03
42,ahr,8992698,8992698,8992418,280,8,utRho03
43,aidB,8828494,8828550,8828494,56,0,utRho03
44,ais,4731512,4731512,4731240,272,12,utRho03
45,alaA,4814816,4815122,4814816,306,10,utRho03
46,alaC,4996798,4996798,4996590,208,0,utRho03
47,alaE,5598140,5598328,5598140,188,78,utRho03
48,alaS,5644180,5644180,5644022,158,1514,utRho03
49,alaW,5036612,5036612,5036462,150,0,utRho03
50,aldA,2976380,2976464,2976380,84,134,utRho03
51,aldB,7513070,7513070,7513022,48,0,utRho03
52,alkA,4295118,4295118,4295080,38,84,utRho03
53,alkB,4618890,4618890,4618682,208,34,utRho03
54,allA,1064780,1064902,1064780,122,0,utRho03
55,allD,1092822,1092822,1092726,96,0,utRho03
56,allE,1088112,1088112,1088092,20,102,utRho03
57,allS,1064600,1064600,1064442,158,0,utRho03
58,alr,8531178,8531564,8531178,386,3198,utRho03
59,alsE,8617334,8617334,8616956,378,36,utRho03
60,alsK,8615990,8615990,8615598,392,46,utRho03
61,alx,6476740,6477160,6476740,420,0,utRho03
62,amiA,5104482,5104704,5104482,222,4,utRho03
63,amiC,5898378,5898378,5898020,358,22,utRho03
64,amn,4110062,4110122,4110062,60,0,utRho03
65,ampC,8758006,8758006,8757888,118,0,utRho03
66,ampD,237362,237466,237362,104,128,utRho03
67,ampG,907372,907372,907090,282,768,utRho03
68,ampH,792726,792726,792574,152,4,utRho03
69,amyA,4012230,4012312,4012230,82,18,utRho03
70,anmK,3439346,3439346,3439204,142,32,utRho03
71,ansB,6201580,6201580,6201456,124,24,utRho03
72,ansP,3052040,3052040,3051960,80,162,utRho03
73,apaG,104068,104068,103212,856,6052,utRho03
74,apaH,102586,102586,102444,142,5646,utRho03
75,apbE,4623188,4623188,4623068,120,30,utRho03
76,appA,2081198,2081234,2081198,36,0,utRho03
77,appC,2075420,2075480,2075420,60,0,utRho03
78,appY,1167134,1167362,1167134,228,0,utRho03
79,apt,982620,982824,982620,204,206,utRho03
80,aqpZ,1832424,1832424,1832094,330,8,utRho03
81,araB,140150,140150,140096,54,0,utRho03
82,araC,140482,140774,140482,292,4,utRho03
83,araE,5964416,5964416,5964364,52,0,utRho03
84,araF,3972476,3972476,3972256,220,0,utRho03
85,araH,3967120,3967120,3967086,34,12,utRho03
86,araJ,825058,825058,824962,96,24,utRho03
87,arcA,9281602,9281602,9280612,990,7026,utRho03
88,arcB,6706098,6706098,6706050,48,0,utRho03
89,arcZ,6701154,6701154,6701154,0,0,utRho03
90,arfA,6877346,6877346,6877298,48,374,utRho03
91,argA,5898312,5898484,5898312,172,28,utRho03
92,argC,8309770,8310002,8309770,232,104,utRho03
93,argD,6980442,6980442,6980360,82,48,utRho03
94,argE,8310156,8310156,8309694,462,116,utRho03
95,argF,580680,580680,580610,70,0,utRho03
96,argG,6637124,6637274,6637124,150,84,utRho03
97,argI,8956688,8956688,8956622,66,0,utRho03
98,argO,6137672,6137672,6137616,56,486,utRho03
99,argP,6119460,6119506,6119460,46,0,utRho03
100,argR,6769204,6769406,6769204,202,8,utRho03
101,argS,3920002,3920124,3920002,122,0,utRho03
102,argT,4855698,4855698,4855582,116,48,utRho03
103,argU,1129406,1129446,1129406,40,8,utRho03
104,argW,4932616,4932618,4932616,2,0,utRho03
105,argX,7964728,7964750,7964728,22,76,utRho03
106,aroF,5482402,5482402,5482300,102,10,utRho03
107,aroG,1571182,1571266,1571182,84,24,utRho03
108,aroH,3576636,3576870,3576636,234,424,utRho03
109,aroK,7038760,7038760,7038128,632,2166,utRho03
110,aroL,812560,812810,812560,250,102,utRho03
111,aroP,243342,243342,243102,240,0,utRho03
112,arpA,8445382,8445382,8444974,408,354,utRho03
113,arrS,7316108,7316108,7316108,0,0,utRho03
114,arsR,7297024,7297056,7297024,32,10,utRho03
115,artJ,1801252,1801252,1801150,102,0,utRho03
116,artP,1807686,1807686,1807468,218,10,utRho03
117,ascF,5678858,5679048,5678858,190,0,utRho03
118,ascG,5678574,5678574,5678528,46,0,utRho03
119,aslB,7965562,7965916,7965562,354,39644,utRho03
120,asnA,7854258,7854310,7854258,52,24,utRho03
121,asnB,1398444,1398444,1398354,90,926,utRho03
122,asnC,23562186,23562186,23562018,168,12,utRho03
123,asnS,1978088,1978088,1977970,118,10004,utRho03
124,asnT,4089082,4089098,4089082,16,30,utRho03
125,asnU,4119690,4119702,4119690,12,4,utRho03
126,asnV,4124504,4124520,4124504,16,4,utRho03
127,aspA,17473728,17473728,17473308,420,312,utRho03
128,aspC,1971486,1971486,1971418,68,166,utRho03
129,aspS,3901402,3901402,3901044,358,140,utRho03
130,aspT,7893560,7893744,7893560,184,49892,utRho03
131,aspV,473826,473862,473826,36,14,utRho03
132,asr,3342654,3342752,3342654,98,56,utRho03
133,astC,3664088,3664088,3663964,124,0,utRho03
134,astE,3654138,3654138,3653846,292,12,utRho03
135,atoD,4646824,4646894,4646824,70,32,utRho03
136,atpB,7844540,7844540,7844102,438,744,utRho03
137,atpC,7832118,7832118,7831944,174,1118,utRho03
138,atpI,7845050,7845050,7844880,170,48,utRho03
139,avtA,7479348,7479410,7479348,62,390,utRho03
140,azoR,2965982,2965982,2965720,262,254,utRho03
141,azuC,3976002,3976002,3975918,84,50,utRho03
142,bacA,6408350,6408350,6408262,88,36,utRho03
143,bamA,394052,395856,394052,1804,1286,utRho03
144,bamB,5277950,5277950,5277304,646,1834,utRho03
145,bamC,5198028,5198028,5197730,298,714,utRho03
146,bamD,5471922,5472292,5471922,370,6026,utRho03
147,bamE,5506972,5507210,5506972,238,436,utRho03
148,basS,8666954,8666954,8666544,410,352,utRho03
149,bax,7474468,7474468,7474354,114,82,utRho03
150,bcp,5200874,5200956,5200874,82,1106,utRho03
151,bcsB,7385346,7385346,7385214,132,0,utRho03
152,bcsE,7392644,7392916,7392644,272,56,utRho03
153,bdcA,8948128,8948128,8948106,22,130,utRho03
154,bdcR,8948192,8948248,8948192,56,22,utRho03
155,bdm,3112680,3112680,3112560,120,0,utRho03
156,betA,654522,654522,654494,28,386,utRho03
157,betI,658722,658722,658668,54,0,utRho03
158,betT,658842,658926,658842,84,8,utRho03
159,bfr,6933498,6933498,6933450,48,4,utRho03
160,bglG,23440182,23440182,23439402,780,0,utRho03
161,bglX,4444240,4444240,4443978,262,0,utRho03
162,bhsA,2337962,2338146,2337962,184,148,utRho03
163,bioA,1618584,1618584,1618514,70,0,utRho03
164,bioB,1618604,1618688,1618604,84,0,utRho03
165,bioH,7089716,7089716,7089688,28,4,utRho03
166,bisC,7433026,7433026,7432788,238,6,utRho03
167,blc,8755490,8755490,8755444,46,8,utRho03
168,blr,3409024,3409102,3409024,78,198,utRho03
169,bluF,2431226,2431226,2430950,276,2656,utRho03
170,bluR,2428226,2428226,2428118,108,12,utRho03
171,bolA,908698,908944,908698,246,0,utRho03
172,borD,1157842,1157842,1157786,56,42,utRho03
173,brnQ,838976,839182,838976,206,3110,utRho03
174,bssR,1756492,1756496,1756492,4,0,utRho03
175,bssS,2242116,2242116,2241910,206,290,utRho03
176,btuB,8326798,8327278,8326798,480,3380,utRho03
177,cadB,8720212,8720212,8720062,150,0,utRho03
178,cadC,8723926,8723926,8723868,58,0,utRho03
179,caiE,70998,70998,70742,256,20,utRho03
180,caiF,68436,68600,68436,164,2,utRho03
181,caiT,84074,84074,83862,212,0,utRho03
182,can,285406,285406,285340,66,84,utRho03
183,carA,59102,59302,59102,200,60,utRho03
184,carB,61550,61634,61550,84,30,utRho03
185,cas2,5757830,5757830,5757706,124,22,utRho03
186,casA,5768638,5768638,5768276,362,0,utRho03
187,cbl,4121882,4121882,4121828,54,18,utRho03
188,cbpA,2128074,2128074,2127550,524,100,utRho03
189,cbrA,7738628,7738754,7738628,126,0,utRho03
190,cbrB,7794958,7795012,7794958,54,42,utRho03
191,ccmH,4585242,4585242,4584820,422,144,utRho03
192,cdaR,364894,364926,364894,32,30,utRho03
193,cdd,4463638,4463688,4463638,50,114,utRho03
194,cdh,8219814,8219860,8219814,46,14,utRho03
195,cdsA,391110,391354,391110,244,2014,utRho03
196,cedA,3627484,3627484,3627326,158,182,utRho03
197,cfa,3482402,3482826,3482402,424,392,utRho03
198,chaC,2544844,2544972,2544844,128,34,utRho03
199,chbB,3643452,3643452,3643238,214,0,utRho03
200,chbG,3634624,3634624,3634270,354,0,utRho03
201,cheW,3946924,3946924,3946678,246,216,utRho03
202,chiA,6939792,6939792,6939706,86,0,utRho03
203,chiP,1416472,1416668,1416472,196,6,utRho03
204,cho,3646984,3647030,3646984,46,52,utRho03
205,chpS,8896804,8896894,8896804,90,26,utRho03
206,cirA,4493884,4493884,4493538,346,330,utRho03
207,citC,1304078,1304078,1303712,366,0,utRho03
208,citT,1293264,1293264,1293160,104,0,utRho03
209,clcA,350104,350214,350104,110,114,utRho03
210,clpA,1846160,1846528,1846160,368,38,utRho03
211,clpB,5468410,5468410,5468346,64,68,utRho03
212,clpP,913154,913354,913154,200,612,utRho03
213,clpS,1845500,1845826,1845500,326,36,utRho03
214,clpX,914404,914852,914404,448,1172,utRho03
215,clsA,2617346,2617346,2617290,56,68,utRho03
216,clsC,2212584,2212710,2212584,126,452,utRho03
217,cmk,1922330,1922402,1922330,72,92,utRho03
218,cnu,3409522,3409898,3409522,376,548,utRho03
219,coaA,8350214,8350214,8350052,162,820,utRho03
220,cobC,1340092,1340092,1339814,278,534,utRho03
221,cobT,4129202,4129202,4128934,268,48,utRho03
222,cobU,4131944,4131944,4131528,416,304,utRho03
223,codB,709768,709844,709768,76,0,utRho03
224,comR,2337726,2337726,2337664,62,0,utRho03
225,copA,1022822,1022822,1022758,64,16,utRho03
226,corA,8002388,8002852,8002388,464,4338,utRho03
227,cpdB,8873258,8873258,8873130,128,0,utRho03
228,cptB,6082198,6082198,6082140,58,118,utRho03
229,cpxA,8210202,8210202,8209950,252,524,utRho03
230,cpxP,8211570,8211640,8211570,70,6,utRho03
231,cpxR,8211372,8211372,8211340,32,70,utRho03
232,cra,175894,176056,175894,162,0,utRho03
233,crcB,1316016,1316016,1315876,140,88,utRho03
234,creA,9270486,9271042,9270486,556,428,utRho03
235,creD,9276320,9276356,9276320,36,16,utRho03
236,crl,515620,515658,515620,38,1878,utRho03
237,crp,6971906,6972240,6971906,334,3068,utRho03
238,crr,5070960,5071668,5070960,708,4966,utRho03
239,csdA,5886414,5886674,5886414,260,92,utRho03
240,csgB,2207718,2207902,2207718,184,0,utRho03
241,csgD,2206688,2206688,2206392,296,28,utRho03
242,csgG,2203510,2203510,2203368,142,46,utRho03
243,csiD,5577854,5577970,5577854,116,2,utRho03
244,csiE,5330802,5330870,5330802,68,36,utRho03
245,csiR,5590942,5591348,5590942,406,0,utRho03
246,cspA,7439778,7440098,7439778,320,415148,utRho03
247,cspB,3283430,3283430,3283108,322,386,utRho03
248,cspC,3815018,3815018,3814870,148,304,utRho03
249,cspD,1845352,1845352,1845180,172,332,utRho03
250,cspE,1314294,1314584,1314294,290,106,utRho03
251,cspF,3283380,3283710,3283380,330,208,utRho03
252,cspG,2102610,2102922,2102610,312,167892,utRho03
253,cspH,2102746,2102746,2102350,396,364,utRho03
254,cspI,3277624,3277624,3277334,290,268,utRho03
255,csrA,5638746,5638746,5638292,454,870,utRho03
256,csrB,5849048,5849048,5849048,0,0,utRho03
257,csrC,8102072,8102072,8102072,0,0,utRho03
258,csrD,6806850,6806850,6806664,186,74,utRho03
259,cstA,1259710,1259788,1259710,78,16,utRho03
260,cueO,274090,274166,274090,76,0,utRho03
261,cueR,1027948,1027986,1027948,38,2,utRho03
262,curA,3037784,3038054,3037784,270,36,utRho03
263,cusC,1191146,1191200,1191146,54,22,utRho03
264,cusR,1190924,1190924,1190886,38,0,utRho03
265,cutA,8730784,8730784,8730712,72,122,utRho03
266,cutC,3918534,3918534,3917920,614,54,utRho03
267,cvpA,4861600,4861600,4861526,74,88,utRho03
268,cvrA,2484328,2484328,2484142,186,144,utRho03
269,cyaA,7981548,7982306,7981548,758,1018,utRho03
270,cyaR,4334228,4334224,4334228,4,0,utRho03
271,cyaY,7988166,7988166,7988118,48,32,utRho03
272,cybB,2981522,2981804,2981522,282,152,utRho03
273,cycA,8859560,8859728,8859560,168,516,utRho03
274,cydA,1542340,1542916,1542340,576,142,utRho03
275,cydC,1858800,1858800,1858390,410,54,utRho03
276,cydD,1862062,1862062,1861924,138,60,utRho03
277,cydX,1548300,1548392,1548300,92,242,utRho03
278,cynR,717418,717418,717380,38,0,utRho03
279,cynT,1435092,1435196,1435092,104,0,utRho03
280,cyoA,903306,903306,903220,86,1978,utRho03
281,cyoE,895540,895540,895410,130,486,utRho03
282,cysB,2667576,2667710,2667576,134,346,utRho03
283,cysC,5748056,5748056,5747984,72,0,utRho03
284,cysD,5752736,5752736,5752658,78,0,utRho03
285,cysE,7565362,7565362,7565124,238,266,utRho03
286,cysG,6995508,6995656,6995508,148,8,utRho03
287,cysJ,5783928,5783928,5783796,132,1270,utRho03
288,cysK,5064688,5064818,5064688,130,62,utRho03
289,cysP,5087114,5087114,5087056,58,150,utRho03
290,cysS,1109154,1109222,1109154,68,98,utRho03
291,cysT,3984100,3984100,3983974,126,92,utRho03
292,cysZ,5062766,5062926,5062766,160,224,utRho03
293,cytR,8249018,8249018,8248912,106,78,utRho03
294,dacA,1328002,1328002,1327926,76,122,utRho03
295,dacB,6657714,6657926,6657714,212,0,utRho03
296,dacC,1761306,1761454,1761306,148,0,utRho03
297,dadA,2475018,2475142,2475018,124,0,utRho03
298,dam,7032504,7032504,7031826,678,1124,utRho03
299,damX,7035200,7035200,7034612,588,290,utRho03
300,dapA,5199568,5199568,5199520,48,0,utRho03
301,dapB,56576,56748,56576,172,28,utRho03
302,dapD,371954,371954,371894,60,142,utRho03
303,dapE,5183120,5183214,5183120,94,160,utRho03
304,dcp,3254844,3254844,3254760,84,22,utRho03
305,dcrB,7219534,7219910,7219534,376,94,utRho03
306,dctA,7366996,7366996,7366894,102,566,utRho03
307,dcuA,8733686,8733686,8733546,140,16,utRho03
308,dcuB,8698182,8698182,8697488,694,180,utRho03
309,dcuC,1312166,1312166,1311936,230,0,utRho03
310,dcuD,6749166,6749738,6749166,572,2,utRho03
311,dcuR,8701130,8701130,8700068,1062,470,utRho03
312,dcuS,8703370,8703370,8703324,46,34,utRho03
313,dcyD,3999016,3999016,3998960,56,0,utRho03
314,ddpX,3126498,3126498,3126152,346,0,utRho03
315,deaD,6615818,6615818,6615720,98,5110,utRho03
316,dedA,4869880,4869880,4869482,398,10790,utRho03
317,dedD,4863750,4863750,4863368,382,98,utRho03
318,def,6867300,6867380,6867300,80,22,utRho03
319,degP,361690,361768,361690,78,124,utRho03
320,degQ,6761308,6761486,6761308,178,4354,utRho03
321,deoB,9239134,9239206,9239134,72,0,utRho03
322,deoC,9233358,9234646,9233358,1288,94,utRho03
323,dfp,7625406,7625462,7625406,56,38,utRho03
324,dgcZ,3247758,3247758,3247700,58,0,utRho03
325,dgkA,8512914,8513274,8512914,360,238,utRho03
326,dgt,358392,358474,358392,82,12,utRho03
327,dhaK,2501888,2501888,2501676,212,134,utRho03
328,dhaR,2502006,2502132,2502006,126,8,utRho03
329,dicB,3299194,3299218,3299194,24,0,utRho03
330,dicC,3295752,3295752,3295700,52,0,utRho03
331,dinB,501760,501796,501760,36,18,utRho03
332,dinD,7635398,7635520,7635398,122,526,utRho03
333,dinG,1666146,1666140,1666146,6,12,utRho03
334,dinI,2243018,2243018,2242974,44,28,utRho03
335,dinJ,493230,493230,493004,226,72,utRho03
336,dinQ,7295964,7295964,7295576,388,1726,utRho03
337,djlA,114536,114728,114536,192,36,utRho03
338,dkgA,6313142,6313246,6313142,104,44,utRho03
339,dkgB,458196,458334,458196,138,658,utRho03
340,dksA,321502,321502,321208,294,160,utRho03
341,dld,4444164,4444370,4444164,206,12,utRho03
342,dmlA,3763424,3763824,3763424,400,0,utRho03
343,dmlR,3763710,3763710,3763618,92,0,utRho03
344,dmsA,1881646,1881918,1881646,272,146,utRho03
345,dnaA,7767922,7767922,7767458,464,5716,utRho03
346,dnaB,8528566,8528628,8528566,62,196,utRho03
347,dnaK,24096,24326,24096,230,212,utRho03
348,dnaN,7765466,7765466,7764642,824,2032,utRho03
349,dnaQ,471868,472134,471868,266,978,utRho03
350,dnaT,18406460,18406460,18406068,392,376,utRho03
351,dnaX,984112,984184,984112,72,536,utRho03
352,dosP,3131486,3131486,3131466,20,0,utRho03
353,dpiB,1303968,1304470,1303968,502,20,utRho03
354,dppA,7415740,7415740,7415410,330,682,utRho03
355,dps,1697900,1697900,1697822,78,30,utRho03
356,dsbA,8086754,8086836,8086754,82,2550,utRho03
357,dsbB,2466294,2466294,2466060,234,56,utRho03
358,dsbC,6079266,6079266,6077644,1622,1200,utRho03
359,dsbG,1277600,1277600,1277146,454,376,utRho03
360,dsdA,4958242,4958404,4958242,162,62,utRho03
361,dsdC,4955492,4955492,4955258,234,0,utRho03
362,dsdX,4955642,4955694,4955642,52,4,utRho03
363,dsrA,4050626,4050626,4050626,0,0,utRho03
364,dsrB,4049686,4049686,4049646,40,114,utRho03
365,dtpD,1485340,1485340,1485112,228,128,utRho03
366,dusA,8523200,8523338,8523200,138,3610,utRho03
367,dusB,6820492,6820560,6820492,68,240,utRho03
368,dusC,4460790,4460790,4460770,20,0,utRho03
369,dut,7627704,7627864,7627704,160,1434,utRho03
370,dxr,386670,387042,386670,372,622,utRho03
371,ebgA,6445102,6445266,6445102,164,12,utRho03
372,ebgR,6442874,6442932,6442874,58,48,utRho03
373,ecnB,8753018,8753106,8753018,88,78,utRho03
374,eco,4607594,4607810,4607594,216,100,utRho03
375,ecpA,621594,621594,621342,252,26,utRho03
376,ecpB,620238,620238,620052,186,0,utRho03
377,ecpR,622964,622964,622672,292,0,utRho03
378,eda,3866218,3866218,3865512,706,184,utRho03
379,edd,3869426,3869426,3869208,218,28,utRho03
380,efeO,2164308,2164486,2164308,178,126,utRho03
381,efeU_1,2162614,2162712,2162614,98,58,utRho03
382,efp,8751134,8751398,8751134,264,8228,utRho03
383,elaA,4763372,4763372,4763086,286,64,utRho03
384,elaD,4765308,4765426,4765308,118,68,utRho03
385,elfA,1995530,1995736,1995530,206,0,utRho03
386,elfD,1996642,1996980,1996642,338,0,utRho03
387,emrD,7707690,7707844,7707690,154,18,utRho03
388,emrK,4966896,4966896,4966678,218,0,utRho03
389,emrY,4964668,4964668,4964352,316,0,utRho03
390,emtA,2486250,2486360,2486250,110,4,utRho03
391,endA,12361100,12361388,12361100,288,0,utRho03
392,eno,5817692,5817692,5815882,1810,4604,utRho03
393,entC,1249662,1249770,1249662,108,0,utRho03
394,entD,1220508,1220508,1220158,350,16,utRho03
395,entH,1258584,1258600,1258584,16,80,utRho03
396,entS,1244506,1244600,1244506,94,42,utRho03
397,envR,6827266,6827266,6826930,336,0,utRho03
398,epd,12295292,12295292,12294764,528,200,utRho03
399,epmA,8765236,8765286,8765236,50,34,utRho03
400,epmB,8751406,8751406,8751314,92,4574,utRho03
401,eptB,7421162,7421162,7420950,212,0,utRho03
402,eptC,8300622,8300622,8300530,92,200,utRho03
403,erfK,4126708,4126708,4126646,62,1522,utRho03
404,erpA,353122,353220,353122,98,24,utRho03
405,esrE,8039956,8039956,8039956,0,0,utRho03
406,essD,1153746,1154796,1153746,1050,208,utRho03
407,etk,2088606,2088606,2088420,186,0,utRho03
408,evgA,4967262,4967510,4967262,248,40,utRho03
409,exbB,6304028,6304028,6303968,60,12,utRho03
410,exbD,6302780,6302780,6302486,294,250,utRho03
411,exuR,6493016,6493304,6493016,288,124,utRho03
412,exuT,6490004,6490208,6490004,204,0,utRho03
413,fabA,2032996,2032996,2032940,56,154,utRho03
414,fabB,4883282,4883282,4883210,72,6,utRho03
415,fabH,2297032,2297518,2297032,486,4322,utRho03
416,fabI,2702236,2702236,2702078,158,70,utRho03
417,fadB,8062026,8062026,8061942,84,0,utRho03
418,fadD,3779614,3779614,3779492,122,0,utRho03
419,fadE,486812,486812,486606,206,46,utRho03
420,fadH,6463248,6463330,6463248,82,0,utRho03
421,fadI,4921022,4921022,4920938,84,80,utRho03
422,fadL,4922410,4922600,4922410,190,26,utRho03
423,fadM,928720,928804,928720,84,18,utRho03
424,fadR,2469810,2469876,2469810,66,48,utRho03
425,fbaB,4357334,4357334,4357128,206,0,utRho03
426,fdhE,8162722,8162722,8162456,266,880,utRho03
427,fdhF,8598814,8598814,8598732,82,0,utRho03
428,fdnG,3094744,3094802,3094744,58,0,utRho03
429,fdrA,1093012,1093360,1093012,348,0,utRho03
430,feaB,2894994,2895038,2894994,44,0,utRho03
431,feaR,2894734,2894734,2894566,168,28,utRho03
432,fecA,9033454,9033454,9033354,100,392,utRho03
433,fecE,9023288,9023288,9022914,374,6872,utRho03
434,fecI,9036564,9036564,9036470,94,66,utRho03
435,feoA,7080114,7080326,7080114,212,240,utRho03
436,fepA,1225334,1225334,1224988,346,68,utRho03
437,fepB,1249454,1249454,1249020,434,308,utRho03
438,fepD,1244468,1244468,1244378,90,0,utRho03
439,fes,1225374,1225630,1225374,256,466,utRho03
440,ffh,5495706,5495706,5495590,116,2112,utRho03
441,ffs,952576,952848,952576,272,0,utRho03
442,fhuA,334884,334968,334884,84,376,utRho03
443,fhuE,2323294,2323294,2323102,192,208,utRho03
444,fhuF,9211504,9211504,9211326,178,2770,utRho03
445,fic,6983296,6983296,6982926,370,438,utRho03
446,fieF,8212864,8212938,8212864,74,66,utRho03
447,fimA,9085388,9086230,9085388,842,138,utRho03
448,fimB,9081334,9081914,9081334,580,1108,utRho03
449,fimE,9083742,9084074,9083742,332,50,utRho03
450,fimZ,1129214,1129214,1128960,254,32,utRho03
451,fiu,1683296,1683296,1683062,234,202,utRho03
452,fixA,84650,84806,84650,156,0,utRho03
453,fkpA,6955050,6955050,6954838,212,6962,utRho03
454,fldA,2846084,2846084,2845860,224,3836,utRho03
455,fldB,6079644,6079710,6079644,66,144,utRho03
456,flgA,2261770,2261770,2261726,44,62,utRho03
457,flgB,2261986,2262036,2261986,50,18,utRho03
458,flgK,2276702,2276756,2276702,54,1810,utRho03
459,flgM,2260330,2260330,2260256,74,448,utRho03
460,flgN,2259828,2259828,2259660,168,178,utRho03
461,flhB,3932432,3932432,3932382,50,132,utRho03
462,flhC,3955864,3955864,3955688,176,136,utRho03
463,flhD,3957154,3957154,3956394,760,898,utRho03
464,fliA,4003638,4003638,4003578,60,48,utRho03
465,fliC,4007352,4007352,4007212,140,112,utRho03
466,fliD,4007634,4007744,4007634,110,206,utRho03
467,fliE,4026186,4026186,4026028,158,0,utRho03
468,fliF,4026292,4026458,4026292,166,484,utRho03
469,fliL,4039168,4039236,4039168,68,156,utRho03
470,flk,4875824,4875900,4875824,76,66,utRho03
471,flu,4142634,4143078,4142634,444,142,utRho03
472,flxA,3292776,3292810,3292776,34,58,utRho03
473,fnr,2799104,2799104,2799052,52,28,utRho03
474,fnrS,2818258,2818258,2818258,0,0,utRho03
475,focA,1909628,1909628,1908932,696,508,utRho03
476,folA,99598,99646,99598,48,8,utRho03
477,folB,6409296,6409296,6409178,118,0,utRho03
478,folD,1115562,1115562,1115482,80,238,utRho03
479,folE,4487696,4487696,4487304,392,2902,utRho03
480,fpr,8228998,8228998,8228944,54,0,utRho03
481,frc,4986878,4986878,4986508,370,0,utRho03
482,frdA,8764824,8764824,8764636,188,134,utRho03
483,frdD,8758948,8758948,8758732,216,180,utRho03
484,fre,8052886,8053054,8052886,168,1820,utRho03
485,frlA,6999518,6999820,6999518,302,0,utRho03
486,frr,385624,385744,385624,120,702,utRho03
487,frsA,513004,513054,513004,50,158,utRho03
488,fruB,4527194,4527194,4526990,204,0,utRho03
489,frvR,8179804,8179804,8179710,94,0,utRho03
490,fryA,5008986,5008986,5008970,16,6,utRho03
491,fsaA,1727060,1727284,1727060,224,12,utRho03
492,fsr,1009710,1009710,1009392,318,80,utRho03
493,ftnA,3977364,3977432,3977364,68,0,utRho03
494,ftnB,3973550,3973850,3973550,300,0,utRho03
495,ftsA,207122,207964,207122,842,950,utRho03
496,ftsB,5745802,5745802,5745640,162,76,utRho03
497,ftsH,6654204,6654204,6653870,334,1202,utRho03
498,ftsK,1865858,1866448,1865858,590,2220,utRho03
499,ftsL,181376,182064,181376,688,1526,utRho03
500,ftsP,6325732,6325732,6325338,394,408,utRho03
501,ftsQ,205484,206310,205484,826,694,utRho03
502,ftsX,7204512,7204512,7204172,340,494,utRho03
503,ftsZ,209272,210610,209272,1338,96,utRho03
504,fucA,5867708,5867708,5867376,332,4,utRho03
505,fucP,5868238,5868470,5868238,232,0,utRho03
506,fumA,6753760,6753760,6753508,252,956,utRho03
507,fumB,8694696,8694696,8694652,44,0,utRho03
508,fumC,3373418,3373418,3373176,242,0,utRho03
509,fur,2842892,2842892,2842584,308,8180,utRho03
510,fusA,6947370,6947370,6947028,342,21464,utRho03
511,fxsA,8737206,8737328,8737206,122,122,utRho03
512,gabD,5581824,5582546,5581824,722,584,utRho03
513,gadA,7335214,7335214,7335160,54,0,utRho03
514,gadB,3144144,3144144,3144090,54,0,utRho03
515,gadC,3141168,3141168,3140978,190,48,utRho03
516,gadE,7315600,7316732,7315600,1132,38,utRho03
517,gadW,7329562,7329562,7329236,326,6,utRho03
518,gadX,14663356,14663356,14663240,116,0,utRho03
519,gadY,7329728,7329728,7329728,0,0,utRho03
520,galE,1584354,1584354,1584110,244,16,utRho03
521,galF,4228702,4228702,4228654,48,180,utRho03
522,galM,1577796,1577796,1577674,122,482,utRho03
523,galP,6176510,6176568,6176510,58,0,utRho03
524,galR,5953138,5953198,5953138,60,38,utRho03
525,galS,4483420,4483420,4483336,84,0,utRho03
526,galU,2582810,2582914,2582810,104,222,utRho03
527,gapA,3724480,3725542,3724480,1062,2670,utRho03
528,garP,6549868,6549868,6549814,54,0,utRho03
529,gatY,4354468,4354468,4354408,60,0,utRho03
530,gatZ,4352864,4352864,4352642,222,3826,utRho03
531,gcd,282558,282558,282450,108,18,utRho03
532,gcl,1067814,1067832,1067814,18,0,utRho03
533,gcvA,5885278,5885278,5885134,144,0,utRho03
534,gcvB,5885392,5885392,5885392,0,0,utRho03
535,gcvR,5199758,5199812,5199758,54,14,utRho03
536,gcvT,6101544,6101544,6101334,210,444,utRho03
537,gdhA,3684616,3684742,3684616,126,0,utRho03
538,gfcA,2099668,2099668,2099488,180,440,utRho03
539,gfcD,2096236,2096236,2095890,346,62,utRho03
540,ghrA,2195648,2195772,2195648,124,216,utRho03
541,ghrB,7434378,7434620,7434378,242,390,utRho03
542,glcA,6242728,6242728,6242558,170,52,utRho03
543,glcC,6256412,6256544,6256412,132,0,utRho03
544,glcD,6256152,6256152,6256042,110,4,utRho03
545,gldA,8278092,8278092,8278070,22,6,utRho03
546,glgA,7136784,7136784,7136066,718,232,utRho03
547,glgB,7147314,7147314,7147004,310,166,utRho03
548,glgC,7139142,7139142,7138656,486,44,utRho03
549,glgP,7133546,7133546,7133162,384,132,utRho03
550,glgS,6384024,6384024,6383878,146,0,utRho03
551,glgX,7142838,7142838,7142638,200,0,utRho03
552,glk,5018922,5018922,5018852,70,88,utRho03
553,glmS,7827622,7827622,7827336,286,6460,utRho03
554,glmU,7830652,7830652,7830400,252,510,utRho03
555,glmY,10765360,10765360,10765360,0,0,utRho03
556,glmZ,7972864,7972864,7972864,0,0,utRho03
557,glnA,16232888,16232888,16232136,752,252,utRho03
558,glnB,5375052,5375052,5374816,236,110,utRho03
559,glnD,377310,377310,377300,10,0,utRho03
560,glnE,6399602,6399602,6399282,320,138,utRho03
561,glnH,1696396,1696396,1696008,388,38,utRho03
562,glnK,945112,945196,945112,84,18,utRho03
563,glnL,8112742,8112742,8112678,64,22,utRho03
564,glnQ,1693262,1693262,1692926,336,204,utRho03
565,glnS,1411998,1412186,1411998,188,266,utRho03
566,gloA,3455602,3455674,3455602,72,70,utRho03
567,gloB,469852,469852,469564,288,758,utRho03
568,glpA,4705166,4705294,4705166,128,0,utRho03
569,glpD,7123942,7124026,7123942,84,8,utRho03
570,glpE,7123698,7123698,7123646,52,82,utRho03
571,glpF,8236322,8236322,8236180,142,88,utRho03
572,glpG,7122960,7122960,7122904,56,322,utRho03
573,glpR,7121782,7121782,7121210,572,202,utRho03
574,glpT,4704902,4704902,4704748,154,42,utRho03
575,glpX,8231212,8231212,8231158,54,3066,utRho03
576,glrK,5382246,5382246,5382196,50,238,utRho03
577,gltA,1509534,1509534,1508936,598,15186,utRho03
578,gltB,6709018,6709264,6709018,246,518,utRho03
579,gltI,1375792,1375792,1375494,298,1126,utRho03
580,gltP,8588536,8588962,8588536,426,1440,utRho03
581,gltS,7657382,7657382,7657330,52,238,utRho03
582,gltX,5041568,5041568,5041344,224,102,utRho03
583,gluQ,320286,320286,320224,62,0,utRho03
584,glyA,5371148,5371148,5371014,134,18,utRho03
585,glyQ,7450708,7450708,7450636,72,192,utRho03
586,glyS,7448990,7448990,7448794,196,1264,utRho03
587,glyU,5998128,5998128,5998114,14,2,utRho03
588,glyV,8784626,8784720,8784626,94,238,utRho03
589,glyW,3984360,3984360,3984234,126,0,utRho03
590,gmhB,445612,445666,445612,54,14,utRho03
591,gmk,7642776,7642856,7642776,80,92,utRho03
592,gmr,2693686,2693686,2693484,202,206,utRho03
593,gnd,4202648,4202648,4202536,112,774,utRho03
594,gnsB,3275692,3275692,3275564,128,110,utRho03
595,gntK,14310580,14310580,14310368,212,704,utRho03
596,gntP,9102668,9102668,9102592,76,30,utRho03
597,gntR,7157760,7157760,7157452,308,304,utRho03
598,gntT,7092810,7093118,7092810,308,62,utRho03
599,gntU,7154170,7154170,7154122,48,0,utRho03
600,gntX,7089334,7089764,7089334,430,54,utRho03
601,gor,7292224,7292598,7292224,374,1304,utRho03
602,gpmA,1575340,1575340,1575190,150,0,utRho03
603,gpmM,7570374,7570520,7570374,146,0,utRho03
604,gpsA,7567620,7567620,7567322,298,5258,utRho03
605,gpt,511828,511954,511828,126,372,utRho03
606,grcA,5433046,5433046,5432898,148,74,utRho03
607,greA,6657728,6657728,6657430,298,1592,utRho03
608,greB,7073488,7073624,7073488,136,36,utRho03
609,groL,8741566,8742050,8741566,484,922,utRho03
610,groS,8741232,8741376,8741232,144,152,utRho03
611,grpE,5501494,5501494,5501416,78,242,utRho03
612,grxA,1781552,1781552,1781506,46,0,utRho03
613,grxB,2248206,2248206,2248108,98,164,utRho03
614,grxC,7569152,7569152,7568884,268,3636,utRho03
615,grxD,3468324,3468324,3468202,122,4858,utRho03
616,gspA,6911268,6911268,6910796,472,14,utRho03
617,gspC,6910964,6911156,6910964,192,0,utRho03
618,gss,6277220,6277220,6277044,176,46,utRho03
619,gstA,3428654,3428754,3428654,100,0,utRho03
620,gstB,1761038,1761038,1760960,78,0,utRho03
621,guaB,5268214,5268214,5268140,74,2,utRho03
622,gudD,5839026,5839026,5838770,256,0,utRho03
623,gyrA,4678914,4678914,4678840,74,58,utRho03
624,gyrB,7760300,7760300,7760238,62,252,utRho03
625,hcaE,5337964,5338064,5337964,100,68,utRho03
626,hcaR,5337928,5337928,5337792,136,70,utRho03
627,hcaT,5336106,5336106,5335692,414,20,utRho03
628,hchA,4071260,4071670,4071260,410,0,utRho03
629,hcp,1828258,1828258,1827628,630,20,utRho03
630,hcr,1824400,1824400,1824300,100,6,utRho03
631,hdeA,7313582,7313582,7313480,102,0,utRho03
632,hdeD,7313920,7313990,7313920,70,0,utRho03
633,hdfR,7896320,7896320,7895934,386,444,utRho03
634,hdhA,3396244,3396244,3396080,164,26,utRho03
635,helD,2048876,2048942,2048876,66,0,utRho03
636,hemA,2527166,2527428,2527166,262,186,utRho03
637,hemB,779722,779722,779454,268,44,utRho03
638,hemF,5106410,5106450,5106410,40,0,utRho03
639,hemH,996062,996110,996062,48,176,utRho03
640,hemL,349882,349882,349764,118,108,utRho03
641,hemN,8103886,8104090,8103886,204,0,utRho03
642,hepA,127176,127176,126528,648,3942,utRho03
643,hflD,2385372,2385372,2385262,110,1080,utRho03
644,hfq,8799602,8800576,8799602,974,2512,utRho03
645,hha,961006,961006,960616,390,332,utRho03
646,hicA,3018442,3018572,3018442,130,0,utRho03
647,higA,6468682,6468682,6468288,394,44,utRho03
648,higB,6468960,6468960,6468910,50,0,utRho03
649,hinT,2323642,2323770,2323642,128,14,utRho03
650,hipB,3184964,3184964,3184884,80,0,utRho03
651,hisB,4186720,4186936,4186720,216,626,utRho03
652,hisJ,4853674,4853674,4853576,98,54,utRho03
653,hisL,8359856,8359984,8359856,128,668,utRho03
654,hisS,5281284,5281284,5281150,134,248,utRho03
655,hlpA,400910,400964,400910,54,128,utRho03
656,hlyE,2460932,2460932,2460788,144,2,utRho03
657,hmp,5371594,5371670,5371594,76,2,utRho03
658,hns,2585916,2585916,2585844,72,1554,utRho03
659,hofM,7045856,7045856,7045502,354,4,utRho03
660,hokA,7441620,7441620,7441200,420,4844,utRho03
661,hokC,33902,33902,33806,96,160,utRho03
662,hokE,1215462,1215672,1215462,210,0,utRho03
663,holC,8968546,8968546,8968560,14,634,utRho03
664,holD,9215562,9215606,9215562,44,0,utRho03
665,holE,3850040,3850216,3850040,176,948,utRho03
666,hpt,282720,282862,282720,142,126,utRho03
667,hrpB,324150,324210,324150,60,34,utRho03
668,hscB,5319048,5319048,5318934,114,938,utRho03
669,hscC,1367188,1367188,1366786,402,160,utRho03
670,hsdS,9163004,9163004,9162924,80,0,utRho03
671,hslJ,2883560,2883560,2883486,74,20,utRho03
672,hslO,7059344,7059548,7059344,204,5286,utRho03
673,hslR,7058220,7058696,7058220,476,870,utRho03
674,hslV,8244708,8244708,8244574,134,84,utRho03
675,hsrA,7881412,7881412,7881224,188,226,utRho03
676,htgA,21286,21660,21286,374,654,utRho03
677,htpG,989634,990240,989634,606,7604,utRho03
678,htpX,3825236,3825236,3825152,84,12,utRho03
679,htrE,311036,311036,310852,184,68,utRho03
680,htrL,7587668,7587668,7587366,302,188,utRho03
681,hupA,8400352,8400562,8400352,210,84,utRho03
682,hupB,1845220,1845804,1845220,584,172,utRho03
683,hyaA,2063968,2064278,2063968,310,4,utRho03
684,hybO,6292726,6292726,6292522,204,670,utRho03
685,hycA,5700922,5700922,5700870,52,0,utRho03
686,hycI,5686204,5686204,5686086,118,38,utRho03
687,hydN,5676264,5676264,5676210,54,0,utRho03
688,hyfA,5202342,5202402,5202342,60,0,utRho03
689,hypA,11402508,11402588,11402508,80,0,utRho03
690,hypB,11403356,11404004,11403356,648,336,utRho03
691,hypF,5676210,5676210,5674850,1360,650,utRho03
692,hypT,9116634,9116634,9116578,56,0,utRho03
693,hyuA,6019660,6020056,6019660,396,20,utRho03
694,iaaA,1733074,1733136,1733074,62,0,utRho03
695,iadA,9119074,9119074,9119052,22,2,utRho03
696,iap,5753072,5753162,5753072,90,4,utRho03
697,ibaG,6673966,6673966,6673606,360,220,utRho03
698,ibpA,7735036,7735036,7734844,192,124,utRho03
699,ibpB,7733962,7733962,7733794,168,160,utRho03
700,icd,2389922,2390246,2389922,324,180,utRho03
701,iclR,8447304,8447304,8447256,48,144,utRho03
702,idi,6065876,6066130,6065876,254,0,utRho03
703,idnD,8988870,8988870,8988812,58,0,utRho03
704,idnK,8989194,8989246,8989194,52,0,utRho03
705,ihfA,3591442,3591442,3591104,338,808,utRho03
706,ihfB,1927498,1927656,1927498,158,1128,utRho03
707,ileS,43666,44782,43666,1116,3008,utRho03
708,ileX,6431194,6431196,6431194,2,0,utRho03
709,ilvA,15820940,15821324,15820940,384,68,utRho03
710,ilvC,7915824,7915940,7915824,116,38,utRho03
711,ilvE,15809552,15809936,15809552,384,612,utRho03
712,ilvI,170840,171260,170840,420,0,utRho03
713,ilvL,23701308,23701932,23701308,624,150,utRho03
714,ilvY,7915734,7915734,7915640,94,0,utRho03
715,inaA,4698998,4698998,4698944,54,100,utRho03
716,infA,1853370,1853370,1852886,484,2910,utRho03
717,infC,3602692,3602692,3601276,1416,5440,utRho03
718,insA-5,3958452,3958452,3958430,22,18,utRho03
719,insA-7,9036758,9037054,9036758,296,74,utRho03
720,insC-5,6372080,6372284,6372080,204,190,utRho03
721,insEF-2,785238,785238,785820,582,458,utRho03
722,insEF-4,2190310,2190310,2190892,582,340,utRho03
723,insG,9007098,9007098,9006862,236,14,utRho03
724,insH-1,550596,550596,550234,362,60,utRho03
725,insH-11,7306538,7306538,7306396,142,90,utRho03
726,insH-2,1151548,1151548,1151506,42,202,utRho03
727,insH-3,1378444,1378444,1378026,418,178,utRho03
728,insH-4,2791942,2792152,2791942,210,90,utRho03
729,insH-5,2857852,2857852,2857452,400,0,utRho03
730,insH-6,4135022,4135022,4134642,380,132,utRho03
731,insH-7,4206186,4206186,4205822,364,9458,utRho03
732,insH-9,6260050,6260356,6260050,306,92,utRho03
733,insI-3,9017372,9017372,9017234,138,0,utRho03
734,insJ,7441188,7441360,7441188,172,2022,utRho03
735,insK,7442130,7442308,7442130,178,32,utRho03
736,insL-1,30760,30890,30760,130,410,utRho03
737,insL-2,1216112,1216130,1216112,18,6,utRho03
738,insL-3,5028644,5028662,5028644,18,114,utRho03
739,insN-1,540452,540484,540452,32,0,utRho03
740,intD,1132202,1132202,1131956,246,106,utRho03
741,intR,2826520,2826520,2826470,50,0,utRho03
742,intS,4933026,4933090,4933026,64,664,utRho03
743,intZ,5117386,5117542,5117386,156,108,utRho03
744,iraD,9113152,9113986,9113152,834,28,utRho03
745,iraM,2424246,2424246,2424006,240,50,utRho03
746,iraP,802638,802772,802638,134,0,utRho03
747,iscA,5319924,5319924,5319772,152,1778,utRho03
748,iscR,5324398,5324398,5324262,136,22774,utRho03
749,iscX,5313834,5313834,5313472,362,2614,utRho03
750,ispF,5743968,5743968,5743560,408,1540,utRho03
751,ispG,5283908,5283908,5283608,300,812,utRho03
752,ispU,389568,389806,389568,238,244,utRho03
753,isrA,2811502,2811502,2811618,116,0,utRho03
754,istr-1,7706384,7706384,7706384,0,0,utRho03
755,istr-2,7706514,7706514,7706514,0,0,utRho03
756,ivbL,15412092,15412092,15411952,140,344,utRho03
757,ivy,480638,480686,480638,48,0,utRho03
758,katE,3627628,3627734,3627628,106,48,utRho03
759,katG,8267624,8267670,8267624,46,84,utRho03
760,kbaZ,6557732,6557828,6557732,96,0,utRho03
761,kbl,7585154,7585154,7585102,52,534,utRho03
762,kch,2621046,2621046,2620538,508,0,utRho03
763,kdgR,3820506,3820506,3820198,308,16,utRho03
764,kdpE,1443788,1443788,1443466,322,114,utRho03
765,kdpF,1457698,1457698,1457642,56,0,utRho03
766,kdsA,2535708,2536330,2535708,622,3410,utRho03
767,kdsC,6683438,6684546,6683438,1108,3526,utRho03
768,kduI,5968388,5968388,5968248,140,542,utRho03
769,kefF,94160,94492,94160,332,26,utRho03
770,kgtP,5451624,5451624,5451492,132,1502,utRho03
771,kup,7862206,7862632,7862206,426,102,utRho03
772,lacI,735076,735076,735020,56,0,utRho03
773,lacZ,1465508,1465508,1465220,288,272,utRho03
774,ldcA,2486394,2486394,2486160,234,4,utRho03
775,ldhA,2885830,2885830,2885686,144,0,utRho03
776,ldrA,2538954,2538954,2538550,404,1468,utRho03
777,ldrB,2540024,2540024,2539620,404,690,utRho03
778,ldrC,2541092,2541092,2540690,402,1036,utRho03
779,ldrD,7400544,7400544,7400174,370,1308,utRho03
780,lepA,5414392,5414392,5414248,144,182,utRho03
781,lepB,5410928,5410928,5410618,310,666,utRho03
782,leuD,159188,159188,158906,282,0,utRho03
783,leuE,3761600,3761600,3761518,82,0,utRho03
784,leuL,168048,168048,167416,632,14,utRho03
785,leuO,168308,168736,168308,428,0,utRho03
786,leuQ,9212864,9212864,9212802,62,0,utRho03
787,leuU,6644556,6644556,6644316,240,4206,utRho03
788,leuV,9212546,9212546,9212330,216,796,utRho03
789,leuX,8992772,8992810,8992772,38,0,utRho03
790,lexA,8514174,8514230,8514174,56,44,utRho03
791,lhr,3456706,3458174,3456706,1468,2654,utRho03
792,ligA,5060402,5060402,5060352,50,0,utRho03
793,ligB,7642576,7642576,7642340,236,8,utRho03
794,lipA,1320602,1320602,1320432,170,298,utRho03
795,lipB,1324802,1324802,1324556,246,1924,utRho03
796,lit,2397032,2397390,2397032,358,108,utRho03
797,livJ,7199524,7199524,7199316,208,3008,utRho03
798,livK,7195510,7195510,7195120,390,74,utRho03
799,lldP,7554578,7554798,7554578,220,618,utRho03
800,lnt,1381968,1381968,1381762,206,482,utRho03
801,loiP,6163784,6163826,6163784,42,42,utRho03
802,lolA,1874656,1874738,1874656,82,784,utRho03
803,lolB,2527112,2527112,2527000,112,74,utRho03
804,lolC,2350748,2350854,2350748,106,0,utRho03
805,lon,917630,917776,917630,146,910,utRho03
806,lpcA,486936,487086,486936,150,0,utRho03
807,lpd,255434,255824,255434,390,3754,utRho03
808,lplA,9248476,9248476,9248234,242,634,utRho03
809,lplT,5947878,5947878,5947724,154,26,utRho03
810,lpoA,6586422,6586800,6586422,378,276,utRho03
811,lpp,3514592,3514842,3514592,250,98,utRho03
812,lptA,6686598,6686760,6686598,162,1530,utRho03
813,lptB,6686792,6687888,6686792,1096,1958,utRho03
814,lptD,114672,114672,114218,454,3872,utRho03
815,lptF,8972244,8972436,8972244,192,26,utRho03
816,lpxC,213016,213114,213016,98,24290,utRho03
817,lpxD,401920,401942,401920,22,20,utRho03
818,lpxL,2233418,2233418,2233164,254,84,utRho03
819,lpxM,3880456,3880456,3880386,70,170,utRho03
820,lpxP,4991156,4991290,4991156,134,554,utRho03
821,lrhA,4813312,4813312,4813282,30,24,utRho03
822,lrp,1864656,1865190,1864656,534,776,utRho03
823,lspA,50028,50414,50028,386,676,utRho03
824,lsrA,3202920,3202980,3202920,60,2,utRho03
825,lsrR,3202514,3202514,3202482,32,0,utRho03
826,ltaE,1818640,1818640,1818588,52,0,utRho03
827,luxS,5630130,5630130,5629466,664,1280,utRho03
828,lysA,5957902,5957902,5957798,104,0,utRho03
829,lysC,8467232,8467232,8466466,766,484,utRho03
830,lysP,4497120,4497120,4497064,56,46,utRho03
831,lysR,5957900,5958042,5957900,142,0,utRho03
832,lysT,1561028,1561108,1561028,80,100,utRho03
833,lysU,8709610,8709610,8709434,176,48,utRho03
834,macB,1840188,1840694,1840188,506,196,utRho03
835,maeA,3111484,3111484,3111338,146,2704,utRho03
836,mak,820236,820288,820236,52,0,utRho03
837,malE,8492928,8492928,8492838,90,0,utRho03
838,malI,3398456,3398456,3398360,96,12,utRho03
839,malK,8493472,8493568,8493472,96,0,utRho03
840,malP,7105020,7105020,7104946,74,168,utRho03
841,malQ,7100798,7100798,7100140,658,308,utRho03
842,malS,14949880,14949988,14949880,108,0,utRho03
843,malT,7106048,7106170,7106048,122,56,utRho03
844,malX,3398626,3398710,3398626,84,0,utRho03
845,malZ,1689980,1690072,1689980,92,2152,utRho03
846,manA,3377102,3377152,3377102,50,20,utRho03
847,manX,3803866,3804096,3803866,230,0,utRho03
848,marC,3237882,3237882,3237816,66,96,utRho03
849,marR,3238186,3238240,3238186,54,28,utRho03
850,matP,2036918,2036970,2036918,52,70,utRho03
851,mazE,5822736,5822736,5822678,58,22,utRho03
852,mazG,5821720,5821720,5821370,350,3166,utRho03
853,mcbA,1684306,1684306,1684112,194,14,utRho03
854,mcbR,3040192,3040524,3040192,332,38,utRho03
855,mcrA,2420278,2420692,2420278,414,64,utRho03
856,mcrC,9156124,9156124,9155916,208,42,utRho03
857,mdaB,6344814,6345060,6344814,246,0,utRho03
858,mdfA,1767138,1767346,1767138,208,0,utRho03
859,mdh,6768940,6768940,6768536,404,192,utRho03
860,mdoB,9198988,9198988,9198882,106,700,utRho03
861,mdoD,2993290,2993712,2993290,422,22,utRho03
862,mdoG,2218514,2218670,2218514,156,156,utRho03
863,mdtA,4307958,4308032,4307958,74,150,utRho03
864,mdtE,7318168,7318464,7318168,296,4,utRho03
865,mdtK,3486538,3486914,3486538,376,142,utRho03
866,mdtP,8602472,8602472,8602060,412,122,utRho03
867,melA,8683774,8683822,8683774,48,0,utRho03
868,melR,8683300,8683300,8683256,44,10,utRho03
869,menA,8240812,8240812,8240698,114,0,utRho03
870,menB,4753774,4753774,4753638,136,212,utRho03
871,mepH,3468714,3468870,3468714,156,2,utRho03
872,mepM,3883666,3883666,3883270,396,768,utRho03
873,mepS,4539840,4539958,4539840,118,624,utRho03
874,metA,8428318,8428560,8428318,242,336,utRho03
875,metB,8257272,8257344,8257272,72,626,utRho03
876,metC,6304150,6304472,6304150,322,322,utRho03
877,metE,8025768,8026106,8025768,338,88,utRho03
878,metF,8265092,8265232,8265092,140,36,utRho03
879,metG,4388538,4388600,4388538,62,132,utRho03
880,metH,8447010,8447656,8447010,646,6584,utRho03
881,metJ,8257116,8257116,8256790,326,158,utRho03
882,metK,6173154,6173412,6173154,258,130,utRho03
883,metN,445428,445428,445290,138,18,utRho03
884,metR,8025710,8025710,8025632,78,0,utRho03
885,metT,1394326,1394326,1394266,60,52,utRho03
886,metY,19910250,19910250,19909734,516,9858,utRho03
887,metZ,11789528,11789548,11789528,20,0,utRho03
888,mfd,2348056,2348056,2347928,128,136,utRho03
889,mglA,4478782,4478782,4478578,204,2,utRho03
890,mglB,4481132,4481132,4480696,436,512,utRho03
891,mglC,4475918,4475918,4475506,412,0,utRho03
892,mgrB,3817584,3817584,3817532,52,0,utRho03
893,mgrR,3245828,3245828,3245828,0,0,utRho03
894,mgsA,2054082,2054082,2054030,52,6,utRho03
895,mgtL,8934560,8934862,8934560,302,16,utRho03
896,mhpA,737038,737222,737038,184,20,utRho03
897,mhpR,737072,737072,736840,232,20,utRho03
898,mhpT,750772,750918,750772,146,0,utRho03
899,miaA,8797964,8798504,8797964,540,946,utRho03
900,micA,5629604,5629604,5629604,0,0,utRho03
901,micC,2874242,2874238,2874242,4,0,utRho03
902,micF,4626168,4626168,4626168,0,0,utRho03
903,micM,1014408,1014408,1014408,0,0,utRho03
904,minE,2449422,2449422,2449090,332,716,utRho03
905,mioC,7852950,7852950,7852910,40,76,utRho03
906,mipA,3733012,3733012,3732944,68,2386,utRho03
907,mlaA,4930270,4930270,4930014,256,10,utRho03
908,mlc,3337206,3337206,3337128,78,74,utRho03
909,mlrA,4429498,4429732,4429498,234,18,utRho03
910,mltA,5894546,5894546,5894356,190,44,utRho03
911,mltD,468050,468050,467910,140,48,utRho03
912,mltF,5391534,5391602,5391534,68,0,utRho03
913,mmuP,550238,550650,550238,412,60,utRho03
914,mngA,1531622,1531968,1531622,346,48,utRho03
915,mngR,1531852,1531852,1531750,102,40,utRho03
916,mnmG,7851348,7851348,7851266,82,7820,utRho03
917,mntH,5025470,5025470,5025412,58,14,utRho03
918,mntP,3810918,3811376,3810918,458,694,utRho03
919,mntR,1706160,1706366,1706160,206,0,utRho03
920,mntS,1706128,1706128,1705994,134,92,utRho03
921,moaA,1633654,1634088,1633654,434,910,utRho03
922,moaB,1635954,1636110,1635954,156,668,utRho03
923,mobA,8084242,8084242,8083998,244,546,utRho03
924,mocA,6030112,6030320,6030112,208,0,utRho03
925,modA,1589990,1590178,1589990,188,102,utRho03
926,moeA,1732788,1732788,1732728,60,94,utRho03
927,mokB,2984610,2984610,2984258,352,694,utRho03
928,molR_1,4392888,4392948,4392888,60,186,utRho03
929,motA,3954604,3954604,3954278,326,82,utRho03
930,mpaA,2781278,2781278,2781196,82,20,utRho03
931,mpl,8911456,8911570,8911456,114,0,utRho03
932,mppA,2786108,2786454,2786108,346,20,utRho03
933,mprA,5621494,5621540,5621494,46,288,utRho03
934,mqo,4613848,4613848,4613508,340,878,utRho03
935,mqsA,6336742,6336742,6336492,250,120,utRho03
936,mqsR,6337306,6337306,6337088,218,294,utRho03
937,mraZ,179192,179268,179192,76,0,utRho03
938,mrcA,7045652,7045742,7045652,90,0,utRho03
939,mrcB,329442,329460,329442,18,0,utRho03
940,mreB,13605424,13605424,13604348,1076,1280,utRho03
941,mreD,6798166,6798166,6797750,416,164,utRho03
942,mrp,4388360,4388360,4388336,24,12,utRho03
943,mscK,972984,973072,972984,88,192,utRho03
944,mscL,6876002,6876048,6876002,46,230,utRho03
945,mscS,6139742,6139742,6139614,128,92,utRho03
946,msrA,8884522,8884522,8884352,170,96,utRho03
947,msrB,3725168,3725168,3724858,310,0,utRho03
948,msyB,2228426,2228426,2228362,64,348,utRho03
949,mtfA,4087236,4087302,4087236,66,272,utRho03
950,mtgA,6699662,6699662,6699618,44,228,utRho03
951,mtlA,30177504,30178248,30177504,744,600,utRho03
952,mtn,358366,358366,358306,60,74,utRho03
953,mtr,6611864,6611864,6611634,230,34,utRho03
954,mug,6430992,6430992,6430946,46,72,utRho03
955,murQ,5091466,5091546,5091466,80,0,utRho03
956,murR,5091586,5091586,5091218,368,40,utRho03
957,mutH,5939164,5939324,5939164,160,764,utRho03
958,mutL,8794092,8794824,8794092,732,938,utRho03
959,mutM,7622554,7622554,7622304,250,1044,utRho03
960,mutS,5714038,5714186,5714038,148,244,utRho03
961,mutY,18617466,18618078,18617466,612,504,utRho03
962,nac,4123956,4123956,4123866,90,4,utRho03
963,nadA,1564122,1564170,1564122,48,0,utRho03
964,nadB,5420714,5420840,5420714,126,48,utRho03
965,nadC,237326,237326,237290,36,16,utRho03
966,nadE,3644604,3644916,3644604,312,12,utRho03
967,nadK,5501526,5501662,5501526,136,158,utRho03
968,nagA,1406350,1406350,1405502,848,1920,utRho03
969,nagB,1407416,1407416,1407222,194,14,utRho03
970,nagC,1404016,1404016,1403188,828,128,utRho03
971,nagE,1407680,1407888,1407680,208,30,utRho03
972,nagK,2357080,2357186,2357080,106,106,utRho03
973,nanA,6747240,6747240,6747152,88,10,utRho03
974,nanC,9079856,9079856,9079002,854,0,utRho03
975,nanR,6749406,6749406,6748978,428,136,utRho03
976,nanS,9075406,9075406,9075188,218,0,utRho03
977,napF,4607390,4607390,4606994,396,0,utRho03
978,narG,2559614,2559728,2559614,114,28,utRho03
979,narK,2555642,2555914,2555642,272,2,utRho03
980,narP,4580844,4581000,4580844,156,8,utRho03
981,narQ,5171154,5171462,5171154,308,0,utRho03
982,narU,3088326,3088326,3088120,206,0,utRho03
983,narW,3077374,3077374,3074618,2756,16,utRho03
984,narX,2555554,2555554,2555236,318,2,utRho03
985,narZ,3085380,3085380,3085180,200,0,utRho03
986,ndh,2331984,2332170,2331984,186,106,utRho03
987,ndk,5289920,5289920,5289728,192,302,utRho03
988,nemR,6904084,6904092,6904084,8,0,utRho03
989,nepI,7683542,7683542,7683478,64,220,utRho03
990,nfo,4501612,4501680,4501612,68,90,utRho03
991,nfsB,1210906,1210906,1210848,58,26,utRho03
992,nfuA,7090916,7091248,7090916,332,404,utRho03
993,nhaA,34634,34978,34634,344,76,utRho03
994,nhaB,2469534,2469534,2469434,100,58,utRho03
995,nhoA,3067926,3068048,3067926,122,0,utRho03
996,nikA,7226878,7227334,7226878,456,2984,utRho03
997,nikR,7237074,7237176,7237074,102,76,utRho03
998,nirB,6987974,6988022,6987974,48,44,utRho03
999,nlpA,7680034,7680034,7679986,48,0,utRho03
1000,nlpC,3585654,3585654,3585462,192,124,utRho03
1001,nlpD,5737658,5737658,5737506,152,112,utRho03
1002,nlpI,6618080,6618080,6617848,232,2,utRho03
1003,nmpC,1153740,1153740,1153650,90,0,utRho03
1004,nohA,3273206,3273206,3272734,472,0,utRho03
1005,norR,5664614,5664614,5664578,36,0,utRho03
1006,norV,5664878,5664952,5664878,74,0,utRho03
1007,nrdA,4689510,4689730,4689510,220,12032,utRho03
1008,nrdD,8925676,8925676,8925320,356,1392,utRho03
1009,nrdH,5601312,5601446,5601312,134,780,utRho03
1010,nrdR,865954,866004,865954,50,42,utRho03
1011,nrfA,8575342,8575528,8575342,186,12,utRho03
1012,nsrR,8812088,8812380,8812088,292,50290,utRho03
1013,nudB,3897348,3897348,3897264,84,0,utRho03
1014,nudC,8393428,8393806,8393428,378,66,utRho03
1015,nudE,7052658,7052658,7052298,360,4858,utRho03
1016,nudG,3682876,3682980,3682876,104,0,utRho03
1017,nudI,4729050,4729108,4729050,58,0,utRho03
1018,nudJ,2388874,2388874,2388576,298,1386,utRho03
1019,nuoA,4810670,4810670,4810144,526,1840,utRho03
1020,nuoN,4783434,4783434,4783010,424,1420,utRho03
1021,nupC,5026018,5026084,5026018,66,16,utRho03
1022,nupG,6211302,6211428,6211302,126,4,utRho03
1023,ogrK,4335096,4335096,4335040,56,0,utRho03
1024,ogt,2800568,2800568,2800472,96,164,utRho03
1025,ohsC,5401036,5401040,5401036,4,0,utRho03
1026,ompA,2040382,2040382,2040106,276,15868,utRho03
1027,ompC,4625774,4625774,4625498,276,94,utRho03
1028,ompF,1974184,1974184,1973964,220,78,utRho03
1029,ompL,8128958,8128958,8128590,368,0,utRho03
1030,ompN,2874158,2874158,2873786,372,6,utRho03
1031,ompR,7073510,7073510,7073168,342,22,utRho03
1032,ompT,1171330,1171330,1171266,64,160,utRho03
1033,ompW,2627982,2628040,2627982,58,0,utRho03
1034,ompX,1700418,1700900,1700418,482,842,utRho03
1035,omrA,5952378,5952378,5952378,0,0,utRho03
1036,omrB,5952770,5952770,5952770,0,0,utRho03
1037,oppA,2602170,2602364,2602170,194,18146,utRho03
1038,orn,8783168,8783208,8783168,40,20,utRho03
1039,osmB,2686952,2686952,2686656,296,88,utRho03
1040,osmC,3113192,3113250,3113192,58,62,utRho03
1041,osmE,3644566,3644566,3644512,54,14,utRho03
1042,osmF,4439046,4439046,4438962,84,254,utRho03
1043,osmY,9222306,9222792,9222306,486,212,utRho03
1044,otsA,3963302,3963302,3963224,78,12,utRho03
1045,otsB,3964930,3964930,3964774,156,60,utRho03
1046,oxc,4984288,4984288,4983900,388,22,utRho03
1047,oxyR,8316914,8316980,8316914,66,54,utRho03
1048,oxyS,8316788,8316788,8316788,0,0,utRho03
1049,paaA,2907730,2907854,2907730,124,0,utRho03
1050,paaX,2927018,2927078,2927018,60,0,utRho03
1051,paaZ,2907340,2907340,2907284,56,0,utRho03
1052,pabA,6981702,6981702,6981658,44,0,utRho03
1053,pabB,3789256,3789610,3789256,354,216,utRho03
1054,pabC,2306186,2306600,2306186,414,274,utRho03
1055,pagP,1313052,1313114,1313052,62,18,utRho03
1056,panB,299260,299260,299202,58,200,utRho03
1057,panC,297840,297840,297590,250,192,utRho03
1058,panD,293490,293490,293388,102,120,utRho03
1059,panZ,7195656,7195968,7195656,312,64,utRho03
1060,parC,6332060,6332060,6331946,114,112,utRho03
1061,patA,6438916,6438988,6438916,72,30,utRho03
1062,patD,3030830,3031156,3030830,326,0,utRho03
1063,pbpC,5294986,5294986,5294650,336,0,utRho03
1064,pbpG,4450132,4450132,4449740,392,36,utRho03
1065,pck,7065358,7065636,7065358,278,1592,utRho03
1066,pcnB,318782,318782,318252,530,760,utRho03
1067,pdhR,244068,244184,244068,116,136,utRho03
1068,pdxB,4875768,4875768,4875702,66,6,utRho03
1069,pdxH,3436068,3436068,3436014,54,218,utRho03
1070,pdxJ,5403626,5403626,5403458,168,138,utRho03
1071,pdxK,5074638,5074638,5074474,164,58,utRho03
1072,pepA,8972278,8972278,8971902,376,190,utRho03
1073,pepD,511618,511618,511432,186,2922,utRho03
1074,pepN,1981182,1981244,1981182,62,42,utRho03
1075,pepQ,8062294,8062322,8062294,28,40,utRho03
1076,pepT,2371646,2371688,2371646,42,0,utRho03
1077,pfkA,8214948,8215104,8214948,156,184,utRho03
1078,pfkB,3612646,3612740,3612646,94,0,utRho03
1079,pflA,1902456,1902456,1902160,296,54,utRho03
1080,pflB,1907850,1907850,1907108,742,584,utRho03
1081,pflD,8287716,8287990,8287716,274,0,utRho03
1082,pgaA,2185046,2185046,2184578,468,0,utRho03
1083,pgi,8467444,8467516,8467444,72,4,utRho03
1084,pgk,12291428,12291428,12290488,940,4332,utRho03
1085,pgl,1597078,1597172,1597078,94,4,utRho03
1086,pgpB,2678324,2678660,2678324,336,96,utRho03
1087,pgpC,5397276,5397276,5397100,176,0,utRho03
1088,pgrR,2783744,2783982,2783744,238,50,utRho03
1089,pheL,5475158,5475198,5475158,40,2,utRho03
1090,pheM,7197204,7197204,7197080,124,52,utRho03
1091,pheP,1203858,1203918,1203858,60,0,utRho03
1092,pheU,8725254,8725254,8725252,2,0,utRho03
1093,pheV,6220730,6220732,6220730,2,0,utRho03
1094,phnC,8650412,8650412,8650330,82,0,utRho03
1095,phoA,803414,803494,803414,80,0,utRho03
1096,phoB,834202,834284,834202,82,14,utRho03
1097,phoE,520316,520316,520200,116,20,utRho03
1098,phoH,2169730,2169984,2169730,254,590,utRho03
1099,phoP,2381016,2381016,2380894,122,1412,utRho03
1100,phoQ,2379880,2379880,2379552,328,1298,utRho03
1101,phoU,7815330,7815330,7815156,174,112,utRho03
1102,phr,1478842,1479014,1478842,172,0,utRho03
1103,pinE,2419054,2419370,2419054,316,38,utRho03
1104,pinQ,3267168,3267244,3267168,76,1156,utRho03
1105,pinR,2867424,2867424,2867348,76,1254,utRho03
1106,pitA,7275224,7275284,7275224,60,4,utRho03
1107,pitB,6272806,6272806,6272742,64,0,utRho03
1108,pka,5439862,5439906,5439862,44,0,utRho03
1109,plaP,4174476,4174476,4174124,352,522,utRho03
1110,pldA,8009628,8009724,8009628,96,44,utRho03
1111,pldB,8018028,8018340,8018028,312,362,utRho03
1112,plsB,8513196,8513196,8512932,264,158,utRho03
1113,pmbA,8915890,8915918,8915890,28,0,utRho03
1114,pmrD,4747148,4747148,4747076,72,0,utRho03
1115,pncB,1980828,1980828,1980712,116,38,utRho03
1116,pncC,5648788,5648788,5648692,96,0,utRho03
1117,pnp,6622652,6622652,6622336,316,114,utRho03
1118,pntA,3355950,3355950,3355806,144,0,utRho03
1119,pntB,3353096,3353096,3352720,376,0,utRho03
1120,polA,8093880,8093932,8093880,52,68,utRho03
1121,polB,131606,131606,131560,46,0,utRho03
1122,potD,2365700,2365700,2365658,42,22,utRho03
1123,potE,1436688,1436688,1436530,158,0,utRho03
1124,potF,1787268,1787568,1787268,300,18,utRho03
1125,poxB,1822152,1822152,1822098,54,0,utRho03
1126,ppa,8899372,8899372,8899304,68,164,utRho03
1127,ppc,8306380,8306380,8306196,184,336,utRho03
1128,ppdA,5928440,5928440,5928354,86,1268,utRho03
1129,ppdD,235410,235410,235098,312,310,utRho03
1130,pphA,3846770,3846770,3845938,832,1946,utRho03
1131,pphB,5719474,5719520,5719474,46,0,utRho03
1132,ppiA,6984898,6984898,6984594,304,82,utRho03
1133,ppiC,7919682,7919682,7919626,56,126,utRho03
1134,ppiD,923638,923830,923638,192,810,utRho03
1135,ppk,5245748,5246088,5245748,340,590,utRho03
1136,pppA,6228958,6228958,6228704,254,0,utRho03
1137,ppsA,3574322,3574322,3574224,98,0,utRho03
1138,ppsR,3574678,3574890,3574678,212,0,utRho03
1139,pptA,3065716,3066104,3065716,388,62,utRho03
1140,pqiA,2023318,2024002,2023318,684,270,utRho03
1141,prc,3830054,3830054,3829632,422,19602,utRho03
1142,preT,4467978,4468066,4467978,88,96,utRho03
1143,prfC,9218688,9218828,9218688,140,862,utRho03
1144,prkB,6968622,6968980,6968622,358,1126,utRho03
1145,prlC,7290476,7290476,7290364,112,206,utRho03
1146,prlF,6553944,6554004,6553944,60,152,utRho03
1147,proB,520432,520776,520432,344,162,utRho03
1148,proC,811372,811372,811288,84,8,utRho03
1149,proK,7417388,7417388,7417384,4,0,utRho03
1150,proL,4572414,4572422,4572414,8,8,utRho03
1151,proP,8660640,8661004,8660640,364,5202,utRho03
1152,proS,437674,437674,437550,124,388,utRho03
1153,proV,5609126,5609630,5609126,504,8,utRho03
1154,prpB,697292,697364,697292,72,0,utRho03
1155,prpR,696942,696942,696886,56,0,utRho03
1156,prs,2524354,2524354,2523750,604,48392,utRho03
1157,psd,8781276,8781276,8780720,556,3024,utRho03
1158,psiE,8480600,8480650,8480600,50,0,utRho03
1159,pspA,2736076,2736158,2736076,82,0,utRho03
1160,pspF,2736080,2736080,2735824,256,0,utRho03
1161,pspG,8525632,8525680,8525632,48,0,utRho03
1162,pssA,5445156,5445454,5445156,298,1280,utRho03
1163,pstB,7817112,7817112,7816732,380,0,utRho03
1164,pstC,7821084,7821084,7820796,288,0,utRho03
1165,pstS,23469408,23469408,23469150,258,252,utRho03
1166,psuG,4517114,4517114,4516734,380,96,utRho03
1167,psuT,4514992,4514992,4514670,322,0,utRho03
1168,pth,2517084,2517084,2517026,58,0,utRho03
1169,ptrA,5918022,5918022,5917768,254,0,utRho03
1170,ptrB,3857730,3857730,3857678,52,3490,utRho03
1171,ptsG,2315252,2315738,2315252,486,1758,utRho03
1172,ptsH,5066996,5067528,5066996,532,2364,utRho03
1173,purA,8809328,8809374,8809328,46,0,utRho03
1174,purC,5195562,5195562,5195236,326,0,utRho03
1175,purD,8411972,8411972,8411862,110,22,utRho03
1176,purE,1106284,1106284,1106200,84,986,utRho03
1177,purH,8415254,8415254,8415064,190,10,utRho03
1178,purL,5391178,5391178,5391086,92,280,utRho03
1179,purM,5242306,5242394,5242306,88,0,utRho03
1180,purR,3475378,3475688,3475378,310,636,utRho03
1181,purT,3861438,3861762,3861438,324,58,utRho03
1182,purU,2577512,2577512,2577248,264,732,utRho03
1183,putA,2157850,2157850,2157764,86,0,utRho03
1184,putP,2158336,2158610,2158336,274,302,utRho03
1185,puuA,2721936,2721936,2721816,120,0,utRho03
1186,puuC,2725456,2725486,2725456,30,0,utRho03
1187,puuD,2722104,2722240,2722104,136,0,utRho03
1188,puuP,2718746,2718746,2718374,372,604,utRho03
1189,pykA,3874988,3875298,3874988,310,226,utRho03
1190,pykF,3510934,3511396,3510934,462,1226,utRho03
1191,pyrC,2245286,2245286,2245214,72,264,utRho03
1192,pyrD,2009464,2009536,2009464,72,18,utRho03
1193,pyrE,7631970,7631970,7631536,434,86,utRho03
1194,pyrF,2683740,2683842,2683740,102,368,utRho03
1195,pyrG,5819594,5819594,5819332,262,2416,utRho03
1196,pyrH,383624,383710,383624,86,1356,utRho03
1197,pyrL,8945490,8945490,8945066,424,78,utRho03
1198,qmcA,1031646,1031646,1031546,100,0,utRho03
1199,qor,8528608,8528608,8528462,146,178,utRho03
1200,qseB,6339502,6339656,6339502,154,28,utRho03
1201,queA,849970,850022,849970,52,530,utRho03
1202,queE,5811212,5811212,5810836,376,56,utRho03
1203,queF,5850642,5850696,5850642,54,0,utRho03
1204,queG,8788184,8788184,8788134,50,648,utRho03
1205,racC,2835630,2835630,2835526,104,0,utRho03
1206,racR,2840898,2840898,2840482,416,88,utRho03
1207,raiA,5474208,5474308,5474208,100,124,utRho03
1208,rarD,8008594,8008594,8008356,238,290,utRho03
1209,ravA,7862256,7862256,7862186,70,32,utRho03
1210,rayT,495088,495274,495088,186,4,utRho03
1211,rbn,4763162,4763216,4763162,54,2,utRho03
1212,rbsD,7866644,7866702,7866644,58,54,utRho03
1213,rcnA,4371654,4371834,4371654,180,0,utRho03
1214,rcnB,4373768,4373920,4373768,152,20,utRho03
1215,rcnR,4371806,4371806,4371592,214,8,utRho03
1216,rcsA,4047672,4047936,4047672,264,218,utRho03
1217,rcsB,4631390,4632354,4631390,964,1512,utRho03
1218,rcsC,4640162,4640162,4639656,506,494,utRho03
1219,rcsD,4626904,4626976,4626904,72,342,utRho03
1220,rdgB,6193240,6193362,6193240,122,572,utRho03
1221,rdlA,2538646,2538646,2538646,0,0,utRho03
1222,rdlB,2539712,2539716,2539712,4,0,utRho03
1223,rdlC,2540782,2540786,2540782,4,0,utRho03
1224,rdlD,7400272,7400272,7400272,0,0,utRho03
1225,rdoA,8084782,8084830,8084782,48,76,utRho03
1226,recA,11295276,11295276,11295076,200,1052,utRho03
1227,recC,5925014,5925014,5924856,158,24,utRho03
1228,recF,7763722,7763722,7762442,1280,10626,utRho03
1229,recN,5503518,5503590,5503518,72,22,utRho03
1230,recQ,8011666,8011728,8011666,62,30,utRho03
1231,relA,5828554,5828554,5827302,1252,292,utRho03
1232,relB,3291806,3291806,3291744,62,0,utRho03
1233,rem,3289950,3289950,3289804,146,0,utRho03
1234,rep,7921294,7921354,7921294,60,54,utRho03
1235,rfaD,7587730,7587974,7587730,244,374,utRho03
1236,rfaE,6393852,6393852,6393506,346,4,utRho03
1237,rfaH,8049930,8049930,8049642,288,1534,utRho03
1238,rfbX,4219436,4219436,4219168,268,2854,utRho03
1239,rfe,7935600,7935832,7935600,232,80,utRho03
1240,rhaB,8194944,8194944,8194896,48,0,utRho03
1241,rhaD,8188770,8188770,8188544,226,0,utRho03
1242,rhaS,8195422,8195472,8195422,50,0,utRho03
1243,rhaT,8201132,8201132,8201050,82,18,utRho03
1244,rhlE,1661566,1661744,1661566,178,450,utRho03
1245,rhoL,47593944,47594772,47593944,828,363060,utRho03
1246,rhsB,7238006,7238384,7238006,378,94,utRho03
1247,rhsC,1458758,1459166,1458758,408,0,utRho03
1248,rhsD,1046132,1046522,1046132,390,0,utRho03
1249,rhtA,1700608,1700608,1700194,414,148,utRho03
1250,rhtC,8015478,8015514,8015478,36,2310,utRho03
1251,ribA,2678468,2678468,2678320,148,52,utRho03
1252,ribC,3486916,3486916,3486484,432,142,utRho03
1253,ribE,869008,869294,869008,286,6498,utRho03
1254,ribF,42766,42814,42766,48,56,utRho03
1255,ridA,8941892,8941892,8941826,66,44,utRho03
1256,rihA,1369204,1369204,1368824,380,372,utRho03
1257,rihB,4510504,4510504,4510372,132,0,utRho03
1258,rimJ,2251044,2251124,2251044,80,0,utRho03
1259,rimK,1783752,1783934,1783752,182,230,utRho03
1260,rimL,2997486,2997876,2997486,390,106,utRho03
1261,rimO,1756140,1756140,1756070,70,38,utRho03
1262,rimP,6636350,6636350,6636012,338,1110,utRho03
1263,rlmA,3814172,3814172,3814120,52,226,utRho03
1264,rlmD,5830086,5830086,5830000,86,42,utRho03
1265,rlmE,6655520,6655520,6655328,192,2150,utRho03
1266,rlmF,1684384,1684664,1684384,280,42,utRho03
1267,rlmG,6471784,6471784,6471750,34,24,utRho03
1268,rlmI,2060002,2060002,2059938,64,40,utRho03
1269,rlmJ,7290700,7290770,7290700,70,190,utRho03
1270,rlmL,2015344,2015688,2015344,344,1326,utRho03
1271,rlpA,1330444,1330444,1330380,64,134,utRho03
1272,rluA,120900,120900,120692,208,312,utRho03
1273,rluF,8460324,8460708,8460324,384,102,utRho03
1274,rmf,2031006,2031430,2031006,424,1546,utRho03
1275,rna,1290068,1290068,1290006,62,0,utRho03
1276,rnb,2698258,2698258,2697824,434,2742,utRho03
1277,rnc,10816892,10816892,10816252,640,10656,utRho03
1278,rnd,3776122,3776122,3775982,140,256,utRho03
1279,rne,2289746,2289746,2288734,1012,10958,utRho03
1280,rnhA,472082,472082,472004,78,336,utRho03
1281,rnk,1288360,1288360,1287934,426,140,utRho03
1282,rnlA,5531788,5531836,5531788,48,230,utRho03
1283,rnlB,5533414,5533968,5533414,554,2274,utRho03
1284,rnpB,19623552,19623552,19623552,0,0,utRho03
1285,rob,9270706,9270706,9270620,86,0,utRho03
1286,rodZ,5285868,5285868,5285688,180,170,utRho03
1287,rpe,7030306,7030306,7030118,188,100,utRho03
1288,rph,15266320,15266320,15266196,124,64,utRho03
1289,rpiA,6118706,6118706,6118650,56,0,utRho03
1290,rpiB,8626514,8626700,8626514,186,0,utRho03
1291,rpiR,8626274,8626274,8625982,292,4,utRho03
1292,rplJ,8359246,8359992,8359246,746,11414,utRho03
1293,rplK,8356708,8356894,8356708,186,610,utRho03
1294,rplM,6757344,6757344,6757302,42,8784,utRho03
1295,rplN,6896444,6896444,6896298,146,5570,utRho03
1296,rplS,5489284,5489284,5489060,224,16534,utRho03
1297,rplT,7199052,7199052,7198996,56,524,utRho03
1298,rplU,6667036,6667036,6666902,134,158,utRho03
1299,rplY,4564866,4565034,4564866,168,154,utRho03
1300,rpmA,6666450,6666450,6666238,212,1180,utRho03
1301,rpmB,15247980,15247980,15246696,1284,107880,utRho03
1302,rpmE,8253816,8254026,8253816,210,710,utRho03
1303,rpmF,2294676,2294734,2294676,58,38934,utRho03
1304,rpmH,7768130,7768672,7768130,542,5532,utRho03
1305,rpmI,3600854,3600854,3599998,856,11396,utRho03
1306,rpoB,8362126,8362490,8362126,364,1100,utRho03
1307,rpoD,6424946,6426094,6424946,1148,19102,utRho03
1308,rpoE,5420372,5420372,5420024,348,0,utRho03
1309,rpoH,7202006,7202006,7201566,440,20040,utRho03
1310,rpoN,6689324,6689434,6689324,110,10,utRho03
1311,rpoS,5736236,5736236,5735102,1134,3178,utRho03
1312,rpoZ,7644154,7644212,7644154,58,734,utRho03
1313,rppH,5937986,5937986,5937954,32,24,utRho03
1314,rprA,3540744,3540744,3540744,0,0,utRho03
1315,rpsA,1923434,1923990,1923434,556,158508,utRho03
1316,rpsF,8850050,8850236,8850050,186,34242,utRho03
1317,rpsI,6756580,6756580,6756414,166,8490,utRho03
1318,rpsJ,6906884,6906884,6906540,344,8810,utRho03
1319,rpsL,6949242,6949242,6949104,138,228,utRho03
1320,rpsM,6885130,6885130,6884942,188,2304,utRho03
1321,rpsO,13247144,13247144,13246736,408,1580,utRho03
1322,rpsP,5492508,5492508,5492370,138,218,utRho03
1323,rpsT,42420,42420,42156,264,514,utRho03
1324,rpsU,12842584,12843124,12842584,540,1484,utRho03
1325,rraA,8238716,8238716,8238660,56,160,utRho03
1326,rraB,8956768,8956946,8956768,178,0,utRho03
1327,rrsA,8070478,8071062,8070478,584,6568,utRho03
1328,rrsB,16665468,16666636,16665468,1168,14756,utRho03
1329,rrsC,7883032,7883616,7883032,584,7424,utRho03
1330,rrsD,6858094,6858094,6857524,570,536,utRho03
1331,rrsE,8415726,8416294,8415726,568,1196,utRho03
1332,rrsG,5462896,5462896,5462314,582,5596,utRho03
1333,rrsH,446970,447542,446970,572,1162,utRho03
1334,rsd,8393908,8393908,8393616,292,82,utRho03
1335,rseA,5419264,5419264,5418808,456,544,utRho03
1336,rseP,392940,393092,392940,152,40,utRho03
1337,rseX,4067298,4067298,4067298,0,0,utRho03
1338,rsfS,1338144,1338144,1338072,72,498,utRho03
1339,rsgA,8783132,8783132,8783018,114,0,utRho03
1340,rsmA,105176,105176,104860,316,3116,utRho03
1341,rsmB,6869982,6870414,6869982,432,254,utRho03
1342,rsmC,9215736,9215736,9215400,336,698,utRho03
1343,rsmD,7208594,7208786,7208594,192,68,utRho03
1344,rsmE,6182036,6182268,6182036,232,244,utRho03
1345,rsmG,7847512,7847512,7847360,152,2560,utRho03
1346,rsmH,180020,180188,180020,168,336,utRho03
1347,rsmI,6587106,6587106,6586670,436,568,utRho03
1348,rssA,2578212,2578412,2578212,200,430,utRho03
1349,rssB,2580440,2580484,2580440,44,298,utRho03
1350,rstA,3364276,3364300,3364276,24,58,utRho03
1351,rsuA,4561096,4561096,4560966,130,412,utRho03
1352,rsxA,3411510,3411534,3411510,24,22,utRho03
1353,rtcA,7114004,7114004,7113698,306,16,utRho03
1354,rtcB,7116214,7116214,7116158,56,0,utRho03
1355,rtn,4541356,4541452,4541356,96,216,utRho03
1356,rutA,2148052,2148052,2148022,30,0,utRho03
1357,rutG,2140090,2140090,2139678,412,0,utRho03
1358,rutR,2148226,2148484,2148226,258,2,utRho03
1359,ruvA,7784096,7784096,7783904,192,24,utRho03
1360,ruvB,7782176,7782176,7781424,752,716,utRho03
1361,ruvC,3894878,3894878,3894752,126,0,utRho03
1362,rybB,1776114,1776114,1776114,0,0,utRho03
1363,rydB,3529860,3529860,3529322,538,90,utRho03
1364,rydC,2983012,2983012,2983012,0,0,utRho03
1365,ryfA,5307398,5307710,5307398,312,0,utRho03
1366,ryfD,5468590,5468590,5468590,0,0,utRho03
1367,ryhB,7162032,7162032,7162032,0,0,utRho03
1368,ryjA,8556132,8556132,8556132,0,0,utRho03
1369,ryjB,9055954,9055954,9055954,0,0,utRho03
1370,sad,3229598,3229598,3229406,192,136,utRho03
1371,safA,3168056,3168056,3167918,138,12,utRho03
1372,sanA,4465368,4465756,4465368,388,98,utRho03
1373,sapF,2705314,2705314,2705268,46,100,utRho03
1374,sbcB,4165456,4165512,4165456,56,18,utRho03
1375,sbcC,831694,831694,831506,188,102,utRho03
1376,sbcD,833954,833954,833904,50,12,utRho03
1377,sbmA,793106,793278,793106,172,90,utRho03
1378,sbmC,4162650,4162650,4162524,126,0,utRho03
1379,sdaA,3793618,3793864,3793618,246,32,utRho03
1380,sdaC,5856070,5856458,5856070,388,430,utRho03
1381,sdhC,1509916,1510354,1509916,438,21294,utRho03
1382,sdhD,1510808,1511120,1510808,312,5142,utRho03
1383,sdiA,3993834,3993834,3993664,170,0,utRho03
1384,secE,8354354,8354716,8354354,362,398,utRho03
1385,secG,6645180,6645180,6645010,170,1786,utRho03
1386,selA,7522594,7522594,7522498,96,438,utRho03
1387,selB,7519850,7519850,7519722,128,90,utRho03
1388,selC,7672396,7672444,7672396,48,2,utRho03
1389,selD,3696058,3696058,3696016,42,4298,utRho03
1390,seqA,1425884,1425974,1425884,90,592,utRho03
1391,serA,6117098,6117098,6116820,278,54,utRho03
1392,serB,9249712,9249790,9249712,78,0,utRho03
1393,serC,3830380,3830612,3830380,232,0,utRho03
1394,serS,1878730,1878856,1878730,126,2554,utRho03
1395,serT,2063438,2063438,2063424,14,0,utRho03
1396,serU,4087124,4087124,4087114,10,6,utRho03
1397,serV,5637394,5637394,5637290,104,156,utRho03
1398,serW,1852014,1852014,1851942,72,252,utRho03
1399,serX,2195352,2195352,2195304,48,2,utRho03
1400,setB,4527426,4527726,4527426,300,0,utRho03
1401,setC,7673488,7673906,7673488,418,18,utRho03
1402,sfmA,1116124,1116424,1116124,300,0,utRho03
1403,sfmC,1117606,1117948,1117606,342,0,utRho03
1404,sfsA,323030,323030,322972,58,334,utRho03
1405,sfsB,6669592,6669818,6669592,226,190,utRho03
1406,sgrR,154676,154676,154598,78,44,utRho03
1407,sgrS,154734,154734,154734,0,0,utRho03
1408,shiA,4107068,4107286,4107068,218,124,utRho03
1409,sibA,4306622,4306622,4306622,0,0,utRho03
1410,sibB,4307292,4307292,4307292,0,0,utRho03
1411,sibC,6113702,6113702,6113702,0,0,utRho03
1412,sibD,6389730,6389730,6389730,0,0,utRho03
1413,sibE,6390480,6390480,6390480,0,0,utRho03
1414,sixA,4913998,4913998,4913624,374,0,utRho03
1415,slp,7307872,7307922,7307872,50,36,utRho03
1416,slt,9261400,9261466,9261400,66,114,utRho03
1417,slyA,3442028,3442028,3441648,380,202,utRho03
1418,slyB,3439496,3439752,3439496,256,72,utRho03
1419,slyD,6957398,6957398,6956994,404,252,utRho03
1420,slyX,6954862,6955280,6954862,418,7170,utRho03
1421,smf,6867372,6867372,6867120,252,36,utRho03
1422,smpB,5509534,5509792,5509534,258,1428,utRho03
1423,smrA,2811872,2811958,2811872,86,136,utRho03
1424,smrB,4896872,4897212,4896872,340,6,utRho03
1425,smtA,1946808,1947074,1946808,266,64,utRho03
1426,sodA,8201518,8201620,8201518,102,5428,utRho03
1427,sodB,3470646,3470756,3470646,110,0,utRho03
1428,sodC,3449358,3449358,3449310,48,0,utRho03
1429,sohB,2658568,2658664,2658568,96,0,utRho03
1430,sokB,2984232,2984238,2984232,6,16,utRho03
1431,solA,2241218,2241218,2241172,46,14,utRho03
1432,soxR,8554894,8554938,8554894,44,0,utRho03
1433,soxS,8554846,8554846,8554766,80,0,utRho03
1434,speA,6172096,6172096,6171822,274,300,utRho03
1435,speB,6167892,6167892,6167594,298,64,utRho03
1436,speC,6218350,6218350,6218310,40,20,utRho03
1437,spf,8099798,8099798,8099798,0,0,utRho03
1438,sppA,3697422,3697674,3697422,252,2,utRho03
1439,spy,3651376,3651376,3651250,126,0,utRho03
1440,sra,3112092,3112092,3111926,166,68,utRho03
1441,sraB,2293178,2293178,2293178,0,0,utRho03
1442,sraC,3846132,3846132,3846132,0,0,utRho03
1443,srlA,5651582,5651664,5651582,82,0,utRho03
1444,srlR,5657720,5658094,5657720,374,550,utRho03
1445,srmB,5425752,5425792,5425752,40,160,utRho03
1446,sroA,151216,151216,151216,0,0,utRho03
1447,sroG,6369436,6369436,6369436,0,0,utRho03
1448,sroH,8380974,8380974,8380974,0,0,utRho03
1449,ssb,8548022,8548250,8548022,228,104,utRho03
1450,sseA,5304782,5304988,5304782,206,3896,utRho03
1451,sspA,6755138,6755138,6754840,298,838,utRho03
1452,ssrA,5511014,5511186,5511014,172,200,utRho03
1453,ssrS,12223036,12223932,12223036,896,1408,utRho03
1454,sstT,6479726,6479888,6479726,162,44,utRho03
1455,ssuB,1988282,1988282,1988088,194,0,utRho03
1456,ssuE,1995126,1995126,1995024,102,0,utRho03
1457,sthA,8321604,8321604,8321580,24,1796,utRho03
1458,stpA,5597156,5597156,5596990,166,58,utRho03
1459,sucA,3034344,3034824,3034344,480,1780,utRho03
1460,sufA,3528836,3528836,3528772,64,52,utRho03
1461,sufE,3518962,3518962,3518580,382,1148,utRho03
1462,sugE,8753588,8753750,8753588,162,520,utRho03
1463,sulA,2041894,2041894,2041838,56,426,utRho03
1464,syd,5850738,5850738,5850560,178,104,utRho03
1465,symE,9159834,9159834,9159680,154,208,utRho03
1466,symR,9159670,9159670,9159670,0,0,utRho03
1467,tabA,8949566,8949724,8949566,158,0,utRho03
1468,talA,5157140,5157332,5157140,192,28,utRho03
1469,talB,16382,16476,16382,94,6514,utRho03
1470,tam,3214442,3214692,3214442,250,34,utRho03
1471,tamA,8884540,8884764,8884540,224,54,utRho03
1472,tar,3945432,3945432,3945382,50,0,utRho03
1473,tas,5943138,5943194,5943138,56,210,utRho03
1474,tatA,16087636,16087780,16087636,144,500,utRho03
1475,tatE,1317742,1317894,1317742,152,70,utRho03
1476,tauA,770410,770464,770410,54,0,utRho03
1477,tdcA,6534186,6534186,6534130,56,0,utRho03
1478,tdcG,6519652,6519652,6519298,354,0,utRho03
1479,tdcR,6534380,6534760,6534380,380,0,utRho03
1480,tdk,2586986,2587054,2586986,68,44,utRho03
1481,tehA,3001072,3001146,3001072,74,0,utRho03
1482,tesA,1039898,1039898,1039530,368,238,utRho03
1483,tesB,950402,950402,950322,80,16,utRho03
1484,tfaE,2418532,2418532,2418238,294,0,utRho03
1485,tfaQ,3269912,3269912,3269770,142,26,utRho03
1486,tff,379424,379256,379424,168,22,utRho03
1487,tgt,852110,852274,852110,164,60,utRho03
1488,thiD,4369346,4369346,4369032,314,32,utRho03
1489,thiI,882936,883098,882936,162,324,utRho03
1490,thiM,4370902,4370902,4370602,300,452,utRho03
1491,thiQ,146170,146170,145854,316,416,utRho03
1492,thrL,592,760,592,168,1244,utRho03
1493,thrS,7210932,7210932,7210280,652,4116,utRho03
1494,thrU,8350762,8350776,8350762,14,0,utRho03
1495,thrV,6847414,6847414,6847310,104,73028,utRho03
1496,thrW,525682,525742,525682,60,792,utRho03
1497,thyA,5930696,5930696,5930310,386,2796,utRho03
1498,tig,909986,910266,909986,280,372,utRho03
1499,tisB,7706674,7707106,7706674,432,606,utRho03
1500,tktA,6163414,6163414,6163270,144,52,utRho03
1501,tktB,5158616,5159272,5158616,656,390,utRho03
1502,tldD,6784368,6784368,6784056,312,14,utRho03
1503,tmcA,5191876,5191876,5191718,158,0,utRho03
1504,tnaC,15553644,15553740,15553644,96,332,utRho03
1505,tolB,1555074,1555480,1555074,406,648,utRho03
1506,tolC,6356008,6356230,6356008,222,558,utRho03
1507,tomB,961588,961588,961416,172,7792,utRho03
1508,tonB,2622108,2622178,2622108,70,0,utRho03
1509,topA,2661578,2662096,2661578,518,1556,utRho03
1510,torC,2116112,2116168,2116112,56,104,utRho03
1511,torR,2115968,2115968,2115908,60,6,utRho03
1512,torS,2112364,2112364,2112356,8,0,utRho03
1513,torT,2112414,2112522,2112414,108,0,utRho03
1514,tpiA,8223138,8223138,8223014,124,64,utRho03
1515,tppB,3425342,3425538,3425342,196,4950,utRho03
1516,tpr,2574376,2574376,2574376,0,0,utRho03
1517,tpx,2777688,2777688,2777622,66,820,utRho03
1518,tqsA,3347780,3347826,3347780,46,0,utRho03
1519,treA,2494850,2494850,2494752,98,148,utRho03
1520,treB,8932420,8932420,8932360,60,46,utRho03
1521,treF,7339102,7339184,7339102,82,100,utRho03
1522,treR,8934694,8934694,8934492,202,0,utRho03
1523,trg,2984878,2984940,2984878,62,34,utRho03
1524,trkG,2847342,2847564,2847342,222,0,utRho03
1525,trmA,8326590,8326590,8326540,50,142,utRho03
1526,trpA,2634678,2634678,2634444,234,692,utRho03
1527,trpC,2639888,2639888,2639570,318,176,utRho03
1528,trpL,5292432,5292432,5292328,104,0,utRho03
1529,trpR,9265408,9265520,9265408,112,156,utRho03
1530,trpS,7027394,7027394,7027276,118,1080,utRho03
1531,trpT,7893560,7893914,7893560,354,50300,utRho03
1532,trxA,7931294,7931522,7931294,228,814,utRho03
1533,trxB,1864156,1864156,1864100,56,128,utRho03
1534,trxC,5437350,5437470,5437350,120,324,utRho03
1535,tsaD,6421256,6421256,6421086,170,112,utRho03
1536,tsgA,6985038,6985136,6985038,98,62,utRho03
1537,tsr,9182824,9183314,9182824,490,262,utRho03
1538,tsx,864490,864490,864026,464,716,utRho03
1539,ttcA,2823970,2823970,2823896,74,2994,utRho03
1540,ttdA,6412848,6412926,6412848,78,0,utRho03
1541,ttdR,6412760,6412760,6412512,248,0,utRho03
1542,tufA,6943448,6943448,6942658,790,123496,utRho03
1543,tus,3368346,3368518,3368346,172,90,utRho03
1544,tusA,7218040,7218040,7217992,48,126,utRho03
1545,tusB,6950218,6950218,6949930,288,1080,utRho03
1546,tynA,2902996,2902996,2902698,298,0,utRho03
1547,typA,8116460,8116814,8116460,354,8048,utRho03
1548,tyrB,8534164,8534228,8534164,64,1722,utRho03
1549,tyrP,3979004,3979362,3979004,358,68,utRho03
1550,tyrR,2773384,2773440,2773384,56,58,utRho03
1551,tyrS,3434566,3434566,3434444,122,0,utRho03
1552,tyrT,2575330,2575330,2575244,86,42,utRho03
1553,uacT,6062378,6062734,6062378,356,44,utRho03
1554,ubiC,8504886,8505012,8504886,126,72,utRho03
1555,ubiD,8049618,8049976,8049618,358,1640,utRho03
1556,ubiE,8037494,8037710,8037494,216,104,utRho03
1557,ubiG,4679078,4679134,4679078,56,0,utRho03
1558,ucpA,5089342,5089342,5089246,96,0,utRho03
1559,udp,8032782,8032862,8032782,80,72,utRho03
1560,ugd,4199470,4199470,4199226,244,0,utRho03
1561,ugpB,7184852,7184852,7184650,202,204,utRho03
1562,ugpQ,7176600,7176600,7176226,374,36,utRho03
1563,uhpT,7694396,7694396,7694334,62,58,utRho03
1564,uidA,3392304,3392304,3392142,162,0,utRho03
1565,uidC,3386012,3386012,3385702,310,0,utRho03
1566,uidR,3394150,3394150,3394104,46,46,utRho03
1567,ulaA,8839854,8839960,8839854,106,118,utRho03
1568,ulaG,8839350,8839350,8839250,100,0,utRho03
1569,ulaR,8837124,8837124,8836906,218,34,utRho03
1570,umpG,5741372,5741372,5740548,824,34,utRho03
1571,umpH,1400704,1400704,1400652,52,28,utRho03
1572,umuD,2461476,2461534,2461476,58,0,utRho03
1573,ung,5433476,5433508,5433476,32,18,utRho03
1574,uof,2843316,2843316,2842900,416,8496,utRho03
1575,upp,5241818,5241818,5241744,74,186,utRho03
1576,usg,4873780,4873780,4873298,482,96,utRho03
1577,ushA,1009772,1009828,1009772,56,0,utRho03
1578,uspA,7279966,7280222,7279966,256,1070,utRho03
1579,uspB,7279696,7279696,7279440,256,1088,utRho03
1580,uspC,3959172,3959506,3959172,334,0,utRho03
1581,uspE,2797318,2797318,2797244,74,18,utRho03
1582,uspF,2871282,2871282,2871238,44,68,utRho03
1583,uspG,1283806,1283806,1283734,72,504,utRho03
1584,uvrA,8547872,8547872,8547742,130,232,utRho03
1585,uvrB,1626304,1627052,1626304,748,1286,utRho03
1586,uvrC,3989758,3989758,3989412,346,76,utRho03
1587,uvrD,7995814,7995966,7995814,152,228,utRho03
1588,uvrY,3990812,3990812,3990718,94,54,utRho03
1589,uxaB,3221474,3221474,3221360,114,0,utRho03
1590,uxaC,6489714,6489714,6489482,232,6,utRho03
1591,uxuA,9103036,9103272,9103036,236,34,utRho03
1592,uxuR,9108916,9109152,9108916,236,40,utRho03
1593,valS,8967854,8967854,8967674,180,614,utRho03
1594,valU,5041848,5041862,5041848,14,0,utRho03
1595,valV,3492830,3492870,3492830,40,0,utRho03
1596,ves,3649968,3649968,3649874,94,26,utRho03
1597,waaA,7616512,7617080,7616512,568,686,utRho03
1598,waaH,7580298,7580298,7580162,136,0,utRho03
1599,waaQ,7616476,7616476,7616196,280,134,utRho03
1600,waaU,7598996,7598996,7598624,372,278,utRho03
1601,waaY,7602272,7602272,7601930,342,7462,utRho03
1602,wbbH,4214888,4214888,4214452,436,9902,utRho03
1603,wbbK,4209212,4209212,4209018,194,394,utRho03
1604,wcaM,4231868,4231868,4231792,76,0,utRho03
1605,wrbA,2135516,2135516,2135416,100,0,utRho03
1606,wza,4275166,4275166,4274486,680,0,utRho03
1607,wzxC,4240674,4240674,4240316,358,0,utRho03
1608,wzzB,4196950,4196950,4196602,348,192,utRho03
1609,xanP,7657642,7657890,7657642,248,30,utRho03
1610,xanQ,6048520,6048702,6048520,182,0,utRho03
1611,xapA,5049820,5049820,5049756,64,0,utRho03
1612,xapR,10090252,10090252,10089908,344,0,utRho03
1613,xdhA,6000514,6000690,6000514,176,74,utRho03
1614,xerD,6079702,6079702,6079486,216,204,utRho03
1615,xseA,5268394,5268464,5268394,70,512,utRho03
1616,xseB,882746,882746,882686,60,310,utRho03
1617,xthA,3664798,3664856,3664798,58,0,utRho03
1618,xylA,7461614,7461614,7461530,84,142,utRho03
1619,xylE,8484540,8484540,8484508,32,0,utRho03
1620,xylF,7462138,7462262,7462138,124,0,utRho03
1621,xylR,7469812,7469958,7469812,146,0,utRho03
1622,yaaA,13230,13230,12918,312,158,utRho03
1623,yaaI,23876,23876,23572,304,92,utRho03
1624,yaaJ,16034,16034,15918,116,178,utRho03
1625,yaaU,91184,91614,91184,430,0,utRho03
1626,yaaW,23084,23084,22712,372,0,utRho03
1627,yaaX,10060,10468,10060,408,250,utRho03
1628,yabI,142542,142702,142542,160,4,utRho03
1629,yacC,273880,273880,273834,46,3446,utRho03
1630,yacH,262932,262932,262520,412,124,utRho03
1631,yacL,268678,268776,268678,98,44,utRho03
1632,yadD,293796,293936,293796,140,0,utRho03
1633,yadE,289930,290162,289930,232,432,utRho03
1634,yadN,314110,314110,313766,344,52,utRho03
1635,yadS,355572,355572,355248,324,250,utRho03
1636,yadV,312470,312470,312402,68,0,utRho03
1637,yaeF,434270,434270,434006,264,18,utRho03
1638,yaeP,428374,428374,428250,124,46,utRho03
1639,yaeQ,428176,428582,428176,406,148,utRho03
1640,yaeR,423716,423754,423716,38,0,utRho03
1641,yafC,462166,462166,461762,404,202,utRho03
1642,yafD,462128,462244,462128,116,106,utRho03
1643,yafK,491986,491986,491610,376,2764,utRho03
1644,yafL,493282,493424,493282,142,72,utRho03
1645,yafN,503938,504010,503938,72,14,utRho03
1646,yafS,469568,469632,469568,64,332,utRho03
1647,yafT,474470,474670,474470,200,8,utRho03
1648,yafV,480432,480432,480378,54,22,utRho03
1649,yafZ,536052,536052,536010,42,6,utRho03
1650,yagE,564446,564556,564446,110,0,utRho03
1651,yagG,570414,570790,570414,376,0,utRho03
1652,yagI,578384,578384,578324,60,24,utRho03
1653,yagK,586236,586236,585896,340,38,utRho03
1654,yagL,588062,588062,587836,226,2,utRho03
1655,yagN,591342,591342,591158,184,1596,utRho03
1656,yahA,663746,664742,663746,996,330,utRho03
1657,yahC,670136,670136,670044,92,24,utRho03
1658,yahE,671478,671850,671478,372,20,utRho03
1659,yahM,690504,690808,690504,304,72,utRho03
1660,yahN,692872,692872,692674,198,8,utRho03
1661,yahO,692864,692968,692864,104,2,utRho03
1662,yaiE,816296,816354,816296,58,22,utRho03
1663,yaiI,811396,811528,811396,132,0,utRho03
1664,yaiO,761946,761946,761684,262,0,utRho03
1665,yaiP,767970,767970,767870,100,0,utRho03
1666,yaiS,769660,769660,769232,428,20,utRho03
1667,yaiV,788922,788922,788922,0,0,utRho03
1668,yaiY,799094,799094,798666,428,300,utRho03
1669,yaiZ,798888,799186,798888,298,850,utRho03
1670,yajC,854410,854574,854410,164,1426,utRho03
1671,yajD,860938,861210,860938,272,690,utRho03
1672,yajI,866068,866068,865702,366,256,utRho03
1673,yajL,887496,887496,887282,214,168,utRho03
1674,yajQ,889316,889366,889316,50,36,utRho03
1675,yajR,893374,893374,893332,42,328,utRho03
1676,ybaB,987418,988152,987418,734,2878,utRho03
1677,ybaL,1006590,1006590,1006476,114,72,utRho03
1678,ybaM,980648,980648,980542,106,756,utRho03
1679,ybaN,981436,981764,981436,328,396,utRho03
1680,ybaO,936704,936766,936704,62,0,utRho03
1681,ybaP,1016568,1016568,1016160,408,954,utRho03
1682,ybaQ,1016348,1016436,1016348,88,78,utRho03
1683,ybaS,1023146,1023282,1023146,136,26,utRho03
1684,ybaV,927504,927874,927504,370,40,utRho03
1685,ybaY,950490,950758,950490,268,148,utRho03
1686,ybbB,1062724,1062724,1062452,272,0,utRho03
1687,ybbJ,1030154,1030154,1029718,436,316,utRho03
1688,ybbL,1031784,1031838,1031784,54,0,utRho03
1689,ybbN,1037136,1037136,1036558,578,936,utRho03
1690,ybbO,1038658,1038658,1038298,360,1014,utRho03
1691,ybbY,1080718,1081130,1080718,412,44,utRho03
1692,ybcH,1176140,1176140,1175962,178,44,utRho03
1693,ybcI,1113264,1113264,1113106,158,844,utRho03
1694,ybcJ,1114050,1114050,1113746,304,192,utRho03
1695,ybcK,1137502,1137804,1137502,302,28,utRho03
1696,ybcL,1141690,1141786,1141690,96,0,utRho03
1697,ybcN,1144628,1144932,1144628,304,0,utRho03
1698,ybcQ,1147548,1147912,1147548,364,2,utRho03
1699,ybcW,1159610,1159760,1159610,150,0,utRho03
1700,ybdD,1263982,1264364,1263982,382,64,utRho03
1701,ybdF,1212106,1212106,1211772,334,72,utRho03
1702,ybdH,1267048,1267048,1266954,94,36,utRho03
1703,ybdJ,1212822,1212822,1212398,424,0,utRho03
1704,ybdK,1215122,1215122,1214766,356,270,utRho03
1705,ybdL,1267114,1267172,1267114,58,0,utRho03
1706,ybdM,1271110,1271110,1270752,358,24,utRho03
1707,ybdN,1273372,1273372,1273138,234,0,utRho03
1708,ybdR,1283844,1284176,1283844,332,636,utRho03
1709,ybeD,1325412,1325412,1325284,128,210,utRho03
1710,ybeF,1323090,1323090,1322756,334,282,utRho03
1711,ybeL,1349986,1350036,1349986,50,58,utRho03
1712,ybeQ,1353412,1353412,1353094,318,0,utRho03
1713,ybeR,1353120,1353422,1353120,302,0,utRho03
1714,ybeT,1358832,1358832,1358812,20,0,utRho03
1715,ybeU,1358924,1359016,1358924,92,4,utRho03
1716,ybeZ,1386938,1386938,1386834,104,2600,utRho03
1717,ybfA,1458074,1458268,1458074,194,78,utRho03
1718,ybfE,1423878,1423878,1423796,82,228,utRho03
1719,ybfF,1425692,1425692,1425604,88,670,utRho03
1720,ybfH,1433282,1433282,1433194,88,0,utRho03
1721,ybgA,1477840,1478002,1477840,162,4,utRho03
1722,ybgC,1549288,1549504,1549288,216,28,utRho03
1723,ybgD,1505916,1505916,1505590,326,452,utRho03
1724,ybgI,1485238,1485654,1485238,416,0,utRho03
1725,ybgO,1498370,1498370,1497964,406,24,utRho03
1726,ybgS,1570992,1570992,1570634,358,0,utRho03
1727,ybhA,1597184,1597184,1596862,322,78,utRho03
1728,ybhB,1616070,1616070,1615818,252,100,utRho03
1729,ybhC,1614642,1614642,1614562,80,592,utRho03
1730,ybhD,1601418,1601418,1601276,142,0,utRho03
1731,ybhH,1601104,1601518,1601104,414,0,utRho03
1732,ybhK,1633384,1633384,1633294,90,30,utRho03
1733,ybhM,1641556,1641586,1641556,30,0,utRho03
1734,ybhN,1645296,1645296,1644996,300,60,utRho03
1735,ybhQ,1649202,1649260,1649202,58,68,utRho03
1736,ybiA,1665920,1665920,1665900,20,10,utRho03
1737,ybiI,1676968,1676968,1676912,56,92,utRho03
1738,ybiO,1691328,1691328,1690960,368,96,utRho03
1739,ybiP,1705252,1705252,1705194,58,1296,utRho03
1740,ybiS,1711572,1711572,1711488,84,426,utRho03
1741,ybiT,1711894,1711926,1711894,32,0,utRho03
1742,ybiU,1718212,1718212,1718122,90,34,utRho03
1743,ybiV,1720176,1720176,1720056,120,0,utRho03
1744,ybiW,1725566,1725566,1725212,354,32,utRho03
1745,ybiX,1678548,1678548,1678414,134,1926,utRho03
1746,ybjC,1781784,1781826,1781784,42,0,utRho03
1747,ybjE,1830154,1830154,1829714,440,32,utRho03
1748,ybjG,1767016,1767016,1766776,240,824,utRho03
1749,ybjL,1779882,1779882,1779638,244,230,utRho03
1750,ybjM,1779770,1780178,1779770,408,134,utRho03
1751,ybjO,1795704,1795978,1795704,274,0,utRho03
1752,ybjP,1809046,1809046,1808934,112,0,utRho03
1753,ybjQ,1809034,1809186,1809034,152,0,utRho03
1754,ybjS,1813796,1813796,1813506,290,140,utRho03
1755,ybjX,1838206,1838206,1838168,38,40,utRho03
1756,ycaD,1891438,1891742,1891438,304,0,utRho03
1757,ycaI,1928210,1928640,1928210,430,216,utRho03
1758,ycaK,1899094,1899336,1899094,242,20,utRho03
1759,ycaL,1920264,1920528,1920264,264,12,utRho03
1760,ycaM,1894240,1894458,1894240,218,48,utRho03
1761,ycaR,1941284,1941346,1941284,62,1980,utRho03
1762,ycbB,1961862,1962094,1961862,232,0,utRho03
1763,ycbJ,1943344,1943504,1943344,160,24,utRho03
1764,ycbK,1966046,1966150,1966046,104,208,utRho03
1765,ycbZ,2036920,2036920,2036598,322,60,utRho03
1766,yccA,2062886,2062886,2062836,50,390,utRho03
1767,yccF,2048730,2048730,2048696,34,0,utRho03
1768,yccS,2047988,2047988,2047766,222,14,utRho03
1769,yccT,2055674,2055674,2055546,128,32,utRho03
1770,yccX,2059960,2060128,2059960,168,242,utRho03
1771,ycdT,2185682,2185752,2185682,70,0,utRho03
1772,ycdU,2191266,2191686,2191266,420,0,utRho03
1773,ycdZ,2200504,2200592,2200504,88,212,utRho03
1774,yceA,2233544,2233614,2233544,70,156,utRho03
1775,yceD,2293298,2293588,2293298,290,4474,utRho03
1776,yceF,2293522,2293522,2293190,332,2630,utRho03
1777,yceH,2252154,2252314,2252154,160,346,utRho03
1778,yceI,2237282,2237282,2236952,330,138,utRho03
1779,yceJ,2238142,2238142,2238092,50,14,utRho03
1780,yceM,2253208,2253612,2253208,404,52,utRho03
1781,yceO,2239264,2239264,2238894,370,378,utRho03
1782,yceQ,2288760,2289004,2288760,244,9190,utRho03
1783,ycfD,2376540,2376540,2376480,60,352,utRho03
1784,ycfJ,2334814,2335198,2334814,384,790,utRho03
1785,ycfS,2340834,2340834,2340748,86,32,utRho03
1786,ycfT,2350658,2350658,2350330,328,24,utRho03
1787,ycfZ,2362760,2362760,2362534,226,434,utRho03
1788,ycgB,2474570,2474570,2474482,88,26,utRho03
1789,ycgG,2434614,2434656,2434614,42,0,utRho03
1790,ycgJ,2452956,2453200,2452956,244,30,utRho03
1791,ycgL,2455218,2455362,2455218,144,0,utRho03
1792,ycgN,2457366,2457660,2457366,294,44,utRho03
1793,ycgR,2489112,2489112,2489054,58,28,utRho03
1794,ycgV,2512222,2512222,2511904,318,112,utRho03
1795,ycgX,2426568,2426568,2426214,354,20606,utRho03
1796,ycgY,2490166,2490320,2490166,154,0,utRho03
1797,ycgZ,2431504,2431578,2431504,74,0,utRho03
1798,ychE,2596904,2597196,2596904,292,12,utRho03
1799,ychF,2515764,2515764,2515624,140,0,utRho03
1800,ychH,2517476,2517582,2517476,106,568,utRho03
1801,ychJ,2578354,2578354,2578264,90,60,utRho03
1802,ychN,2547310,2547310,2547198,112,126,utRho03
1803,ychO,2547520,2547850,2547520,330,264,utRho03
1804,ychQ,2533798,2533848,2533798,50,136,utRho03
1805,yciA,2624828,2624828,2624492,336,348,utRho03
1806,yciB,2626110,2626110,2625780,330,3862,utRho03
1807,yciC,2627396,2627396,2627326,70,0,utRho03
1808,yciE,2630794,2630794,2630448,346,4,utRho03
1809,yciG,5264368,5264368,5264140,228,0,utRho03
1810,yciI,2621784,2621784,2621730,54,48,utRho03
1811,yciN,2661606,2661606,2661336,270,38,utRho03
1812,yciS,2680270,2680486,2680270,216,20,utRho03
1813,yciT,2689088,2689088,2688692,396,538,utRho03
1814,yciU,2614718,2614718,2614300,418,3990,utRho03
1815,yciV,2646376,2646440,2646376,64,0,utRho03
1816,yciW,2700472,2700472,2700214,258,538,utRho03
1817,yciZ,2689276,2689276,2689218,58,388,utRho03
1818,ycjD,2703792,2703792,2703520,272,74,utRho03
1819,ycjG,2777748,2777860,2777748,112,160,utRho03
1820,ycjM,2740006,2740432,2740006,426,12,utRho03
1821,ycjW,2767982,2767982,2767922,60,42,utRho03
1822,ycjX,2768138,2768234,2768138,96,0,utRho03
1823,ycjY,5568288,5568288,5567460,828,164,utRho03
1824,ydaE,2836438,2836438,2836016,422,0,utRho03
1825,ydaN,2816048,2816100,2816048,52,0,utRho03
1826,ydaS,2840340,2840730,2840340,390,240,utRho03
1827,ydbC,2948376,2948442,2948376,66,0,utRho03
1828,ydbD,2950132,2950288,2950132,156,14,utRho03
1829,ydbH,2885800,2886102,2885800,302,2,utRho03
1830,ydbJ,2881712,2882116,2881712,404,132,utRho03
1831,ydbK,2881692,2881692,2881568,124,34,utRho03
1832,ydcA,2983294,2983354,2983294,60,10,utRho03
1833,ydcF,2974404,2974470,2974404,66,38,utRho03
1834,ydcI,2990268,2990268,2990142,126,16,utRho03
1835,ydcJ,2990266,2990576,2990266,310,2,utRho03
1836,ydcK,3001280,3001280,3000898,382,0,utRho03
1837,ydcL,3004646,3004914,3004646,268,0,utRho03
1838,ydcN,3012308,3012344,3012308,36,6,utRho03
1839,ydcP,3013508,3013562,3013508,54,68,utRho03
1840,ydcR,3019956,3020006,3019956,50,0,utRho03
1841,ydcS,3022906,3023308,3022906,402,8,utRho03
1842,ydcX,3034442,3034778,3034442,336,332,utRho03
1843,ydcY,3035220,3035296,3035220,76,150,utRho03
1844,ydcZ,3036750,3036750,3036662,88,138,utRho03
1845,yddB,3155332,3155332,3155238,94,20,utRho03
1846,yddE,3071738,3071738,3071716,22,0,utRho03
1847,yddG,3094410,3094410,3094338,72,0,utRho03
1848,yddJ,3089732,3089732,3089438,294,0,utRho03
1849,yddW,3137704,3137704,3137646,58,2,utRho03
1850,ydeA,3233910,3234056,3233910,146,244,utRho03
1851,ydeE,3242528,3242664,3242528,136,0,utRho03
1852,ydeI,3249118,3249118,3248994,124,0,utRho03
1853,ydeJ,3249376,3249546,3249376,170,0,utRho03
1854,ydeN,3165458,3165458,3165048,410,0,utRho03
1855,ydeP,3173328,3173328,3172972,356,0,utRho03
1856,ydeR,3176596,3176596,3176592,4,0,utRho03
1857,ydfA,3296872,3297016,3296872,144,68,utRho03
1858,ydfG,3254982,3255034,3254982,52,0,utRho03
1859,ydfH,3256652,3256704,3256652,52,42,utRho03
1860,ydfK,3265446,3266144,3265446,698,55892,utRho03
1861,ydgA,3379588,3379704,3379588,116,24,utRho03
1862,ydgC,3364124,3364124,3364060,64,70,utRho03
1863,ydgD,3343906,3343920,3343906,14,84,utRho03
1864,ydgH,3356754,3356854,3356754,100,26,utRho03
1865,ydgJ,3408798,3408798,3408616,182,132,utRho03
1866,ydgK,3410414,3410500,3410414,86,102,utRho03
1867,ydhB,3479618,3479618,3479596,22,0,utRho03
1868,ydhC,3479698,3479822,3479698,124,6,utRho03
1869,ydhF,3451310,3451310,3451264,46,24,utRho03
1870,ydhI,3441996,3442050,3441996,54,0,utRho03
1871,ydhL,3451864,3451864,3451840,24,0,utRho03
1872,ydhQ,3492404,3492404,3492254,150,6,utRho03
1873,ydhS,3494136,3494262,3494136,126,340,utRho03
1874,ydhT,3499138,3499138,3499118,20,0,utRho03
1875,ydhY,3509284,3509284,3508954,330,0,utRho03
1876,ydhZ,3510418,3510418,3510282,136,0,utRho03
1877,ydiE,3579206,3579226,3579206,20,36,utRho03
1878,ydiH,3530582,3530582,3530406,176,16,utRho03
1879,ydiM,3541852,3542142,3541852,290,0,utRho03
1880,ydiN,3544818,3545024,3544818,206,0,utRho03
1881,ydiP,3558656,3558656,3558602,54,0,utRho03
1882,ydiU,3582508,3582508,3582488,20,76,utRho03
1883,ydiV,3584174,3584174,3584040,134,146,utRho03
1884,ydiY,3612500,3612500,3612166,334,42,utRho03
1885,ydjA,3697400,3697400,3697352,48,0,utRho03
1886,ydjE,3708082,3708082,3707958,124,0,utRho03
1887,ydjF,3709848,3709848,3709708,140,0,utRho03
1888,ydjM,3620340,3620422,3620340,82,0,utRho03
1889,ydjO,3626696,3626696,3626288,408,0,utRho03
1890,ydjX,3666434,3666802,3666434,368,1248,utRho03
1891,yeaE,3731448,3731448,3731272,176,92,utRho03
1892,yeaG,3733530,3733816,3733530,286,0,utRho03
1893,yeaI,3740486,3740770,3740486,284,0,utRho03
1894,yeaJ,3743874,3744082,3743874,208,58,utRho03
1895,yeaL,3748646,3748704,3748646,58,484,utRho03
1896,yeaM,3751296,3751296,3751152,144,0,utRho03
1897,yeaN,3750926,3751346,3750926,420,0,utRho03
1898,yeaO,3753554,3753818,3753554,264,124,utRho03
1899,yeaP,3755314,3755430,3755314,116,1084,utRho03
1900,yeaQ,3758780,3758780,3758510,270,118,utRho03
1901,yeaR,3759988,3759988,3759896,92,16,utRho03
1902,yeaY,3781122,3781122,3781064,58,136,utRho03
1903,yebB,3892220,3892502,3892220,282,0,utRho03
1904,yebC,3896370,3896370,3896302,68,24,utRho03
1905,yebE,3859464,3859464,3859414,50,478,utRho03
1906,yebG,3861530,3861530,3861494,36,40,utRho03
1907,yebK,3873180,3873304,3873180,124,12,utRho03
1908,yebQ,3820314,3820552,3820314,238,34,utRho03
1909,yebS,3832238,3832516,3832238,278,78,utRho03
1910,yebV,3843430,3843560,3843430,130,0,utRho03
1911,yebW,3843914,3844242,3843914,328,1402,utRho03
1912,yecC,3995646,3995646,3995628,18,0,utRho03
1913,yecD,3901272,3901664,3901272,392,64,utRho03
1914,yecF,3991434,3991636,3991434,202,160,utRho03
1915,yecH,3979304,3979304,3978980,324,148,utRho03
1916,yecJ,3975604,3975604,3975516,88,12,utRho03
1917,yecM,3919968,3919968,3919692,276,20,utRho03
1918,yecR,3976400,3976444,3976400,44,96,utRho03
1919,yecT,3923862,3923944,3923862,82,100,utRho03
1920,yedD,4016522,4016522,4016180,342,34,utRho03
1921,yedE,4016310,4016554,4016310,244,40,utRho03
1922,yedI,4058922,4058922,4058732,190,0,utRho03
1923,yedJ,4066446,4066446,4066158,288,56,utRho03
1924,yedV,4076404,4076404,4076304,100,34,utRho03
1925,yedX,4077680,4077912,4077680,232,0,utRho03
1926,yedY,4078572,4078956,4078572,384,0,utRho03
1927,yeeA,4161322,4161322,4161182,140,76,utRho03
1928,yeeE,4171104,4171104,4171050,54,0,utRho03
1929,yeeJ,4089526,4089822,4089526,296,536,utRho03
1930,yeeN,4113508,4113716,4113508,208,16,utRho03
1931,yeeO,4119444,4119444,4119692,248,0,utRho03
1932,yeeX,4158834,4158834,4158722,112,150,utRho03
1933,yeeZ,4178422,4178422,4178256,166,16,utRho03
1934,yefM,4179466,4179466,4179426,40,96,utRho03
1935,yegD,4295288,4295348,4295288,60,92,utRho03
1936,yegH,4275726,4275804,4275726,78,22,utRho03
1937,yegI,4302154,4302154,4301970,184,26,utRho03
1938,yegJ,4302032,4302370,4302032,338,0,utRho03
1939,yegQ,4331182,4331336,4331182,154,34,utRho03
1940,yegR,4336698,4336698,4336612,86,0,utRho03
1941,yegS,4337086,4337424,4337086,338,0,utRho03
1942,yegT,4357562,4357642,4357562,80,0,utRho03
1943,yegX,4367640,4367640,4367302,338,32,utRho03
1944,yehA,4376944,4376944,4376828,116,0,utRho03
1945,yehE,4385818,4385818,4385592,226,44,utRho03
1946,yehK,4407568,4407944,4407568,376,0,utRho03
1947,yehL,4408804,4409192,4408804,388,0,utRho03
1948,yeiB,4486146,4486146,4485934,212,76,utRho03
1949,yeiE,4499422,4499422,4499236,186,0,utRho03
1950,yeiG,4487776,4487820,4487776,44,372,utRho03
1951,yeiH,4499332,4499434,4499332,102,6,utRho03
1952,yeiI,4503306,4503400,4503306,94,124,utRho03
1953,yeiL,4510580,4510710,4510580,130,0,utRho03
1954,yeiP,4530834,4530900,4530834,66,500,utRho03
1955,yeiQ,4532328,4532490,4532328,162,46,utRho03
1956,yeiR,4535484,4535658,4535484,174,26,utRho03
1957,yeiW,4530840,4530840,4530590,250,560,utRho03
1958,yejA,4544624,4544728,4544624,104,120,utRho03
1959,yejG,4556892,4556892,4556474,418,4448,utRho03
1960,yejH,4561244,4561264,4561244,20,0,utRho03
1961,yejK,4568218,4568218,4567894,324,196,utRho03
1962,yejO,4578352,4578352,4577800,552,110,utRho03
1963,yfaD,4713380,4713808,4713380,428,418,utRho03
1964,yfaE,4696676,4697028,4696676,352,1842,utRho03
1965,yfaL,4688568,4688568,4688338,230,0,utRho03
1966,yfaP,4656398,4656398,4656286,112,0,utRho03
1967,yfaU,4717892,4717892,4717690,202,0,utRho03
1968,yfaY,4727310,4727310,4727266,44,14,utRho03
1969,yfaZ,4728744,4728744,4728550,194,66,utRho03
1970,yfbK,4771810,4771810,4771444,366,10,utRho03
1971,yfbL,4771500,4771720,4771500,220,8,utRho03
1972,yfbN,4777174,4777174,4776852,322,0,utRho03
1973,yfbO,4776916,4777162,4776916,246,0,utRho03
1974,yfbP,4777990,4778232,4777990,242,488,utRho03
1975,yfbR,4817662,4817724,4817662,62,18,utRho03
1976,yfcI,4847424,4847424,4847078,346,54,utRho03
1977,yfcJ,4880482,4880482,4880240,242,182,utRho03
1978,yfcL,4888502,4888502,4888338,164,54,utRho03
1979,yfcV,4911642,4911642,4911292,350,14,utRho03
1980,yfcZ,4921958,4921958,4921868,90,28,utRho03
1981,yfdF,4925604,4926024,4925604,420,754,utRho03
1982,yfdG,4935474,4935710,4935474,236,0,utRho03
1983,yfdP,4946844,4947040,4946844,196,0,utRho03
1984,yfdX,4988866,4988866,4988804,62,0,utRho03
1985,yfdY,4990672,4990672,4990584,88,0,utRho03
1986,yfeA,5035784,5035784,5035664,120,39278,utRho03
1987,yfeC,5036668,5036934,5036668,266,272,utRho03
1988,yfeH,5053818,5053892,5053818,74,2,utRho03
1989,yfeK,5074630,5074684,5074630,54,0,utRho03
1990,yfeO,5018906,5019260,5018906,354,234,utRho03
1991,yfeR,5054078,5054078,5053712,366,6,utRho03
1992,yfeX,5101356,5101356,5101090,266,14,utRho03
1993,yfeY,5102486,5102486,5102432,54,0,utRho03
1994,yfeZ,5103842,5103842,5103452,390,36,utRho03
1995,yffO,5123804,5124222,5123804,418,16,utRho03
1996,yffQ,5126778,5127154,5126778,376,20,utRho03
1997,yffS,5128800,5128986,5128800,186,48,utRho03
1998,yfgC,5232052,5232188,5232052,136,88,utRho03
1999,yfgF,5258062,5258062,5257876,186,0,utRho03
2000,yfgG,5258170,5258580,5258170,410,126,utRho03
2001,yfgH,5259344,5259584,5259344,240,0,utRho03
2002,yfgM,5278866,5278866,5278566,300,574,utRho03
2003,yfhH,5397414,5397518,5397414,104,0,utRho03
2004,yfhM,5304648,5304648,5304574,74,28,utRho03
2005,yfhR,5328408,5328726,5328408,318,4222,utRho03
2006,yfiC,5425610,5425610,5425528,82,0,utRho03
2007,yfiE,5430688,5430688,5430640,48,0,utRho03
2008,yfiL,5482630,5482720,5482630,90,0,utRho03
2009,yfiM,5448066,5448358,5448066,292,20484,utRho03
2010,yfiR,5483354,5483750,5483354,396,188,utRho03
2011,yfjH,5517326,5517326,5517200,126,0,utRho03
2012,yfjI,5517710,5517970,5517710,260,0,utRho03
2013,yfjJ,5521014,5521094,5521014,80,46,utRho03
2014,yfjM,5531970,5531970,5531552,418,1022,utRho03
2015,yfjP,5535080,5535420,5535080,340,288,utRho03
2016,yfjW,5546570,5546636,5546570,66,8,utRho03
2017,yfjX,5551776,5551838,5551776,62,0,utRho03
2018,ygaC,5601180,5601180,5599988,1192,794,utRho03
2019,ygaM,5600242,5600292,5600242,50,122,utRho03
2020,ygaU,5593628,5593628,5593572,56,6,utRho03
2021,ygaZ,5619190,5619234,5619190,44,1100,utRho03
2022,ygbA,5713656,5713656,5713612,44,0,utRho03
2023,ygbE,5746784,5746784,5746674,110,78,utRho03
2024,ygbI,5722882,5722882,5722528,354,0,utRho03
2025,ygbK,5724394,5724670,5724394,276,40,utRho03
2026,ygbL,5727074,5727186,5727074,112,0,utRho03
2027,ygbN,5729814,5730202,5729814,388,42,utRho03
2028,ygcG,5811210,5811422,5811210,212,0,utRho03
2029,ygcN,5785144,5785314,5785144,170,54,utRho03
2030,ygcU,5799214,5799214,5798836,378,44,utRho03
2031,ygcW,5800942,5800942,5800546,396,0,utRho03
2032,ygdD,5883442,5883442,5883262,180,84,utRho03
2033,ygdG,5861746,5861930,5861746,184,470,utRho03
2034,ygdI,5886526,5886526,5886290,236,40,utRho03
2035,ygdQ,5940784,5940840,5940784,56,26,utRho03
2036,ygdR,5942494,5942542,5942494,48,52,utRho03
2037,ygeA,5961606,5961606,5961270,336,0,utRho03
2038,ygeH,5983758,5984188,5983758,430,4,utRho03
2039,ygeI,5987162,5987276,5987162,114,2,utRho03
2040,ygeR,6000078,6000078,5999782,296,122,utRho03
2041,ygeV,6011694,6011694,6011572,122,0,utRho03
2042,ygeW,6012234,6012524,6012234,290,0,utRho03
2043,ygfB,6110946,6110946,6110888,58,90,utRho03
2044,ygfK,6031984,6032120,6031984,136,12,utRho03
2045,ygfS,6058328,6058328,6058024,304,26,utRho03
2046,ygfZ,6082564,6082626,6082564,62,82,utRho03
2047,yggC,6149512,6149512,6149378,134,88,utRho03
2048,yggE,6136370,6136370,6136160,210,0,utRho03
2049,yggI,6179176,6179510,6179176,334,36,utRho03
2050,yggL,6204508,6204508,6204266,242,74,utRho03
2051,yggM,6199514,6199514,6199130,384,146,utRho03
2052,yggN,6203596,6203596,6203246,350,0,utRho03
2053,yggX,18623958,18624558,18623958,600,810,utRho03
2054,yghA,6298966,6299324,6298966,358,22,utRho03
2055,yghB,6307058,6307126,6307058,68,100,utRho03
2056,yghD,6222614,6222614,6222252,362,100,utRho03
2057,yghF,6225798,6225798,6225840,42,0,utRho03
2058,yghJ,6238640,6238640,6238224,416,0,utRho03
2059,yghQ,6265186,6265186,6264816,370,0,utRho03
2060,yghT,6267830,6268262,6267830,432,0,utRho03
2061,yghU,6277400,6277454,6277400,54,52,utRho03
2062,yghW,6293506,6293506,6293474,32,12,utRho03
2063,yghZ,6295562,6295794,6295562,232,0,utRho03
2064,ygiD,6365122,6365122,6364868,254,548,utRho03
2065,ygiH,6409066,6409388,6409066,322,4,utRho03
2066,ygiL,6370622,6370828,6370622,206,0,utRho03
2067,ygiM,6402084,6402414,6402084,330,46,utRho03
2068,ygiN,6346156,6346284,6346156,128,982,utRho03
2069,ygiQ,6322620,6322620,6322292,328,378,utRho03
2070,ygiS,6335462,6335462,6335436,26,0,utRho03
2071,ygiV,6338582,6338582,6338462,120,24,utRho03
2072,ygiW,6339774,6339774,6339352,422,58,utRho03
2073,ygiZ,6344506,6344506,6344422,84,0,utRho03
2074,ygjH,6442528,6442528,6442494,34,32,utRho03
2075,ygjI,6452140,6452468,6452140,328,0,utRho03
2076,ygjQ,6472730,6473080,6472730,350,344,utRho03
2077,ygjR,6474564,6474586,6474564,22,0,utRho03
2078,ygjV,6483638,6483638,6483488,150,0,utRho03
2079,yhaB,6535632,6535708,6535632,76,0,utRho03
2080,yhaH,6504498,6504608,6504498,110,28,utRho03
2081,yhaI,6505400,6505822,6505400,422,0,utRho03
2082,yhaJ,6508560,6508560,6508428,132,64,utRho03
2083,yhaK,6508538,6508638,6508538,100,54,utRho03
2084,yhbQ,6599878,6599932,6599878,54,108,utRho03
2085,yhbT,6602736,6602736,6602552,184,70,utRho03
2086,yhbU,6602558,6602970,6602558,412,106,utRho03
2087,yhbX,6643302,6643302,6643226,76,8,utRho03
2088,yhbY,6655518,6655580,6655518,62,1392,utRho03
2089,yhcA,6723956,6724224,6723956,268,20,utRho03
2090,yhcB,6760364,6760382,6760364,18,146,utRho03
2091,yhcC,6708470,6708470,6708100,370,288,utRho03
2092,yhcF,6733440,6733852,6733440,412,82,utRho03
2093,yhcH,6739124,6739124,6738956,168,16,utRho03
2094,yhcM,6760312,6760312,6759994,318,94,utRho03
2095,yhcN,6770812,6771076,6770812,264,878,utRho03
2096,yhcO,6772606,6772606,6772258,348,36,utRho03
2097,yhdH,6806560,6806968,6806560,408,130,utRho03
2098,yhdJ,6823234,6823306,6823234,72,8,utRho03
2099,yhdN,6879092,6879092,6879018,74,2934,utRho03
2100,yhdT,6814702,6814750,6814702,48,460,utRho03
2101,yhdU,6824994,6825242,6824994,248,98,utRho03
2102,yhdV,6836392,6836780,6836392,388,20,utRho03
2103,yhdW,6837944,6838298,6837944,354,0,utRho03
2104,yheO,6953082,6953082,6952880,202,1230,utRho03
2105,yheV,6957970,6957970,6957584,386,96,utRho03
2106,yhfA,6971902,6971902,6971636,266,108,utRho03
2107,yhfG,6983294,6983294,6983240,54,222,utRho03
2108,yhfL,6998622,6998896,6998622,274,8,utRho03
2109,yhfY,7023244,7023244,7022844,400,0,utRho03
2110,yhgA,7086294,7086334,7086294,40,0,utRho03
2111,yhgE,7065176,7065176,7064878,298,34,utRho03
2112,yhgF,7074352,7074770,7074352,418,1720,utRho03
2113,yhhA,7173458,7173886,7173458,428,70,utRho03
2114,yhhI,7248346,7248756,7248346,410,0,utRho03
2115,yhhJ,7253696,7253696,7253606,90,0,utRho03
2116,yhhM,7211588,7211588,7211220,368,234,utRho03
2117,yhhN,7211150,7211502,7211150,352,190,utRho03
2118,yhhQ,7218238,7218434,7218238,196,798,utRho03
2119,yhhT,7223682,7223730,7223682,48,8,utRho03
2120,yhhX,7162032,7162032,7161610,422,622,utRho03
2121,yhhY,7162222,7162276,7162222,54,92,utRho03
2122,yhhZ,7163516,7163726,7163516,210,0,utRho03
2123,yhiD,7312220,7312220,7311804,416,1928,utRho03
2124,yhiJ,7265190,7265190,7265180,10,0,utRho03
2125,yhiM,7269270,7269682,7269270,412,314,utRho03
2126,yhiN,7275000,7275000,7274820,180,36,utRho03
2127,yhjA,7338522,7338522,7338376,146,16,utRho03
2128,yhjB,7344090,7344090,7343788,302,16,utRho03
2129,yhjC,7344272,7344684,7344272,412,0,utRho03
2130,yhjD,7346660,7346724,7346660,64,0,utRho03
2131,yhjE,7349274,7349572,7349274,298,106,utRho03
2132,yhjG,7356824,7356824,7356730,94,14,utRho03
2133,yhjH,7358458,7358458,7358374,84,30,utRho03
2134,yhjJ,7364032,7364032,7363880,152,76,utRho03
2135,yhjK,7371296,7371296,7371158,138,24,utRho03
2136,yhjR,7392750,7392750,7392370,380,0,utRho03
2137,yhjV,7400796,7401126,7400796,330,896,utRho03
2138,yhjX,7424194,7424194,7424014,180,16,utRho03
2139,yhjY,7425966,7425966,7425868,98,48,utRho03
2140,yiaB,7455654,7455654,7455496,158,0,utRho03
2141,yiaD,7432712,7433094,7432712,382,18,utRho03
2142,yiaF,7438194,7438194,7438088,106,86,utRho03
2143,yiaG,7438862,7438956,7438862,94,122,utRho03
2144,yiaJ,7485236,7485236,7485064,172,0,utRho03
2145,yiaK,7485348,7485466,7485348,118,0,utRho03
2146,yiaT,7503924,7503924,7503736,188,0,utRho03
2147,yiaU,7503792,7503984,7503792,192,0,utRho03
2148,yiaY,7515856,7515856,7515654,202,92,utRho03
2149,yibF,7523950,7523950,7523910,40,16,utRho03
2150,yibG,7536128,7536354,7536128,226,8,utRho03
2151,yibL,7553194,7553330,7553194,136,60,utRho03
2152,yibN,7570112,7570112,7570030,82,306,utRho03
2153,yibT,7552848,7552848,7552760,88,138,utRho03
2154,yicC,7633290,7633352,7633290,62,52,utRho03
2155,yicH,7660862,7660914,7660862,52,8,utRho03
2156,yicJ,7673328,7673328,7671858,1470,252,utRho03
2157,yicN,7685018,7685018,7684804,214,0,utRho03
2158,yicO,7687914,7687914,7687578,336,18,utRho03
2159,yicR,15250308,15250308,15250236,72,0,utRho03
2160,yidB,7755230,7755230,7754930,300,16,utRho03
2161,yidE,7732780,7732780,7732546,234,0,utRho03
2162,yidF,7711580,7711580,7711222,358,66,utRho03
2163,yidQ,7735088,7735456,7735088,368,346,utRho03
2164,yidR,7738824,7738824,7738618,206,0,utRho03
2165,yieE,7787658,7787738,7787658,80,326,utRho03
2166,yieH,7793314,7793548,7793314,234,0,utRho03
2167,yieK,7798928,7798928,7798786,142,0,utRho03
2168,yifB,7900350,7900350,7899998,352,242,utRho03
2169,yifL,7988984,7989044,7988984,60,196,utRho03
2170,yigF,8005750,8005750,8005598,152,42,utRho03
2171,yigI,8009448,8009448,8009394,54,4,utRho03
2172,yigM,8022100,8022152,8022100,52,44,utRho03
2173,yihA,8101970,8101970,8101458,512,132,utRho03
2174,yihD,8084098,8084138,8084098,40,94,utRho03
2175,yihF,8088110,8088398,8088110,288,0,utRho03
2176,yihG,8093304,8093304,8093204,100,12,utRho03
2177,yihI,8102616,8102694,8102616,78,0,utRho03
2178,yihL,8120506,8120894,8120506,388,146,utRho03
2179,yihN,8124332,8124494,8124332,162,0,utRho03
2180,yihO,8131942,8131942,8131532,410,10,utRho03
2181,yihQ,8138892,8138892,8138552,340,0,utRho03
2182,yihV,8147064,8147478,8147064,414,8,utRho03
2183,yihX,8151096,8151106,8151096,10,0,utRho03
2184,yiiE,8158192,8158582,8158192,390,0,utRho03
2185,yiiF,8159124,8159502,8159124,378,4,utRho03
2186,yiiG,8173762,8174004,8173762,242,0,utRho03
2187,yiiM,8205506,8205644,8205506,138,30,utRho03
2188,yiiQ,8224624,8224624,8224428,196,24,utRho03
2189,yiiS,8225738,8225934,8225738,196,32,utRho03
2190,yijE,8272178,8272216,8272178,38,0,utRho03
2191,yijF,8275728,8275728,8275314,414,64,utRho03
2192,yijO,8296858,8296858,8296634,224,16,utRho03
2193,yjaA,8426240,8426468,8426240,228,47008,utRho03
2194,yjaB,8428312,8428312,8428246,66,528,utRho03
2195,yjaG,8398746,8399008,8398746,262,1132,utRho03
2196,yjaH,8401022,8401132,8401022,110,132,utRho03
2197,yjaZ,8379506,8379572,8379506,66,66,utRho03
2198,yjbB,8455204,8455462,8455204,258,0,utRho03
2199,yjbE,16943432,16943624,16943432,192,12,utRho03
2200,yjbL,8520318,8520642,8520318,324,0,utRho03
2201,yjbQ,8540428,8540476,8540428,48,0,utRho03
2202,yjcB,8550328,8550328,8550082,246,8074,utRho03
2203,yjcC,8550836,8550942,8550836,106,134,utRho03
2204,yjcD,8556628,8556958,8556628,330,214,utRho03
2205,yjcE,8559658,8559960,8559658,302,36,utRho03
2206,yjcF,8566212,8566212,8566150,62,0,utRho03
2207,yjcO,8594660,8594660,8594250,410,12,utRho03
2208,yjdA,8654128,8654270,8654128,142,14,utRho03
2209,yjdC,8726660,8726660,8726616,44,0,utRho03
2210,yjdK,8704780,8705168,8704780,388,20,utRho03
2211,yjdL,8713034,8713034,8712822,212,0,utRho03
2212,yjdM,8653672,8653672,8653468,204,20,utRho03
2213,yjeF,8787354,8788132,8787354,778,8428,utRho03
2214,yjeI,8745522,8745618,8745522,96,0,utRho03
2215,yjeJ,8748806,8748806,8748468,338,40,utRho03
2216,yjeV,8785472,8785784,8785472,312,298,utRho03
2217,yjfP,8833512,8833904,8833512,392,16,utRho03
2218,yjfY,8849656,8849656,8849582,74,6,utRho03
2219,yjfZ,8855052,8855052,8854844,208,0,utRho03
2220,yjgA,8916162,8916162,8915730,432,108,utRho03
2221,yjgL,8950802,8950874,8950802,72,0,utRho03
2222,yjgM,8959342,8959342,8959074,268,0,utRho03
2223,yjgN,8959132,8959460,8959132,328,0,utRho03
2224,yjgR,8980170,8980170,8980126,44,78,utRho03
2225,yjgZ,9002116,9002520,9002116,404,712,utRho03
2226,yjhB,9007764,9008116,9007764,352,52,utRho03
2227,yjhG,9048452,9048452,9048188,264,436,utRho03
2228,yjhU,9041080,9041080,9040648,432,278,utRho03
2229,yjiA,9178096,9178096,9177730,366,194,utRho03
2230,yjiJ,9125364,9125364,9125350,14,0,utRho03
2231,yjiK,9127270,9127270,9127422,152,58,utRho03
2232,yjiL,9129604,9129604,9129378,226,54,utRho03
2233,yjiS,9143410,9143502,9143410,92,0,utRho03
2234,yjiY,9182734,9182734,9182558,176,14,utRho03
2235,yjjA,9200674,9200674,9200378,296,472,utRho03
2236,yjjB,18408708,18408708,18407800,908,100,utRho03
2237,yjjJ,9243314,9243538,9243314,224,44,utRho03
2238,yjjK,9261132,9261132,9261044,88,132,utRho03
2239,yjjL,9189764,9189764,9189444,320,0,utRho03
2240,yjjM,9191894,9191894,9191702,192,8,utRho03
2241,yjjP,9206068,9206068,9205716,352,62,utRho03
2242,yjjQ,9206638,9206954,9206638,316,26,utRho03
2243,yjjX,9267798,9267798,9267490,308,576,utRho03
2244,yjjY,9280716,9280804,9280716,88,504,utRho03
2245,yjjZ,9211554,9211608,9211554,54,1600,utRho03
2246,yjtD,9281676,9281884,9281676,208,8,utRho03
2247,ykfB,532454,532454,532174,280,240,utRho03
2248,ykfI,527636,527636,527338,298,16,utRho03
2249,ykgB,637050,637050,636638,412,0,utRho03
2250,ykgC,640430,640430,640002,428,0,utRho03
2251,ykgD,640232,640454,640232,222,4,utRho03
2252,ykgE,642962,643216,642962,254,24,utRho03
2253,ykgJ,608524,608524,608364,160,104,utRho03
2254,ykgL,623878,624224,623878,346,104,utRho03
2255,ykgM,625610,625610,625554,56,0,utRho03
2256,ykgR,626570,626570,626484,86,0,utRho03
2257,ylaC,958576,958576,958502,74,952,utRho03
2258,yliE,1745938,1745958,1745938,20,0,utRho03
2259,ymcE,2103660,2103694,2103660,34,642,utRho03
2260,ymdA,2210450,2210828,2210450,378,8,utRho03
2261,ymdB,2211428,2211640,2211428,212,34,utRho03
2262,ymfD,2395322,2395322,2395064,258,332,utRho03
2263,ymfI,2402880,2402994,2402880,114,0,utRho03
2264,ymfJ,2404518,2404518,2404168,350,78,utRho03
2265,ymfK,2406176,2406176,2405866,310,60,utRho03
2266,ymfT,2405766,2406048,2405766,282,54,utRho03
2267,ymgE,2489110,2489456,2489110,346,228,utRho03
2268,ymgF,2437628,2437966,2437628,338,0,utRho03
2269,ymiA,2670112,2670320,2670112,208,42,utRho03
2270,ymjA,2715620,2715620,2715336,284,478,utRho03
2271,ynaI,2791946,2791946,2791844,102,0,utRho03
2272,ynaK,2850438,2850754,2850438,316,0,utRho03
2273,ynbA,2954924,2955242,2954924,318,0,utRho03
2274,yncD,3046552,3046552,3046130,422,146,utRho03
2275,yncE,3046454,3046614,3046454,160,0,utRho03
2276,yncG,3052456,3052494,3052456,38,8,utRho03
2277,yncL,3034492,3034492,3034388,104,236,utRho03
2278,yneE,3218364,3218364,3218044,320,2,utRho03
2279,yneF,3223748,3223748,3223708,40,0,utRho03
2280,yneJ,3229560,3229608,3229560,48,68,utRho03
2281,yneK,3231100,3231526,3231100,426,0,utRho03
2282,yneM,3245176,3245292,3245176,116,210,utRho03
2283,ynfA,3311398,3311398,3311346,52,24,utRho03
2284,ynfB,3311418,3311616,3311418,198,186,utRho03
2285,ynfC,3315094,3315094,3314914,180,24,utRho03
2286,ynfD,3314828,3315130,3314828,302,24,utRho03
2287,ynfE,3316006,3316138,3316006,132,88,utRho03
2288,ynfK,3334670,3334670,3334438,232,42,utRho03
2289,ynfL,3339304,3339304,3339184,120,26,utRho03
2290,ynfM,3339260,3339398,3339260,138,52,utRho03
2291,ynfN,3276598,3276598,3276218,380,2094,utRho03
2292,ynfO,3273454,3273512,3273454,58,0,utRho03
2293,ynhG,3517890,3517890,3517450,440,688,utRho03
2294,yniA,3615158,3615592,3615158,434,36,utRho03
2295,yniB,3618526,3618526,3618466,60,0,utRho03
2296,yniC,3618652,3618760,3618652,108,0,utRho03
2297,yniD,3610202,3610330,3610202,128,24,utRho03
2298,ynjE,3678880,3678934,3678880,54,0,utRho03
2299,ynjF,3683222,3683222,3682806,416,4,utRho03
2300,ynjH,3684376,3684376,3684270,106,22,utRho03
2301,ynjI,3690022,3690022,3689742,280,18,utRho03
2302,yoaB,3786642,3786734,3786642,92,166,utRho03
2303,yoaC,3787932,3788146,3787932,214,224,utRho03
2304,yoaE,3803544,3803544,3803170,374,192,utRho03
2305,yoaF,3755444,3755444,3755064,380,1168,utRho03
2306,yoaH,3789866,3789866,3789462,404,412,utRho03
2307,yobB,3850418,3850880,3850418,462,662,utRho03
2308,yobF,3815586,3815586,3815182,404,44,utRho03
2309,yobH,3817800,3817850,3817800,50,66,utRho03
2310,yodB,4084352,4084736,4084352,384,54,utRho03
2311,yodC,4057008,4057008,4056740,268,42,utRho03
2312,yohC,4451358,4451358,4451262,96,18,utRho03
2313,yohD,4451526,4451602,4451526,76,18,utRho03
2314,yohJ,4460986,4461248,4460986,262,28,utRho03
2315,yohO,4431172,4431314,4431172,142,16,utRho03
2316,yojI,4617282,4617282,4617230,52,0,utRho03
2317,ypdI,4988988,4989396,4988988,408,0,utRho03
2318,ypfG,5165786,5165786,5165554,232,6,utRho03
2319,ypfM,5182140,5182140,5181732,408,56,utRho03
2320,yphB,5349590,5349590,5349376,214,22,utRho03
2321,ypjA,5565644,5565644,5565452,192,16,utRho03
2322,ypjB,5569636,5569636,5568858,778,0,utRho03
2323,ypjD,5495860,5495774,5495860,86,0,utRho03
2324,yqaE,5594170,5594170,5594056,114,0,utRho03
2325,yqcA,5846100,5846100,5845968,132,66,utRho03
2326,yqcE,5800944,5801184,5800944,240,0,utRho03
2327,yqeC,6030468,6030468,6030114,354,0,utRho03
2328,yqeF,5971618,5971618,5971184,434,158,utRho03
2329,yqeG,5971438,5971694,5971438,256,116,utRho03
2330,yqeH,5975016,5975072,5975016,56,0,utRho03
2331,yqeI,5976688,5977004,5976688,316,0,utRho03
2332,yqeK,5981140,5981140,5980720,420,68,utRho03
2333,yqfA,6086728,6086728,6086296,432,440,utRho03
2334,yqgA,6219042,6219106,6219042,64,0,utRho03
2335,yqgB,6172500,6172500,6172102,398,1298,utRho03
2336,yqgE,6185768,6185874,6185768,106,460,utRho03
2337,yqhA,6299150,6299150,6298942,208,22,utRho03
2338,yqhC,6310768,6310768,6310436,332,66,utRho03
2339,yqhD,6310604,6310710,6310604,106,16,utRho03
2340,yqhH,6316842,6317254,6316842,412,564,utRho03
2341,yqiC,6369662,6369680,6369662,18,92,utRho03
2342,yqiJ,6384108,6384416,6384108,308,152,utRho03
2343,yqjA,6495096,6495546,6495096,450,11160,utRho03
2344,yqjF,6500932,6501124,6500932,192,104,utRho03
2345,yqjG,6501948,6502048,6501948,100,0,utRho03
2346,yqjH,6433078,6433078,6432982,96,90,utRho03
2347,yqjI,6433506,6433558,6433506,52,0,utRho03
2348,yraH,6574552,6574852,6574552,300,0,utRho03
2349,yraP,6592144,6592818,6592144,674,334,utRho03
2350,yraQ,6596414,6596414,6596276,138,0,utRho03
2351,yraR,6598024,6598024,6597692,332,38,utRho03
2352,yrbG,13360844,13361100,13360844,256,196,utRho03
2353,yrbL,6696842,6696904,6696842,62,940,utRho03
2354,yrbN,6616172,6616172,6615866,306,16962,utRho03
2355,yrdB,6860176,6860176,6860046,130,272,utRho03
2356,yrfF,7052548,7052938,7052548,390,346,utRho03
2357,yrhB,7169440,7169518,7169440,78,14,utRho03
2358,ysaB,7451804,7451804,7451424,380,36,utRho03
2359,ysgA,8032686,8032686,8032338,348,94,utRho03
2360,ytfB,8857638,8857638,8857434,204,186,utRho03
2361,ytfE,8864018,8864018,8863966,52,0,utRho03
2362,ytfF,8866296,8866296,8866130,166,0,utRho03
2363,ytfH,8868164,8868226,8868164,62,4,utRho03
2364,ytfI,8875234,8875414,8875234,180,0,utRho03
2365,ytfJ,8878572,8878572,8878524,48,16,utRho03
2366,ytfK,8879022,8879174,8879022,152,150,utRho03
2367,ytfL,8882642,8882642,8882430,212,0,utRho03
2368,ytfQ,8899634,8899924,8899634,290,72,utRho03
2369,ytjB,9249598,9249598,9249578,20,12,utRho03
2370,yzfA,8896588,8896588,8896490,98,32,utRho03
2371,zapA,6111102,6111224,6111102,122,3892,utRho03
2372,zapB,8236772,8237030,8236772,258,122,utRho03
2373,zapC,2011700,2011904,2011700,204,102,utRho03
2374,zinT,4082692,4082750,4082692,58,10,utRho03
2375,zipA,5062814,5062814,5062466,348,0,utRho03
2376,zitB,1569716,1569716,1569646,70,30,utRho03
2377,zntA,7212844,7212902,7212844,58,14,utRho03
2378,zntR,6878336,6878336,6878260,76,68,utRho03
2379,znuA,3885322,3885322,3885166,156,34,utRho03
2380,znuC,3885268,3885324,3885268,56,34,utRho03
2381,zraP,8403424,8403424,8403376,48,18,utRho03
2382,zraS,8403810,8403852,8403810,42,0,utRho03
2383,zupT,6364866,6365100,6364866,234,536,utRho03
2384,zur,8520282,8520282,8520006,276,1576,utRho03
2385,zwf,3872752,3872752,3872628,124,86,utRho03
0,C0343,2818676,2818728,2818676,52,0,utRho04
1,aaeB,6776526,6776526,6776376,150,0,utRho04
2,aaeR,6778762,6779040,6778762,278,54,utRho04
3,aaeX,6778860,6778860,6778674,186,46,utRho04
4,aat,1854920,1854920,1854864,56,14,utRho04
5,accA,416822,417242,416822,420,1866,utRho04
6,accB,6810280,6810872,6810280,592,8770,utRho04
7,accD,4868030,4868030,4867852,178,522,utRho04
8,aceB,8430804,8430956,8430804,152,0,utRho04
9,aceE,245938,246034,245938,96,542,utRho04
10,ackA,4826918,4826940,4826918,22,1964,utRho04
11,acnA,2670848,2671662,2670848,814,496,utRho04
12,acnB,263038,263230,263038,192,914,utRho04
13,acpP,2303148,2303230,2303148,82,142,utRho04
14,acpS,5402324,5402324,5401996,328,124,utRho04
15,acrA,971396,971396,971238,158,136,utRho04
16,acrB,969370,969370,968806,564,1396,utRho04
17,acrD,5174950,5175190,5174950,240,18,utRho04
18,acrE,6827404,6827728,6827404,324,0,utRho04
19,acrR,971398,971522,971398,124,202,utRho04
20,acrZ,1589502,1589546,1589502,44,0,utRho04
21,acs,8575190,8575190,8574742,448,14,utRho04
22,actP,8569870,8569870,8569804,66,0,utRho04
23,ada,4620854,4620854,4620810,44,0,utRho04
24,add,3404404,3404466,3404404,62,20,utRho04
25,ade,7687802,7687928,7687802,126,0,utRho04
26,adhE,2596826,2596826,2596242,584,22,utRho04
27,adhP,3107988,3107988,3107676,312,790,utRho04
28,adiA,8681112,8681112,8681042,70,50,utRho04
29,adiC,8674404,8674404,8674062,342,0,utRho04
30,adiY,8676084,8676084,8675858,226,0,utRho04
31,adk,994278,994350,994278,72,20,utRho04
32,adrA,807374,807406,807374,32,0,utRho04
33,aer,6438240,6438240,6438152,88,0,utRho04
34,aes,1000102,1000102,999946,156,12,utRho04
35,agaR,6557406,6557406,6557330,76,0,utRho04
36,agaS,6563778,6563952,6563778,174,0,utRho04
37,agp,2131118,2131170,2131118,52,0,utRho04
38,agrA,7296126,7296126,7296126,0,0,utRho04
39,agrB,7296588,7296588,7296588,0,0,utRho04
40,ahpC,1277386,1277890,1277386,504,616,utRho04
41,ahpF,1278004,1279506,1278004,1502,32364,utRho04
42,ahr,8992698,8992698,8992418,280,0,utRho04
43,aidB,8828494,8828550,8828494,56,0,utRho04
44,ais,4731512,4731512,4731240,272,0,utRho04
45,alaA,4814816,4815122,4814816,306,0,utRho04
46,alaC,4996798,4996798,4996590,208,0,utRho04
47,alaE,5598140,5598328,5598140,188,112,utRho04
48,alaS,5644180,5644180,5644022,158,1272,utRho04
49,alaW,5036612,5036612,5036462,150,0,utRho04
50,aldA,2976380,2976464,2976380,84,16,utRho04
51,aldB,7513070,7513070,7513022,48,0,utRho04
52,alkA,4295118,4295118,4295080,38,0,utRho04
53,alkB,4618890,4618890,4618682,208,84,utRho04
54,allA,1064780,1064902,1064780,122,0,utRho04
55,allD,1092822,1092822,1092726,96,0,utRho04
56,allE,1088112,1088112,1088092,20,2,utRho04
57,allS,1064600,1064600,1064442,158,0,utRho04
58,alr,8531178,8531564,8531178,386,1448,utRho04
59,alsE,8617334,8617334,8616956,378,78,utRho04
60,alsK,8615990,8615990,8615598,392,4,utRho04
61,alx,6476740,6477160,6476740,420,4,utRho04
62,amiA,5104482,5104704,5104482,222,46,utRho04
63,amiC,5898378,5898378,5898020,358,0,utRho04
64,amn,4110062,4110122,4110062,60,0,utRho04
65,ampC,8758006,8758006,8757888,118,0,utRho04
66,ampD,237362,237466,237362,104,38,utRho04
67,ampG,907372,907372,907090,282,308,utRho04
68,ampH,792726,792726,792574,152,20,utRho04
69,amyA,4012230,4012312,4012230,82,46,utRho04
70,anmK,3439346,3439346,3439204,142,22,utRho04
71,ansB,6201580,6201580,6201456,124,14,utRho04
72,ansP,3052040,3052040,3051960,80,116,utRho04
73,apaG,104068,104068,103212,856,3278,utRho04
74,apaH,102586,102586,102444,142,3470,utRho04
75,apbE,4623188,4623188,4623068,120,72,utRho04
76,appA,2081198,2081234,2081198,36,6,utRho04
77,appC,2075420,2075480,2075420,60,0,utRho04
78,appY,1167134,1167362,1167134,228,0,utRho04
79,apt,982620,982824,982620,204,168,utRho04
80,aqpZ,1832424,1832424,1832094,330,0,utRho04
81,araB,140150,140150,140096,54,0,utRho04
82,araC,140482,140774,140482,292,104,utRho04
83,araE,5964416,5964416,5964364,52,0,utRho04
84,araF,3972476,3972476,3972256,220,0,utRho04
85,araH,3967120,3967120,3967086,34,0,utRho04
86,araJ,825058,825058,824962,96,0,utRho04
87,arcA,9281602,9281602,9280612,990,6772,utRho04
88,arcB,6706098,6706098,6706050,48,0,utRho04
89,arcZ,6701154,6701154,6701154,0,0,utRho04
90,arfA,6877346,6877346,6877298,48,610,utRho04
91,argA,5898312,5898484,5898312,172,0,utRho04
92,argC,8309770,8310002,8309770,232,0,utRho04
93,argD,6980442,6980442,6980360,82,0,utRho04
94,argE,8310156,8310156,8309694,462,0,utRho04
95,argF,580680,580680,580610,70,76,utRho04
96,argG,6637124,6637274,6637124,150,22,utRho04
97,argI,8956688,8956688,8956622,66,0,utRho04
98,argO,6137672,6137672,6137616,56,70,utRho04
99,argP,6119460,6119506,6119460,46,0,utRho04
100,argR,6769204,6769406,6769204,202,116,utRho04
101,argS,3920002,3920124,3920002,122,0,utRho04
102,argT,4855698,4855698,4855582,116,146,utRho04
103,argU,1129406,1129446,1129406,40,4,utRho04
104,argW,4932616,4932618,4932616,2,2,utRho04
105,argX,7964728,7964750,7964728,22,16,utRho04
106,aroF,5482402,5482402,5482300,102,48,utRho04
107,aroG,1571182,1571266,1571182,84,66,utRho04
108,aroH,3576636,3576870,3576636,234,256,utRho04
109,aroK,7038760,7038760,7038128,632,1748,utRho04
110,aroL,812560,812810,812560,250,136,utRho04
111,aroP,243342,243342,243102,240,32,utRho04
112,arpA,8445382,8445382,8444974,408,284,utRho04
113,arrS,7316108,7316108,7316108,0,0,utRho04
114,arsR,7297024,7297056,7297024,32,0,utRho04
115,artJ,1801252,1801252,1801150,102,52,utRho04
116,artP,1807686,1807686,1807468,218,120,utRho04
117,ascF,5678858,5679048,5678858,190,20,utRho04
118,ascG,5678574,5678574,5678528,46,0,utRho04
119,aslB,7965562,7965916,7965562,354,26952,utRho04
120,asnA,7854258,7854310,7854258,52,46,utRho04
121,asnB,1398444,1398444,1398354,90,478,utRho04
122,asnC,23562186,23562186,23562018,168,114,utRho04
123,asnS,1978088,1978088,1977970,118,7360,utRho04
124,asnT,4089082,4089098,4089082,16,6,utRho04
125,asnU,4119690,4119702,4119690,12,0,utRho04
126,asnV,4124504,4124520,4124504,16,16,utRho04
127,aspA,17473728,17473728,17473308,420,416,utRho04
128,aspC,1971486,1971486,1971418,68,242,utRho04
129,aspS,3901402,3901402,3901044,358,62,utRho04
130,aspT,7893560,7893744,7893560,184,48832,utRho04
131,aspV,473826,473862,473826,36,4,utRho04
132,asr,3342654,3342752,3342654,98,32,utRho04
133,astC,3664088,3664088,3663964,124,30,utRho04
134,astE,3654138,3654138,3653846,292,4,utRho04
135,atoD,4646824,4646894,4646824,70,28,utRho04
136,atpB,7844540,7844540,7844102,438,328,utRho04
137,atpC,7832118,7832118,7831944,174,1324,utRho04
138,atpI,7845050,7845050,7844880,170,0,utRho04
139,avtA,7479348,7479410,7479348,62,118,utRho04
140,azoR,2965982,2965982,2965720,262,138,utRho04
141,azuC,3976002,3976002,3975918,84,46,utRho04
142,bacA,6408350,6408350,6408262,88,78,utRho04
143,bamA,394052,395856,394052,1804,660,utRho04
144,bamB,5277950,5277950,5277304,646,1414,utRho04
145,bamC,5198028,5198028,5197730,298,550,utRho04
146,bamD,5471922,5472292,5471922,370,4790,utRho04
147,bamE,5506972,5507210,5506972,238,272,utRho04
148,basS,8666954,8666954,8666544,410,170,utRho04
149,bax,7474468,7474468,7474354,114,146,utRho04
150,bcp,5200874,5200956,5200874,82,824,utRho04
151,bcsB,7385346,7385346,7385214,132,0,utRho04
152,bcsE,7392644,7392916,7392644,272,0,utRho04
153,bdcA,8948128,8948128,8948106,22,12,utRho04
154,bdcR,8948192,8948248,8948192,56,0,utRho04
155,bdm,3112680,3112680,3112560,120,0,utRho04
156,betA,654522,654522,654494,28,244,utRho04
157,betI,658722,658722,658668,54,0,utRho04
158,betT,658842,658926,658842,84,36,utRho04
159,bfr,6933498,6933498,6933450,48,24,utRho04
160,bglG,23440182,23440182,23439402,780,0,utRho04
161,bglX,4444240,4444240,4443978,262,0,utRho04
162,bhsA,2337962,2338146,2337962,184,48,utRho04
163,bioA,1618584,1618584,1618514,70,0,utRho04
164,bioB,1618604,1618688,1618604,84,38,utRho04
165,bioH,7089716,7089716,7089688,28,0,utRho04
166,bisC,7433026,7433026,7432788,238,92,utRho04
167,blc,8755490,8755490,8755444,46,0,utRho04
168,blr,3409024,3409102,3409024,78,138,utRho04
169,bluF,2431226,2431226,2430950,276,1626,utRho04
170,bluR,2428226,2428226,2428118,108,0,utRho04
171,bolA,908698,908944,908698,246,0,utRho04
172,borD,1157842,1157842,1157786,56,2,utRho04
173,brnQ,838976,839182,838976,206,1710,utRho04
174,bssR,1756492,1756496,1756492,4,0,utRho04
175,bssS,2242116,2242116,2241910,206,254,utRho04
176,btuB,8326798,8327278,8326798,480,2096,utRho04
177,cadB,8720212,8720212,8720062,150,0,utRho04
178,cadC,8723926,8723926,8723868,58,0,utRho04
179,caiE,70998,70998,70742,256,0,utRho04
180,caiF,68436,68600,68436,164,88,utRho04
181,caiT,84074,84074,83862,212,0,utRho04
182,can,285406,285406,285340,66,66,utRho04
183,carA,59102,59302,59102,200,2,utRho04
184,carB,61550,61634,61550,84,100,utRho04
185,cas2,5757830,5757830,5757706,124,0,utRho04
186,casA,5768638,5768638,5768276,362,0,utRho04
187,cbl,4121882,4121882,4121828,54,12,utRho04
188,cbpA,2128074,2128074,2127550,524,84,utRho04
189,cbrA,7738628,7738754,7738628,126,0,utRho04
190,cbrB,7794958,7795012,7794958,54,12,utRho04
191,ccmH,4585242,4585242,4584820,422,0,utRho04
192,cdaR,364894,364926,364894,32,0,utRho04
193,cdd,4463638,4463688,4463638,50,46,utRho04
194,cdh,8219814,8219860,8219814,46,12,utRho04
195,cdsA,391110,391354,391110,244,1046,utRho04
196,cedA,3627484,3627484,3627326,158,0,utRho04
197,cfa,3482402,3482826,3482402,424,246,utRho04
198,chaC,2544844,2544972,2544844,128,0,utRho04
199,chbB,3643452,3643452,3643238,214,0,utRho04
200,chbG,3634624,3634624,3634270,354,0,utRho04
201,cheW,3946924,3946924,3946678,246,44,utRho04
202,chiA,6939792,6939792,6939706,86,0,utRho04
203,chiP,1416472,1416668,1416472,196,8,utRho04
204,cho,3646984,3647030,3646984,46,88,utRho04
205,chpS,8896804,8896894,8896804,90,6,utRho04
206,cirA,4493884,4493884,4493538,346,268,utRho04
207,citC,1304078,1304078,1303712,366,0,utRho04
208,citT,1293264,1293264,1293160,104,0,utRho04
209,clcA,350104,350214,350104,110,0,utRho04
210,clpA,1846160,1846528,1846160,368,54,utRho04
211,clpB,5468410,5468410,5468346,64,44,utRho04
212,clpP,913154,913354,913154,200,604,utRho04
213,clpS,1845500,1845826,1845500,326,6,utRho04
214,clpX,914404,914852,914404,448,716,utRho04
215,clsA,2617346,2617346,2617290,56,20,utRho04
216,clsC,2212584,2212710,2212584,126,184,utRho04
217,cmk,1922330,1922402,1922330,72,30,utRho04
218,cnu,3409522,3409898,3409522,376,422,utRho04
219,coaA,8350214,8350214,8350052,162,712,utRho04
220,cobC,1340092,1340092,1339814,278,462,utRho04
221,cobT,4129202,4129202,4128934,268,12,utRho04
222,cobU,4131944,4131944,4131528,416,166,utRho04
223,codB,709768,709844,709768,76,16,utRho04
224,comR,2337726,2337726,2337664,62,0,utRho04
225,copA,1022822,1022822,1022758,64,0,utRho04
226,corA,8002388,8002852,8002388,464,2896,utRho04
227,cpdB,8873258,8873258,8873130,128,0,utRho04
228,cptB,6082198,6082198,6082140,58,26,utRho04
229,cpxA,8210202,8210202,8209950,252,554,utRho04
230,cpxP,8211570,8211640,8211570,70,70,utRho04
231,cpxR,8211372,8211372,8211340,32,0,utRho04
232,cra,175894,176056,175894,162,16,utRho04
233,crcB,1316016,1316016,1315876,140,22,utRho04
234,creA,9270486,9271042,9270486,556,388,utRho04
235,creD,9276320,9276356,9276320,36,0,utRho04
236,crl,515620,515658,515620,38,782,utRho04
237,crp,6971906,6972240,6971906,334,3196,utRho04
238,crr,5070960,5071668,5070960,708,2924,utRho04
239,csdA,5886414,5886674,5886414,260,0,utRho04
240,csgB,2207718,2207902,2207718,184,0,utRho04
241,csgD,2206688,2206688,2206392,296,16,utRho04
242,csgG,2203510,2203510,2203368,142,12,utRho04
243,csiD,5577854,5577970,5577854,116,0,utRho04
244,csiE,5330802,5330870,5330802,68,34,utRho04
245,csiR,5590942,5591348,5590942,406,0,utRho04
246,cspA,7439778,7440098,7439778,320,357638,utRho04
247,cspB,3283430,3283430,3283108,322,612,utRho04
248,cspC,3815018,3815018,3814870,148,226,utRho04
249,cspD,1845352,1845352,1845180,172,368,utRho04
250,cspE,1314294,1314584,1314294,290,122,utRho04
251,cspF,3283380,3283710,3283380,330,38,utRho04
252,cspG,2102610,2102922,2102610,312,142390,utRho04
253,cspH,2102746,2102746,2102350,396,312,utRho04
254,cspI,3277624,3277624,3277334,290,106,utRho04
255,csrA,5638746,5638746,5638292,454,1218,utRho04
256,csrB,5849048,5849048,5849048,0,0,utRho04
257,csrC,8102072,8102072,8102072,0,0,utRho04
258,csrD,6806850,6806850,6806664,186,84,utRho04
259,cstA,1259710,1259788,1259710,78,0,utRho04
260,cueO,274090,274166,274090,76,0,utRho04
261,cueR,1027948,1027986,1027948,38,0,utRho04
262,curA,3037784,3038054,3037784,270,12,utRho04
263,cusC,1191146,1191200,1191146,54,0,utRho04
264,cusR,1190924,1190924,1190886,38,0,utRho04
265,cutA,8730784,8730784,8730712,72,144,utRho04
266,cutC,3918534,3918534,3917920,614,154,utRho04
267,cvpA,4861600,4861600,4861526,74,48,utRho04
268,cvrA,2484328,2484328,2484142,186,186,utRho04
269,cyaA,7981548,7982306,7981548,758,1428,utRho04
270,cyaR,4334228,4334224,4334228,4,28,utRho04
271,cyaY,7988166,7988166,7988118,48,66,utRho04
272,cybB,2981522,2981804,2981522,282,162,utRho04
273,cycA,8859560,8859728,8859560,168,218,utRho04
274,cydA,1542340,1542916,1542340,576,12,utRho04
275,cydC,1858800,1858800,1858390,410,108,utRho04
276,cydD,1862062,1862062,1861924,138,26,utRho04
277,cydX,1548300,1548392,1548300,92,274,utRho04
278,cynR,717418,717418,717380,38,0,utRho04
279,cynT,1435092,1435196,1435092,104,0,utRho04
280,cyoA,903306,903306,903220,86,1672,utRho04
281,cyoE,895540,895540,895410,130,498,utRho04
282,cysB,2667576,2667710,2667576,134,438,utRho04
283,cysC,5748056,5748056,5747984,72,18,utRho04
284,cysD,5752736,5752736,5752658,78,0,utRho04
285,cysE,7565362,7565362,7565124,238,198,utRho04
286,cysG,6995508,6995656,6995508,148,10,utRho04
287,cysJ,5783928,5783928,5783796,132,830,utRho04
288,cysK,5064688,5064818,5064688,130,16,utRho04
289,cysP,5087114,5087114,5087056,58,174,utRho04
290,cysS,1109154,1109222,1109154,68,30,utRho04
291,cysT,3984100,3984100,3983974,126,116,utRho04
292,cysZ,5062766,5062926,5062766,160,132,utRho04
293,cytR,8249018,8249018,8248912,106,50,utRho04
294,dacA,1328002,1328002,1327926,76,8,utRho04
295,dacB,6657714,6657926,6657714,212,0,utRho04
296,dacC,1761306,1761454,1761306,148,0,utRho04
297,dadA,2475018,2475142,2475018,124,0,utRho04
298,dam,7032504,7032504,7031826,678,968,utRho04
299,damX,7035200,7035200,7034612,588,500,utRho04
300,dapA,5199568,5199568,5199520,48,0,utRho04
301,dapB,56576,56748,56576,172,4,utRho04
302,dapD,371954,371954,371894,60,108,utRho04
303,dapE,5183120,5183214,5183120,94,132,utRho04
304,dcp,3254844,3254844,3254760,84,0,utRho04
305,dcrB,7219534,7219910,7219534,376,0,utRho04
306,dctA,7366996,7366996,7366894,102,620,utRho04
307,dcuA,8733686,8733686,8733546,140,0,utRho04
308,dcuB,8698182,8698182,8697488,694,0,utRho04
309,dcuC,1312166,1312166,1311936,230,12,utRho04
310,dcuD,6749166,6749738,6749166,572,48,utRho04
311,dcuR,8701130,8701130,8700068,1062,260,utRho04
312,dcuS,8703370,8703370,8703324,46,0,utRho04
313,dcyD,3999016,3999016,3998960,56,0,utRho04
314,ddpX,3126498,3126498,3126152,346,0,utRho04
315,deaD,6615818,6615818,6615720,98,4050,utRho04
316,dedA,4869880,4869880,4869482,398,6426,utRho04
317,dedD,4863750,4863750,4863368,382,140,utRho04
318,def,6867300,6867380,6867300,80,0,utRho04
319,degP,361690,361768,361690,78,0,utRho04
320,degQ,6761308,6761486,6761308,178,2986,utRho04
321,deoB,9239134,9239206,9239134,72,0,utRho04
322,deoC,9233358,9234646,9233358,1288,152,utRho04
323,dfp,7625406,7625462,7625406,56,58,utRho04
324,dgcZ,3247758,3247758,3247700,58,0,utRho04
325,dgkA,8512914,8513274,8512914,360,68,utRho04
326,dgt,358392,358474,358392,82,0,utRho04
327,dhaK,2501888,2501888,2501676,212,90,utRho04
328,dhaR,2502006,2502132,2502006,126,40,utRho04
329,dicB,3299194,3299218,3299194,24,0,utRho04
330,dicC,3295752,3295752,3295700,52,0,utRho04
331,dinB,501760,501796,501760,36,0,utRho04
332,dinD,7635398,7635520,7635398,122,258,utRho04
333,dinG,1666146,1666140,1666146,6,0,utRho04
334,dinI,2243018,2243018,2242974,44,0,utRho04
335,dinJ,493230,493230,493004,226,76,utRho04
336,dinQ,7295964,7295964,7295576,388,1398,utRho04
337,djlA,114536,114728,114536,192,64,utRho04
338,dkgA,6313142,6313246,6313142,104,10,utRho04
339,dkgB,458196,458334,458196,138,266,utRho04
340,dksA,321502,321502,321208,294,292,utRho04
341,dld,4444164,4444370,4444164,206,0,utRho04
342,dmlA,3763424,3763824,3763424,400,4,utRho04
343,dmlR,3763710,3763710,3763618,92,0,utRho04
344,dmsA,1881646,1881918,1881646,272,184,utRho04
345,dnaA,7767922,7767922,7767458,464,5020,utRho04
346,dnaB,8528566,8528628,8528566,62,114,utRho04
347,dnaK,24096,24326,24096,230,174,utRho04
348,dnaN,7765466,7765466,7764642,824,842,utRho04
349,dnaQ,471868,472134,471868,266,910,utRho04
350,dnaT,18406460,18406460,18406068,392,292,utRho04
351,dnaX,984112,984184,984112,72,380,utRho04
352,dosP,3131486,3131486,3131466,20,0,utRho04
353,dpiB,1303968,1304470,1303968,502,0,utRho04
354,dppA,7415740,7415740,7415410,330,1250,utRho04
355,dps,1697900,1697900,1697822,78,66,utRho04
356,dsbA,8086754,8086836,8086754,82,1656,utRho04
357,dsbB,2466294,2466294,2466060,234,38,utRho04
358,dsbC,6079266,6079266,6077644,1622,748,utRho04
359,dsbG,1277600,1277600,1277146,454,508,utRho04
360,dsdA,4958242,4958404,4958242,162,102,utRho04
361,dsdC,4955492,4955492,4955258,234,0,utRho04
362,dsdX,4955642,4955694,4955642,52,0,utRho04
363,dsrA,4050626,4050626,4050626,0,0,utRho04
364,dsrB,4049686,4049686,4049646,40,0,utRho04
365,dtpD,1485340,1485340,1485112,228,76,utRho04
366,dusA,8523200,8523338,8523200,138,2422,utRho04
367,dusB,6820492,6820560,6820492,68,40,utRho04
368,dusC,4460790,4460790,4460770,20,0,utRho04
369,dut,7627704,7627864,7627704,160,1430,utRho04
370,dxr,386670,387042,386670,372,792,utRho04
371,ebgA,6445102,6445266,6445102,164,18,utRho04
372,ebgR,6442874,6442932,6442874,58,12,utRho04
373,ecnB,8753018,8753106,8753018,88,190,utRho04
374,eco,4607594,4607810,4607594,216,0,utRho04
375,ecpA,621594,621594,621342,252,42,utRho04
376,ecpB,620238,620238,620052,186,0,utRho04
377,ecpR,622964,622964,622672,292,0,utRho04
378,eda,3866218,3866218,3865512,706,68,utRho04
379,edd,3869426,3869426,3869208,218,42,utRho04
380,efeO,2164308,2164486,2164308,178,0,utRho04
381,efeU_1,2162614,2162712,2162614,98,4,utRho04
382,efp,8751134,8751398,8751134,264,5752,utRho04
383,elaA,4763372,4763372,4763086,286,128,utRho04
384,elaD,4765308,4765426,4765308,118,28,utRho04
385,elfA,1995530,1995736,1995530,206,24,utRho04
386,elfD,1996642,1996980,1996642,338,0,utRho04
387,emrD,7707690,7707844,7707690,154,0,utRho04
388,emrK,4966896,4966896,4966678,218,0,utRho04
389,emrY,4964668,4964668,4964352,316,0,utRho04
390,emtA,2486250,2486360,2486250,110,0,utRho04
391,endA,12361100,12361388,12361100,288,0,utRho04
392,eno,5817692,5817692,5815882,1810,4074,utRho04
393,entC,1249662,1249770,1249662,108,16,utRho04
394,entD,1220508,1220508,1220158,350,0,utRho04
395,entH,1258584,1258600,1258584,16,18,utRho04
396,entS,1244506,1244600,1244506,94,0,utRho04
397,envR,6827266,6827266,6826930,336,0,utRho04
398,epd,12295292,12295292,12294764,528,228,utRho04
399,epmA,8765236,8765286,8765236,50,14,utRho04
400,epmB,8751406,8751406,8751314,92,2964,utRho04
401,eptB,7421162,7421162,7420950,212,230,utRho04
402,eptC,8300622,8300622,8300530,92,140,utRho04
403,erfK,4126708,4126708,4126646,62,702,utRho04
404,erpA,353122,353220,353122,98,40,utRho04
405,esrE,8039956,8039956,8039956,0,0,utRho04
406,essD,1153746,1154796,1153746,1050,296,utRho04
407,etk,2088606,2088606,2088420,186,0,utRho04
408,evgA,4967262,4967510,4967262,248,0,utRho04
409,exbB,6304028,6304028,6303968,60,12,utRho04
410,exbD,6302780,6302780,6302486,294,136,utRho04
411,exuR,6493016,6493304,6493016,288,140,utRho04
412,exuT,6490004,6490208,6490004,204,0,utRho04
413,fabA,2032996,2032996,2032940,56,58,utRho04
414,fabB,4883282,4883282,4883210,72,2,utRho04
415,fabH,2297032,2297518,2297032,486,2828,utRho04
416,fabI,2702236,2702236,2702078,158,0,utRho04
417,fadB,8062026,8062026,8061942,84,0,utRho04
418,fadD,3779614,3779614,3779492,122,0,utRho04
419,fadE,486812,486812,486606,206,0,utRho04
420,fadH,6463248,6463330,6463248,82,0,utRho04
421,fadI,4921022,4921022,4920938,84,0,utRho04
422,fadL,4922410,4922600,4922410,190,0,utRho04
423,fadM,928720,928804,928720,84,0,utRho04
424,fadR,2469810,2469876,2469810,66,0,utRho04
425,fbaB,4357334,4357334,4357128,206,0,utRho04
426,fdhE,8162722,8162722,8162456,266,924,utRho04
427,fdhF,8598814,8598814,8598732,82,0,utRho04
428,fdnG,3094744,3094802,3094744,58,16,utRho04
429,fdrA,1093012,1093360,1093012,348,0,utRho04
430,feaB,2894994,2895038,2894994,44,0,utRho04
431,feaR,2894734,2894734,2894566,168,0,utRho04
432,fecA,9033454,9033454,9033354,100,384,utRho04
433,fecE,9023288,9023288,9022914,374,6076,utRho04
434,fecI,9036564,9036564,9036470,94,0,utRho04
435,feoA,7080114,7080326,7080114,212,94,utRho04
436,fepA,1225334,1225334,1224988,346,0,utRho04
437,fepB,1249454,1249454,1249020,434,292,utRho04
438,fepD,1244468,1244468,1244378,90,20,utRho04
439,fes,1225374,1225630,1225374,256,34,utRho04
440,ffh,5495706,5495706,5495590,116,1386,utRho04
441,ffs,952576,952848,952576,272,28,utRho04
442,fhuA,334884,334968,334884,84,102,utRho04
443,fhuE,2323294,2323294,2323102,192,178,utRho04
444,fhuF,9211504,9211504,9211326,178,2846,utRho04
445,fic,6983296,6983296,6982926,370,422,utRho04
446,fieF,8212864,8212938,8212864,74,78,utRho04
447,fimA,9085388,9086230,9085388,842,152,utRho04
448,fimB,9081334,9081914,9081334,580,304,utRho04
449,fimE,9083742,9084074,9083742,332,0,utRho04
450,fimZ,1129214,1129214,1128960,254,4,utRho04
451,fiu,1683296,1683296,1683062,234,32,utRho04
452,fixA,84650,84806,84650,156,0,utRho04
453,fkpA,6955050,6955050,6954838,212,5174,utRho04
454,fldA,2846084,2846084,2845860,224,3256,utRho04
455,fldB,6079644,6079710,6079644,66,104,utRho04
456,flgA,2261770,2261770,2261726,44,38,utRho04
457,flgB,2261986,2262036,2261986,50,0,utRho04
458,flgK,2276702,2276756,2276702,54,1788,utRho04
459,flgM,2260330,2260330,2260256,74,182,utRho04
460,flgN,2259828,2259828,2259660,168,122,utRho04
461,flhB,3932432,3932432,3932382,50,126,utRho04
462,flhC,3955864,3955864,3955688,176,68,utRho04
463,flhD,3957154,3957154,3956394,760,468,utRho04
464,fliA,4003638,4003638,4003578,60,40,utRho04
465,fliC,4007352,4007352,4007212,140,86,utRho04
466,fliD,4007634,4007744,4007634,110,222,utRho04
467,fliE,4026186,4026186,4026028,158,0,utRho04
468,fliF,4026292,4026458,4026292,166,304,utRho04
469,fliL,4039168,4039236,4039168,68,124,utRho04
470,flk,4875824,4875900,4875824,76,26,utRho04
471,flu,4142634,4143078,4142634,444,90,utRho04
472,flxA,3292776,3292810,3292776,34,130,utRho04
473,fnr,2799104,2799104,2799052,52,0,utRho04
474,fnrS,2818258,2818258,2818258,0,0,utRho04
475,focA,1909628,1909628,1908932,696,414,utRho04
476,folA,99598,99646,99598,48,0,utRho04
477,folB,6409296,6409296,6409178,118,0,utRho04
478,folD,1115562,1115562,1115482,80,176,utRho04
479,folE,4487696,4487696,4487304,392,2100,utRho04
480,fpr,8228998,8228998,8228944,54,0,utRho04
481,frc,4986878,4986878,4986508,370,0,utRho04
482,frdA,8764824,8764824,8764636,188,62,utRho04
483,frdD,8758948,8758948,8758732,216,160,utRho04
484,fre,8052886,8053054,8052886,168,1458,utRho04
485,frlA,6999518,6999820,6999518,302,0,utRho04
486,frr,385624,385744,385624,120,906,utRho04
487,frsA,513004,513054,513004,50,66,utRho04
488,fruB,4527194,4527194,4526990,204,0,utRho04
489,frvR,8179804,8179804,8179710,94,0,utRho04
490,fryA,5008986,5008986,5008970,16,0,utRho04
491,fsaA,1727060,1727284,1727060,224,0,utRho04
492,fsr,1009710,1009710,1009392,318,144,utRho04
493,ftnA,3977364,3977432,3977364,68,0,utRho04
494,ftnB,3973550,3973850,3973550,300,0,utRho04
495,ftsA,207122,207964,207122,842,854,utRho04
496,ftsB,5745802,5745802,5745640,162,16,utRho04
497,ftsH,6654204,6654204,6653870,334,498,utRho04
498,ftsK,1865858,1866448,1865858,590,1386,utRho04
499,ftsL,181376,182064,181376,688,1166,utRho04
500,ftsP,6325732,6325732,6325338,394,166,utRho04
501,ftsQ,205484,206310,205484,826,520,utRho04
502,ftsX,7204512,7204512,7204172,340,838,utRho04
503,ftsZ,209272,210610,209272,1338,46,utRho04
504,fucA,5867708,5867708,5867376,332,16,utRho04
505,fucP,5868238,5868470,5868238,232,4,utRho04
506,fumA,6753760,6753760,6753508,252,1692,utRho04
507,fumB,8694696,8694696,8694652,44,0,utRho04
508,fumC,3373418,3373418,3373176,242,0,utRho04
509,fur,2842892,2842892,2842584,308,6840,utRho04
510,fusA,6947370,6947370,6947028,342,13148,utRho04
511,fxsA,8737206,8737328,8737206,122,36,utRho04
512,gabD,5581824,5582546,5581824,722,172,utRho04
513,gadA,7335214,7335214,7335160,54,0,utRho04
514,gadB,3144144,3144144,3144090,54,0,utRho04
515,gadC,3141168,3141168,3140978,190,0,utRho04
516,gadE,7315600,7316732,7315600,1132,0,utRho04
517,gadW,7329562,7329562,7329236,326,0,utRho04
518,gadX,14663356,14663356,14663240,116,0,utRho04
519,gadY,7329728,7329728,7329728,0,0,utRho04
520,galE,1584354,1584354,1584110,244,0,utRho04
521,galF,4228702,4228702,4228654,48,28,utRho04
522,galM,1577796,1577796,1577674,122,176,utRho04
523,galP,6176510,6176568,6176510,58,6,utRho04
524,galR,5953138,5953198,5953138,60,56,utRho04
525,galS,4483420,4483420,4483336,84,0,utRho04
526,galU,2582810,2582914,2582810,104,156,utRho04
527,gapA,3724480,3725542,3724480,1062,2784,utRho04
528,garP,6549868,6549868,6549814,54,0,utRho04
529,gatY,4354468,4354468,4354408,60,0,utRho04
530,gatZ,4352864,4352864,4352642,222,4070,utRho04
531,gcd,282558,282558,282450,108,0,utRho04
532,gcl,1067814,1067832,1067814,18,0,utRho04
533,gcvA,5885278,5885278,5885134,144,0,utRho04
534,gcvB,5885392,5885392,5885392,0,0,utRho04
535,gcvR,5199758,5199812,5199758,54,0,utRho04
536,gcvT,6101544,6101544,6101334,210,376,utRho04
537,gdhA,3684616,3684742,3684616,126,0,utRho04
538,gfcA,2099668,2099668,2099488,180,146,utRho04
539,gfcD,2096236,2096236,2095890,346,10,utRho04
540,ghrA,2195648,2195772,2195648,124,178,utRho04
541,ghrB,7434378,7434620,7434378,242,424,utRho04
542,glcA,6242728,6242728,6242558,170,86,utRho04
543,glcC,6256412,6256544,6256412,132,0,utRho04
544,glcD,6256152,6256152,6256042,110,0,utRho04
545,gldA,8278092,8278092,8278070,22,0,utRho04
546,glgA,7136784,7136784,7136066,718,0,utRho04
547,glgB,7147314,7147314,7147004,310,162,utRho04
548,glgC,7139142,7139142,7138656,486,128,utRho04
549,glgP,7133546,7133546,7133162,384,108,utRho04
550,glgS,6384024,6384024,6383878,146,0,utRho04
551,glgX,7142838,7142838,7142638,200,0,utRho04
552,glk,5018922,5018922,5018852,70,48,utRho04
553,glmS,7827622,7827622,7827336,286,3984,utRho04
554,glmU,7830652,7830652,7830400,252,136,utRho04
555,glmY,10765360,10765360,10765360,0,0,utRho04
556,glmZ,7972864,7972864,7972864,0,0,utRho04
557,glnA,16232888,16232888,16232136,752,280,utRho04
558,glnB,5375052,5375052,5374816,236,78,utRho04
559,glnD,377310,377310,377300,10,58,utRho04
560,glnE,6399602,6399602,6399282,320,8,utRho04
561,glnH,1696396,1696396,1696008,388,0,utRho04
562,glnK,945112,945196,945112,84,0,utRho04
563,glnL,8112742,8112742,8112678,64,0,utRho04
564,glnQ,1693262,1693262,1692926,336,138,utRho04
565,glnS,1411998,1412186,1411998,188,266,utRho04
566,gloA,3455602,3455674,3455602,72,0,utRho04
567,gloB,469852,469852,469564,288,672,utRho04
568,glpA,4705166,4705294,4705166,128,0,utRho04
569,glpD,7123942,7124026,7123942,84,68,utRho04
570,glpE,7123698,7123698,7123646,52,86,utRho04
571,glpF,8236322,8236322,8236180,142,222,utRho04
572,glpG,7122960,7122960,7122904,56,258,utRho04
573,glpR,7121782,7121782,7121210,572,210,utRho04
574,glpT,4704902,4704902,4704748,154,60,utRho04
575,glpX,8231212,8231212,8231158,54,3626,utRho04
576,glrK,5382246,5382246,5382196,50,68,utRho04
577,gltA,1509534,1509534,1508936,598,13494,utRho04
578,gltB,6709018,6709264,6709018,246,250,utRho04
579,gltI,1375792,1375792,1375494,298,1380,utRho04
580,gltP,8588536,8588962,8588536,426,1282,utRho04
581,gltS,7657382,7657382,7657330,52,152,utRho04
582,gltX,5041568,5041568,5041344,224,110,utRho04
583,gluQ,320286,320286,320224,62,30,utRho04
584,glyA,5371148,5371148,5371014,134,2,utRho04
585,glyQ,7450708,7450708,7450636,72,50,utRho04
586,glyS,7448990,7448990,7448794,196,1030,utRho04
587,glyU,5998128,5998128,5998114,14,2,utRho04
588,glyV,8784626,8784720,8784626,94,288,utRho04
589,glyW,3984360,3984360,3984234,126,0,utRho04
590,gmhB,445612,445666,445612,54,0,utRho04
591,gmk,7642776,7642856,7642776,80,26,utRho04
592,gmr,2693686,2693686,2693484,202,26,utRho04
593,gnd,4202648,4202648,4202536,112,334,utRho04
594,gnsB,3275692,3275692,3275564,128,510,utRho04
595,gntK,14310580,14310580,14310368,212,440,utRho04
596,gntP,9102668,9102668,9102592,76,0,utRho04
597,gntR,7157760,7157760,7157452,308,204,utRho04
598,gntT,7092810,7093118,7092810,308,54,utRho04
599,gntU,7154170,7154170,7154122,48,28,utRho04
600,gntX,7089334,7089764,7089334,430,0,utRho04
601,gor,7292224,7292598,7292224,374,660,utRho04
602,gpmA,1575340,1575340,1575190,150,0,utRho04
603,gpmM,7570374,7570520,7570374,146,0,utRho04
604,gpsA,7567620,7567620,7567322,298,4702,utRho04
605,gpt,511828,511954,511828,126,272,utRho04
606,grcA,5433046,5433046,5432898,148,56,utRho04
607,greA,6657728,6657728,6657430,298,898,utRho04
608,greB,7073488,7073624,7073488,136,18,utRho04
609,groL,8741566,8742050,8741566,484,390,utRho04
610,groS,8741232,8741376,8741232,144,320,utRho04
611,grpE,5501494,5501494,5501416,78,142,utRho04
612,grxA,1781552,1781552,1781506,46,10,utRho04
613,grxB,2248206,2248206,2248108,98,12,utRho04
614,grxC,7569152,7569152,7568884,268,3464,utRho04
615,grxD,3468324,3468324,3468202,122,3762,utRho04
616,gspA,6911268,6911268,6910796,472,2,utRho04
617,gspC,6910964,6911156,6910964,192,0,utRho04
618,gss,6277220,6277220,6277044,176,0,utRho04
619,gstA,3428654,3428754,3428654,100,0,utRho04
620,gstB,1761038,1761038,1760960,78,0,utRho04
621,guaB,5268214,5268214,5268140,74,2,utRho04
622,gudD,5839026,5839026,5838770,256,0,utRho04
623,gyrA,4678914,4678914,4678840,74,8,utRho04
624,gyrB,7760300,7760300,7760238,62,166,utRho04
625,hcaE,5337964,5338064,5337964,100,4,utRho04
626,hcaR,5337928,5337928,5337792,136,0,utRho04
627,hcaT,5336106,5336106,5335692,414,128,utRho04
628,hchA,4071260,4071670,4071260,410,0,utRho04
629,hcp,1828258,1828258,1827628,630,8,utRho04
630,hcr,1824400,1824400,1824300,100,0,utRho04
631,hdeA,7313582,7313582,7313480,102,0,utRho04
632,hdeD,7313920,7313990,7313920,70,0,utRho04
633,hdfR,7896320,7896320,7895934,386,384,utRho04
634,hdhA,3396244,3396244,3396080,164,42,utRho04
635,helD,2048876,2048942,2048876,66,0,utRho04
636,hemA,2527166,2527428,2527166,262,238,utRho04
637,hemB,779722,779722,779454,268,32,utRho04
638,hemF,5106410,5106450,5106410,40,4,utRho04
639,hemH,996062,996110,996062,48,48,utRho04
640,hemL,349882,349882,349764,118,6,utRho04
641,hemN,8103886,8104090,8103886,204,38,utRho04
642,hepA,127176,127176,126528,648,2708,utRho04
643,hflD,2385372,2385372,2385262,110,776,utRho04
644,hfq,8799602,8800576,8799602,974,1878,utRho04
645,hha,961006,961006,960616,390,310,utRho04
646,hicA,3018442,3018572,3018442,130,0,utRho04
647,higA,6468682,6468682,6468288,394,72,utRho04
648,higB,6468960,6468960,6468910,50,58,utRho04
649,hinT,2323642,2323770,2323642,128,78,utRho04
650,hipB,3184964,3184964,3184884,80,12,utRho04
651,hisB,4186720,4186936,4186720,216,282,utRho04
652,hisJ,4853674,4853674,4853576,98,22,utRho04
653,hisL,8359856,8359984,8359856,128,500,utRho04
654,hisS,5281284,5281284,5281150,134,428,utRho04
655,hlpA,400910,400964,400910,54,140,utRho04
656,hlyE,2460932,2460932,2460788,144,0,utRho04
657,hmp,5371594,5371670,5371594,76,0,utRho04
658,hns,2585916,2585916,2585844,72,956,utRho04
659,hofM,7045856,7045856,7045502,354,8,utRho04
660,hokA,7441620,7441620,7441200,420,3210,utRho04
661,hokC,33902,33902,33806,96,42,utRho04
662,hokE,1215462,1215672,1215462,210,40,utRho04
663,holC,8968546,8968546,8968560,14,314,utRho04
664,holD,9215562,9215606,9215562,44,0,utRho04
665,holE,3850040,3850216,3850040,176,494,utRho04
666,hpt,282720,282862,282720,142,118,utRho04
667,hrpB,324150,324210,324150,60,142,utRho04
668,hscB,5319048,5319048,5318934,114,648,utRho04
669,hscC,1367188,1367188,1366786,402,278,utRho04
670,hsdS,9163004,9163004,9162924,80,0,utRho04
671,hslJ,2883560,2883560,2883486,74,126,utRho04
672,hslO,7059344,7059548,7059344,204,4128,utRho04
673,hslR,7058220,7058696,7058220,476,860,utRho04
674,hslV,8244708,8244708,8244574,134,130,utRho04
675,hsrA,7881412,7881412,7881224,188,36,utRho04
676,htgA,21286,21660,21286,374,662,utRho04
677,htpG,989634,990240,989634,606,4550,utRho04
678,htpX,3825236,3825236,3825152,84,0,utRho04
679,htrE,311036,311036,310852,184,102,utRho04
680,htrL,7587668,7587668,7587366,302,100,utRho04
681,hupA,8400352,8400562,8400352,210,274,utRho04
682,hupB,1845220,1845804,1845220,584,268,utRho04
683,hyaA,2063968,2064278,2063968,310,40,utRho04
684,hybO,6292726,6292726,6292522,204,700,utRho04
685,hycA,5700922,5700922,5700870,52,0,utRho04
686,hycI,5686204,5686204,5686086,118,12,utRho04
687,hydN,5676264,5676264,5676210,54,0,utRho04
688,hyfA,5202342,5202402,5202342,60,0,utRho04
689,hypA,11402508,11402588,11402508,80,0,utRho04
690,hypB,11403356,11404004,11403356,648,40,utRho04
691,hypF,5676210,5676210,5674850,1360,488,utRho04
692,hypT,9116634,9116634,9116578,56,24,utRho04
693,hyuA,6019660,6020056,6019660,396,0,utRho04
694,iaaA,1733074,1733136,1733074,62,0,utRho04
695,iadA,9119074,9119074,9119052,22,14,utRho04
696,iap,5753072,5753162,5753072,90,2,utRho04
697,ibaG,6673966,6673966,6673606,360,106,utRho04
698,ibpA,7735036,7735036,7734844,192,306,utRho04
699,ibpB,7733962,7733962,7733794,168,180,utRho04
700,icd,2389922,2390246,2389922,324,294,utRho04
701,iclR,8447304,8447304,8447256,48,74,utRho04
702,idi,6065876,6066130,6065876,254,0,utRho04
703,idnD,8988870,8988870,8988812,58,0,utRho04
704,idnK,8989194,8989246,8989194,52,0,utRho04
705,ihfA,3591442,3591442,3591104,338,960,utRho04
706,ihfB,1927498,1927656,1927498,158,660,utRho04
707,ileS,43666,44782,43666,1116,2732,utRho04
708,ileX,6431194,6431196,6431194,2,2,utRho04
709,ilvA,15820940,15821324,15820940,384,192,utRho04
710,ilvC,7915824,7915940,7915824,116,0,utRho04
711,ilvE,15809552,15809936,15809552,384,452,utRho04
712,ilvI,170840,171260,170840,420,0,utRho04
713,ilvL,23701308,23701932,23701308,624,0,utRho04
714,ilvY,7915734,7915734,7915640,94,0,utRho04
715,inaA,4698998,4698998,4698944,54,54,utRho04
716,infA,1853370,1853370,1852886,484,3242,utRho04
717,infC,3602692,3602692,3601276,1416,5266,utRho04
718,insA-5,3958452,3958452,3958430,22,4,utRho04
719,insA-7,9036758,9037054,9036758,296,108,utRho04
720,insC-5,6372080,6372284,6372080,204,102,utRho04
721,insEF-2,785238,785238,785820,582,264,utRho04
722,insEF-4,2190310,2190310,2190892,582,204,utRho04
723,insG,9007098,9007098,9006862,236,0,utRho04
724,insH-1,550596,550596,550234,362,44,utRho04
725,insH-11,7306538,7306538,7306396,142,42,utRho04
726,insH-2,1151548,1151548,1151506,42,102,utRho04
727,insH-3,1378444,1378444,1378026,418,180,utRho04
728,insH-4,2791942,2792152,2791942,210,58,utRho04
729,insH-5,2857852,2857852,2857452,400,14,utRho04
730,insH-6,4135022,4135022,4134642,380,60,utRho04
731,insH-7,4206186,4206186,4205822,364,4366,utRho04
732,insH-9,6260050,6260356,6260050,306,100,utRho04
733,insI-3,9017372,9017372,9017234,138,8,utRho04
734,insJ,7441188,7441360,7441188,172,1700,utRho04
735,insK,7442130,7442308,7442130,178,24,utRho04
736,insL-1,30760,30890,30760,130,254,utRho04
737,insL-2,1216112,1216130,1216112,18,22,utRho04
738,insL-3,5028644,5028662,5028644,18,108,utRho04
739,insN-1,540452,540484,540452,32,0,utRho04
740,intD,1132202,1132202,1131956,246,78,utRho04
741,intR,2826520,2826520,2826470,50,0,utRho04
742,intS,4933026,4933090,4933026,64,370,utRho04
743,intZ,5117386,5117542,5117386,156,10,utRho04
744,iraD,9113152,9113986,9113152,834,0,utRho04
745,iraM,2424246,2424246,2424006,240,0,utRho04
746,iraP,802638,802772,802638,134,0,utRho04
747,iscA,5319924,5319924,5319772,152,498,utRho04
748,iscR,5324398,5324398,5324262,136,18026,utRho04
749,iscX,5313834,5313834,5313472,362,2084,utRho04
750,ispF,5743968,5743968,5743560,408,818,utRho04
751,ispG,5283908,5283908,5283608,300,1064,utRho04
752,ispU,389568,389806,389568,238,280,utRho04
753,isrA,2811502,2811502,2811618,116,56,utRho04
754,istr-1,7706384,7706384,7706384,0,0,utRho04
755,istr-2,7706514,7706514,7706514,0,0,utRho04
756,ivbL,15412092,15412092,15411952,140,196,utRho04
757,ivy,480638,480686,480638,48,0,utRho04
758,katE,3627628,3627734,3627628,106,24,utRho04
759,katG,8267624,8267670,8267624,46,26,utRho04
760,kbaZ,6557732,6557828,6557732,96,0,utRho04
761,kbl,7585154,7585154,7585102,52,296,utRho04
762,kch,2621046,2621046,2620538,508,0,utRho04
763,kdgR,3820506,3820506,3820198,308,2,utRho04
764,kdpE,1443788,1443788,1443466,322,0,utRho04
765,kdpF,1457698,1457698,1457642,56,0,utRho04
766,kdsA,2535708,2536330,2535708,622,2032,utRho04
767,kdsC,6683438,6684546,6683438,1108,2378,utRho04
768,kduI,5968388,5968388,5968248,140,648,utRho04
769,kefF,94160,94492,94160,332,0,utRho04
770,kgtP,5451624,5451624,5451492,132,1016,utRho04
771,kup,7862206,7862632,7862206,426,24,utRho04
772,lacI,735076,735076,735020,56,34,utRho04
773,lacZ,1465508,1465508,1465220,288,176,utRho04
774,ldcA,2486394,2486394,2486160,234,0,utRho04
775,ldhA,2885830,2885830,2885686,144,0,utRho04
776,ldrA,2538954,2538954,2538550,404,1046,utRho04
777,ldrB,2540024,2540024,2539620,404,536,utRho04
778,ldrC,2541092,2541092,2540690,402,764,utRho04
779,ldrD,7400544,7400544,7400174,370,1144,utRho04
780,lepA,5414392,5414392,5414248,144,158,utRho04
781,lepB,5410928,5410928,5410618,310,928,utRho04
782,leuD,159188,159188,158906,282,0,utRho04
783,leuE,3761600,3761600,3761518,82,38,utRho04
784,leuL,168048,168048,167416,632,0,utRho04
785,leuO,168308,168736,168308,428,136,utRho04
786,leuQ,9212864,9212864,9212802,62,2,utRho04
787,leuU,6644556,6644556,6644316,240,3746,utRho04
788,leuV,9212546,9212546,9212330,216,938,utRho04
789,leuX,8992772,8992810,8992772,38,0,utRho04
790,lexA,8514174,8514230,8514174,56,104,utRho04
791,lhr,3456706,3458174,3456706,1468,3060,utRho04
792,ligA,5060402,5060402,5060352,50,0,utRho04
793,ligB,7642576,7642576,7642340,236,0,utRho04
794,lipA,1320602,1320602,1320432,170,0,utRho04
795,lipB,1324802,1324802,1324556,246,1710,utRho04
796,lit,2397032,2397390,2397032,358,184,utRho04
797,livJ,7199524,7199524,7199316,208,1652,utRho04
798,livK,7195510,7195510,7195120,390,2,utRho04
799,lldP,7554578,7554798,7554578,220,778,utRho04
800,lnt,1381968,1381968,1381762,206,192,utRho04
801,loiP,6163784,6163826,6163784,42,0,utRho04
802,lolA,1874656,1874738,1874656,82,516,utRho04
803,lolB,2527112,2527112,2527000,112,44,utRho04
804,lolC,2350748,2350854,2350748,106,24,utRho04
805,lon,917630,917776,917630,146,218,utRho04
806,lpcA,486936,487086,486936,150,0,utRho04
807,lpd,255434,255824,255434,390,3148,utRho04
808,lplA,9248476,9248476,9248234,242,646,utRho04
809,lplT,5947878,5947878,5947724,154,0,utRho04
810,lpoA,6586422,6586800,6586422,378,174,utRho04
811,lpp,3514592,3514842,3514592,250,232,utRho04
812,lptA,6686598,6686760,6686598,162,1122,utRho04
813,lptB,6686792,6687888,6686792,1096,1446,utRho04
814,lptD,114672,114672,114218,454,1528,utRho04
815,lptF,8972244,8972436,8972244,192,0,utRho04
816,lpxC,213016,213114,213016,98,19188,utRho04
817,lpxD,401920,401942,401920,22,0,utRho04
818,lpxL,2233418,2233418,2233164,254,30,utRho04
819,lpxM,3880456,3880456,3880386,70,98,utRho04
820,lpxP,4991156,4991290,4991156,134,348,utRho04
821,lrhA,4813312,4813312,4813282,30,0,utRho04
822,lrp,1864656,1865190,1864656,534,426,utRho04
823,lspA,50028,50414,50028,386,496,utRho04
824,lsrA,3202920,3202980,3202920,60,0,utRho04
825,lsrR,3202514,3202514,3202482,32,0,utRho04
826,ltaE,1818640,1818640,1818588,52,0,utRho04
827,luxS,5630130,5630130,5629466,664,1056,utRho04
828,lysA,5957902,5957902,5957798,104,0,utRho04
829,lysC,8467232,8467232,8466466,766,212,utRho04
830,lysP,4497120,4497120,4497064,56,50,utRho04
831,lysR,5957900,5958042,5957900,142,0,utRho04
832,lysT,1561028,1561108,1561028,80,32,utRho04
833,lysU,8709610,8709610,8709434,176,52,utRho04
834,macB,1840188,1840694,1840188,506,72,utRho04
835,maeA,3111484,3111484,3111338,146,1980,utRho04
836,mak,820236,820288,820236,52,2,utRho04
837,malE,8492928,8492928,8492838,90,36,utRho04
838,malI,3398456,3398456,3398360,96,0,utRho04
839,malK,8493472,8493568,8493472,96,0,utRho04
840,malP,7105020,7105020,7104946,74,166,utRho04
841,malQ,7100798,7100798,7100140,658,130,utRho04
842,malS,14949880,14949988,14949880,108,80,utRho04
843,malT,7106048,7106170,7106048,122,90,utRho04
844,malX,3398626,3398710,3398626,84,0,utRho04
845,malZ,1689980,1690072,1689980,92,1528,utRho04
846,manA,3377102,3377152,3377102,50,86,utRho04
847,manX,3803866,3804096,3803866,230,0,utRho04
848,marC,3237882,3237882,3237816,66,46,utRho04
849,marR,3238186,3238240,3238186,54,18,utRho04
850,matP,2036918,2036970,2036918,52,70,utRho04
851,mazE,5822736,5822736,5822678,58,12,utRho04
852,mazG,5821720,5821720,5821370,350,2142,utRho04
853,mcbA,1684306,1684306,1684112,194,0,utRho04
854,mcbR,3040192,3040524,3040192,332,0,utRho04
855,mcrA,2420278,2420692,2420278,414,88,utRho04
856,mcrC,9156124,9156124,9155916,208,168,utRho04
857,mdaB,6344814,6345060,6344814,246,0,utRho04
858,mdfA,1767138,1767346,1767138,208,0,utRho04
859,mdh,6768940,6768940,6768536,404,228,utRho04
860,mdoB,9198988,9198988,9198882,106,398,utRho04
861,mdoD,2993290,2993712,2993290,422,0,utRho04
862,mdoG,2218514,2218670,2218514,156,0,utRho04
863,mdtA,4307958,4308032,4307958,74,0,utRho04
864,mdtE,7318168,7318464,7318168,296,40,utRho04
865,mdtK,3486538,3486914,3486538,376,144,utRho04
866,mdtP,8602472,8602472,8602060,412,2,utRho04
867,melA,8683774,8683822,8683774,48,0,utRho04
868,melR,8683300,8683300,8683256,44,14,utRho04
869,menA,8240812,8240812,8240698,114,24,utRho04
870,menB,4753774,4753774,4753638,136,190,utRho04
871,mepH,3468714,3468870,3468714,156,0,utRho04
872,mepM,3883666,3883666,3883270,396,926,utRho04
873,mepS,4539840,4539958,4539840,118,478,utRho04
874,metA,8428318,8428560,8428318,242,178,utRho04
875,metB,8257272,8257344,8257272,72,528,utRho04
876,metC,6304150,6304472,6304150,322,196,utRho04
877,metE,8025768,8026106,8025768,338,88,utRho04
878,metF,8265092,8265232,8265092,140,82,utRho04
879,metG,4388538,4388600,4388538,62,80,utRho04
880,metH,8447010,8447656,8447010,646,5162,utRho04
881,metJ,8257116,8257116,8256790,326,210,utRho04
882,metK,6173154,6173412,6173154,258,94,utRho04
883,metN,445428,445428,445290,138,0,utRho04
884,metR,8025710,8025710,8025632,78,0,utRho04
885,metT,1394326,1394326,1394266,60,84,utRho04
886,metY,19910250,19910250,19909734,516,5898,utRho04
887,metZ,11789528,11789548,11789528,20,4,utRho04
888,mfd,2348056,2348056,2347928,128,120,utRho04
889,mglA,4478782,4478782,4478578,204,62,utRho04
890,mglB,4481132,4481132,4480696,436,2524,utRho04
891,mglC,4475918,4475918,4475506,412,254,utRho04
892,mgrB,3817584,3817584,3817532,52,16,utRho04
893,mgrR,3245828,3245828,3245828,0,0,utRho04
894,mgsA,2054082,2054082,2054030,52,0,utRho04
895,mgtL,8934560,8934862,8934560,302,100,utRho04
896,mhpA,737038,737222,737038,184,0,utRho04
897,mhpR,737072,737072,736840,232,0,utRho04
898,mhpT,750772,750918,750772,146,0,utRho04
899,miaA,8797964,8798504,8797964,540,992,utRho04
900,micA,5629604,5629604,5629604,0,0,utRho04
901,micC,2874242,2874238,2874242,4,0,utRho04
902,micF,4626168,4626168,4626168,0,0,utRho04
903,micM,1014408,1014408,1014408,0,0,utRho04
904,minE,2449422,2449422,2449090,332,470,utRho04
905,mioC,7852950,7852950,7852910,40,22,utRho04
906,mipA,3733012,3733012,3732944,68,2924,utRho04
907,mlaA,4930270,4930270,4930014,256,26,utRho04
908,mlc,3337206,3337206,3337128,78,0,utRho04
909,mlrA,4429498,4429732,4429498,234,0,utRho04
910,mltA,5894546,5894546,5894356,190,106,utRho04
911,mltD,468050,468050,467910,140,18,utRho04
912,mltF,5391534,5391602,5391534,68,0,utRho04
913,mmuP,550238,550650,550238,412,44,utRho04
914,mngA,1531622,1531968,1531622,346,50,utRho04
915,mngR,1531852,1531852,1531750,102,26,utRho04
916,mnmG,7851348,7851348,7851266,82,5076,utRho04
917,mntH,5025470,5025470,5025412,58,0,utRho04
918,mntP,3810918,3811376,3810918,458,574,utRho04
919,mntR,1706160,1706366,1706160,206,0,utRho04
920,mntS,1706128,1706128,1705994,134,98,utRho04
921,moaA,1633654,1634088,1633654,434,632,utRho04
922,moaB,1635954,1636110,1635954,156,486,utRho04
923,mobA,8084242,8084242,8083998,244,326,utRho04
924,mocA,6030112,6030320,6030112,208,0,utRho04
925,modA,1589990,1590178,1589990,188,28,utRho04
926,moeA,1732788,1732788,1732728,60,104,utRho04
927,mokB,2984610,2984610,2984258,352,446,utRho04
928,molR_1,4392888,4392948,4392888,60,166,utRho04
929,motA,3954604,3954604,3954278,326,8,utRho04
930,mpaA,2781278,2781278,2781196,82,56,utRho04
931,mpl,8911456,8911570,8911456,114,0,utRho04
932,mppA,2786108,2786454,2786108,346,0,utRho04
933,mprA,5621494,5621540,5621494,46,234,utRho04
934,mqo,4613848,4613848,4613508,340,382,utRho04
935,mqsA,6336742,6336742,6336492,250,18,utRho04
936,mqsR,6337306,6337306,6337088,218,128,utRho04
937,mraZ,179192,179268,179192,76,0,utRho04
938,mrcA,7045652,7045742,7045652,90,0,utRho04
939,mrcB,329442,329460,329442,18,0,utRho04
940,mreB,13605424,13605424,13604348,1076,1376,utRho04
941,mreD,6798166,6798166,6797750,416,292,utRho04
942,mrp,4388360,4388360,4388336,24,2,utRho04
943,mscK,972984,973072,972984,88,20,utRho04
944,mscL,6876002,6876048,6876002,46,144,utRho04
945,mscS,6139742,6139742,6139614,128,34,utRho04
946,msrA,8884522,8884522,8884352,170,118,utRho04
947,msrB,3725168,3725168,3724858,310,0,utRho04
948,msyB,2228426,2228426,2228362,64,36,utRho04
949,mtfA,4087236,4087302,4087236,66,436,utRho04
950,mtgA,6699662,6699662,6699618,44,48,utRho04
951,mtlA,30177504,30178248,30177504,744,696,utRho04
952,mtn,358366,358366,358306,60,6,utRho04
953,mtr,6611864,6611864,6611634,230,86,utRho04
954,mug,6430992,6430992,6430946,46,84,utRho04
955,murQ,5091466,5091546,5091466,80,0,utRho04
956,murR,5091586,5091586,5091218,368,0,utRho04
957,mutH,5939164,5939324,5939164,160,650,utRho04
958,mutL,8794092,8794824,8794092,732,786,utRho04
959,mutM,7622554,7622554,7622304,250,644,utRho04
960,mutS,5714038,5714186,5714038,148,114,utRho04
961,mutY,18617466,18618078,18617466,612,408,utRho04
962,nac,4123956,4123956,4123866,90,0,utRho04
963,nadA,1564122,1564170,1564122,48,0,utRho04
964,nadB,5420714,5420840,5420714,126,20,utRho04
965,nadC,237326,237326,237290,36,18,utRho04
966,nadE,3644604,3644916,3644604,312,78,utRho04
967,nadK,5501526,5501662,5501526,136,284,utRho04
968,nagA,1406350,1406350,1405502,848,1420,utRho04
969,nagB,1407416,1407416,1407222,194,52,utRho04
970,nagC,1404016,1404016,1403188,828,116,utRho04
971,nagE,1407680,1407888,1407680,208,48,utRho04
972,nagK,2357080,2357186,2357080,106,0,utRho04
973,nanA,6747240,6747240,6747152,88,2,utRho04
974,nanC,9079856,9079856,9079002,854,60,utRho04
975,nanR,6749406,6749406,6748978,428,108,utRho04
976,nanS,9075406,9075406,9075188,218,0,utRho04
977,napF,4607390,4607390,4606994,396,0,utRho04
978,narG,2559614,2559728,2559614,114,0,utRho04
979,narK,2555642,2555914,2555642,272,0,utRho04
980,narP,4580844,4581000,4580844,156,0,utRho04
981,narQ,5171154,5171462,5171154,308,46,utRho04
982,narU,3088326,3088326,3088120,206,20,utRho04
983,narW,3077374,3077374,3074618,2756,28,utRho04
984,narX,2555554,2555554,2555236,318,94,utRho04
985,narZ,3085380,3085380,3085180,200,0,utRho04
986,ndh,2331984,2332170,2331984,186,72,utRho04
987,ndk,5289920,5289920,5289728,192,390,utRho04
988,nemR,6904084,6904092,6904084,8,0,utRho04
989,nepI,7683542,7683542,7683478,64,224,utRho04
990,nfo,4501612,4501680,4501612,68,46,utRho04
991,nfsB,1210906,1210906,1210848,58,10,utRho04
992,nfuA,7090916,7091248,7090916,332,368,utRho04
993,nhaA,34634,34978,34634,344,58,utRho04
994,nhaB,2469534,2469534,2469434,100,12,utRho04
995,nhoA,3067926,3068048,3067926,122,0,utRho04
996,nikA,7226878,7227334,7226878,456,1302,utRho04
997,nikR,7237074,7237176,7237074,102,220,utRho04
998,nirB,6987974,6988022,6987974,48,34,utRho04
999,nlpA,7680034,7680034,7679986,48,0,utRho04
1000,nlpC,3585654,3585654,3585462,192,60,utRho04
1001,nlpD,5737658,5737658,5737506,152,16,utRho04
1002,nlpI,6618080,6618080,6617848,232,12,utRho04
1003,nmpC,1153740,1153740,1153650,90,0,utRho04
1004,nohA,3273206,3273206,3272734,472,2,utRho04
1005,norR,5664614,5664614,5664578,36,0,utRho04
1006,norV,5664878,5664952,5664878,74,0,utRho04
1007,nrdA,4689510,4689730,4689510,220,5018,utRho04
1008,nrdD,8925676,8925676,8925320,356,1782,utRho04
1009,nrdH,5601312,5601446,5601312,134,366,utRho04
1010,nrdR,865954,866004,865954,50,0,utRho04
1011,nrfA,8575342,8575528,8575342,186,50,utRho04
1012,nsrR,8812088,8812380,8812088,292,26194,utRho04
1013,nudB,3897348,3897348,3897264,84,42,utRho04
1014,nudC,8393428,8393806,8393428,378,0,utRho04
1015,nudE,7052658,7052658,7052298,360,2714,utRho04
1016,nudG,3682876,3682980,3682876,104,0,utRho04
1017,nudI,4729050,4729108,4729050,58,0,utRho04
1018,nudJ,2388874,2388874,2388576,298,916,utRho04
1019,nuoA,4810670,4810670,4810144,526,2146,utRho04
1020,nuoN,4783434,4783434,4783010,424,1282,utRho04
1021,nupC,5026018,5026084,5026018,66,0,utRho04
1022,nupG,6211302,6211428,6211302,126,90,utRho04
1023,ogrK,4335096,4335096,4335040,56,0,utRho04
1024,ogt,2800568,2800568,2800472,96,70,utRho04
1025,ohsC,5401036,5401040,5401036,4,4,utRho04
1026,ompA,2040382,2040382,2040106,276,11932,utRho04
1027,ompC,4625774,4625774,4625498,276,44,utRho04
1028,ompF,1974184,1974184,1973964,220,90,utRho04
1029,ompL,8128958,8128958,8128590,368,0,utRho04
1030,ompN,2874158,2874158,2873786,372,4,utRho04
1031,ompR,7073510,7073510,7073168,342,92,utRho04
1032,ompT,1171330,1171330,1171266,64,2,utRho04
1033,ompW,2627982,2628040,2627982,58,0,utRho04
1034,ompX,1700418,1700900,1700418,482,626,utRho04
1035,omrA,5952378,5952378,5952378,0,0,utRho04
1036,omrB,5952770,5952770,5952770,0,0,utRho04
1037,oppA,2602170,2602364,2602170,194,10364,utRho04
1038,orn,8783168,8783208,8783168,40,0,utRho04
1039,osmB,2686952,2686952,2686656,296,132,utRho04
1040,osmC,3113192,3113250,3113192,58,0,utRho04
1041,osmE,3644566,3644566,3644512,54,0,utRho04
1042,osmF,4439046,4439046,4438962,84,392,utRho04
1043,osmY,9222306,9222792,9222306,486,26,utRho04
1044,otsA,3963302,3963302,3963224,78,12,utRho04
1045,otsB,3964930,3964930,3964774,156,112,utRho04
1046,oxc,4984288,4984288,4983900,388,0,utRho04
1047,oxyR,8316914,8316980,8316914,66,0,utRho04
1048,oxyS,8316788,8316788,8316788,0,0,utRho04
1049,paaA,2907730,2907854,2907730,124,0,utRho04
1050,paaX,2927018,2927078,2927018,60,0,utRho04
1051,paaZ,2907340,2907340,2907284,56,0,utRho04
1052,pabA,6981702,6981702,6981658,44,0,utRho04
1053,pabB,3789256,3789610,3789256,354,132,utRho04
1054,pabC,2306186,2306600,2306186,414,162,utRho04
1055,pagP,1313052,1313114,1313052,62,0,utRho04
1056,panB,299260,299260,299202,58,96,utRho04
1057,panC,297840,297840,297590,250,356,utRho04
1058,panD,293490,293490,293388,102,54,utRho04
1059,panZ,7195656,7195968,7195656,312,0,utRho04
1060,parC,6332060,6332060,6331946,114,26,utRho04
1061,patA,6438916,6438988,6438916,72,0,utRho04
1062,patD,3030830,3031156,3030830,326,0,utRho04
1063,pbpC,5294986,5294986,5294650,336,12,utRho04
1064,pbpG,4450132,4450132,4449740,392,24,utRho04
1065,pck,7065358,7065636,7065358,278,1624,utRho04
1066,pcnB,318782,318782,318252,530,608,utRho04
1067,pdhR,244068,244184,244068,116,232,utRho04
1068,pdxB,4875768,4875768,4875702,66,0,utRho04
1069,pdxH,3436068,3436068,3436014,54,292,utRho04
1070,pdxJ,5403626,5403626,5403458,168,90,utRho04
1071,pdxK,5074638,5074638,5074474,164,74,utRho04
1072,pepA,8972278,8972278,8971902,376,26,utRho04
1073,pepD,511618,511618,511432,186,2330,utRho04
1074,pepN,1981182,1981244,1981182,62,2,utRho04
1075,pepQ,8062294,8062322,8062294,28,0,utRho04
1076,pepT,2371646,2371688,2371646,42,0,utRho04
1077,pfkA,8214948,8215104,8214948,156,302,utRho04
1078,pfkB,3612646,3612740,3612646,94,0,utRho04
1079,pflA,1902456,1902456,1902160,296,26,utRho04
1080,pflB,1907850,1907850,1907108,742,1140,utRho04
1081,pflD,8287716,8287990,8287716,274,0,utRho04
1082,pgaA,2185046,2185046,2184578,468,4,utRho04
1083,pgi,8467444,8467516,8467444,72,0,utRho04
1084,pgk,12291428,12291428,12290488,940,2892,utRho04
1085,pgl,1597078,1597172,1597078,94,0,utRho04
1086,pgpB,2678324,2678660,2678324,336,48,utRho04
1087,pgpC,5397276,5397276,5397100,176,0,utRho04
1088,pgrR,2783744,2783982,2783744,238,0,utRho04
1089,pheL,5475158,5475198,5475158,40,0,utRho04
1090,pheM,7197204,7197204,7197080,124,128,utRho04
1091,pheP,1203858,1203918,1203858,60,2,utRho04
1092,pheU,8725254,8725254,8725252,2,0,utRho04
1093,pheV,6220730,6220732,6220730,2,0,utRho04
1094,phnC,8650412,8650412,8650330,82,8,utRho04
1095,phoA,803414,803494,803414,80,0,utRho04
1096,phoB,834202,834284,834202,82,0,utRho04
1097,phoE,520316,520316,520200,116,0,utRho04
1098,phoH,2169730,2169984,2169730,254,346,utRho04
1099,phoP,2381016,2381016,2380894,122,472,utRho04
1100,phoQ,2379880,2379880,2379552,328,890,utRho04
1101,phoU,7815330,7815330,7815156,174,36,utRho04
1102,phr,1478842,1479014,1478842,172,86,utRho04
1103,pinE,2419054,2419370,2419054,316,0,utRho04
1104,pinQ,3267168,3267244,3267168,76,600,utRho04
1105,pinR,2867424,2867424,2867348,76,546,utRho04
1106,pitA,7275224,7275284,7275224,60,0,utRho04
1107,pitB,6272806,6272806,6272742,64,0,utRho04
1108,pka,5439862,5439906,5439862,44,0,utRho04
1109,plaP,4174476,4174476,4174124,352,776,utRho04
1110,pldA,8009628,8009724,8009628,96,22,utRho04
1111,pldB,8018028,8018340,8018028,312,170,utRho04
1112,plsB,8513196,8513196,8512932,264,54,utRho04
1113,pmbA,8915890,8915918,8915890,28,4,utRho04
1114,pmrD,4747148,4747148,4747076,72,12,utRho04
1115,pncB,1980828,1980828,1980712,116,66,utRho04
1116,pncC,5648788,5648788,5648692,96,0,utRho04
1117,pnp,6622652,6622652,6622336,316,56,utRho04
1118,pntA,3355950,3355950,3355806,144,0,utRho04
1119,pntB,3353096,3353096,3352720,376,24,utRho04
1120,polA,8093880,8093932,8093880,52,66,utRho04
1121,polB,131606,131606,131560,46,20,utRho04
1122,potD,2365700,2365700,2365658,42,8,utRho04
1123,potE,1436688,1436688,1436530,158,18,utRho04
1124,potF,1787268,1787568,1787268,300,0,utRho04
1125,poxB,1822152,1822152,1822098,54,0,utRho04
1126,ppa,8899372,8899372,8899304,68,152,utRho04
1127,ppc,8306380,8306380,8306196,184,156,utRho04
1128,ppdA,5928440,5928440,5928354,86,782,utRho04
1129,ppdD,235410,235410,235098,312,402,utRho04
1130,pphA,3846770,3846770,3845938,832,1172,utRho04
1131,pphB,5719474,5719520,5719474,46,0,utRho04
1132,ppiA,6984898,6984898,6984594,304,0,utRho04
1133,ppiC,7919682,7919682,7919626,56,8,utRho04
1134,ppiD,923638,923830,923638,192,824,utRho04
1135,ppk,5245748,5246088,5245748,340,380,utRho04
1136,pppA,6228958,6228958,6228704,254,56,utRho04
1137,ppsA,3574322,3574322,3574224,98,12,utRho04
1138,ppsR,3574678,3574890,3574678,212,0,utRho04
1139,pptA,3065716,3066104,3065716,388,0,utRho04
1140,pqiA,2023318,2024002,2023318,684,124,utRho04
1141,prc,3830054,3830054,3829632,422,12692,utRho04
1142,preT,4467978,4468066,4467978,88,0,utRho04
1143,prfC,9218688,9218828,9218688,140,682,utRho04
1144,prkB,6968622,6968980,6968622,358,888,utRho04
1145,prlC,7290476,7290476,7290364,112,280,utRho04
1146,prlF,6553944,6554004,6553944,60,244,utRho04
1147,proB,520432,520776,520432,344,156,utRho04
1148,proC,811372,811372,811288,84,0,utRho04
1149,proK,7417388,7417388,7417384,4,12,utRho04
1150,proL,4572414,4572422,4572414,8,78,utRho04
1151,proP,8660640,8661004,8660640,364,3500,utRho04
1152,proS,437674,437674,437550,124,244,utRho04
1153,proV,5609126,5609630,5609126,504,48,utRho04
1154,prpB,697292,697364,697292,72,0,utRho04
1155,prpR,696942,696942,696886,56,0,utRho04
1156,prs,2524354,2524354,2523750,604,43112,utRho04
1157,psd,8781276,8781276,8780720,556,2488,utRho04
1158,psiE,8480600,8480650,8480600,50,0,utRho04
1159,pspA,2736076,2736158,2736076,82,0,utRho04
1160,pspF,2736080,2736080,2735824,256,0,utRho04
1161,pspG,8525632,8525680,8525632,48,0,utRho04
1162,pssA,5445156,5445454,5445156,298,1418,utRho04
1163,pstB,7817112,7817112,7816732,380,138,utRho04
1164,pstC,7821084,7821084,7820796,288,50,utRho04
1165,pstS,23469408,23469408,23469150,258,72,utRho04
1166,psuG,4517114,4517114,4516734,380,82,utRho04
1167,psuT,4514992,4514992,4514670,322,0,utRho04
1168,pth,2517084,2517084,2517026,58,42,utRho04
1169,ptrA,5918022,5918022,5917768,254,22,utRho04
1170,ptrB,3857730,3857730,3857678,52,2550,utRho04
1171,ptsG,2315252,2315738,2315252,486,980,utRho04
1172,ptsH,5066996,5067528,5066996,532,2334,utRho04
1173,purA,8809328,8809374,8809328,46,2,utRho04
1174,purC,5195562,5195562,5195236,326,16,utRho04
1175,purD,8411972,8411972,8411862,110,24,utRho04
1176,purE,1106284,1106284,1106200,84,862,utRho04
1177,purH,8415254,8415254,8415064,190,84,utRho04
1178,purL,5391178,5391178,5391086,92,332,utRho04
1179,purM,5242306,5242394,5242306,88,20,utRho04
1180,purR,3475378,3475688,3475378,310,810,utRho04
1181,purT,3861438,3861762,3861438,324,174,utRho04
1182,purU,2577512,2577512,2577248,264,896,utRho04
1183,putA,2157850,2157850,2157764,86,0,utRho04
1184,putP,2158336,2158610,2158336,274,286,utRho04
1185,puuA,2721936,2721936,2721816,120,0,utRho04
1186,puuC,2725456,2725486,2725456,30,0,utRho04
1187,puuD,2722104,2722240,2722104,136,0,utRho04
1188,puuP,2718746,2718746,2718374,372,614,utRho04
1189,pykA,3874988,3875298,3874988,310,176,utRho04
1190,pykF,3510934,3511396,3510934,462,1020,utRho04
1191,pyrC,2245286,2245286,2245214,72,58,utRho04
1192,pyrD,2009464,2009536,2009464,72,34,utRho04
1193,pyrE,7631970,7631970,7631536,434,0,utRho04
1194,pyrF,2683740,2683842,2683740,102,136,utRho04
1195,pyrG,5819594,5819594,5819332,262,1872,utRho04
1196,pyrH,383624,383710,383624,86,1162,utRho04
1197,pyrL,8945490,8945490,8945066,424,0,utRho04
1198,qmcA,1031646,1031646,1031546,100,36,utRho04
1199,qor,8528608,8528608,8528462,146,140,utRho04
1200,qseB,6339502,6339656,6339502,154,0,utRho04
1201,queA,849970,850022,849970,52,300,utRho04
1202,queE,5811212,5811212,5810836,376,0,utRho04
1203,queF,5850642,5850696,5850642,54,6,utRho04
1204,queG,8788184,8788184,8788134,50,408,utRho04
1205,racC,2835630,2835630,2835526,104,2,utRho04
1206,racR,2840898,2840898,2840482,416,0,utRho04
1207,raiA,5474208,5474308,5474208,100,126,utRho04
1208,rarD,8008594,8008594,8008356,238,76,utRho04
1209,ravA,7862256,7862256,7862186,70,0,utRho04
1210,rayT,495088,495274,495088,186,0,utRho04
1211,rbn,4763162,4763216,4763162,54,0,utRho04
1212,rbsD,7866644,7866702,7866644,58,0,utRho04
1213,rcnA,4371654,4371834,4371654,180,2,utRho04
1214,rcnB,4373768,4373920,4373768,152,92,utRho04
1215,rcnR,4371806,4371806,4371592,214,2,utRho04
1216,rcsA,4047672,4047936,4047672,264,170,utRho04
1217,rcsB,4631390,4632354,4631390,964,1144,utRho04
1218,rcsC,4640162,4640162,4639656,506,180,utRho04
1219,rcsD,4626904,4626976,4626904,72,486,utRho04
1220,rdgB,6193240,6193362,6193240,122,118,utRho04
1221,rdlA,2538646,2538646,2538646,0,0,utRho04
1222,rdlB,2539712,2539716,2539712,4,0,utRho04
1223,rdlC,2540782,2540786,2540782,4,0,utRho04
1224,rdlD,7400272,7400272,7400272,0,0,utRho04
1225,rdoA,8084782,8084830,8084782,48,46,utRho04
1226,recA,11295276,11295276,11295076,200,956,utRho04
1227,recC,5925014,5925014,5924856,158,118,utRho04
1228,recF,7763722,7763722,7762442,1280,11334,utRho04
1229,recN,5503518,5503590,5503518,72,0,utRho04
1230,recQ,8011666,8011728,8011666,62,0,utRho04
1231,relA,5828554,5828554,5827302,1252,462,utRho04
1232,relB,3291806,3291806,3291744,62,0,utRho04
1233,rem,3289950,3289950,3289804,146,0,utRho04
1234,rep,7921294,7921354,7921294,60,16,utRho04
1235,rfaD,7587730,7587974,7587730,244,64,utRho04
1236,rfaE,6393852,6393852,6393506,346,8,utRho04
1237,rfaH,8049930,8049930,8049642,288,1260,utRho04
1238,rfbX,4219436,4219436,4219168,268,1380,utRho04
1239,rfe,7935600,7935832,7935600,232,32,utRho04
1240,rhaB,8194944,8194944,8194896,48,0,utRho04
1241,rhaD,8188770,8188770,8188544,226,0,utRho04
1242,rhaS,8195422,8195472,8195422,50,0,utRho04
1243,rhaT,8201132,8201132,8201050,82,0,utRho04
1244,rhlE,1661566,1661744,1661566,178,288,utRho04
1245,rhoL,47593944,47594772,47593944,828,262440,utRho04
1246,rhsB,7238006,7238384,7238006,378,150,utRho04
1247,rhsC,1458758,1459166,1458758,408,0,utRho04
1248,rhsD,1046132,1046522,1046132,390,0,utRho04
1249,rhtA,1700608,1700608,1700194,414,0,utRho04
1250,rhtC,8015478,8015514,8015478,36,1394,utRho04
1251,ribA,2678468,2678468,2678320,148,24,utRho04
1252,ribC,3486916,3486916,3486484,432,176,utRho04
1253,ribE,869008,869294,869008,286,4826,utRho04
1254,ribF,42766,42814,42766,48,22,utRho04
1255,ridA,8941892,8941892,8941826,66,58,utRho04
1256,rihA,1369204,1369204,1368824,380,344,utRho04
1257,rihB,4510504,4510504,4510372,132,0,utRho04
1258,rimJ,2251044,2251124,2251044,80,0,utRho04
1259,rimK,1783752,1783934,1783752,182,136,utRho04
1260,rimL,2997486,2997876,2997486,390,130,utRho04
1261,rimO,1756140,1756140,1756070,70,0,utRho04
1262,rimP,6636350,6636350,6636012,338,642,utRho04
1263,rlmA,3814172,3814172,3814120,52,298,utRho04
1264,rlmD,5830086,5830086,5830000,86,0,utRho04
1265,rlmE,6655520,6655520,6655328,192,2432,utRho04
1266,rlmF,1684384,1684664,1684384,280,26,utRho04
1267,rlmG,6471784,6471784,6471750,34,20,utRho04
1268,rlmI,2060002,2060002,2059938,64,30,utRho04
1269,rlmJ,7290700,7290770,7290700,70,70,utRho04
1270,rlmL,2015344,2015688,2015344,344,578,utRho04
1271,rlpA,1330444,1330444,1330380,64,262,utRho04
1272,rluA,120900,120900,120692,208,138,utRho04
1273,rluF,8460324,8460708,8460324,384,0,utRho04
1274,rmf,2031006,2031430,2031006,424,956,utRho04
1275,rna,1290068,1290068,1290006,62,30,utRho04
1276,rnb,2698258,2698258,2697824,434,2594,utRho04
1277,rnc,10816892,10816892,10816252,640,7100,utRho04
1278,rnd,3776122,3776122,3775982,140,140,utRho04
1279,rne,2289746,2289746,2288734,1012,8722,utRho04
1280,rnhA,472082,472082,472004,78,324,utRho04
1281,rnk,1288360,1288360,1287934,426,310,utRho04
1282,rnlA,5531788,5531836,5531788,48,84,utRho04
1283,rnlB,5533414,5533968,5533414,554,1560,utRho04
1284,rnpB,19623552,19623552,19623552,0,0,utRho04
1285,rob,9270706,9270706,9270620,86,0,utRho04
1286,rodZ,5285868,5285868,5285688,180,112,utRho04
1287,rpe,7030306,7030306,7030118,188,244,utRho04
1288,rph,15266320,15266320,15266196,124,0,utRho04
1289,rpiA,6118706,6118706,6118650,56,34,utRho04
1290,rpiB,8626514,8626700,8626514,186,0,utRho04
1291,rpiR,8626274,8626274,8625982,292,0,utRho04
1292,rplJ,8359246,8359992,8359246,746,7720,utRho04
1293,rplK,8356708,8356894,8356708,186,680,utRho04
1294,rplM,6757344,6757344,6757302,42,7382,utRho04
1295,rplN,6896444,6896444,6896298,146,6236,utRho04
1296,rplS,5489284,5489284,5489060,224,10472,utRho04
1297,rplT,7199052,7199052,7198996,56,724,utRho04
1298,rplU,6667036,6667036,6666902,134,150,utRho04
1299,rplY,4564866,4565034,4564866,168,48,utRho04
1300,rpmA,6666450,6666450,6666238,212,460,utRho04
1301,rpmB,15247980,15247980,15246696,1284,76920,utRho04
1302,rpmE,8253816,8254026,8253816,210,768,utRho04
1303,rpmF,2294676,2294734,2294676,58,34442,utRho04
1304,rpmH,7768130,7768672,7768130,542,4166,utRho04
1305,rpmI,3600854,3600854,3599998,856,11886,utRho04
1306,rpoB,8362126,8362490,8362126,364,772,utRho04
1307,rpoD,6424946,6426094,6424946,1148,13744,utRho04
1308,rpoE,5420372,5420372,5420024,348,60,utRho04
1309,rpoH,7202006,7202006,7201566,440,14672,utRho04
1310,rpoN,6689324,6689434,6689324,110,62,utRho04
1311,rpoS,5736236,5736236,5735102,1134,1784,utRho04
1312,rpoZ,7644154,7644212,7644154,58,928,utRho04
1313,rppH,5937986,5937986,5937954,32,0,utRho04
1314,rprA,3540744,3540744,3540744,0,0,utRho04
1315,rpsA,1923434,1923990,1923434,556,114030,utRho04
1316,rpsF,8850050,8850236,8850050,186,27816,utRho04
1317,rpsI,6756580,6756580,6756414,166,6624,utRho04
1318,rpsJ,6906884,6906884,6906540,344,10088,utRho04
1319,rpsL,6949242,6949242,6949104,138,196,utRho04
1320,rpsM,6885130,6885130,6884942,188,1816,utRho04
1321,rpsO,13247144,13247144,13246736,408,1180,utRho04
1322,rpsP,5492508,5492508,5492370,138,66,utRho04
1323,rpsT,42420,42420,42156,264,534,utRho04
1324,rpsU,12842584,12843124,12842584,540,1776,utRho04
1325,rraA,8238716,8238716,8238660,56,250,utRho04
1326,rraB,8956768,8956946,8956768,178,0,utRho04
1327,rrsA,8070478,8071062,8070478,584,5694,utRho04
1328,rrsB,16665468,16666636,16665468,1168,12120,utRho04
1329,rrsC,7883032,7883616,7883032,584,7184,utRho04
1330,rrsD,6858094,6858094,6857524,570,472,utRho04
1331,rrsE,8415726,8416294,8415726,568,1410,utRho04
1332,rrsG,5462896,5462896,5462314,582,4452,utRho04
1333,rrsH,446970,447542,446970,572,1544,utRho04
1334,rsd,8393908,8393908,8393616,292,10,utRho04
1335,rseA,5419264,5419264,5418808,456,530,utRho04
1336,rseP,392940,393092,392940,152,198,utRho04
1337,rseX,4067298,4067298,4067298,0,0,utRho04
1338,rsfS,1338144,1338144,1338072,72,224,utRho04
1339,rsgA,8783132,8783132,8783018,114,34,utRho04
1340,rsmA,105176,105176,104860,316,2836,utRho04
1341,rsmB,6869982,6870414,6869982,432,476,utRho04
1342,rsmC,9215736,9215736,9215400,336,340,utRho04
1343,rsmD,7208594,7208786,7208594,192,40,utRho04
1344,rsmE,6182036,6182268,6182036,232,166,utRho04
1345,rsmG,7847512,7847512,7847360,152,1806,utRho04
1346,rsmH,180020,180188,180020,168,146,utRho04
1347,rsmI,6587106,6587106,6586670,436,568,utRho04
1348,rssA,2578212,2578412,2578212,200,226,utRho04
1349,rssB,2580440,2580484,2580440,44,142,utRho04
1350,rstA,3364276,3364300,3364276,24,0,utRho04
1351,rsuA,4561096,4561096,4560966,130,322,utRho04
1352,rsxA,3411510,3411534,3411510,24,102,utRho04
1353,rtcA,7114004,7114004,7113698,306,84,utRho04
1354,rtcB,7116214,7116214,7116158,56,0,utRho04
1355,rtn,4541356,4541452,4541356,96,86,utRho04
1356,rutA,2148052,2148052,2148022,30,0,utRho04
1357,rutG,2140090,2140090,2139678,412,0,utRho04
1358,rutR,2148226,2148484,2148226,258,0,utRho04
1359,ruvA,7784096,7784096,7783904,192,0,utRho04
1360,ruvB,7782176,7782176,7781424,752,420,utRho04
1361,ruvC,3894878,3894878,3894752,126,0,utRho04
1362,rybB,1776114,1776114,1776114,0,0,utRho04
1363,rydB,3529860,3529860,3529322,538,140,utRho04
1364,rydC,2983012,2983012,2983012,0,0,utRho04
1365,ryfA,5307398,5307710,5307398,312,0,utRho04
1366,ryfD,5468590,5468590,5468590,0,0,utRho04
1367,ryhB,7162032,7162032,7162032,0,0,utRho04
1368,ryjA,8556132,8556132,8556132,0,0,utRho04
1369,ryjB,9055954,9055954,9055954,0,0,utRho04
1370,sad,3229598,3229598,3229406,192,0,utRho04
1371,safA,3168056,3168056,3167918,138,0,utRho04
1372,sanA,4465368,4465756,4465368,388,36,utRho04
1373,sapF,2705314,2705314,2705268,46,28,utRho04
1374,sbcB,4165456,4165512,4165456,56,8,utRho04
1375,sbcC,831694,831694,831506,188,166,utRho04
1376,sbcD,833954,833954,833904,50,0,utRho04
1377,sbmA,793106,793278,793106,172,124,utRho04
1378,sbmC,4162650,4162650,4162524,126,2,utRho04
1379,sdaA,3793618,3793864,3793618,246,78,utRho04
1380,sdaC,5856070,5856458,5856070,388,944,utRho04
1381,sdhC,1509916,1510354,1509916,438,21602,utRho04
1382,sdhD,1510808,1511120,1510808,312,5986,utRho04
1383,sdiA,3993834,3993834,3993664,170,64,utRho04
1384,secE,8354354,8354716,8354354,362,678,utRho04
1385,secG,6645180,6645180,6645010,170,2882,utRho04
1386,selA,7522594,7522594,7522498,96,266,utRho04
1387,selB,7519850,7519850,7519722,128,126,utRho04
1388,selC,7672396,7672444,7672396,48,0,utRho04
1389,selD,3696058,3696058,3696016,42,2592,utRho04
1390,seqA,1425884,1425974,1425884,90,230,utRho04
1391,serA,6117098,6117098,6116820,278,88,utRho04
1392,serB,9249712,9249790,9249712,78,0,utRho04
1393,serC,3830380,3830612,3830380,232,24,utRho04
1394,serS,1878730,1878856,1878730,126,1760,utRho04
1395,serT,2063438,2063438,2063424,14,0,utRho04
1396,serU,4087124,4087124,4087114,10,82,utRho04
1397,serV,5637394,5637394,5637290,104,182,utRho04
1398,serW,1852014,1852014,1851942,72,188,utRho04
1399,serX,2195352,2195352,2195304,48,24,utRho04
1400,setB,4527426,4527726,4527426,300,28,utRho04
1401,setC,7673488,7673906,7673488,418,0,utRho04
1402,sfmA,1116124,1116424,1116124,300,0,utRho04
1403,sfmC,1117606,1117948,1117606,342,0,utRho04
1404,sfsA,323030,323030,322972,58,332,utRho04
1405,sfsB,6669592,6669818,6669592,226,164,utRho04
1406,sgrR,154676,154676,154598,78,0,utRho04
1407,sgrS,154734,154734,154734,0,0,utRho04
1408,shiA,4107068,4107286,4107068,218,0,utRho04
1409,sibA,4306622,4306622,4306622,0,0,utRho04
1410,sibB,4307292,4307292,4307292,0,0,utRho04
1411,sibC,6113702,6113702,6113702,0,0,utRho04
1412,sibD,6389730,6389730,6389730,0,0,utRho04
1413,sibE,6390480,6390480,6390480,0,0,utRho04
1414,sixA,4913998,4913998,4913624,374,12,utRho04
1415,slp,7307872,7307922,7307872,50,0,utRho04
1416,slt,9261400,9261466,9261400,66,22,utRho04
1417,slyA,3442028,3442028,3441648,380,24,utRho04
1418,slyB,3439496,3439752,3439496,256,84,utRho04
1419,slyD,6957398,6957398,6956994,404,352,utRho04
1420,slyX,6954862,6955280,6954862,418,5298,utRho04
1421,smf,6867372,6867372,6867120,252,48,utRho04
1422,smpB,5509534,5509792,5509534,258,900,utRho04
1423,smrA,2811872,2811958,2811872,86,32,utRho04
1424,smrB,4896872,4897212,4896872,340,0,utRho04
1425,smtA,1946808,1947074,1946808,266,0,utRho04
1426,sodA,8201518,8201620,8201518,102,4084,utRho04
1427,sodB,3470646,3470756,3470646,110,0,utRho04
1428,sodC,3449358,3449358,3449310,48,20,utRho04
1429,sohB,2658568,2658664,2658568,96,36,utRho04
1430,sokB,2984232,2984238,2984232,6,6,utRho04
1431,solA,2241218,2241218,2241172,46,16,utRho04
1432,soxR,8554894,8554938,8554894,44,0,utRho04
1433,soxS,8554846,8554846,8554766,80,0,utRho04
1434,speA,6172096,6172096,6171822,274,12,utRho04
1435,speB,6167892,6167892,6167594,298,70,utRho04
1436,speC,6218350,6218350,6218310,40,0,utRho04
1437,spf,8099798,8099798,8099798,0,0,utRho04
1438,sppA,3697422,3697674,3697422,252,26,utRho04
1439,spy,3651376,3651376,3651250,126,0,utRho04
1440,sra,3112092,3112092,3111926,166,66,utRho04
1441,sraB,2293178,2293178,2293178,0,0,utRho04
1442,sraC,3846132,3846132,3846132,0,0,utRho04
1443,srlA,5651582,5651664,5651582,82,40,utRho04
1444,srlR,5657720,5658094,5657720,374,48,utRho04
1445,srmB,5425752,5425792,5425752,40,94,utRho04
1446,sroA,151216,151216,151216,0,0,utRho04
1447,sroG,6369436,6369436,6369436,0,0,utRho04
1448,sroH,8380974,8380974,8380974,0,0,utRho04
1449,ssb,8548022,8548250,8548022,228,90,utRho04
1450,sseA,5304782,5304988,5304782,206,4086,utRho04
1451,sspA,6755138,6755138,6754840,298,700,utRho04
1452,ssrA,5511014,5511186,5511014,172,116,utRho04
1453,ssrS,12223036,12223932,12223036,896,2084,utRho04
1454,sstT,6479726,6479888,6479726,162,0,utRho04
1455,ssuB,1988282,1988282,1988088,194,0,utRho04
1456,ssuE,1995126,1995126,1995024,102,0,utRho04
1457,sthA,8321604,8321604,8321580,24,1448,utRho04
1458,stpA,5597156,5597156,5596990,166,58,utRho04
1459,sucA,3034344,3034824,3034344,480,1360,utRho04
1460,sufA,3528836,3528836,3528772,64,24,utRho04
1461,sufE,3518962,3518962,3518580,382,848,utRho04
1462,sugE,8753588,8753750,8753588,162,506,utRho04
1463,sulA,2041894,2041894,2041838,56,70,utRho04
1464,syd,5850738,5850738,5850560,178,74,utRho04
1465,symE,9159834,9159834,9159680,154,12,utRho04
1466,symR,9159670,9159670,9159670,0,0,utRho04
1467,tabA,8949566,8949724,8949566,158,0,utRho04
1468,talA,5157140,5157332,5157140,192,0,utRho04
1469,talB,16382,16476,16382,94,3982,utRho04
1470,tam,3214442,3214692,3214442,250,46,utRho04
1471,tamA,8884540,8884764,8884540,224,68,utRho04
1472,tar,3945432,3945432,3945382,50,12,utRho04
1473,tas,5943138,5943194,5943138,56,152,utRho04
1474,tatA,16087636,16087780,16087636,144,192,utRho04
1475,tatE,1317742,1317894,1317742,152,18,utRho04
1476,tauA,770410,770464,770410,54,0,utRho04
1477,tdcA,6534186,6534186,6534130,56,0,utRho04
1478,tdcG,6519652,6519652,6519298,354,68,utRho04
1479,tdcR,6534380,6534760,6534380,380,12,utRho04
1480,tdk,2586986,2587054,2586986,68,82,utRho04
1481,tehA,3001072,3001146,3001072,74,0,utRho04
1482,tesA,1039898,1039898,1039530,368,144,utRho04
1483,tesB,950402,950402,950322,80,0,utRho04
1484,tfaE,2418532,2418532,2418238,294,4,utRho04
1485,tfaQ,3269912,3269912,3269770,142,46,utRho04
1486,tff,379424,379256,379424,168,0,utRho04
1487,tgt,852110,852274,852110,164,4,utRho04
1488,thiD,4369346,4369346,4369032,314,0,utRho04
1489,thiI,882936,883098,882936,162,288,utRho04
1490,thiM,4370902,4370902,4370602,300,316,utRho04
1491,thiQ,146170,146170,145854,316,366,utRho04
1492,thrL,592,760,592,168,392,utRho04
1493,thrS,7210932,7210932,7210280,652,2036,utRho04
1494,thrU,8350762,8350776,8350762,14,0,utRho04
1495,thrV,6847414,6847414,6847310,104,78174,utRho04
1496,thrW,525682,525742,525682,60,1018,utRho04
1497,thyA,5930696,5930696,5930310,386,2000,utRho04
1498,tig,909986,910266,909986,280,366,utRho04
1499,tisB,7706674,7707106,7706674,432,256,utRho04
1500,tktA,6163414,6163414,6163270,144,34,utRho04
1501,tktB,5158616,5159272,5158616,656,272,utRho04
1502,tldD,6784368,6784368,6784056,312,12,utRho04
1503,tmcA,5191876,5191876,5191718,158,0,utRho04
1504,tnaC,15553644,15553740,15553644,96,84,utRho04
1505,tolB,1555074,1555480,1555074,406,280,utRho04
1506,tolC,6356008,6356230,6356008,222,404,utRho04
1507,tomB,961588,961588,961416,172,4222,utRho04
1508,tonB,2622108,2622178,2622108,70,66,utRho04
1509,topA,2661578,2662096,2661578,518,946,utRho04
1510,torC,2116112,2116168,2116112,56,72,utRho04
1511,torR,2115968,2115968,2115908,60,168,utRho04
1512,torS,2112364,2112364,2112356,8,0,utRho04
1513,torT,2112414,2112522,2112414,108,0,utRho04
1514,tpiA,8223138,8223138,8223014,124,46,utRho04
1515,tppB,3425342,3425538,3425342,196,3254,utRho04
1516,tpr,2574376,2574376,2574376,0,0,utRho04
1517,tpx,2777688,2777688,2777622,66,706,utRho04
1518,tqsA,3347780,3347826,3347780,46,0,utRho04
1519,treA,2494850,2494850,2494752,98,146,utRho04
1520,treB,8932420,8932420,8932360,60,78,utRho04
1521,treF,7339102,7339184,7339102,82,28,utRho04
1522,treR,8934694,8934694,8934492,202,0,utRho04
1523,trg,2984878,2984940,2984878,62,24,utRho04
1524,trkG,2847342,2847564,2847342,222,2,utRho04
1525,trmA,8326590,8326590,8326540,50,64,utRho04
1526,trpA,2634678,2634678,2634444,234,754,utRho04
1527,trpC,2639888,2639888,2639570,318,276,utRho04
1528,trpL,5292432,5292432,5292328,104,0,utRho04
1529,trpR,9265408,9265520,9265408,112,68,utRho04
1530,trpS,7027394,7027394,7027276,118,632,utRho04
1531,trpT,7893560,7893914,7893560,354,49314,utRho04
1532,trxA,7931294,7931522,7931294,228,440,utRho04
1533,trxB,1864156,1864156,1864100,56,114,utRho04
1534,trxC,5437350,5437470,5437350,120,116,utRho04
1535,tsaD,6421256,6421256,6421086,170,0,utRho04
1536,tsgA,6985038,6985136,6985038,98,0,utRho04
1537,tsr,9182824,9183314,9182824,490,36,utRho04
1538,tsx,864490,864490,864026,464,686,utRho04
1539,ttcA,2823970,2823970,2823896,74,2486,utRho04
1540,ttdA,6412848,6412926,6412848,78,0,utRho04
1541,ttdR,6412760,6412760,6412512,248,0,utRho04
1542,tufA,6943448,6943448,6942658,790,101578,utRho04
1543,tus,3368346,3368518,3368346,172,2,utRho04
1544,tusA,7218040,7218040,7217992,48,26,utRho04
1545,tusB,6950218,6950218,6949930,288,706,utRho04
1546,tynA,2902996,2902996,2902698,298,0,utRho04
1547,typA,8116460,8116814,8116460,354,4874,utRho04
1548,tyrB,8534164,8534228,8534164,64,1486,utRho04
1549,tyrP,3979004,3979362,3979004,358,60,utRho04
1550,tyrR,2773384,2773440,2773384,56,8,utRho04
1551,tyrS,3434566,3434566,3434444,122,0,utRho04
1552,tyrT,2575330,2575330,2575244,86,98,utRho04
1553,uacT,6062378,6062734,6062378,356,0,utRho04
1554,ubiC,8504886,8505012,8504886,126,82,utRho04
1555,ubiD,8049618,8049976,8049618,358,1262,utRho04
1556,ubiE,8037494,8037710,8037494,216,112,utRho04
1557,ubiG,4679078,4679134,4679078,56,0,utRho04
1558,ucpA,5089342,5089342,5089246,96,0,utRho04
1559,udp,8032782,8032862,8032782,80,6,utRho04
1560,ugd,4199470,4199470,4199226,244,6,utRho04
1561,ugpB,7184852,7184852,7184650,202,244,utRho04
1562,ugpQ,7176600,7176600,7176226,374,92,utRho04
1563,uhpT,7694396,7694396,7694334,62,90,utRho04
1564,uidA,3392304,3392304,3392142,162,50,utRho04
1565,uidC,3386012,3386012,3385702,310,0,utRho04
1566,uidR,3394150,3394150,3394104,46,44,utRho04
1567,ulaA,8839854,8839960,8839854,106,126,utRho04
1568,ulaG,8839350,8839350,8839250,100,0,utRho04
1569,ulaR,8837124,8837124,8836906,218,0,utRho04
1570,umpG,5741372,5741372,5740548,824,48,utRho04
1571,umpH,1400704,1400704,1400652,52,138,utRho04
1572,umuD,2461476,2461534,2461476,58,0,utRho04
1573,ung,5433476,5433508,5433476,32,20,utRho04
1574,uof,2843316,2843316,2842900,416,7436,utRho04
1575,upp,5241818,5241818,5241744,74,292,utRho04
1576,usg,4873780,4873780,4873298,482,42,utRho04
1577,ushA,1009772,1009828,1009772,56,0,utRho04
1578,uspA,7279966,7280222,7279966,256,650,utRho04
1579,uspB,7279696,7279696,7279440,256,782,utRho04
1580,uspC,3959172,3959506,3959172,334,16,utRho04
1581,uspE,2797318,2797318,2797244,74,102,utRho04
1582,uspF,2871282,2871282,2871238,44,22,utRho04
1583,uspG,1283806,1283806,1283734,72,336,utRho04
1584,uvrA,8547872,8547872,8547742,130,138,utRho04
1585,uvrB,1626304,1627052,1626304,748,1380,utRho04
1586,uvrC,3989758,3989758,3989412,346,106,utRho04
1587,uvrD,7995814,7995966,7995814,152,126,utRho04
1588,uvrY,3990812,3990812,3990718,94,36,utRho04
1589,uxaB,3221474,3221474,3221360,114,0,utRho04
1590,uxaC,6489714,6489714,6489482,232,30,utRho04
1591,uxuA,9103036,9103272,9103036,236,150,utRho04
1592,uxuR,9108916,9109152,9108916,236,8,utRho04
1593,valS,8967854,8967854,8967674,180,358,utRho04
1594,valU,5041848,5041862,5041848,14,44,utRho04
1595,valV,3492830,3492870,3492830,40,8,utRho04
1596,ves,3649968,3649968,3649874,94,30,utRho04
1597,waaA,7616512,7617080,7616512,568,466,utRho04
1598,waaH,7580298,7580298,7580162,136,0,utRho04
1599,waaQ,7616476,7616476,7616196,280,54,utRho04
1600,waaU,7598996,7598996,7598624,372,142,utRho04
1601,waaY,7602272,7602272,7601930,342,4412,utRho04
1602,wbbH,4214888,4214888,4214452,436,4456,utRho04
1603,wbbK,4209212,4209212,4209018,194,308,utRho04
1604,wcaM,4231868,4231868,4231792,76,0,utRho04
1605,wrbA,2135516,2135516,2135416,100,0,utRho04
1606,wza,4275166,4275166,4274486,680,0,utRho04
1607,wzxC,4240674,4240674,4240316,358,0,utRho04
1608,wzzB,4196950,4196950,4196602,348,138,utRho04
1609,xanP,7657642,7657890,7657642,248,0,utRho04
1610,xanQ,6048520,6048702,6048520,182,0,utRho04
1611,xapA,5049820,5049820,5049756,64,0,utRho04
1612,xapR,10090252,10090252,10089908,344,0,utRho04
1613,xdhA,6000514,6000690,6000514,176,90,utRho04
1614,xerD,6079702,6079702,6079486,216,0,utRho04
1615,xseA,5268394,5268464,5268394,70,208,utRho04
1616,xseB,882746,882746,882686,60,156,utRho04
1617,xthA,3664798,3664856,3664798,58,0,utRho04
1618,xylA,7461614,7461614,7461530,84,46,utRho04
1619,xylE,8484540,8484540,8484508,32,0,utRho04
1620,xylF,7462138,7462262,7462138,124,0,utRho04
1621,xylR,7469812,7469958,7469812,146,0,utRho04
1622,yaaA,13230,13230,12918,312,156,utRho04
1623,yaaI,23876,23876,23572,304,10,utRho04
1624,yaaJ,16034,16034,15918,116,80,utRho04
1625,yaaU,91184,91614,91184,430,0,utRho04
1626,yaaW,23084,23084,22712,372,0,utRho04
1627,yaaX,10060,10468,10060,408,102,utRho04
1628,yabI,142542,142702,142542,160,8,utRho04
1629,yacC,273880,273880,273834,46,4000,utRho04
1630,yacH,262932,262932,262520,412,36,utRho04
1631,yacL,268678,268776,268678,98,38,utRho04
1632,yadD,293796,293936,293796,140,0,utRho04
1633,yadE,289930,290162,289930,232,576,utRho04
1634,yadN,314110,314110,313766,344,8,utRho04
1635,yadS,355572,355572,355248,324,368,utRho04
1636,yadV,312470,312470,312402,68,2,utRho04
1637,yaeF,434270,434270,434006,264,42,utRho04
1638,yaeP,428374,428374,428250,124,24,utRho04
1639,yaeQ,428176,428582,428176,406,48,utRho04
1640,yaeR,423716,423754,423716,38,0,utRho04
1641,yafC,462166,462166,461762,404,322,utRho04
1642,yafD,462128,462244,462128,116,52,utRho04
1643,yafK,491986,491986,491610,376,1996,utRho04
1644,yafL,493282,493424,493282,142,22,utRho04
1645,yafN,503938,504010,503938,72,0,utRho04
1646,yafS,469568,469632,469568,64,328,utRho04
1647,yafT,474470,474670,474470,200,0,utRho04
1648,yafV,480432,480432,480378,54,34,utRho04
1649,yafZ,536052,536052,536010,42,0,utRho04
1650,yagE,564446,564556,564446,110,0,utRho04
1651,yagG,570414,570790,570414,376,26,utRho04
1652,yagI,578384,578384,578324,60,0,utRho04
1653,yagK,586236,586236,585896,340,18,utRho04
1654,yagL,588062,588062,587836,226,0,utRho04
1655,yagN,591342,591342,591158,184,426,utRho04
1656,yahA,663746,664742,663746,996,152,utRho04
1657,yahC,670136,670136,670044,92,0,utRho04
1658,yahE,671478,671850,671478,372,0,utRho04
1659,yahM,690504,690808,690504,304,32,utRho04
1660,yahN,692872,692872,692674,198,22,utRho04
1661,yahO,692864,692968,692864,104,22,utRho04
1662,yaiE,816296,816354,816296,58,6,utRho04
1663,yaiI,811396,811528,811396,132,0,utRho04
1664,yaiO,761946,761946,761684,262,54,utRho04
1665,yaiP,767970,767970,767870,100,0,utRho04
1666,yaiS,769660,769660,769232,428,0,utRho04
1667,yaiV,788922,788922,788922,0,0,utRho04
1668,yaiY,799094,799094,798666,428,98,utRho04
1669,yaiZ,798888,799186,798888,298,442,utRho04
1670,yajC,854410,854574,854410,164,1182,utRho04
1671,yajD,860938,861210,860938,272,620,utRho04
1672,yajI,866068,866068,865702,366,100,utRho04
1673,yajL,887496,887496,887282,214,56,utRho04
1674,yajQ,889316,889366,889316,50,14,utRho04
1675,yajR,893374,893374,893332,42,360,utRho04
1676,ybaB,987418,988152,987418,734,2118,utRho04
1677,ybaL,1006590,1006590,1006476,114,44,utRho04
1678,ybaM,980648,980648,980542,106,966,utRho04
1679,ybaN,981436,981764,981436,328,262,utRho04
1680,ybaO,936704,936766,936704,62,22,utRho04
1681,ybaP,1016568,1016568,1016160,408,680,utRho04
1682,ybaQ,1016348,1016436,1016348,88,0,utRho04
1683,ybaS,1023146,1023282,1023146,136,28,utRho04
1684,ybaV,927504,927874,927504,370,58,utRho04
1685,ybaY,950490,950758,950490,268,64,utRho04
1686,ybbB,1062724,1062724,1062452,272,48,utRho04
1687,ybbJ,1030154,1030154,1029718,436,316,utRho04
1688,ybbL,1031784,1031838,1031784,54,0,utRho04
1689,ybbN,1037136,1037136,1036558,578,716,utRho04
1690,ybbO,1038658,1038658,1038298,360,700,utRho04
1691,ybbY,1080718,1081130,1080718,412,40,utRho04
1692,ybcH,1176140,1176140,1175962,178,0,utRho04
1693,ybcI,1113264,1113264,1113106,158,826,utRho04
1694,ybcJ,1114050,1114050,1113746,304,42,utRho04
1695,ybcK,1137502,1137804,1137502,302,28,utRho04
1696,ybcL,1141690,1141786,1141690,96,0,utRho04
1697,ybcN,1144628,1144932,1144628,304,0,utRho04
1698,ybcQ,1147548,1147912,1147548,364,0,utRho04
1699,ybcW,1159610,1159760,1159610,150,0,utRho04
1700,ybdD,1263982,1264364,1263982,382,248,utRho04
1701,ybdF,1212106,1212106,1211772,334,0,utRho04
1702,ybdH,1267048,1267048,1266954,94,12,utRho04
1703,ybdJ,1212822,1212822,1212398,424,54,utRho04
1704,ybdK,1215122,1215122,1214766,356,308,utRho04
1705,ybdL,1267114,1267172,1267114,58,0,utRho04
1706,ybdM,1271110,1271110,1270752,358,242,utRho04
1707,ybdN,1273372,1273372,1273138,234,0,utRho04
1708,ybdR,1283844,1284176,1283844,332,380,utRho04
1709,ybeD,1325412,1325412,1325284,128,246,utRho04
1710,ybeF,1323090,1323090,1322756,334,84,utRho04
1711,ybeL,1349986,1350036,1349986,50,2,utRho04
1712,ybeQ,1353412,1353412,1353094,318,0,utRho04
1713,ybeR,1353120,1353422,1353120,302,0,utRho04
1714,ybeT,1358832,1358832,1358812,20,0,utRho04
1715,ybeU,1358924,1359016,1358924,92,0,utRho04
1716,ybeZ,1386938,1386938,1386834,104,1946,utRho04
1717,ybfA,1458074,1458268,1458074,194,0,utRho04
1718,ybfE,1423878,1423878,1423796,82,288,utRho04
1719,ybfF,1425692,1425692,1425604,88,468,utRho04
1720,ybfH,1433282,1433282,1433194,88,0,utRho04
1721,ybgA,1477840,1478002,1477840,162,0,utRho04
1722,ybgC,1549288,1549504,1549288,216,36,utRho04
1723,ybgD,1505916,1505916,1505590,326,220,utRho04
1724,ybgI,1485238,1485654,1485238,416,0,utRho04
1725,ybgO,1498370,1498370,1497964,406,36,utRho04
1726,ybgS,1570992,1570992,1570634,358,0,utRho04
1727,ybhA,1597184,1597184,1596862,322,12,utRho04
1728,ybhB,1616070,1616070,1615818,252,122,utRho04
1729,ybhC,1614642,1614642,1614562,80,460,utRho04
1730,ybhD,1601418,1601418,1601276,142,0,utRho04
1731,ybhH,1601104,1601518,1601104,414,0,utRho04
1732,ybhK,1633384,1633384,1633294,90,2,utRho04
1733,ybhM,1641556,1641586,1641556,30,0,utRho04
1734,ybhN,1645296,1645296,1644996,300,0,utRho04
1735,ybhQ,1649202,1649260,1649202,58,0,utRho04
1736,ybiA,1665920,1665920,1665900,20,0,utRho04
1737,ybiI,1676968,1676968,1676912,56,6,utRho04
1738,ybiO,1691328,1691328,1690960,368,156,utRho04
1739,ybiP,1705252,1705252,1705194,58,1892,utRho04
1740,ybiS,1711572,1711572,1711488,84,352,utRho04
1741,ybiT,1711894,1711926,1711894,32,18,utRho04
1742,ybiU,1718212,1718212,1718122,90,0,utRho04
1743,ybiV,1720176,1720176,1720056,120,0,utRho04
1744,ybiW,1725566,1725566,1725212,354,0,utRho04
1745,ybiX,1678548,1678548,1678414,134,572,utRho04
1746,ybjC,1781784,1781826,1781784,42,0,utRho04
1747,ybjE,1830154,1830154,1829714,440,58,utRho04
1748,ybjG,1767016,1767016,1766776,240,528,utRho04
1749,ybjL,1779882,1779882,1779638,244,124,utRho04
1750,ybjM,1779770,1780178,1779770,408,82,utRho04
1751,ybjO,1795704,1795978,1795704,274,0,utRho04
1752,ybjP,1809046,1809046,1808934,112,0,utRho04
1753,ybjQ,1809034,1809186,1809034,152,0,utRho04
1754,ybjS,1813796,1813796,1813506,290,152,utRho04
1755,ybjX,1838206,1838206,1838168,38,0,utRho04
1756,ycaD,1891438,1891742,1891438,304,0,utRho04
1757,ycaI,1928210,1928640,1928210,430,258,utRho04
1758,ycaK,1899094,1899336,1899094,242,28,utRho04
1759,ycaL,1920264,1920528,1920264,264,0,utRho04
1760,ycaM,1894240,1894458,1894240,218,20,utRho04
1761,ycaR,1941284,1941346,1941284,62,1050,utRho04
1762,ycbB,1961862,1962094,1961862,232,0,utRho04
1763,ycbJ,1943344,1943504,1943344,160,0,utRho04
1764,ycbK,1966046,1966150,1966046,104,492,utRho04
1765,ycbZ,2036920,2036920,2036598,322,140,utRho04
1766,yccA,2062886,2062886,2062836,50,356,utRho04
1767,yccF,2048730,2048730,2048696,34,10,utRho04
1768,yccS,2047988,2047988,2047766,222,34,utRho04
1769,yccT,2055674,2055674,2055546,128,0,utRho04
1770,yccX,2059960,2060128,2059960,168,104,utRho04
1771,ycdT,2185682,2185752,2185682,70,0,utRho04
1772,ycdU,2191266,2191686,2191266,420,0,utRho04
1773,ycdZ,2200504,2200592,2200504,88,198,utRho04
1774,yceA,2233544,2233614,2233544,70,58,utRho04
1775,yceD,2293298,2293588,2293298,290,4238,utRho04
1776,yceF,2293522,2293522,2293190,332,2412,utRho04
1777,yceH,2252154,2252314,2252154,160,346,utRho04
1778,yceI,2237282,2237282,2236952,330,134,utRho04
1779,yceJ,2238142,2238142,2238092,50,80,utRho04
1780,yceM,2253208,2253612,2253208,404,28,utRho04
1781,yceO,2239264,2239264,2238894,370,220,utRho04
1782,yceQ,2288760,2289004,2288760,244,6678,utRho04
1783,ycfD,2376540,2376540,2376480,60,152,utRho04
1784,ycfJ,2334814,2335198,2334814,384,140,utRho04
1785,ycfS,2340834,2340834,2340748,86,0,utRho04
1786,ycfT,2350658,2350658,2350330,328,36,utRho04
1787,ycfZ,2362760,2362760,2362534,226,358,utRho04
1788,ycgB,2474570,2474570,2474482,88,46,utRho04
1789,ycgG,2434614,2434656,2434614,42,0,utRho04
1790,ycgJ,2452956,2453200,2452956,244,0,utRho04
1791,ycgL,2455218,2455362,2455218,144,8,utRho04
1792,ycgN,2457366,2457660,2457366,294,0,utRho04
1793,ycgR,2489112,2489112,2489054,58,0,utRho04
1794,ycgV,2512222,2512222,2511904,318,156,utRho04
1795,ycgX,2426568,2426568,2426214,354,12844,utRho04
1796,ycgY,2490166,2490320,2490166,154,2,utRho04
1797,ycgZ,2431504,2431578,2431504,74,0,utRho04
1798,ychE,2596904,2597196,2596904,292,136,utRho04
1799,ychF,2515764,2515764,2515624,140,0,utRho04
1800,ychH,2517476,2517582,2517476,106,164,utRho04
1801,ychJ,2578354,2578354,2578264,90,2,utRho04
1802,ychN,2547310,2547310,2547198,112,20,utRho04
1803,ychO,2547520,2547850,2547520,330,320,utRho04
1804,ychQ,2533798,2533848,2533798,50,100,utRho04
1805,yciA,2624828,2624828,2624492,336,268,utRho04
1806,yciB,2626110,2626110,2625780,330,2128,utRho04
1807,yciC,2627396,2627396,2627326,70,0,utRho04
1808,yciE,2630794,2630794,2630448,346,28,utRho04
1809,yciG,5264368,5264368,5264140,228,0,utRho04
1810,yciI,2621784,2621784,2621730,54,24,utRho04
1811,yciN,2661606,2661606,2661336,270,38,utRho04
1812,yciS,2680270,2680486,2680270,216,12,utRho04
1813,yciT,2689088,2689088,2688692,396,194,utRho04
1814,yciU,2614718,2614718,2614300,418,2934,utRho04
1815,yciV,2646376,2646440,2646376,64,0,utRho04
1816,yciW,2700472,2700472,2700214,258,286,utRho04
1817,yciZ,2689276,2689276,2689218,58,148,utRho04
1818,ycjD,2703792,2703792,2703520,272,10,utRho04
1819,ycjG,2777748,2777860,2777748,112,50,utRho04
1820,ycjM,2740006,2740432,2740006,426,4,utRho04
1821,ycjW,2767982,2767982,2767922,60,48,utRho04
1822,ycjX,2768138,2768234,2768138,96,0,utRho04
1823,ycjY,5568288,5568288,5567460,828,0,utRho04
1824,ydaE,2836438,2836438,2836016,422,0,utRho04
1825,ydaN,2816048,2816100,2816048,52,0,utRho04
1826,ydaS,2840340,2840730,2840340,390,154,utRho04
1827,ydbC,2948376,2948442,2948376,66,2,utRho04
1828,ydbD,2950132,2950288,2950132,156,0,utRho04
1829,ydbH,2885800,2886102,2885800,302,46,utRho04
1830,ydbJ,2881712,2882116,2881712,404,0,utRho04
1831,ydbK,2881692,2881692,2881568,124,0,utRho04
1832,ydcA,2983294,2983354,2983294,60,18,utRho04
1833,ydcF,2974404,2974470,2974404,66,0,utRho04
1834,ydcI,2990268,2990268,2990142,126,28,utRho04
1835,ydcJ,2990266,2990576,2990266,310,0,utRho04
1836,ydcK,3001280,3001280,3000898,382,0,utRho04
1837,ydcL,3004646,3004914,3004646,268,10,utRho04
1838,ydcN,3012308,3012344,3012308,36,2,utRho04
1839,ydcP,3013508,3013562,3013508,54,2,utRho04
1840,ydcR,3019956,3020006,3019956,50,0,utRho04
1841,ydcS,3022906,3023308,3022906,402,36,utRho04
1842,ydcX,3034442,3034778,3034442,336,72,utRho04
1843,ydcY,3035220,3035296,3035220,76,0,utRho04
1844,ydcZ,3036750,3036750,3036662,88,198,utRho04
1845,yddB,3155332,3155332,3155238,94,0,utRho04
1846,yddE,3071738,3071738,3071716,22,0,utRho04
1847,yddG,3094410,3094410,3094338,72,0,utRho04
1848,yddJ,3089732,3089732,3089438,294,0,utRho04
1849,yddW,3137704,3137704,3137646,58,42,utRho04
1850,ydeA,3233910,3234056,3233910,146,146,utRho04
1851,ydeE,3242528,3242664,3242528,136,0,utRho04
1852,ydeI,3249118,3249118,3248994,124,0,utRho04
1853,ydeJ,3249376,3249546,3249376,170,0,utRho04
1854,ydeN,3165458,3165458,3165048,410,0,utRho04
1855,ydeP,3173328,3173328,3172972,356,0,utRho04
1856,ydeR,3176596,3176596,3176592,4,12,utRho04
1857,ydfA,3296872,3297016,3296872,144,0,utRho04
1858,ydfG,3254982,3255034,3254982,52,0,utRho04
1859,ydfH,3256652,3256704,3256652,52,72,utRho04
1860,ydfK,3265446,3266144,3265446,698,31296,utRho04
1861,ydgA,3379588,3379704,3379588,116,46,utRho04
1862,ydgC,3364124,3364124,3364060,64,68,utRho04
1863,ydgD,3343906,3343920,3343906,14,14,utRho04
1864,ydgH,3356754,3356854,3356754,100,16,utRho04
1865,ydgJ,3408798,3408798,3408616,182,176,utRho04
1866,ydgK,3410414,3410500,3410414,86,56,utRho04
1867,ydhB,3479618,3479618,3479596,22,0,utRho04
1868,ydhC,3479698,3479822,3479698,124,0,utRho04
1869,ydhF,3451310,3451310,3451264,46,0,utRho04
1870,ydhI,3441996,3442050,3441996,54,0,utRho04
1871,ydhL,3451864,3451864,3451840,24,0,utRho04
1872,ydhQ,3492404,3492404,3492254,150,0,utRho04
1873,ydhS,3494136,3494262,3494136,126,418,utRho04
1874,ydhT,3499138,3499138,3499118,20,0,utRho04
1875,ydhY,3509284,3509284,3508954,330,0,utRho04
1876,ydhZ,3510418,3510418,3510282,136,0,utRho04
1877,ydiE,3579206,3579226,3579206,20,0,utRho04
1878,ydiH,3530582,3530582,3530406,176,8,utRho04
1879,ydiM,3541852,3542142,3541852,290,0,utRho04
1880,ydiN,3544818,3545024,3544818,206,0,utRho04
1881,ydiP,3558656,3558656,3558602,54,0,utRho04
1882,ydiU,3582508,3582508,3582488,20,44,utRho04
1883,ydiV,3584174,3584174,3584040,134,48,utRho04
1884,ydiY,3612500,3612500,3612166,334,4,utRho04
1885,ydjA,3697400,3697400,3697352,48,26,utRho04
1886,ydjE,3708082,3708082,3707958,124,78,utRho04
1887,ydjF,3709848,3709848,3709708,140,0,utRho04
1888,ydjM,3620340,3620422,3620340,82,56,utRho04
1889,ydjO,3626696,3626696,3626288,408,0,utRho04
1890,ydjX,3666434,3666802,3666434,368,956,utRho04
1891,yeaE,3731448,3731448,3731272,176,36,utRho04
1892,yeaG,3733530,3733816,3733530,286,0,utRho04
1893,yeaI,3740486,3740770,3740486,284,0,utRho04
1894,yeaJ,3743874,3744082,3743874,208,28,utRho04
1895,yeaL,3748646,3748704,3748646,58,90,utRho04
1896,yeaM,3751296,3751296,3751152,144,0,utRho04
1897,yeaN,3750926,3751346,3750926,420,16,utRho04
1898,yeaO,3753554,3753818,3753554,264,0,utRho04
1899,yeaP,3755314,3755430,3755314,116,762,utRho04
1900,yeaQ,3758780,3758780,3758510,270,44,utRho04
1901,yeaR,3759988,3759988,3759896,92,46,utRho04
1902,yeaY,3781122,3781122,3781064,58,104,utRho04
1903,yebB,3892220,3892502,3892220,282,0,utRho04
1904,yebC,3896370,3896370,3896302,68,106,utRho04
1905,yebE,3859464,3859464,3859414,50,290,utRho04
1906,yebG,3861530,3861530,3861494,36,34,utRho04
1907,yebK,3873180,3873304,3873180,124,16,utRho04
1908,yebQ,3820314,3820552,3820314,238,2,utRho04
1909,yebS,3832238,3832516,3832238,278,26,utRho04
1910,yebV,3843430,3843560,3843430,130,0,utRho04
1911,yebW,3843914,3844242,3843914,328,862,utRho04
1912,yecC,3995646,3995646,3995628,18,0,utRho04
1913,yecD,3901272,3901664,3901272,392,26,utRho04
1914,yecF,3991434,3991636,3991434,202,158,utRho04
1915,yecH,3979304,3979304,3978980,324,60,utRho04
1916,yecJ,3975604,3975604,3975516,88,0,utRho04
1917,yecM,3919968,3919968,3919692,276,72,utRho04
1918,yecR,3976400,3976444,3976400,44,12,utRho04
1919,yecT,3923862,3923944,3923862,82,86,utRho04
1920,yedD,4016522,4016522,4016180,342,0,utRho04
1921,yedE,4016310,4016554,4016310,244,0,utRho04
1922,yedI,4058922,4058922,4058732,190,0,utRho04
1923,yedJ,4066446,4066446,4066158,288,0,utRho04
1924,yedV,4076404,4076404,4076304,100,26,utRho04
1925,yedX,4077680,4077912,4077680,232,0,utRho04
1926,yedY,4078572,4078956,4078572,384,10,utRho04
1927,yeeA,4161322,4161322,4161182,140,0,utRho04
1928,yeeE,4171104,4171104,4171050,54,0,utRho04
1929,yeeJ,4089526,4089822,4089526,296,366,utRho04
1930,yeeN,4113508,4113716,4113508,208,0,utRho04
1931,yeeO,4119444,4119444,4119692,248,0,utRho04
1932,yeeX,4158834,4158834,4158722,112,362,utRho04
1933,yeeZ,4178422,4178422,4178256,166,0,utRho04
1934,yefM,4179466,4179466,4179426,40,0,utRho04
1935,yegD,4295288,4295348,4295288,60,0,utRho04
1936,yegH,4275726,4275804,4275726,78,8,utRho04
1937,yegI,4302154,4302154,4301970,184,0,utRho04
1938,yegJ,4302032,4302370,4302032,338,0,utRho04
1939,yegQ,4331182,4331336,4331182,154,40,utRho04
1940,yegR,4336698,4336698,4336612,86,0,utRho04
1941,yegS,4337086,4337424,4337086,338,0,utRho04
1942,yegT,4357562,4357642,4357562,80,4,utRho04
1943,yegX,4367640,4367640,4367302,338,0,utRho04
1944,yehA,4376944,4376944,4376828,116,0,utRho04
1945,yehE,4385818,4385818,4385592,226,0,utRho04
1946,yehK,4407568,4407944,4407568,376,0,utRho04
1947,yehL,4408804,4409192,4408804,388,0,utRho04
1948,yeiB,4486146,4486146,4485934,212,48,utRho04
1949,yeiE,4499422,4499422,4499236,186,12,utRho04
1950,yeiG,4487776,4487820,4487776,44,312,utRho04
1951,yeiH,4499332,4499434,4499332,102,14,utRho04
1952,yeiI,4503306,4503400,4503306,94,92,utRho04
1953,yeiL,4510580,4510710,4510580,130,0,utRho04
1954,yeiP,4530834,4530900,4530834,66,294,utRho04
1955,yeiQ,4532328,4532490,4532328,162,78,utRho04
1956,yeiR,4535484,4535658,4535484,174,60,utRho04
1957,yeiW,4530840,4530840,4530590,250,366,utRho04
1958,yejA,4544624,4544728,4544624,104,24,utRho04
1959,yejG,4556892,4556892,4556474,418,2944,utRho04
1960,yejH,4561244,4561264,4561244,20,0,utRho04
1961,yejK,4568218,4568218,4567894,324,308,utRho04
1962,yejO,4578352,4578352,4577800,552,70,utRho04
1963,yfaD,4713380,4713808,4713380,428,992,utRho04
1964,yfaE,4696676,4697028,4696676,352,1484,utRho04
1965,yfaL,4688568,4688568,4688338,230,0,utRho04
1966,yfaP,4656398,4656398,4656286,112,0,utRho04
1967,yfaU,4717892,4717892,4717690,202,0,utRho04
1968,yfaY,4727310,4727310,4727266,44,2,utRho04
1969,yfaZ,4728744,4728744,4728550,194,0,utRho04
1970,yfbK,4771810,4771810,4771444,366,0,utRho04
1971,yfbL,4771500,4771720,4771500,220,0,utRho04
1972,yfbN,4777174,4777174,4776852,322,0,utRho04
1973,yfbO,4776916,4777162,4776916,246,0,utRho04
1974,yfbP,4777990,4778232,4777990,242,336,utRho04
1975,yfbR,4817662,4817724,4817662,62,164,utRho04
1976,yfcI,4847424,4847424,4847078,346,20,utRho04
1977,yfcJ,4880482,4880482,4880240,242,84,utRho04
1978,yfcL,4888502,4888502,4888338,164,0,utRho04
1979,yfcV,4911642,4911642,4911292,350,0,utRho04
1980,yfcZ,4921958,4921958,4921868,90,48,utRho04
1981,yfdF,4925604,4926024,4925604,420,470,utRho04
1982,yfdG,4935474,4935710,4935474,236,0,utRho04
1983,yfdP,4946844,4947040,4946844,196,0,utRho04
1984,yfdX,4988866,4988866,4988804,62,0,utRho04
1985,yfdY,4990672,4990672,4990584,88,0,utRho04
1986,yfeA,5035784,5035784,5035664,120,26924,utRho04
1987,yfeC,5036668,5036934,5036668,266,170,utRho04
1988,yfeH,5053818,5053892,5053818,74,0,utRho04
1989,yfeK,5074630,5074684,5074630,54,0,utRho04
1990,yfeO,5018906,5019260,5018906,354,146,utRho04
1991,yfeR,5054078,5054078,5053712,366,0,utRho04
1992,yfeX,5101356,5101356,5101090,266,0,utRho04
1993,yfeY,5102486,5102486,5102432,54,0,utRho04
1994,yfeZ,5103842,5103842,5103452,390,0,utRho04
1995,yffO,5123804,5124222,5123804,418,0,utRho04
1996,yffQ,5126778,5127154,5126778,376,0,utRho04
1997,yffS,5128800,5128986,5128800,186,26,utRho04
1998,yfgC,5232052,5232188,5232052,136,0,utRho04
1999,yfgF,5258062,5258062,5257876,186,4,utRho04
2000,yfgG,5258170,5258580,5258170,410,120,utRho04
2001,yfgH,5259344,5259584,5259344,240,56,utRho04
2002,yfgM,5278866,5278866,5278566,300,476,utRho04
2003,yfhH,5397414,5397518,5397414,104,0,utRho04
2004,yfhM,5304648,5304648,5304574,74,30,utRho04
2005,yfhR,5328408,5328726,5328408,318,3132,utRho04
2006,yfiC,5425610,5425610,5425528,82,0,utRho04
2007,yfiE,5430688,5430688,5430640,48,2,utRho04
2008,yfiL,5482630,5482720,5482630,90,0,utRho04
2009,yfiM,5448066,5448358,5448066,292,14592,utRho04
2010,yfiR,5483354,5483750,5483354,396,328,utRho04
2011,yfjH,5517326,5517326,5517200,126,0,utRho04
2012,yfjI,5517710,5517970,5517710,260,0,utRho04
2013,yfjJ,5521014,5521094,5521014,80,0,utRho04
2014,yfjM,5531970,5531970,5531552,418,790,utRho04
2015,yfjP,5535080,5535420,5535080,340,32,utRho04
2016,yfjW,5546570,5546636,5546570,66,26,utRho04
2017,yfjX,5551776,5551838,5551776,62,0,utRho04
2018,ygaC,5601180,5601180,5599988,1192,890,utRho04
2019,ygaM,5600242,5600292,5600242,50,328,utRho04
2020,ygaU,5593628,5593628,5593572,56,16,utRho04
2021,ygaZ,5619190,5619234,5619190,44,686,utRho04
2022,ygbA,5713656,5713656,5713612,44,0,utRho04
2023,ygbE,5746784,5746784,5746674,110,138,utRho04
2024,ygbI,5722882,5722882,5722528,354,2,utRho04
2025,ygbK,5724394,5724670,5724394,276,52,utRho04
2026,ygbL,5727074,5727186,5727074,112,0,utRho04
2027,ygbN,5729814,5730202,5729814,388,24,utRho04
2028,ygcG,5811210,5811422,5811210,212,0,utRho04
2029,ygcN,5785144,5785314,5785144,170,38,utRho04
2030,ygcU,5799214,5799214,5798836,378,0,utRho04
2031,ygcW,5800942,5800942,5800546,396,0,utRho04
2032,ygdD,5883442,5883442,5883262,180,14,utRho04
2033,ygdG,5861746,5861930,5861746,184,618,utRho04
2034,ygdI,5886526,5886526,5886290,236,0,utRho04
2035,ygdQ,5940784,5940840,5940784,56,14,utRho04
2036,ygdR,5942494,5942542,5942494,48,4,utRho04
2037,ygeA,5961606,5961606,5961270,336,0,utRho04
2038,ygeH,5983758,5984188,5983758,430,0,utRho04
2039,ygeI,5987162,5987276,5987162,114,0,utRho04
2040,ygeR,6000078,6000078,5999782,296,178,utRho04
2041,ygeV,6011694,6011694,6011572,122,0,utRho04
2042,ygeW,6012234,6012524,6012234,290,0,utRho04
2043,ygfB,6110946,6110946,6110888,58,6,utRho04
2044,ygfK,6031984,6032120,6031984,136,0,utRho04
2045,ygfS,6058328,6058328,6058024,304,0,utRho04
2046,ygfZ,6082564,6082626,6082564,62,46,utRho04
2047,yggC,6149512,6149512,6149378,134,186,utRho04
2048,yggE,6136370,6136370,6136160,210,0,utRho04
2049,yggI,6179176,6179510,6179176,334,170,utRho04
2050,yggL,6204508,6204508,6204266,242,140,utRho04
2051,yggM,6199514,6199514,6199130,384,184,utRho04
2052,yggN,6203596,6203596,6203246,350,64,utRho04
2053,yggX,18623958,18624558,18623958,600,1008,utRho04
2054,yghA,6298966,6299324,6298966,358,28,utRho04
2055,yghB,6307058,6307126,6307058,68,4,utRho04
2056,yghD,6222614,6222614,6222252,362,58,utRho04
2057,yghF,6225798,6225798,6225840,42,0,utRho04
2058,yghJ,6238640,6238640,6238224,416,0,utRho04
2059,yghQ,6265186,6265186,6264816,370,2,utRho04
2060,yghT,6267830,6268262,6267830,432,0,utRho04
2061,yghU,6277400,6277454,6277400,54,0,utRho04
2062,yghW,6293506,6293506,6293474,32,0,utRho04
2063,yghZ,6295562,6295794,6295562,232,0,utRho04
2064,ygiD,6365122,6365122,6364868,254,224,utRho04
2065,ygiH,6409066,6409388,6409066,322,0,utRho04
2066,ygiL,6370622,6370828,6370622,206,2,utRho04
2067,ygiM,6402084,6402414,6402084,330,90,utRho04
2068,ygiN,6346156,6346284,6346156,128,624,utRho04
2069,ygiQ,6322620,6322620,6322292,328,548,utRho04
2070,ygiS,6335462,6335462,6335436,26,2,utRho04
2071,ygiV,6338582,6338582,6338462,120,74,utRho04
2072,ygiW,6339774,6339774,6339352,422,0,utRho04
2073,ygiZ,6344506,6344506,6344422,84,0,utRho04
2074,ygjH,6442528,6442528,6442494,34,0,utRho04
2075,ygjI,6452140,6452468,6452140,328,0,utRho04
2076,ygjQ,6472730,6473080,6472730,350,378,utRho04
2077,ygjR,6474564,6474586,6474564,22,0,utRho04
2078,ygjV,6483638,6483638,6483488,150,0,utRho04
2079,yhaB,6535632,6535708,6535632,76,0,utRho04
2080,yhaH,6504498,6504608,6504498,110,0,utRho04
2081,yhaI,6505400,6505822,6505400,422,68,utRho04
2082,yhaJ,6508560,6508560,6508428,132,26,utRho04
2083,yhaK,6508538,6508638,6508538,100,46,utRho04
2084,yhbQ,6599878,6599932,6599878,54,110,utRho04
2085,yhbT,6602736,6602736,6602552,184,0,utRho04
2086,yhbU,6602558,6602970,6602558,412,0,utRho04
2087,yhbX,6643302,6643302,6643226,76,0,utRho04
2088,yhbY,6655518,6655580,6655518,62,1726,utRho04
2089,yhcA,6723956,6724224,6723956,268,0,utRho04
2090,yhcB,6760364,6760382,6760364,18,112,utRho04
2091,yhcC,6708470,6708470,6708100,370,268,utRho04
2092,yhcF,6733440,6733852,6733440,412,182,utRho04
2093,yhcH,6739124,6739124,6738956,168,74,utRho04
2094,yhcM,6760312,6760312,6759994,318,76,utRho04
2095,yhcN,6770812,6771076,6770812,264,398,utRho04
2096,yhcO,6772606,6772606,6772258,348,0,utRho04
2097,yhdH,6806560,6806968,6806560,408,104,utRho04
2098,yhdJ,6823234,6823306,6823234,72,0,utRho04
2099,yhdN,6879092,6879092,6879018,74,2184,utRho04
2100,yhdT,6814702,6814750,6814702,48,392,utRho04
2101,yhdU,6824994,6825242,6824994,248,24,utRho04
2102,yhdV,6836392,6836780,6836392,388,0,utRho04
2103,yhdW,6837944,6838298,6837944,354,4,utRho04
2104,yheO,6953082,6953082,6952880,202,466,utRho04
2105,yheV,6957970,6957970,6957584,386,28,utRho04
2106,yhfA,6971902,6971902,6971636,266,0,utRho04
2107,yhfG,6983294,6983294,6983240,54,242,utRho04
2108,yhfL,6998622,6998896,6998622,274,26,utRho04
2109,yhfY,7023244,7023244,7022844,400,0,utRho04
2110,yhgA,7086294,7086334,7086294,40,0,utRho04
2111,yhgE,7065176,7065176,7064878,298,34,utRho04
2112,yhgF,7074352,7074770,7074352,418,1480,utRho04
2113,yhhA,7173458,7173886,7173458,428,134,utRho04
2114,yhhI,7248346,7248756,7248346,410,0,utRho04
2115,yhhJ,7253696,7253696,7253606,90,0,utRho04
2116,yhhM,7211588,7211588,7211220,368,370,utRho04
2117,yhhN,7211150,7211502,7211150,352,320,utRho04
2118,yhhQ,7218238,7218434,7218238,196,326,utRho04
2119,yhhT,7223682,7223730,7223682,48,20,utRho04
2120,yhhX,7162032,7162032,7161610,422,556,utRho04
2121,yhhY,7162222,7162276,7162222,54,48,utRho04
2122,yhhZ,7163516,7163726,7163516,210,0,utRho04
2123,yhiD,7312220,7312220,7311804,416,1080,utRho04
2124,yhiJ,7265190,7265190,7265180,10,0,utRho04
2125,yhiM,7269270,7269682,7269270,412,78,utRho04
2126,yhiN,7275000,7275000,7274820,180,34,utRho04
2127,yhjA,7338522,7338522,7338376,146,0,utRho04
2128,yhjB,7344090,7344090,7343788,302,62,utRho04
2129,yhjC,7344272,7344684,7344272,412,0,utRho04
2130,yhjD,7346660,7346724,7346660,64,0,utRho04
2131,yhjE,7349274,7349572,7349274,298,0,utRho04
2132,yhjG,7356824,7356824,7356730,94,0,utRho04
2133,yhjH,7358458,7358458,7358374,84,0,utRho04
2134,yhjJ,7364032,7364032,7363880,152,282,utRho04
2135,yhjK,7371296,7371296,7371158,138,0,utRho04
2136,yhjR,7392750,7392750,7392370,380,0,utRho04
2137,yhjV,7400796,7401126,7400796,330,710,utRho04
2138,yhjX,7424194,7424194,7424014,180,8,utRho04
2139,yhjY,7425966,7425966,7425868,98,28,utRho04
2140,yiaB,7455654,7455654,7455496,158,0,utRho04
2141,yiaD,7432712,7433094,7432712,382,158,utRho04
2142,yiaF,7438194,7438194,7438088,106,20,utRho04
2143,yiaG,7438862,7438956,7438862,94,140,utRho04
2144,yiaJ,7485236,7485236,7485064,172,0,utRho04
2145,yiaK,7485348,7485466,7485348,118,0,utRho04
2146,yiaT,7503924,7503924,7503736,188,0,utRho04
2147,yiaU,7503792,7503984,7503792,192,0,utRho04
2148,yiaY,7515856,7515856,7515654,202,104,utRho04
2149,yibF,7523950,7523950,7523910,40,0,utRho04
2150,yibG,7536128,7536354,7536128,226,0,utRho04
2151,yibL,7553194,7553330,7553194,136,26,utRho04
2152,yibN,7570112,7570112,7570030,82,94,utRho04
2153,yibT,7552848,7552848,7552760,88,86,utRho04
2154,yicC,7633290,7633352,7633290,62,50,utRho04
2155,yicH,7660862,7660914,7660862,52,0,utRho04
2156,yicJ,7673328,7673328,7671858,1470,276,utRho04
2157,yicN,7685018,7685018,7684804,214,0,utRho04
2158,yicO,7687914,7687914,7687578,336,0,utRho04
2159,yicR,15250308,15250308,15250236,72,0,utRho04
2160,yidB,7755230,7755230,7754930,300,2,utRho04
2161,yidE,7732780,7732780,7732546,234,0,utRho04
2162,yidF,7711580,7711580,7711222,358,122,utRho04
2163,yidQ,7735088,7735456,7735088,368,540,utRho04
2164,yidR,7738824,7738824,7738618,206,0,utRho04
2165,yieE,7787658,7787738,7787658,80,180,utRho04
2166,yieH,7793314,7793548,7793314,234,0,utRho04
2167,yieK,7798928,7798928,7798786,142,0,utRho04
2168,yifB,7900350,7900350,7899998,352,124,utRho04
2169,yifL,7988984,7989044,7988984,60,166,utRho04
2170,yigF,8005750,8005750,8005598,152,38,utRho04
2171,yigI,8009448,8009448,8009394,54,0,utRho04
2172,yigM,8022100,8022152,8022100,52,38,utRho04
2173,yihA,8101970,8101970,8101458,512,172,utRho04
2174,yihD,8084098,8084138,8084098,40,76,utRho04
2175,yihF,8088110,8088398,8088110,288,0,utRho04
2176,yihG,8093304,8093304,8093204,100,0,utRho04
2177,yihI,8102616,8102694,8102616,78,14,utRho04
2178,yihL,8120506,8120894,8120506,388,0,utRho04
2179,yihN,8124332,8124494,8124332,162,0,utRho04
2180,yihO,8131942,8131942,8131532,410,154,utRho04
2181,yihQ,8138892,8138892,8138552,340,0,utRho04
2182,yihV,8147064,8147478,8147064,414,0,utRho04
2183,yihX,8151096,8151106,8151096,10,18,utRho04
2184,yiiE,8158192,8158582,8158192,390,0,utRho04
2185,yiiF,8159124,8159502,8159124,378,78,utRho04
2186,yiiG,8173762,8174004,8173762,242,0,utRho04
2187,yiiM,8205506,8205644,8205506,138,44,utRho04
2188,yiiQ,8224624,8224624,8224428,196,0,utRho04
2189,yiiS,8225738,8225934,8225738,196,42,utRho04
2190,yijE,8272178,8272216,8272178,38,96,utRho04
2191,yijF,8275728,8275728,8275314,414,44,utRho04
2192,yijO,8296858,8296858,8296634,224,64,utRho04
2193,yjaA,8426240,8426468,8426240,228,46806,utRho04
2194,yjaB,8428312,8428312,8428246,66,322,utRho04
2195,yjaG,8398746,8399008,8398746,262,1176,utRho04
2196,yjaH,8401022,8401132,8401022,110,150,utRho04
2197,yjaZ,8379506,8379572,8379506,66,22,utRho04
2198,yjbB,8455204,8455462,8455204,258,0,utRho04
2199,yjbE,16943432,16943624,16943432,192,0,utRho04
2200,yjbL,8520318,8520642,8520318,324,0,utRho04
2201,yjbQ,8540428,8540476,8540428,48,76,utRho04
2202,yjcB,8550328,8550328,8550082,246,4556,utRho04
2203,yjcC,8550836,8550942,8550836,106,0,utRho04
2204,yjcD,8556628,8556958,8556628,330,148,utRho04
2205,yjcE,8559658,8559960,8559658,302,0,utRho04
2206,yjcF,8566212,8566212,8566150,62,0,utRho04
2207,yjcO,8594660,8594660,8594250,410,2,utRho04
2208,yjdA,8654128,8654270,8654128,142,0,utRho04
2209,yjdC,8726660,8726660,8726616,44,0,utRho04
2210,yjdK,8704780,8705168,8704780,388,28,utRho04
2211,yjdL,8713034,8713034,8712822,212,0,utRho04
2212,yjdM,8653672,8653672,8653468,204,30,utRho04
2213,yjeF,8787354,8788132,8787354,778,4438,utRho04
2214,yjeI,8745522,8745618,8745522,96,0,utRho04
2215,yjeJ,8748806,8748806,8748468,338,100,utRho04
2216,yjeV,8785472,8785784,8785472,312,264,utRho04
2217,yjfP,8833512,8833904,8833512,392,6,utRho04
2218,yjfY,8849656,8849656,8849582,74,0,utRho04
2219,yjfZ,8855052,8855052,8854844,208,0,utRho04
2220,yjgA,8916162,8916162,8915730,432,72,utRho04
2221,yjgL,8950802,8950874,8950802,72,0,utRho04
2222,yjgM,8959342,8959342,8959074,268,0,utRho04
2223,yjgN,8959132,8959460,8959132,328,0,utRho04
2224,yjgR,8980170,8980170,8980126,44,132,utRho04
2225,yjgZ,9002116,9002520,9002116,404,406,utRho04
2226,yjhB,9007764,9008116,9007764,352,0,utRho04
2227,yjhG,9048452,9048452,9048188,264,642,utRho04
2228,yjhU,9041080,9041080,9040648,432,384,utRho04
2229,yjiA,9178096,9178096,9177730,366,288,utRho04
2230,yjiJ,9125364,9125364,9125350,14,0,utRho04
2231,yjiK,9127270,9127270,9127422,152,56,utRho04
2232,yjiL,9129604,9129604,9129378,226,12,utRho04
2233,yjiS,9143410,9143502,9143410,92,0,utRho04
2234,yjiY,9182734,9182734,9182558,176,0,utRho04
2235,yjjA,9200674,9200674,9200378,296,156,utRho04
2236,yjjB,18408708,18408708,18407800,908,0,utRho04
2237,yjjJ,9243314,9243538,9243314,224,0,utRho04
2238,yjjK,9261132,9261132,9261044,88,24,utRho04
2239,yjjL,9189764,9189764,9189444,320,0,utRho04
2240,yjjM,9191894,9191894,9191702,192,14,utRho04
2241,yjjP,9206068,9206068,9205716,352,26,utRho04
2242,yjjQ,9206638,9206954,9206638,316,36,utRho04
2243,yjjX,9267798,9267798,9267490,308,260,utRho04
2244,yjjY,9280716,9280804,9280716,88,614,utRho04
2245,yjjZ,9211554,9211608,9211554,54,1856,utRho04
2246,yjtD,9281676,9281884,9281676,208,24,utRho04
2247,ykfB,532454,532454,532174,280,210,utRho04
2248,ykfI,527636,527636,527338,298,0,utRho04
2249,ykgB,637050,637050,636638,412,0,utRho04
2250,ykgC,640430,640430,640002,428,0,utRho04
2251,ykgD,640232,640454,640232,222,0,utRho04
2252,ykgE,642962,643216,642962,254,28,utRho04
2253,ykgJ,608524,608524,608364,160,30,utRho04
2254,ykgL,623878,624224,623878,346,0,utRho04
2255,ykgM,625610,625610,625554,56,0,utRho04
2256,ykgR,626570,626570,626484,86,0,utRho04
2257,ylaC,958576,958576,958502,74,678,utRho04
2258,yliE,1745938,1745958,1745938,20,0,utRho04
2259,ymcE,2103660,2103694,2103660,34,670,utRho04
2260,ymdA,2210450,2210828,2210450,378,98,utRho04
2261,ymdB,2211428,2211640,2211428,212,20,utRho04
2262,ymfD,2395322,2395322,2395064,258,256,utRho04
2263,ymfI,2402880,2402994,2402880,114,90,utRho04
2264,ymfJ,2404518,2404518,2404168,350,12,utRho04
2265,ymfK,2406176,2406176,2405866,310,84,utRho04
2266,ymfT,2405766,2406048,2405766,282,112,utRho04
2267,ymgE,2489110,2489456,2489110,346,84,utRho04
2268,ymgF,2437628,2437966,2437628,338,0,utRho04
2269,ymiA,2670112,2670320,2670112,208,16,utRho04
2270,ymjA,2715620,2715620,2715336,284,428,utRho04
2271,ynaI,2791946,2791946,2791844,102,0,utRho04
2272,ynaK,2850438,2850754,2850438,316,46,utRho04
2273,ynbA,2954924,2955242,2954924,318,0,utRho04
2274,yncD,3046552,3046552,3046130,422,32,utRho04
2275,yncE,3046454,3046614,3046454,160,0,utRho04
2276,yncG,3052456,3052494,3052456,38,46,utRho04
2277,yncL,3034492,3034492,3034388,104,36,utRho04
2278,yneE,3218364,3218364,3218044,320,26,utRho04
2279,yneF,3223748,3223748,3223708,40,0,utRho04
2280,yneJ,3229560,3229608,3229560,48,0,utRho04
2281,yneK,3231100,3231526,3231100,426,0,utRho04
2282,yneM,3245176,3245292,3245176,116,54,utRho04
2283,ynfA,3311398,3311398,3311346,52,0,utRho04
2284,ynfB,3311418,3311616,3311418,198,154,utRho04
2285,ynfC,3315094,3315094,3314914,180,0,utRho04
2286,ynfD,3314828,3315130,3314828,302,0,utRho04
2287,ynfE,3316006,3316138,3316006,132,0,utRho04
2288,ynfK,3334670,3334670,3334438,232,102,utRho04
2289,ynfL,3339304,3339304,3339184,120,0,utRho04
2290,ynfM,3339260,3339398,3339260,138,38,utRho04
2291,ynfN,3276598,3276598,3276218,380,1372,utRho04
2292,ynfO,3273454,3273512,3273454,58,0,utRho04
2293,ynhG,3517890,3517890,3517450,440,404,utRho04
2294,yniA,3615158,3615592,3615158,434,16,utRho04
2295,yniB,3618526,3618526,3618466,60,32,utRho04
2296,yniC,3618652,3618760,3618652,108,32,utRho04
2297,yniD,3610202,3610330,3610202,128,0,utRho04
2298,ynjE,3678880,3678934,3678880,54,0,utRho04
2299,ynjF,3683222,3683222,3682806,416,10,utRho04
2300,ynjH,3684376,3684376,3684270,106,38,utRho04
2301,ynjI,3690022,3690022,3689742,280,40,utRho04
2302,yoaB,3786642,3786734,3786642,92,84,utRho04
2303,yoaC,3787932,3788146,3787932,214,298,utRho04
2304,yoaE,3803544,3803544,3803170,374,142,utRho04
2305,yoaF,3755444,3755444,3755064,380,812,utRho04
2306,yoaH,3789866,3789866,3789462,404,330,utRho04
2307,yobB,3850418,3850880,3850418,462,210,utRho04
2308,yobF,3815586,3815586,3815182,404,308,utRho04
2309,yobH,3817800,3817850,3817800,50,68,utRho04
2310,yodB,4084352,4084736,4084352,384,110,utRho04
2311,yodC,4057008,4057008,4056740,268,0,utRho04
2312,yohC,4451358,4451358,4451262,96,8,utRho04
2313,yohD,4451526,4451602,4451526,76,0,utRho04
2314,yohJ,4460986,4461248,4460986,262,16,utRho04
2315,yohO,4431172,4431314,4431172,142,28,utRho04
2316,yojI,4617282,4617282,4617230,52,0,utRho04
2317,ypdI,4988988,4989396,4988988,408,8,utRho04
2318,ypfG,5165786,5165786,5165554,232,0,utRho04
2319,ypfM,5182140,5182140,5181732,408,44,utRho04
2320,yphB,5349590,5349590,5349376,214,114,utRho04
2321,ypjA,5565644,5565644,5565452,192,0,utRho04
2322,ypjB,5569636,5569636,5568858,778,0,utRho04
2323,ypjD,5495860,5495774,5495860,86,0,utRho04
2324,yqaE,5594170,5594170,5594056,114,0,utRho04
2325,yqcA,5846100,5846100,5845968,132,0,utRho04
2326,yqcE,5800944,5801184,5800944,240,0,utRho04
2327,yqeC,6030468,6030468,6030114,354,0,utRho04
2328,yqeF,5971618,5971618,5971184,434,154,utRho04
2329,yqeG,5971438,5971694,5971438,256,78,utRho04
2330,yqeH,5975016,5975072,5975016,56,0,utRho04
2331,yqeI,5976688,5977004,5976688,316,0,utRho04
2332,yqeK,5981140,5981140,5980720,420,0,utRho04
2333,yqfA,6086728,6086728,6086296,432,382,utRho04
2334,yqgA,6219042,6219106,6219042,64,0,utRho04
2335,yqgB,6172500,6172500,6172102,398,430,utRho04
2336,yqgE,6185768,6185874,6185768,106,310,utRho04
2337,yqhA,6299150,6299150,6298942,208,28,utRho04
2338,yqhC,6310768,6310768,6310436,332,4,utRho04
2339,yqhD,6310604,6310710,6310604,106,4,utRho04
2340,yqhH,6316842,6317254,6316842,412,252,utRho04
2341,yqiC,6369662,6369680,6369662,18,76,utRho04
2342,yqiJ,6384108,6384416,6384108,308,20,utRho04
2343,yqjA,6495096,6495546,6495096,450,6916,utRho04
2344,yqjF,6500932,6501124,6500932,192,126,utRho04
2345,yqjG,6501948,6502048,6501948,100,0,utRho04
2346,yqjH,6433078,6433078,6432982,96,8,utRho04
2347,yqjI,6433506,6433558,6433506,52,0,utRho04
2348,yraH,6574552,6574852,6574552,300,0,utRho04
2349,yraP,6592144,6592818,6592144,674,216,utRho04
2350,yraQ,6596414,6596414,6596276,138,0,utRho04
2351,yraR,6598024,6598024,6597692,332,24,utRho04
2352,yrbG,13360844,13361100,13360844,256,72,utRho04
2353,yrbL,6696842,6696904,6696842,62,302,utRho04
2354,yrbN,6616172,6616172,6615866,306,14166,utRho04
2355,yrdB,6860176,6860176,6860046,130,64,utRho04
2356,yrfF,7052548,7052938,7052548,390,308,utRho04
2357,yrhB,7169440,7169518,7169440,78,0,utRho04
2358,ysaB,7451804,7451804,7451424,380,74,utRho04
2359,ysgA,8032686,8032686,8032338,348,26,utRho04
2360,ytfB,8857638,8857638,8857434,204,2,utRho04
2361,ytfE,8864018,8864018,8863966,52,0,utRho04
2362,ytfF,8866296,8866296,8866130,166,2,utRho04
2363,ytfH,8868164,8868226,8868164,62,0,utRho04
2364,ytfI,8875234,8875414,8875234,180,0,utRho04
2365,ytfJ,8878572,8878572,8878524,48,0,utRho04
2366,ytfK,8879022,8879174,8879022,152,112,utRho04
2367,ytfL,8882642,8882642,8882430,212,56,utRho04
2368,ytfQ,8899634,8899924,8899634,290,198,utRho04
2369,ytjB,9249598,9249598,9249578,20,4,utRho04
2370,yzfA,8896588,8896588,8896490,98,0,utRho04
2371,zapA,6111102,6111224,6111102,122,5162,utRho04
2372,zapB,8236772,8237030,8236772,258,36,utRho04
2373,zapC,2011700,2011904,2011700,204,72,utRho04
2374,zinT,4082692,4082750,4082692,58,0,utRho04
2375,zipA,5062814,5062814,5062466,348,0,utRho04
2376,zitB,1569716,1569716,1569646,70,0,utRho04
2377,zntA,7212844,7212902,7212844,58,0,utRho04
2378,zntR,6878336,6878336,6878260,76,76,utRho04
2379,znuA,3885322,3885322,3885166,156,0,utRho04
2380,znuC,3885268,3885324,3885268,56,0,utRho04
2381,zraP,8403424,8403424,8403376,48,0,utRho04
2382,zraS,8403810,8403852,8403810,42,0,utRho04
2383,zupT,6364866,6365100,6364866,234,208,utRho04
2384,zur,8520282,8520282,8520006,276,1728,utRho04
2385,zwf,3872752,3872752,3872628,124,62,utRho04
0,C0343,2818676,2818728,2818676,52,18,utRho05
1,aaeB,6776526,6776526,6776376,150,0,utRho05
2,aaeR,6778762,6779040,6778762,278,120,utRho05
3,aaeX,6778860,6778860,6778674,186,106,utRho05
4,aat,1854920,1854920,1854864,56,0,utRho05
5,accA,416822,417242,416822,420,2388,utRho05
6,accB,6810280,6810872,6810280,592,7940,utRho05
7,accD,4868030,4868030,4867852,178,380,utRho05
8,aceB,8430804,8430956,8430804,152,48,utRho05
9,aceE,245938,246034,245938,96,662,utRho05
10,ackA,4826918,4826940,4826918,22,1302,utRho05
11,acnA,2670848,2671662,2670848,814,950,utRho05
12,acnB,263038,263230,263038,192,1020,utRho05
13,acpP,2303148,2303230,2303148,82,436,utRho05
14,acpS,5402324,5402324,5401996,328,398,utRho05
15,acrA,971396,971396,971238,158,414,utRho05
16,acrB,969370,969370,968806,564,1952,utRho05
17,acrD,5174950,5175190,5174950,240,0,utRho05
18,acrE,6827404,6827728,6827404,324,0,utRho05
19,acrR,971398,971522,971398,124,190,utRho05
20,acrZ,1589502,1589546,1589502,44,16,utRho05
21,acs,8575190,8575190,8574742,448,42,utRho05
22,actP,8569870,8569870,8569804,66,0,utRho05
23,ada,4620854,4620854,4620810,44,28,utRho05
24,add,3404404,3404466,3404404,62,30,utRho05
25,ade,7687802,7687928,7687802,126,0,utRho05
26,adhE,2596826,2596826,2596242,584,2,utRho05
27,adhP,3107988,3107988,3107676,312,1172,utRho05
28,adiA,8681112,8681112,8681042,70,46,utRho05
29,adiC,8674404,8674404,8674062,342,2,utRho05
30,adiY,8676084,8676084,8675858,226,0,utRho05
31,adk,994278,994350,994278,72,202,utRho05
32,adrA,807374,807406,807374,32,0,utRho05
33,aer,6438240,6438240,6438152,88,0,utRho05
34,aes,1000102,1000102,999946,156,10,utRho05
35,agaR,6557406,6557406,6557330,76,0,utRho05
36,agaS,6563778,6563952,6563778,174,0,utRho05
37,agp,2131118,2131170,2131118,52,0,utRho05
38,agrA,7296126,7296126,7296126,0,0,utRho05
39,agrB,7296588,7296588,7296588,0,0,utRho05
40,ahpC,1277386,1277890,1277386,504,880,utRho05
41,ahpF,1278004,1279506,1278004,1502,57012,utRho05
42,ahr,8992698,8992698,8992418,280,50,utRho05
43,aidB,8828494,8828550,8828494,56,0,utRho05
44,ais,4731512,4731512,4731240,272,0,utRho05
45,alaA,4814816,4815122,4814816,306,0,utRho05
46,alaC,4996798,4996798,4996590,208,14,utRho05
47,alaE,5598140,5598328,5598140,188,0,utRho05
48,alaS,5644180,5644180,5644022,158,2466,utRho05
49,alaW,5036612,5036612,5036462,150,2,utRho05
50,aldA,2976380,2976464,2976380,84,92,utRho05
51,aldB,7513070,7513070,7513022,48,0,utRho05
52,alkA,4295118,4295118,4295080,38,4,utRho05
53,alkB,4618890,4618890,4618682,208,78,utRho05
54,allA,1064780,1064902,1064780,122,0,utRho05
55,allD,1092822,1092822,1092726,96,0,utRho05
56,allE,1088112,1088112,1088092,20,40,utRho05
57,allS,1064600,1064600,1064442,158,2,utRho05
58,alr,8531178,8531564,8531178,386,4764,utRho05
59,alsE,8617334,8617334,8616956,378,48,utRho05
60,alsK,8615990,8615990,8615598,392,232,utRho05
61,alx,6476740,6477160,6476740,420,144,utRho05
62,amiA,5104482,5104704,5104482,222,88,utRho05
63,amiC,5898378,5898378,5898020,358,8,utRho05
64,amn,4110062,4110122,4110062,60,40,utRho05
65,ampC,8758006,8758006,8757888,118,0,utRho05
66,ampD,237362,237466,237362,104,98,utRho05
67,ampG,907372,907372,907090,282,876,utRho05
68,ampH,792726,792726,792574,152,112,utRho05
69,amyA,4012230,4012312,4012230,82,0,utRho05
70,anmK,3439346,3439346,3439204,142,0,utRho05
71,ansB,6201580,6201580,6201456,124,50,utRho05
72,ansP,3052040,3052040,3051960,80,286,utRho05
73,apaG,104068,104068,103212,856,7106,utRho05
74,apaH,102586,102586,102444,142,6458,utRho05
75,apbE,4623188,4623188,4623068,120,0,utRho05
76,appA,2081198,2081234,2081198,36,0,utRho05
77,appC,2075420,2075480,2075420,60,0,utRho05
78,appY,1167134,1167362,1167134,228,0,utRho05
79,apt,982620,982824,982620,204,454,utRho05
80,aqpZ,1832424,1832424,1832094,330,0,utRho05
81,araB,140150,140150,140096,54,0,utRho05
82,araC,140482,140774,140482,292,16,utRho05
83,araE,5964416,5964416,5964364,52,0,utRho05
84,araF,3972476,3972476,3972256,220,2,utRho05
85,araH,3967120,3967120,3967086,34,2,utRho05
86,araJ,825058,825058,824962,96,48,utRho05
87,arcA,9281602,9281602,9280612,990,6584,utRho05
88,arcB,6706098,6706098,6706050,48,0,utRho05
89,arcZ,6701154,6701154,6701154,0,0,utRho05
90,arfA,6877346,6877346,6877298,48,336,utRho05
91,argA,5898312,5898484,5898312,172,8,utRho05
92,argC,8309770,8310002,8309770,232,24,utRho05
93,argD,6980442,6980442,6980360,82,0,utRho05
94,argE,8310156,8310156,8309694,462,148,utRho05
95,argF,580680,580680,580610,70,0,utRho05
96,argG,6637124,6637274,6637124,150,134,utRho05
97,argI,8956688,8956688,8956622,66,2,utRho05
98,argO,6137672,6137672,6137616,56,264,utRho05
99,argP,6119460,6119506,6119460,46,0,utRho05
100,argR,6769204,6769406,6769204,202,40,utRho05
101,argS,3920002,3920124,3920002,122,4,utRho05
102,argT,4855698,4855698,4855582,116,98,utRho05
103,argU,1129406,1129446,1129406,40,2,utRho05
104,argW,4932616,4932618,4932616,2,32,utRho05
105,argX,7964728,7964750,7964728,22,104,utRho05
106,aroF,5482402,5482402,5482300,102,70,utRho05
107,aroG,1571182,1571266,1571182,84,296,utRho05
108,aroH,3576636,3576870,3576636,234,390,utRho05
109,aroK,7038760,7038760,7038128,632,3326,utRho05
110,aroL,812560,812810,812560,250,74,utRho05
111,aroP,243342,243342,243102,240,0,utRho05
112,arpA,8445382,8445382,8444974,408,130,utRho05
113,arrS,7316108,7316108,7316108,0,0,utRho05
114,arsR,7297024,7297056,7297024,32,0,utRho05
115,artJ,1801252,1801252,1801150,102,0,utRho05
116,artP,1807686,1807686,1807468,218,30,utRho05
117,ascF,5678858,5679048,5678858,190,2,utRho05
118,ascG,5678574,5678574,5678528,46,2,utRho05
119,aslB,7965562,7965916,7965562,354,38086,utRho05
120,asnA,7854258,7854310,7854258,52,2,utRho05
121,asnB,1398444,1398444,1398354,90,820,utRho05
122,asnC,23562186,23562186,23562018,168,6,utRho05
123,asnS,1978088,1978088,1977970,118,9116,utRho05
124,asnT,4089082,4089098,4089082,16,0,utRho05
125,asnU,4119690,4119702,4119690,12,0,utRho05
126,asnV,4124504,4124520,4124504,16,0,utRho05
127,aspA,17473728,17473728,17473308,420,344,utRho05
128,aspC,1971486,1971486,1971418,68,500,utRho05
129,aspS,3901402,3901402,3901044,358,324,utRho05
130,aspT,7893560,7893744,7893560,184,105586,utRho05
131,aspV,473826,473862,473826,36,48,utRho05
132,asr,3342654,3342752,3342654,98,44,utRho05
133,astC,3664088,3664088,3663964,124,0,utRho05
134,astE,3654138,3654138,3653846,292,18,utRho05
135,atoD,4646824,4646894,4646824,70,0,utRho05
136,atpB,7844540,7844540,7844102,438,800,utRho05
137,atpC,7832118,7832118,7831944,174,1012,utRho05
138,atpI,7845050,7845050,7844880,170,6,utRho05
139,avtA,7479348,7479410,7479348,62,342,utRho05
140,azoR,2965982,2965982,2965720,262,236,utRho05
141,azuC,3976002,3976002,3975918,84,30,utRho05
142,bacA,6408350,6408350,6408262,88,32,utRho05
143,bamA,394052,395856,394052,1804,1498,utRho05
144,bamB,5277950,5277950,5277304,646,2346,utRho05
145,bamC,5198028,5198028,5197730,298,1060,utRho05
146,bamD,5471922,5472292,5471922,370,8338,utRho05
147,bamE,5506972,5507210,5506972,238,420,utRho05
148,basS,8666954,8666954,8666544,410,120,utRho05
149,bax,7474468,7474468,7474354,114,202,utRho05
150,bcp,5200874,5200956,5200874,82,2082,utRho05
151,bcsB,7385346,7385346,7385214,132,6,utRho05
152,bcsE,7392644,7392916,7392644,272,0,utRho05
153,bdcA,8948128,8948128,8948106,22,48,utRho05
154,bdcR,8948192,8948248,8948192,56,0,utRho05
155,bdm,3112680,3112680,3112560,120,0,utRho05
156,betA,654522,654522,654494,28,434,utRho05
157,betI,658722,658722,658668,54,0,utRho05
158,betT,658842,658926,658842,84,30,utRho05
159,bfr,6933498,6933498,6933450,48,0,utRho05
160,bglG,23440182,23440182,23439402,780,0,utRho05
161,bglX,4444240,4444240,4443978,262,36,utRho05
162,bhsA,2337962,2338146,2337962,184,46,utRho05
163,bioA,1618584,1618584,1618514,70,0,utRho05
164,bioB,1618604,1618688,1618604,84,0,utRho05
165,bioH,7089716,7089716,7089688,28,14,utRho05
166,bisC,7433026,7433026,7432788,238,0,utRho05
167,blc,8755490,8755490,8755444,46,0,utRho05
168,blr,3409024,3409102,3409024,78,142,utRho05
169,bluF,2431226,2431226,2430950,276,2734,utRho05
170,bluR,2428226,2428226,2428118,108,0,utRho05
171,bolA,908698,908944,908698,246,0,utRho05
172,borD,1157842,1157842,1157786,56,48,utRho05
173,brnQ,838976,839182,838976,206,2774,utRho05
174,bssR,1756492,1756496,1756492,4,0,utRho05
175,bssS,2242116,2242116,2241910,206,352,utRho05
176,btuB,8326798,8327278,8326798,480,3838,utRho05
177,cadB,8720212,8720212,8720062,150,2,utRho05
178,cadC,8723926,8723926,8723868,58,0,utRho05
179,caiE,70998,70998,70742,256,72,utRho05
180,caiF,68436,68600,68436,164,2,utRho05
181,caiT,84074,84074,83862,212,0,utRho05
182,can,285406,285406,285340,66,68,utRho05
183,carA,59102,59302,59102,200,56,utRho05
184,carB,61550,61634,61550,84,0,utRho05
185,cas2,5757830,5757830,5757706,124,0,utRho05
186,casA,5768638,5768638,5768276,362,0,utRho05
187,cbl,4121882,4121882,4121828,54,6,utRho05
188,cbpA,2128074,2128074,2127550,524,206,utRho05
189,cbrA,7738628,7738754,7738628,126,0,utRho05
190,cbrB,7794958,7795012,7794958,54,116,utRho05
191,ccmH,4585242,4585242,4584820,422,4,utRho05
192,cdaR,364894,364926,364894,32,0,utRho05
193,cdd,4463638,4463688,4463638,50,140,utRho05
194,cdh,8219814,8219860,8219814,46,190,utRho05
195,cdsA,391110,391354,391110,244,2406,utRho05
196,cedA,3627484,3627484,3627326,158,20,utRho05
197,cfa,3482402,3482826,3482402,424,458,utRho05
198,chaC,2544844,2544972,2544844,128,2,utRho05
199,chbB,3643452,3643452,3643238,214,0,utRho05
200,chbG,3634624,3634624,3634270,354,0,utRho05
201,cheW,3946924,3946924,3946678,246,238,utRho05
202,chiA,6939792,6939792,6939706,86,50,utRho05
203,chiP,1416472,1416668,1416472,196,0,utRho05
204,cho,3646984,3647030,3646984,46,24,utRho05
205,chpS,8896804,8896894,8896804,90,0,utRho05
206,cirA,4493884,4493884,4493538,346,618,utRho05
207,citC,1304078,1304078,1303712,366,4,utRho05
208,citT,1293264,1293264,1293160,104,0,utRho05
209,clcA,350104,350214,350104,110,0,utRho05
210,clpA,1846160,1846528,1846160,368,0,utRho05
211,clpB,5468410,5468410,5468346,64,56,utRho05
212,clpP,913154,913354,913154,200,530,utRho05
213,clpS,1845500,1845826,1845500,326,2,utRho05
214,clpX,914404,914852,914404,448,1510,utRho05
215,clsA,2617346,2617346,2617290,56,56,utRho05
216,clsC,2212584,2212710,2212584,126,328,utRho05
217,cmk,1922330,1922402,1922330,72,162,utRho05
218,cnu,3409522,3409898,3409522,376,494,utRho05
219,coaA,8350214,8350214,8350052,162,988,utRho05
220,cobC,1340092,1340092,1339814,278,642,utRho05
221,cobT,4129202,4129202,4128934,268,0,utRho05
222,cobU,4131944,4131944,4131528,416,386,utRho05
223,codB,709768,709844,709768,76,2,utRho05
224,comR,2337726,2337726,2337664,62,0,utRho05
225,copA,1022822,1022822,1022758,64,2,utRho05
226,corA,8002388,8002852,8002388,464,5324,utRho05
227,cpdB,8873258,8873258,8873130,128,38,utRho05
228,cptB,6082198,6082198,6082140,58,60,utRho05
229,cpxA,8210202,8210202,8209950,252,790,utRho05
230,cpxP,8211570,8211640,8211570,70,34,utRho05
231,cpxR,8211372,8211372,8211340,32,78,utRho05
232,cra,175894,176056,175894,162,0,utRho05
233,crcB,1316016,1316016,1315876,140,262,utRho05
234,creA,9270486,9271042,9270486,556,726,utRho05
235,creD,9276320,9276356,9276320,36,44,utRho05
236,crl,515620,515658,515620,38,752,utRho05
237,crp,6971906,6972240,6971906,334,5318,utRho05
238,crr,5070960,5071668,5070960,708,4232,utRho05
239,csdA,5886414,5886674,5886414,260,0,utRho05
240,csgB,2207718,2207902,2207718,184,0,utRho05
241,csgD,2206688,2206688,2206392,296,0,utRho05
242,csgG,2203510,2203510,2203368,142,18,utRho05
243,csiD,5577854,5577970,5577854,116,56,utRho05
244,csiE,5330802,5330870,5330802,68,0,utRho05
245,csiR,5590942,5591348,5590942,406,0,utRho05
246,cspA,7439778,7440098,7439778,320,606382,utRho05
247,cspB,3283430,3283430,3283108,322,816,utRho05
248,cspC,3815018,3815018,3814870,148,240,utRho05
249,cspD,1845352,1845352,1845180,172,982,utRho05
250,cspE,1314294,1314584,1314294,290,0,utRho05
251,cspF,3283380,3283710,3283380,330,86,utRho05
252,cspG,2102610,2102922,2102610,312,134226,utRho05
253,cspH,2102746,2102746,2102350,396,600,utRho05
254,cspI,3277624,3277624,3277334,290,352,utRho05
255,csrA,5638746,5638746,5638292,454,1252,utRho05
256,csrB,5849048,5849048,5849048,0,0,utRho05
257,csrC,8102072,8102072,8102072,0,0,utRho05
258,csrD,6806850,6806850,6806664,186,62,utRho05
259,cstA,1259710,1259788,1259710,78,38,utRho05
260,cueO,274090,274166,274090,76,0,utRho05
261,cueR,1027948,1027986,1027948,38,0,utRho05
262,curA,3037784,3038054,3037784,270,32,utRho05
263,cusC,1191146,1191200,1191146,54,2,utRho05
264,cusR,1190924,1190924,1190886,38,2,utRho05
265,cutA,8730784,8730784,8730712,72,492,utRho05
266,cutC,3918534,3918534,3917920,614,16,utRho05
267,cvpA,4861600,4861600,4861526,74,116,utRho05
268,cvrA,2484328,2484328,2484142,186,106,utRho05
269,cyaA,7981548,7982306,7981548,758,1146,utRho05
270,cyaR,4334228,4334224,4334228,4,0,utRho05
271,cyaY,7988166,7988166,7988118,48,78,utRho05
272,cybB,2981522,2981804,2981522,282,346,utRho05
273,cycA,8859560,8859728,8859560,168,440,utRho05
274,cydA,1542340,1542916,1542340,576,0,utRho05
275,cydC,1858800,1858800,1858390,410,116,utRho05
276,cydD,1862062,1862062,1861924,138,196,utRho05
277,cydX,1548300,1548392,1548300,92,630,utRho05
278,cynR,717418,717418,717380,38,54,utRho05
279,cynT,1435092,1435196,1435092,104,108,utRho05
280,cyoA,903306,903306,903220,86,1748,utRho05
281,cyoE,895540,895540,895410,130,678,utRho05
282,cysB,2667576,2667710,2667576,134,304,utRho05
283,cysC,5748056,5748056,5747984,72,196,utRho05
284,cysD,5752736,5752736,5752658,78,10,utRho05
285,cysE,7565362,7565362,7565124,238,1334,utRho05
286,cysG,6995508,6995656,6995508,148,96,utRho05
287,cysJ,5783928,5783928,5783796,132,1890,utRho05
288,cysK,5064688,5064818,5064688,130,2,utRho05
289,cysP,5087114,5087114,5087056,58,38,utRho05
290,cysS,1109154,1109222,1109154,68,200,utRho05
291,cysT,3984100,3984100,3983974,126,222,utRho05
292,cysZ,5062766,5062926,5062766,160,264,utRho05
293,cytR,8249018,8249018,8248912,106,264,utRho05
294,dacA,1328002,1328002,1327926,76,98,utRho05
295,dacB,6657714,6657926,6657714,212,16,utRho05
296,dacC,1761306,1761454,1761306,148,0,utRho05
297,dadA,2475018,2475142,2475018,124,0,utRho05
298,dam,7032504,7032504,7031826,678,2008,utRho05
299,damX,7035200,7035200,7034612,588,966,utRho05
300,dapA,5199568,5199568,5199520,48,0,utRho05
301,dapB,56576,56748,56576,172,160,utRho05
302,dapD,371954,371954,371894,60,360,utRho05
303,dapE,5183120,5183214,5183120,94,276,utRho05
304,dcp,3254844,3254844,3254760,84,32,utRho05
305,dcrB,7219534,7219910,7219534,376,102,utRho05
306,dctA,7366996,7366996,7366894,102,478,utRho05
307,dcuA,8733686,8733686,8733546,140,0,utRho05
308,dcuB,8698182,8698182,8697488,694,240,utRho05
309,dcuC,1312166,1312166,1311936,230,26,utRho05
310,dcuD,6749166,6749738,6749166,572,0,utRho05
311,dcuR,8701130,8701130,8700068,1062,858,utRho05
312,dcuS,8703370,8703370,8703324,46,0,utRho05
313,dcyD,3999016,3999016,3998960,56,0,utRho05
314,ddpX,3126498,3126498,3126152,346,0,utRho05
315,deaD,6615818,6615818,6615720,98,7598,utRho05
316,dedA,4869880,4869880,4869482,398,13182,utRho05
317,dedD,4863750,4863750,4863368,382,148,utRho05
318,def,6867300,6867380,6867300,80,60,utRho05
319,degP,361690,361768,361690,78,0,utRho05
320,degQ,6761308,6761486,6761308,178,4112,utRho05
321,deoB,9239134,9239206,9239134,72,2,utRho05
322,deoC,9233358,9234646,9233358,1288,224,utRho05
323,dfp,7625406,7625462,7625406,56,0,utRho05
324,dgcZ,3247758,3247758,3247700,58,0,utRho05
325,dgkA,8512914,8513274,8512914,360,250,utRho05
326,dgt,358392,358474,358392,82,14,utRho05
327,dhaK,2501888,2501888,2501676,212,110,utRho05
328,dhaR,2502006,2502132,2502006,126,12,utRho05
329,dicB,3299194,3299218,3299194,24,0,utRho05
330,dicC,3295752,3295752,3295700,52,0,utRho05
331,dinB,501760,501796,501760,36,0,utRho05
332,dinD,7635398,7635520,7635398,122,292,utRho05
333,dinG,1666146,1666140,1666146,6,0,utRho05
334,dinI,2243018,2243018,2242974,44,0,utRho05
335,dinJ,493230,493230,493004,226,6,utRho05
336,dinQ,7295964,7295964,7295576,388,1490,utRho05
337,djlA,114536,114728,114536,192,0,utRho05
338,dkgA,6313142,6313246,6313142,104,32,utRho05
339,dkgB,458196,458334,458196,138,452,utRho05
340,dksA,321502,321502,321208,294,434,utRho05
341,dld,4444164,4444370,4444164,206,36,utRho05
342,dmlA,3763424,3763824,3763424,400,0,utRho05
343,dmlR,3763710,3763710,3763618,92,0,utRho05
344,dmsA,1881646,1881918,1881646,272,54,utRho05
345,dnaA,7767922,7767922,7767458,464,10298,utRho05
346,dnaB,8528566,8528628,8528566,62,148,utRho05
347,dnaK,24096,24326,24096,230,454,utRho05
348,dnaN,7765466,7765466,7764642,824,1544,utRho05
349,dnaQ,471868,472134,471868,266,1400,utRho05
350,dnaT,18406460,18406460,18406068,392,580,utRho05
351,dnaX,984112,984184,984112,72,604,utRho05
352,dosP,3131486,3131486,3131466,20,0,utRho05
353,dpiB,1303968,1304470,1303968,502,76,utRho05
354,dppA,7415740,7415740,7415410,330,1258,utRho05
355,dps,1697900,1697900,1697822,78,78,utRho05
356,dsbA,8086754,8086836,8086754,82,3224,utRho05
357,dsbB,2466294,2466294,2466060,234,68,utRho05
358,dsbC,6079266,6079266,6077644,1622,1168,utRho05
359,dsbG,1277600,1277600,1277146,454,384,utRho05
360,dsdA,4958242,4958404,4958242,162,106,utRho05
361,dsdC,4955492,4955492,4955258,234,0,utRho05
362,dsdX,4955642,4955694,4955642,52,48,utRho05
363,dsrA,4050626,4050626,4050626,0,0,utRho05
364,dsrB,4049686,4049686,4049646,40,82,utRho05
365,dtpD,1485340,1485340,1485112,228,82,utRho05
366,dusA,8523200,8523338,8523200,138,4272,utRho05
367,dusB,6820492,6820560,6820492,68,152,utRho05
368,dusC,4460790,4460790,4460770,20,0,utRho05
369,dut,7627704,7627864,7627704,160,1400,utRho05
370,dxr,386670,387042,386670,372,702,utRho05
371,ebgA,6445102,6445266,6445102,164,84,utRho05
372,ebgR,6442874,6442932,6442874,58,26,utRho05
373,ecnB,8753018,8753106,8753018,88,78,utRho05
374,eco,4607594,4607810,4607594,216,0,utRho05
375,ecpA,621594,621594,621342,252,0,utRho05
376,ecpB,620238,620238,620052,186,0,utRho05
377,ecpR,622964,622964,622672,292,0,utRho05
378,eda,3866218,3866218,3865512,706,112,utRho05
379,edd,3869426,3869426,3869208,218,0,utRho05
380,efeO,2164308,2164486,2164308,178,60,utRho05
381,efeU_1,2162614,2162712,2162614,98,108,utRho05
382,efp,8751134,8751398,8751134,264,12502,utRho05
383,elaA,4763372,4763372,4763086,286,104,utRho05
384,elaD,4765308,4765426,4765308,118,0,utRho05
385,elfA,1995530,1995736,1995530,206,0,utRho05
386,elfD,1996642,1996980,1996642,338,0,utRho05
387,emrD,7707690,7707844,7707690,154,30,utRho05
388,emrK,4966896,4966896,4966678,218,0,utRho05
389,emrY,4964668,4964668,4964352,316,4,utRho05
390,emtA,2486250,2486360,2486250,110,6,utRho05
391,endA,12361100,12361388,12361100,288,0,utRho05
392,eno,5817692,5817692,5815882,1810,4836,utRho05
393,entC,1249662,1249770,1249662,108,0,utRho05
394,entD,1220508,1220508,1220158,350,94,utRho05
395,entH,1258584,1258600,1258584,16,92,utRho05
396,entS,1244506,1244600,1244506,94,0,utRho05
397,envR,6827266,6827266,6826930,336,0,utRho05
398,epd,12295292,12295292,12294764,528,4,utRho05
399,epmA,8765236,8765286,8765236,50,34,utRho05
400,epmB,8751406,8751406,8751314,92,6496,utRho05
401,eptB,7421162,7421162,7420950,212,532,utRho05
402,eptC,8300622,8300622,8300530,92,122,utRho05
403,erfK,4126708,4126708,4126646,62,2106,utRho05
404,erpA,353122,353220,353122,98,56,utRho05
405,esrE,8039956,8039956,8039956,0,0,utRho05
406,essD,1153746,1154796,1153746,1050,228,utRho05
407,etk,2088606,2088606,2088420,186,0,utRho05
408,evgA,4967262,4967510,4967262,248,16,utRho05
409,exbB,6304028,6304028,6303968,60,70,utRho05
410,exbD,6302780,6302780,6302486,294,430,utRho05
411,exuR,6493016,6493304,6493016,288,92,utRho05
412,exuT,6490004,6490208,6490004,204,0,utRho05
413,fabA,2032996,2032996,2032940,56,4,utRho05
414,fabB,4883282,4883282,4883210,72,0,utRho05
415,fabH,2297032,2297518,2297032,486,4256,utRho05
416,fabI,2702236,2702236,2702078,158,260,utRho05
417,fadB,8062026,8062026,8061942,84,0,utRho05
418,fadD,3779614,3779614,3779492,122,2,utRho05
419,fadE,486812,486812,486606,206,106,utRho05
420,fadH,6463248,6463330,6463248,82,42,utRho05
421,fadI,4921022,4921022,4920938,84,8,utRho05
422,fadL,4922410,4922600,4922410,190,2,utRho05
423,fadM,928720,928804,928720,84,0,utRho05
424,fadR,2469810,2469876,2469810,66,80,utRho05
425,fbaB,4357334,4357334,4357128,206,0,utRho05
426,fdhE,8162722,8162722,8162456,266,1600,utRho05
427,fdhF,8598814,8598814,8598732,82,10,utRho05
428,fdnG,3094744,3094802,3094744,58,0,utRho05
429,fdrA,1093012,1093360,1093012,348,0,utRho05
430,feaB,2894994,2895038,2894994,44,0,utRho05
431,feaR,2894734,2894734,2894566,168,0,utRho05
432,fecA,9033454,9033454,9033354,100,414,utRho05
433,fecE,9023288,9023288,9022914,374,11110,utRho05
434,fecI,9036564,9036564,9036470,94,78,utRho05
435,feoA,7080114,7080326,7080114,212,32,utRho05
436,fepA,1225334,1225334,1224988,346,230,utRho05
437,fepB,1249454,1249454,1249020,434,538,utRho05
438,fepD,1244468,1244468,1244378,90,206,utRho05
439,fes,1225374,1225630,1225374,256,284,utRho05
440,ffh,5495706,5495706,5495590,116,2296,utRho05
441,ffs,952576,952848,952576,272,38,utRho05
442,fhuA,334884,334968,334884,84,184,utRho05
443,fhuE,2323294,2323294,2323102,192,444,utRho05
444,fhuF,9211504,9211504,9211326,178,3378,utRho05
445,fic,6983296,6983296,6982926,370,468,utRho05
446,fieF,8212864,8212938,8212864,74,218,utRho05
447,fimA,9085388,9086230,9085388,842,386,utRho05
448,fimB,9081334,9081914,9081334,580,628,utRho05
449,fimE,9083742,9084074,9083742,332,34,utRho05
450,fimZ,1129214,1129214,1128960,254,0,utRho05
451,fiu,1683296,1683296,1683062,234,86,utRho05
452,fixA,84650,84806,84650,156,0,utRho05
453,fkpA,6955050,6955050,6954838,212,8864,utRho05
454,fldA,2846084,2846084,2845860,224,4288,utRho05
455,fldB,6079644,6079710,6079644,66,34,utRho05
456,flgA,2261770,2261770,2261726,44,64,utRho05
457,flgB,2261986,2262036,2261986,50,2,utRho05
458,flgK,2276702,2276756,2276702,54,1694,utRho05
459,flgM,2260330,2260330,2260256,74,364,utRho05
460,flgN,2259828,2259828,2259660,168,228,utRho05
461,flhB,3932432,3932432,3932382,50,134,utRho05
462,flhC,3955864,3955864,3955688,176,66,utRho05
463,flhD,3957154,3957154,3956394,760,564,utRho05
464,fliA,4003638,4003638,4003578,60,172,utRho05
465,fliC,4007352,4007352,4007212,140,166,utRho05
466,fliD,4007634,4007744,4007634,110,292,utRho05
467,fliE,4026186,4026186,4026028,158,0,utRho05
468,fliF,4026292,4026458,4026292,166,172,utRho05
469,fliL,4039168,4039236,4039168,68,236,utRho05
470,flk,4875824,4875900,4875824,76,82,utRho05
471,flu,4142634,4143078,4142634,444,24,utRho05
472,flxA,3292776,3292810,3292776,34,0,utRho05
473,fnr,2799104,2799104,2799052,52,44,utRho05
474,fnrS,2818258,2818258,2818258,0,0,utRho05
475,focA,1909628,1909628,1908932,696,356,utRho05
476,folA,99598,99646,99598,48,40,utRho05
477,folB,6409296,6409296,6409178,118,0,utRho05
478,folD,1115562,1115562,1115482,80,252,utRho05
479,folE,4487696,4487696,4487304,392,3822,utRho05
480,fpr,8228998,8228998,8228944,54,110,utRho05
481,frc,4986878,4986878,4986508,370,2,utRho05
482,frdA,8764824,8764824,8764636,188,132,utRho05
483,frdD,8758948,8758948,8758732,216,126,utRho05
484,fre,8052886,8053054,8052886,168,1780,utRho05
485,frlA,6999518,6999820,6999518,302,0,utRho05
486,frr,385624,385744,385624,120,1158,utRho05
487,frsA,513004,513054,513004,50,86,utRho05
488,fruB,4527194,4527194,4526990,204,48,utRho05
489,frvR,8179804,8179804,8179710,94,0,utRho05
490,fryA,5008986,5008986,5008970,16,0,utRho05
491,fsaA,1727060,1727284,1727060,224,2,utRho05
492,fsr,1009710,1009710,1009392,318,202,utRho05
493,ftnA,3977364,3977432,3977364,68,42,utRho05
494,ftnB,3973550,3973850,3973550,300,16,utRho05
495,ftsA,207122,207964,207122,842,1594,utRho05
496,ftsB,5745802,5745802,5745640,162,58,utRho05
497,ftsH,6654204,6654204,6653870,334,664,utRho05
498,ftsK,1865858,1866448,1865858,590,1668,utRho05
499,ftsL,181376,182064,181376,688,1302,utRho05
500,ftsP,6325732,6325732,6325338,394,328,utRho05
501,ftsQ,205484,206310,205484,826,792,utRho05
502,ftsX,7204512,7204512,7204172,340,476,utRho05
503,ftsZ,209272,210610,209272,1338,388,utRho05
504,fucA,5867708,5867708,5867376,332,42,utRho05
505,fucP,5868238,5868470,5868238,232,0,utRho05
506,fumA,6753760,6753760,6753508,252,1968,utRho05
507,fumB,8694696,8694696,8694652,44,4,utRho05
508,fumC,3373418,3373418,3373176,242,0,utRho05
509,fur,2842892,2842892,2842584,308,5532,utRho05
510,fusA,6947370,6947370,6947028,342,26486,utRho05
511,fxsA,8737206,8737328,8737206,122,42,utRho05
512,gabD,5581824,5582546,5581824,722,650,utRho05
513,gadA,7335214,7335214,7335160,54,0,utRho05
514,gadB,3144144,3144144,3144090,54,0,utRho05
515,gadC,3141168,3141168,3140978,190,98,utRho05
516,gadE,7315600,7316732,7315600,1132,4,utRho05
517,gadW,7329562,7329562,7329236,326,126,utRho05
518,gadX,14663356,14663356,14663240,116,0,utRho05
519,gadY,7329728,7329728,7329728,0,0,utRho05
520,galE,1584354,1584354,1584110,244,2,utRho05
521,galF,4228702,4228702,4228654,48,116,utRho05
522,galM,1577796,1577796,1577674,122,644,utRho05
523,galP,6176510,6176568,6176510,58,0,utRho05
524,galR,5953138,5953198,5953138,60,148,utRho05
525,galS,4483420,4483420,4483336,84,0,utRho05
526,galU,2582810,2582914,2582810,104,346,utRho05
527,gapA,3724480,3725542,3724480,1062,3788,utRho05
528,garP,6549868,6549868,6549814,54,2,utRho05
529,gatY,4354468,4354468,4354408,60,0,utRho05
530,gatZ,4352864,4352864,4352642,222,9488,utRho05
531,gcd,282558,282558,282450,108,0,utRho05
532,gcl,1067814,1067832,1067814,18,0,utRho05
533,gcvA,5885278,5885278,5885134,144,96,utRho05
534,gcvB,5885392,5885392,5885392,0,0,utRho05
535,gcvR,5199758,5199812,5199758,54,56,utRho05
536,gcvT,6101544,6101544,6101334,210,770,utRho05
537,gdhA,3684616,3684742,3684616,126,0,utRho05
538,gfcA,2099668,2099668,2099488,180,432,utRho05
539,gfcD,2096236,2096236,2095890,346,122,utRho05
540,ghrA,2195648,2195772,2195648,124,150,utRho05
541,ghrB,7434378,7434620,7434378,242,590,utRho05
542,glcA,6242728,6242728,6242558,170,4,utRho05
543,glcC,6256412,6256544,6256412,132,0,utRho05
544,glcD,6256152,6256152,6256042,110,0,utRho05
545,gldA,8278092,8278092,8278070,22,0,utRho05
546,glgA,7136784,7136784,7136066,718,138,utRho05
547,glgB,7147314,7147314,7147004,310,118,utRho05
548,glgC,7139142,7139142,7138656,486,190,utRho05
549,glgP,7133546,7133546,7133162,384,84,utRho05
550,glgS,6384024,6384024,6383878,146,2,utRho05
551,glgX,7142838,7142838,7142638,200,18,utRho05
552,glk,5018922,5018922,5018852,70,46,utRho05
553,glmS,7827622,7827622,7827336,286,5720,utRho05
554,glmU,7830652,7830652,7830400,252,244,utRho05
555,glmY,10765360,10765360,10765360,0,0,utRho05
556,glmZ,7972864,7972864,7972864,0,0,utRho05
557,glnA,16232888,16232888,16232136,752,880,utRho05
558,glnB,5375052,5375052,5374816,236,46,utRho05
559,glnD,377310,377310,377300,10,18,utRho05
560,glnE,6399602,6399602,6399282,320,86,utRho05
561,glnH,1696396,1696396,1696008,388,4,utRho05
562,glnK,945112,945196,945112,84,4,utRho05
563,glnL,8112742,8112742,8112678,64,40,utRho05
564,glnQ,1693262,1693262,1692926,336,254,utRho05
565,glnS,1411998,1412186,1411998,188,492,utRho05
566,gloA,3455602,3455674,3455602,72,36,utRho05
567,gloB,469852,469852,469564,288,916,utRho05
568,glpA,4705166,4705294,4705166,128,30,utRho05
569,glpD,7123942,7124026,7123942,84,46,utRho05
570,glpE,7123698,7123698,7123646,52,104,utRho05
571,glpF,8236322,8236322,8236180,142,372,utRho05
572,glpG,7122960,7122960,7122904,56,520,utRho05
573,glpR,7121782,7121782,7121210,572,312,utRho05
574,glpT,4704902,4704902,4704748,154,140,utRho05
575,glpX,8231212,8231212,8231158,54,8002,utRho05
576,glrK,5382246,5382246,5382196,50,378,utRho05
577,gltA,1509534,1509534,1508936,598,15972,utRho05
578,gltB,6709018,6709264,6709018,246,326,utRho05
579,gltI,1375792,1375792,1375494,298,2964,utRho05
580,gltP,8588536,8588962,8588536,426,1408,utRho05
581,gltS,7657382,7657382,7657330,52,212,utRho05
582,gltX,5041568,5041568,5041344,224,240,utRho05
583,gluQ,320286,320286,320224,62,22,utRho05
584,glyA,5371148,5371148,5371014,134,2,utRho05
585,glyQ,7450708,7450708,7450636,72,190,utRho05
586,glyS,7448990,7448990,7448794,196,1908,utRho05
587,glyU,5998128,5998128,5998114,14,0,utRho05
588,glyV,8784626,8784720,8784626,94,340,utRho05
589,glyW,3984360,3984360,3984234,126,36,utRho05
590,gmhB,445612,445666,445612,54,0,utRho05
591,gmk,7642776,7642856,7642776,80,62,utRho05
592,gmr,2693686,2693686,2693484,202,252,utRho05
593,gnd,4202648,4202648,4202536,112,394,utRho05
594,gnsB,3275692,3275692,3275564,128,80,utRho05
595,gntK,14310580,14310580,14310368,212,680,utRho05
596,gntP,9102668,9102668,9102592,76,0,utRho05
597,gntR,7157760,7157760,7157452,308,250,utRho05
598,gntT,7092810,7093118,7092810,308,164,utRho05
599,gntU,7154170,7154170,7154122,48,2,utRho05
600,gntX,7089334,7089764,7089334,430,28,utRho05
601,gor,7292224,7292598,7292224,374,882,utRho05
602,gpmA,1575340,1575340,1575190,150,20,utRho05
603,gpmM,7570374,7570520,7570374,146,0,utRho05
604,gpsA,7567620,7567620,7567322,298,8398,utRho05
605,gpt,511828,511954,511828,126,478,utRho05
606,grcA,5433046,5433046,5432898,148,194,utRho05
607,greA,6657728,6657728,6657430,298,2590,utRho05
608,greB,7073488,7073624,7073488,136,8,utRho05
609,groL,8741566,8742050,8741566,484,228,utRho05
610,groS,8741232,8741376,8741232,144,422,utRho05
611,grpE,5501494,5501494,5501416,78,270,utRho05
612,grxA,1781552,1781552,1781506,46,0,utRho05
613,grxB,2248206,2248206,2248108,98,90,utRho05
614,grxC,7569152,7569152,7568884,268,4164,utRho05
615,grxD,3468324,3468324,3468202,122,8324,utRho05
616,gspA,6911268,6911268,6910796,472,0,utRho05
617,gspC,6910964,6911156,6910964,192,0,utRho05
618,gss,6277220,6277220,6277044,176,104,utRho05
619,gstA,3428654,3428754,3428654,100,0,utRho05
620,gstB,1761038,1761038,1760960,78,2,utRho05
621,guaB,5268214,5268214,5268140,74,2,utRho05
622,gudD,5839026,5839026,5838770,256,66,utRho05
623,gyrA,4678914,4678914,4678840,74,114,utRho05
624,gyrB,7760300,7760300,7760238,62,150,utRho05
625,hcaE,5337964,5338064,5337964,100,14,utRho05
626,hcaR,5337928,5337928,5337792,136,26,utRho05
627,hcaT,5336106,5336106,5335692,414,126,utRho05
628,hchA,4071260,4071670,4071260,410,2,utRho05
629,hcp,1828258,1828258,1827628,630,54,utRho05
630,hcr,1824400,1824400,1824300,100,32,utRho05
631,hdeA,7313582,7313582,7313480,102,0,utRho05
632,hdeD,7313920,7313990,7313920,70,6,utRho05
633,hdfR,7896320,7896320,7895934,386,516,utRho05
634,hdhA,3396244,3396244,3396080,164,0,utRho05
635,helD,2048876,2048942,2048876,66,0,utRho05
636,hemA,2527166,2527428,2527166,262,280,utRho05
637,hemB,779722,779722,779454,268,154,utRho05
638,hemF,5106410,5106450,5106410,40,0,utRho05
639,hemH,996062,996110,996062,48,34,utRho05
640,hemL,349882,349882,349764,118,84,utRho05
641,hemN,8103886,8104090,8103886,204,30,utRho05
642,hepA,127176,127176,126528,648,2786,utRho05
643,hflD,2385372,2385372,2385262,110,948,utRho05
644,hfq,8799602,8800576,8799602,974,3632,utRho05
645,hha,961006,961006,960616,390,120,utRho05
646,hicA,3018442,3018572,3018442,130,0,utRho05
647,higA,6468682,6468682,6468288,394,4,utRho05
648,higB,6468960,6468960,6468910,50,0,utRho05
649,hinT,2323642,2323770,2323642,128,32,utRho05
650,hipB,3184964,3184964,3184884,80,0,utRho05
651,hisB,4186720,4186936,4186720,216,1100,utRho05
652,hisJ,4853674,4853674,4853576,98,0,utRho05
653,hisL,8359856,8359984,8359856,128,600,utRho05
654,hisS,5281284,5281284,5281150,134,292,utRho05
655,hlpA,400910,400964,400910,54,248,utRho05
656,hlyE,2460932,2460932,2460788,144,2,utRho05
657,hmp,5371594,5371670,5371594,76,0,utRho05
658,hns,2585916,2585916,2585844,72,1244,utRho05
659,hofM,7045856,7045856,7045502,354,0,utRho05
660,hokA,7441620,7441620,7441200,420,6060,utRho05
661,hokC,33902,33902,33806,96,258,utRho05
662,hokE,1215462,1215672,1215462,210,114,utRho05
663,holC,8968546,8968546,8968560,14,1016,utRho05
664,holD,9215562,9215606,9215562,44,0,utRho05
665,holE,3850040,3850216,3850040,176,1162,utRho05
666,hpt,282720,282862,282720,142,148,utRho05
667,hrpB,324150,324210,324150,60,80,utRho05
668,hscB,5319048,5319048,5318934,114,1792,utRho05
669,hscC,1367188,1367188,1366786,402,406,utRho05
670,hsdS,9163004,9163004,9162924,80,0,utRho05
671,hslJ,2883560,2883560,2883486,74,18,utRho05
672,hslO,7059344,7059548,7059344,204,7486,utRho05
673,hslR,7058220,7058696,7058220,476,1264,utRho05
674,hslV,8244708,8244708,8244574,134,4,utRho05
675,hsrA,7881412,7881412,7881224,188,38,utRho05
676,htgA,21286,21660,21286,374,1446,utRho05
677,htpG,989634,990240,989634,606,8070,utRho05
678,htpX,3825236,3825236,3825152,84,0,utRho05
679,htrE,311036,311036,310852,184,0,utRho05
680,htrL,7587668,7587668,7587366,302,2,utRho05
681,hupA,8400352,8400562,8400352,210,500,utRho05
682,hupB,1845220,1845804,1845220,584,724,utRho05
683,hyaA,2063968,2064278,2063968,310,0,utRho05
684,hybO,6292726,6292726,6292522,204,146,utRho05
685,hycA,5700922,5700922,5700870,52,0,utRho05
686,hycI,5686204,5686204,5686086,118,90,utRho05
687,hydN,5676264,5676264,5676210,54,0,utRho05
688,hyfA,5202342,5202402,5202342,60,54,utRho05
689,hypA,11402508,11402588,11402508,80,0,utRho05
690,hypB,11403356,11404004,11403356,648,228,utRho05
691,hypF,5676210,5676210,5674850,1360,1708,utRho05
692,hypT,9116634,9116634,9116578,56,0,utRho05
693,hyuA,6019660,6020056,6019660,396,16,utRho05
694,iaaA,1733074,1733136,1733074,62,0,utRho05
695,iadA,9119074,9119074,9119052,22,24,utRho05
696,iap,5753072,5753162,5753072,90,20,utRho05
697,ibaG,6673966,6673966,6673606,360,516,utRho05
698,ibpA,7735036,7735036,7734844,192,352,utRho05
699,ibpB,7733962,7733962,7733794,168,552,utRho05
700,icd,2389922,2390246,2389922,324,350,utRho05
701,iclR,8447304,8447304,8447256,48,86,utRho05
702,idi,6065876,6066130,6065876,254,42,utRho05
703,idnD,8988870,8988870,8988812,58,2,utRho05
704,idnK,8989194,8989246,8989194,52,6,utRho05
705,ihfA,3591442,3591442,3591104,338,1058,utRho05
706,ihfB,1927498,1927656,1927498,158,782,utRho05
707,ileS,43666,44782,43666,1116,4592,utRho05
708,ileX,6431194,6431196,6431194,2,0,utRho05
709,ilvA,15820940,15821324,15820940,384,0,utRho05
710,ilvC,7915824,7915940,7915824,116,0,utRho05
711,ilvE,15809552,15809936,15809552,384,528,utRho05
712,ilvI,170840,171260,170840,420,4,utRho05
713,ilvL,23701308,23701932,23701308,624,6,utRho05
714,ilvY,7915734,7915734,7915640,94,0,utRho05
715,inaA,4698998,4698998,4698944,54,60,utRho05
716,infA,1853370,1853370,1852886,484,4822,utRho05
717,infC,3602692,3602692,3601276,1416,6302,utRho05
718,insA-5,3958452,3958452,3958430,22,64,utRho05
719,insA-7,9036758,9037054,9036758,296,92,utRho05
720,insC-5,6372080,6372284,6372080,204,208,utRho05
721,insEF-2,785238,785238,785820,582,438,utRho05
722,insEF-4,2190310,2190310,2190892,582,462,utRho05
723,insG,9007098,9007098,9006862,236,0,utRho05
724,insH-1,550596,550596,550234,362,190,utRho05
725,insH-11,7306538,7306538,7306396,142,58,utRho05
726,insH-2,1151548,1151548,1151506,42,48,utRho05
727,insH-3,1378444,1378444,1378026,418,382,utRho05
728,insH-4,2791942,2792152,2791942,210,62,utRho05
729,insH-5,2857852,2857852,2857452,400,0,utRho05
730,insH-6,4135022,4135022,4134642,380,148,utRho05
731,insH-7,4206186,4206186,4205822,364,10378,utRho05
732,insH-9,6260050,6260356,6260050,306,36,utRho05
733,insI-3,9017372,9017372,9017234,138,46,utRho05
734,insJ,7441188,7441360,7441188,172,2652,utRho05
735,insK,7442130,7442308,7442130,178,8,utRho05
736,insL-1,30760,30890,30760,130,766,utRho05
737,insL-2,1216112,1216130,1216112,18,28,utRho05
738,insL-3,5028644,5028662,5028644,18,152,utRho05
739,insN-1,540452,540484,540452,32,0,utRho05
740,intD,1132202,1132202,1131956,246,164,utRho05
741,intR,2826520,2826520,2826470,50,0,utRho05
742,intS,4933026,4933090,4933026,64,642,utRho05
743,intZ,5117386,5117542,5117386,156,230,utRho05
744,iraD,9113152,9113986,9113152,834,82,utRho05
745,iraM,2424246,2424246,2424006,240,0,utRho05
746,iraP,802638,802772,802638,134,0,utRho05
747,iscA,5319924,5319924,5319772,152,1860,utRho05
748,iscR,5324398,5324398,5324262,136,25928,utRho05
749,iscX,5313834,5313834,5313472,362,2114,utRho05
750,ispF,5743968,5743968,5743560,408,1236,utRho05
751,ispG,5283908,5283908,5283608,300,1424,utRho05
752,ispU,389568,389806,389568,238,130,utRho05
753,isrA,2811502,2811502,2811618,116,4,utRho05
754,istr-1,7706384,7706384,7706384,0,0,utRho05
755,istr-2,7706514,7706514,7706514,0,0,utRho05
756,ivbL,15412092,15412092,15411952,140,848,utRho05
757,ivy,480638,480686,480638,48,2,utRho05
758,katE,3627628,3627734,3627628,106,2,utRho05
759,katG,8267624,8267670,8267624,46,32,utRho05
760,kbaZ,6557732,6557828,6557732,96,0,utRho05
761,kbl,7585154,7585154,7585102,52,686,utRho05
762,kch,2621046,2621046,2620538,508,0,utRho05
763,kdgR,3820506,3820506,3820198,308,44,utRho05
764,kdpE,1443788,1443788,1443466,322,38,utRho05
765,kdpF,1457698,1457698,1457642,56,0,utRho05
766,kdsA,2535708,2536330,2535708,622,4152,utRho05
767,kdsC,6683438,6684546,6683438,1108,3990,utRho05
768,kduI,5968388,5968388,5968248,140,1034,utRho05
769,kefF,94160,94492,94160,332,302,utRho05
770,kgtP,5451624,5451624,5451492,132,1006,utRho05
771,kup,7862206,7862632,7862206,426,196,utRho05
772,lacI,735076,735076,735020,56,0,utRho05
773,lacZ,1465508,1465508,1465220,288,212,utRho05
774,ldcA,2486394,2486394,2486160,234,8,utRho05
775,ldhA,2885830,2885830,2885686,144,0,utRho05
776,ldrA,2538954,2538954,2538550,404,2018,utRho05
777,ldrB,2540024,2540024,2539620,404,934,utRho05
778,ldrC,2541092,2541092,2540690,402,2078,utRho05
779,ldrD,7400544,7400544,7400174,370,2204,utRho05
780,lepA,5414392,5414392,5414248,144,144,utRho05
781,lepB,5410928,5410928,5410618,310,814,utRho05
782,leuD,159188,159188,158906,282,0,utRho05
783,leuE,3761600,3761600,3761518,82,0,utRho05
784,leuL,168048,168048,167416,632,0,utRho05
785,leuO,168308,168736,168308,428,0,utRho05
786,leuQ,9212864,9212864,9212802,62,0,utRho05
787,leuU,6644556,6644556,6644316,240,5504,utRho05
788,leuV,9212546,9212546,9212330,216,810,utRho05
789,leuX,8992772,8992810,8992772,38,12,utRho05
790,lexA,8514174,8514230,8514174,56,188,utRho05
791,lhr,3456706,3458174,3456706,1468,3076,utRho05
792,ligA,5060402,5060402,5060352,50,0,utRho05
793,ligB,7642576,7642576,7642340,236,0,utRho05
794,lipA,1320602,1320602,1320432,170,40,utRho05
795,lipB,1324802,1324802,1324556,246,2208,utRho05
796,lit,2397032,2397390,2397032,358,82,utRho05
797,livJ,7199524,7199524,7199316,208,1412,utRho05
798,livK,7195510,7195510,7195120,390,38,utRho05
799,lldP,7554578,7554798,7554578,220,2290,utRho05
800,lnt,1381968,1381968,1381762,206,510,utRho05
801,loiP,6163784,6163826,6163784,42,0,utRho05
802,lolA,1874656,1874738,1874656,82,516,utRho05
803,lolB,2527112,2527112,2527000,112,120,utRho05
804,lolC,2350748,2350854,2350748,106,0,utRho05
805,lon,917630,917776,917630,146,1228,utRho05
806,lpcA,486936,487086,486936,150,0,utRho05
807,lpd,255434,255824,255434,390,3310,utRho05
808,lplA,9248476,9248476,9248234,242,1266,utRho05
809,lplT,5947878,5947878,5947724,154,12,utRho05
810,lpoA,6586422,6586800,6586422,378,550,utRho05
811,lpp,3514592,3514842,3514592,250,164,utRho05
812,lptA,6686598,6686760,6686598,162,1114,utRho05
813,lptB,6686792,6687888,6686792,1096,1868,utRho05
814,lptD,114672,114672,114218,454,4498,utRho05
815,lptF,8972244,8972436,8972244,192,240,utRho05
816,lpxC,213016,213114,213016,98,32354,utRho05
817,lpxD,401920,401942,401920,22,156,utRho05
818,lpxL,2233418,2233418,2233164,254,110,utRho05
819,lpxM,3880456,3880456,3880386,70,254,utRho05
820,lpxP,4991156,4991290,4991156,134,956,utRho05
821,lrhA,4813312,4813312,4813282,30,78,utRho05
822,lrp,1864656,1865190,1864656,534,1114,utRho05
823,lspA,50028,50414,50028,386,1174,utRho05
824,lsrA,3202920,3202980,3202920,60,34,utRho05
825,lsrR,3202514,3202514,3202482,32,0,utRho05
826,ltaE,1818640,1818640,1818588,52,0,utRho05
827,luxS,5630130,5630130,5629466,664,3208,utRho05
828,lysA,5957902,5957902,5957798,104,0,utRho05
829,lysC,8467232,8467232,8466466,766,748,utRho05
830,lysP,4497120,4497120,4497064,56,124,utRho05
831,lysR,5957900,5958042,5957900,142,0,utRho05
832,lysT,1561028,1561108,1561028,80,202,utRho05
833,lysU,8709610,8709610,8709434,176,0,utRho05
834,macB,1840188,1840694,1840188,506,316,utRho05
835,maeA,3111484,3111484,3111338,146,2474,utRho05
836,mak,820236,820288,820236,52,0,utRho05
837,malE,8492928,8492928,8492838,90,0,utRho05
838,malI,3398456,3398456,3398360,96,0,utRho05
839,malK,8493472,8493568,8493472,96,0,utRho05
840,malP,7105020,7105020,7104946,74,278,utRho05
841,malQ,7100798,7100798,7100140,658,474,utRho05
842,malS,14949880,14949988,14949880,108,44,utRho05
843,malT,7106048,7106170,7106048,122,118,utRho05
844,malX,3398626,3398710,3398626,84,0,utRho05
845,malZ,1689980,1690072,1689980,92,2728,utRho05
846,manA,3377102,3377152,3377102,50,144,utRho05
847,manX,3803866,3804096,3803866,230,2,utRho05
848,marC,3237882,3237882,3237816,66,176,utRho05
849,marR,3238186,3238240,3238186,54,0,utRho05
850,matP,2036918,2036970,2036918,52,56,utRho05
851,mazE,5822736,5822736,5822678,58,34,utRho05
852,mazG,5821720,5821720,5821370,350,4722,utRho05
853,mcbA,1684306,1684306,1684112,194,0,utRho05
854,mcbR,3040192,3040524,3040192,332,0,utRho05
855,mcrA,2420278,2420692,2420278,414,0,utRho05
856,mcrC,9156124,9156124,9155916,208,182,utRho05
857,mdaB,6344814,6345060,6344814,246,72,utRho05
858,mdfA,1767138,1767346,1767138,208,2,utRho05
859,mdh,6768940,6768940,6768536,404,118,utRho05
860,mdoB,9198988,9198988,9198882,106,518,utRho05
861,mdoD,2993290,2993712,2993290,422,0,utRho05
862,mdoG,2218514,2218670,2218514,156,170,utRho05
863,mdtA,4307958,4308032,4307958,74,76,utRho05
864,mdtE,7318168,7318464,7318168,296,64,utRho05
865,mdtK,3486538,3486914,3486538,376,312,utRho05
866,mdtP,8602472,8602472,8602060,412,4,utRho05
867,melA,8683774,8683822,8683774,48,0,utRho05
868,melR,8683300,8683300,8683256,44,30,utRho05
869,menA,8240812,8240812,8240698,114,34,utRho05
870,menB,4753774,4753774,4753638,136,246,utRho05
871,mepH,3468714,3468870,3468714,156,36,utRho05
872,mepM,3883666,3883666,3883270,396,614,utRho05
873,mepS,4539840,4539958,4539840,118,1166,utRho05
874,metA,8428318,8428560,8428318,242,350,utRho05
875,metB,8257272,8257344,8257272,72,536,utRho05
876,metC,6304150,6304472,6304150,322,174,utRho05
877,metE,8025768,8026106,8025768,338,28,utRho05
878,metF,8265092,8265232,8265092,140,70,utRho05
879,metG,4388538,4388600,4388538,62,102,utRho05
880,metH,8447010,8447656,8447010,646,9926,utRho05
881,metJ,8257116,8257116,8256790,326,2,utRho05
882,metK,6173154,6173412,6173154,258,284,utRho05
883,metN,445428,445428,445290,138,0,utRho05
884,metR,8025710,8025710,8025632,78,0,utRho05
885,metT,1394326,1394326,1394266,60,174,utRho05
886,metY,19910250,19910250,19909734,516,8304,utRho05
887,metZ,11789528,11789548,11789528,20,0,utRho05
888,mfd,2348056,2348056,2347928,128,202,utRho05
889,mglA,4478782,4478782,4478578,204,300,utRho05
890,mglB,4481132,4481132,4480696,436,4196,utRho05
891,mglC,4475918,4475918,4475506,412,166,utRho05
892,mgrB,3817584,3817584,3817532,52,0,utRho05
893,mgrR,3245828,3245828,3245828,0,0,utRho05
894,mgsA,2054082,2054082,2054030,52,40,utRho05
895,mgtL,8934560,8934862,8934560,302,134,utRho05
896,mhpA,737038,737222,737038,184,0,utRho05
897,mhpR,737072,737072,736840,232,0,utRho05
898,mhpT,750772,750918,750772,146,0,utRho05
899,miaA,8797964,8798504,8797964,540,1050,utRho05
900,micA,5629604,5629604,5629604,0,0,utRho05
901,micC,2874242,2874238,2874242,4,0,utRho05
902,micF,4626168,4626168,4626168,0,0,utRho05
903,micM,1014408,1014408,1014408,0,0,utRho05
904,minE,2449422,2449422,2449090,332,628,utRho05
905,mioC,7852950,7852950,7852910,40,76,utRho05
906,mipA,3733012,3733012,3732944,68,4306,utRho05
907,mlaA,4930270,4930270,4930014,256,20,utRho05
908,mlc,3337206,3337206,3337128,78,0,utRho05
909,mlrA,4429498,4429732,4429498,234,0,utRho05
910,mltA,5894546,5894546,5894356,190,0,utRho05
911,mltD,468050,468050,467910,140,2,utRho05
912,mltF,5391534,5391602,5391534,68,0,utRho05
913,mmuP,550238,550650,550238,412,198,utRho05
914,mngA,1531622,1531968,1531622,346,142,utRho05
915,mngR,1531852,1531852,1531750,102,46,utRho05
916,mnmG,7851348,7851348,7851266,82,7314,utRho05
917,mntH,5025470,5025470,5025412,58,46,utRho05
918,mntP,3810918,3811376,3810918,458,928,utRho05
919,mntR,1706160,1706366,1706160,206,0,utRho05
920,mntS,1706128,1706128,1705994,134,68,utRho05
921,moaA,1633654,1634088,1633654,434,1384,utRho05
922,moaB,1635954,1636110,1635954,156,734,utRho05
923,mobA,8084242,8084242,8083998,244,442,utRho05
924,mocA,6030112,6030320,6030112,208,28,utRho05
925,modA,1589990,1590178,1589990,188,276,utRho05
926,moeA,1732788,1732788,1732728,60,96,utRho05
927,mokB,2984610,2984610,2984258,352,770,utRho05
928,molR_1,4392888,4392948,4392888,60,244,utRho05
929,motA,3954604,3954604,3954278,326,56,utRho05
930,mpaA,2781278,2781278,2781196,82,190,utRho05
931,mpl,8911456,8911570,8911456,114,0,utRho05
932,mppA,2786108,2786454,2786108,346,0,utRho05
933,mprA,5621494,5621540,5621494,46,272,utRho05
934,mqo,4613848,4613848,4613508,340,376,utRho05
935,mqsA,6336742,6336742,6336492,250,76,utRho05
936,mqsR,6337306,6337306,6337088,218,358,utRho05
937,mraZ,179192,179268,179192,76,44,utRho05
938,mrcA,7045652,7045742,7045652,90,0,utRho05
939,mrcB,329442,329460,329442,18,0,utRho05
940,mreB,13605424,13605424,13604348,1076,2508,utRho05
941,mreD,6798166,6798166,6797750,416,446,utRho05
942,mrp,4388360,4388360,4388336,24,16,utRho05
943,mscK,972984,973072,972984,88,36,utRho05
944,mscL,6876002,6876048,6876002,46,316,utRho05
945,mscS,6139742,6139742,6139614,128,24,utRho05
946,msrA,8884522,8884522,8884352,170,138,utRho05
947,msrB,3725168,3725168,3724858,310,56,utRho05
948,msyB,2228426,2228426,2228362,64,308,utRho05
949,mtfA,4087236,4087302,4087236,66,754,utRho05
950,mtgA,6699662,6699662,6699618,44,304,utRho05
951,mtlA,30177504,30178248,30177504,744,672,utRho05
952,mtn,358366,358366,358306,60,28,utRho05
953,mtr,6611864,6611864,6611634,230,116,utRho05
954,mug,6430992,6430992,6430946,46,106,utRho05
955,murQ,5091466,5091546,5091466,80,0,utRho05
956,murR,5091586,5091586,5091218,368,68,utRho05
957,mutH,5939164,5939324,5939164,160,790,utRho05
958,mutL,8794092,8794824,8794092,732,1640,utRho05
959,mutM,7622554,7622554,7622304,250,1272,utRho05
960,mutS,5714038,5714186,5714038,148,706,utRho05
961,mutY,18617466,18618078,18617466,612,102,utRho05
962,nac,4123956,4123956,4123866,90,44,utRho05
963,nadA,1564122,1564170,1564122,48,2,utRho05
964,nadB,5420714,5420840,5420714,126,28,utRho05
965,nadC,237326,237326,237290,36,18,utRho05
966,nadE,3644604,3644916,3644604,312,30,utRho05
967,nadK,5501526,5501662,5501526,136,84,utRho05
968,nagA,1406350,1406350,1405502,848,1864,utRho05
969,nagB,1407416,1407416,1407222,194,0,utRho05
970,nagC,1404016,1404016,1403188,828,106,utRho05
971,nagE,1407680,1407888,1407680,208,0,utRho05
972,nagK,2357080,2357186,2357080,106,182,utRho05
973,nanA,6747240,6747240,6747152,88,92,utRho05
974,nanC,9079856,9079856,9079002,854,2,utRho05
975,nanR,6749406,6749406,6748978,428,214,utRho05
976,nanS,9075406,9075406,9075188,218,2,utRho05
977,napF,4607390,4607390,4606994,396,4,utRho05
978,narG,2559614,2559728,2559614,114,16,utRho05
979,narK,2555642,2555914,2555642,272,0,utRho05
980,narP,4580844,4581000,4580844,156,0,utRho05
981,narQ,5171154,5171462,5171154,308,84,utRho05
982,narU,3088326,3088326,3088120,206,0,utRho05
983,narW,3077374,3077374,3074618,2756,8,utRho05
984,narX,2555554,2555554,2555236,318,0,utRho05
985,narZ,3085380,3085380,3085180,200,0,utRho05
986,ndh,2331984,2332170,2331984,186,48,utRho05
987,ndk,5289920,5289920,5289728,192,456,utRho05
988,nemR,6904084,6904092,6904084,8,8,utRho05
989,nepI,7683542,7683542,7683478,64,332,utRho05
990,nfo,4501612,4501680,4501612,68,76,utRho05
991,nfsB,1210906,1210906,1210848,58,6,utRho05
992,nfuA,7090916,7091248,7090916,332,758,utRho05
993,nhaA,34634,34978,34634,344,2,utRho05
994,nhaB,2469534,2469534,2469434,100,50,utRho05
995,nhoA,3067926,3068048,3067926,122,0,utRho05
996,nikA,7226878,7227334,7226878,456,3076,utRho05
997,nikR,7237074,7237176,7237074,102,58,utRho05
998,nirB,6987974,6988022,6987974,48,0,utRho05
999,nlpA,7680034,7680034,7679986,48,0,utRho05
1000,nlpC,3585654,3585654,3585462,192,22,utRho05
1001,nlpD,5737658,5737658,5737506,152,66,utRho05
1002,nlpI,6618080,6618080,6617848,232,32,utRho05
1003,nmpC,1153740,1153740,1153650,90,0,utRho05
1004,nohA,3273206,3273206,3272734,472,14,utRho05
1005,norR,5664614,5664614,5664578,36,50,utRho05
1006,norV,5664878,5664952,5664878,74,0,utRho05
1007,nrdA,4689510,4689730,4689510,220,10246,utRho05
1008,nrdD,8925676,8925676,8925320,356,3658,utRho05
1009,nrdH,5601312,5601446,5601312,134,484,utRho05
1010,nrdR,865954,866004,865954,50,20,utRho05
1011,nrfA,8575342,8575528,8575342,186,62,utRho05
1012,nsrR,8812088,8812380,8812088,292,59478,utRho05
1013,nudB,3897348,3897348,3897264,84,0,utRho05
1014,nudC,8393428,8393806,8393428,378,62,utRho05
1015,nudE,7052658,7052658,7052298,360,5352,utRho05
1016,nudG,3682876,3682980,3682876,104,0,utRho05
1017,nudI,4729050,4729108,4729050,58,0,utRho05
1018,nudJ,2388874,2388874,2388576,298,1326,utRho05
1019,nuoA,4810670,4810670,4810144,526,3758,utRho05
1020,nuoN,4783434,4783434,4783010,424,1940,utRho05
1021,nupC,5026018,5026084,5026018,66,60,utRho05
1022,nupG,6211302,6211428,6211302,126,48,utRho05
1023,ogrK,4335096,4335096,4335040,56,0,utRho05
1024,ogt,2800568,2800568,2800472,96,94,utRho05
1025,ohsC,5401036,5401040,5401036,4,0,utRho05
1026,ompA,2040382,2040382,2040106,276,16802,utRho05
1027,ompC,4625774,4625774,4625498,276,116,utRho05
1028,ompF,1974184,1974184,1973964,220,146,utRho05
1029,ompL,8128958,8128958,8128590,368,0,utRho05
1030,ompN,2874158,2874158,2873786,372,0,utRho05
1031,ompR,7073510,7073510,7073168,342,92,utRho05
1032,ompT,1171330,1171330,1171266,64,98,utRho05
1033,ompW,2627982,2628040,2627982,58,0,utRho05
1034,ompX,1700418,1700900,1700418,482,738,utRho05
1035,omrA,5952378,5952378,5952378,0,0,utRho05
1036,omrB,5952770,5952770,5952770,0,0,utRho05
1037,oppA,2602170,2602364,2602170,194,21526,utRho05
1038,orn,8783168,8783208,8783168,40,4,utRho05
1039,osmB,2686952,2686952,2686656,296,240,utRho05
1040,osmC,3113192,3113250,3113192,58,38,utRho05
1041,osmE,3644566,3644566,3644512,54,36,utRho05
1042,osmF,4439046,4439046,4438962,84,754,utRho05
1043,osmY,9222306,9222792,9222306,486,178,utRho05
1044,otsA,3963302,3963302,3963224,78,0,utRho05
1045,otsB,3964930,3964930,3964774,156,96,utRho05
1046,oxc,4984288,4984288,4983900,388,0,utRho05
1047,oxyR,8316914,8316980,8316914,66,6,utRho05
1048,oxyS,8316788,8316788,8316788,0,0,utRho05
1049,paaA,2907730,2907854,2907730,124,70,utRho05
1050,paaX,2927018,2927078,2927018,60,0,utRho05
1051,paaZ,2907340,2907340,2907284,56,0,utRho05
1052,pabA,6981702,6981702,6981658,44,0,utRho05
1053,pabB,3789256,3789610,3789256,354,120,utRho05
1054,pabC,2306186,2306600,2306186,414,298,utRho05
1055,pagP,1313052,1313114,1313052,62,0,utRho05
1056,panB,299260,299260,299202,58,112,utRho05
1057,panC,297840,297840,297590,250,350,utRho05
1058,panD,293490,293490,293388,102,4,utRho05
1059,panZ,7195656,7195968,7195656,312,12,utRho05
1060,parC,6332060,6332060,6331946,114,220,utRho05
1061,patA,6438916,6438988,6438916,72,104,utRho05
1062,patD,3030830,3031156,3030830,326,0,utRho05
1063,pbpC,5294986,5294986,5294650,336,0,utRho05
1064,pbpG,4450132,4450132,4449740,392,116,utRho05
1065,pck,7065358,7065636,7065358,278,3116,utRho05
1066,pcnB,318782,318782,318252,530,1332,utRho05
1067,pdhR,244068,244184,244068,116,136,utRho05
1068,pdxB,4875768,4875768,4875702,66,0,utRho05
1069,pdxH,3436068,3436068,3436014,54,452,utRho05
1070,pdxJ,5403626,5403626,5403458,168,2,utRho05
1071,pdxK,5074638,5074638,5074474,164,72,utRho05
1072,pepA,8972278,8972278,8971902,376,254,utRho05
1073,pepD,511618,511618,511432,186,3474,utRho05
1074,pepN,1981182,1981244,1981182,62,118,utRho05
1075,pepQ,8062294,8062322,8062294,28,0,utRho05
1076,pepT,2371646,2371688,2371646,42,0,utRho05
1077,pfkA,8214948,8215104,8214948,156,310,utRho05
1078,pfkB,3612646,3612740,3612646,94,0,utRho05
1079,pflA,1902456,1902456,1902160,296,80,utRho05
1080,pflB,1907850,1907850,1907108,742,848,utRho05
1081,pflD,8287716,8287990,8287716,274,0,utRho05
1082,pgaA,2185046,2185046,2184578,468,64,utRho05
1083,pgi,8467444,8467516,8467444,72,10,utRho05
1084,pgk,12291428,12291428,12290488,940,4488,utRho05
1085,pgl,1597078,1597172,1597078,94,100,utRho05
1086,pgpB,2678324,2678660,2678324,336,0,utRho05
1087,pgpC,5397276,5397276,5397100,176,0,utRho05
1088,pgrR,2783744,2783982,2783744,238,68,utRho05
1089,pheL,5475158,5475198,5475158,40,0,utRho05
1090,pheM,7197204,7197204,7197080,124,8,utRho05
1091,pheP,1203858,1203918,1203858,60,70,utRho05
1092,pheU,8725254,8725254,8725252,2,0,utRho05
1093,pheV,6220730,6220732,6220730,2,60,utRho05
1094,phnC,8650412,8650412,8650330,82,4,utRho05
1095,phoA,803414,803494,803414,80,0,utRho05
1096,phoB,834202,834284,834202,82,42,utRho05
1097,phoE,520316,520316,520200,116,0,utRho05
1098,phoH,2169730,2169984,2169730,254,508,utRho05
1099,phoP,2381016,2381016,2380894,122,1878,utRho05
1100,phoQ,2379880,2379880,2379552,328,630,utRho05
1101,phoU,7815330,7815330,7815156,174,0,utRho05
1102,phr,1478842,1479014,1478842,172,0,utRho05
1103,pinE,2419054,2419370,2419054,316,20,utRho05
1104,pinQ,3267168,3267244,3267168,76,636,utRho05
1105,pinR,2867424,2867424,2867348,76,696,utRho05
1106,pitA,7275224,7275284,7275224,60,4,utRho05
1107,pitB,6272806,6272806,6272742,64,88,utRho05
1108,pka,5439862,5439906,5439862,44,0,utRho05
1109,plaP,4174476,4174476,4174124,352,770,utRho05
1110,pldA,8009628,8009724,8009628,96,128,utRho05
1111,pldB,8018028,8018340,8018028,312,502,utRho05
1112,plsB,8513196,8513196,8512932,264,112,utRho05
1113,pmbA,8915890,8915918,8915890,28,0,utRho05
1114,pmrD,4747148,4747148,4747076,72,110,utRho05
1115,pncB,1980828,1980828,1980712,116,48,utRho05
1116,pncC,5648788,5648788,5648692,96,0,utRho05
1117,pnp,6622652,6622652,6622336,316,44,utRho05
1118,pntA,3355950,3355950,3355806,144,0,utRho05
1119,pntB,3353096,3353096,3352720,376,0,utRho05
1120,polA,8093880,8093932,8093880,52,0,utRho05
1121,polB,131606,131606,131560,46,0,utRho05
1122,potD,2365700,2365700,2365658,42,98,utRho05
1123,potE,1436688,1436688,1436530,158,2,utRho05
1124,potF,1787268,1787568,1787268,300,4,utRho05
1125,poxB,1822152,1822152,1822098,54,0,utRho05
1126,ppa,8899372,8899372,8899304,68,328,utRho05
1127,ppc,8306380,8306380,8306196,184,658,utRho05
1128,ppdA,5928440,5928440,5928354,86,1200,utRho05
1129,ppdD,235410,235410,235098,312,438,utRho05
1130,pphA,3846770,3846770,3845938,832,1942,utRho05
1131,pphB,5719474,5719520,5719474,46,0,utRho05
1132,ppiA,6984898,6984898,6984594,304,74,utRho05
1133,ppiC,7919682,7919682,7919626,56,278,utRho05
1134,ppiD,923638,923830,923638,192,1188,utRho05
1135,ppk,5245748,5246088,5245748,340,216,utRho05
1136,pppA,6228958,6228958,6228704,254,0,utRho05
1137,ppsA,3574322,3574322,3574224,98,0,utRho05
1138,ppsR,3574678,3574890,3574678,212,0,utRho05
1139,pptA,3065716,3066104,3065716,388,8,utRho05
1140,pqiA,2023318,2024002,2023318,684,76,utRho05
1141,prc,3830054,3830054,3829632,422,24812,utRho05
1142,preT,4467978,4468066,4467978,88,36,utRho05
1143,prfC,9218688,9218828,9218688,140,1230,utRho05
1144,prkB,6968622,6968980,6968622,358,1452,utRho05
1145,prlC,7290476,7290476,7290364,112,64,utRho05
1146,prlF,6553944,6554004,6553944,60,190,utRho05
1147,proB,520432,520776,520432,344,16,utRho05
1148,proC,811372,811372,811288,84,0,utRho05
1149,proK,7417388,7417388,7417384,4,170,utRho05
1150,proL,4572414,4572422,4572414,8,0,utRho05
1151,proP,8660640,8661004,8660640,364,4422,utRho05
1152,proS,437674,437674,437550,124,424,utRho05
1153,proV,5609126,5609630,5609126,504,166,utRho05
1154,prpB,697292,697364,697292,72,0,utRho05
1155,prpR,696942,696942,696886,56,0,utRho05
1156,prs,2524354,2524354,2523750,604,60526,utRho05
1157,psd,8781276,8781276,8780720,556,4236,utRho05
1158,psiE,8480600,8480650,8480600,50,0,utRho05
1159,pspA,2736076,2736158,2736076,82,0,utRho05
1160,pspF,2736080,2736080,2735824,256,0,utRho05
1161,pspG,8525632,8525680,8525632,48,46,utRho05
1162,pssA,5445156,5445454,5445156,298,3048,utRho05
1163,pstB,7817112,7817112,7816732,380,124,utRho05
1164,pstC,7821084,7821084,7820796,288,0,utRho05
1165,pstS,23469408,23469408,23469150,258,204,utRho05
1166,psuG,4517114,4517114,4516734,380,72,utRho05
1167,psuT,4514992,4514992,4514670,322,0,utRho05
1168,pth,2517084,2517084,2517026,58,12,utRho05
1169,ptrA,5918022,5918022,5917768,254,0,utRho05
1170,ptrB,3857730,3857730,3857678,52,6646,utRho05
1171,ptsG,2315252,2315738,2315252,486,2630,utRho05
1172,ptsH,5066996,5067528,5066996,532,2286,utRho05
1173,purA,8809328,8809374,8809328,46,0,utRho05
1174,purC,5195562,5195562,5195236,326,0,utRho05
1175,purD,8411972,8411972,8411862,110,70,utRho05
1176,purE,1106284,1106284,1106200,84,1372,utRho05
1177,purH,8415254,8415254,8415064,190,48,utRho05
1178,purL,5391178,5391178,5391086,92,374,utRho05
1179,purM,5242306,5242394,5242306,88,0,utRho05
1180,purR,3475378,3475688,3475378,310,818,utRho05
1181,purT,3861438,3861762,3861438,324,20,utRho05
1182,purU,2577512,2577512,2577248,264,996,utRho05
1183,putA,2157850,2157850,2157764,86,0,utRho05
1184,putP,2158336,2158610,2158336,274,450,utRho05
1185,puuA,2721936,2721936,2721816,120,0,utRho05
1186,puuC,2725456,2725486,2725456,30,0,utRho05
1187,puuD,2722104,2722240,2722104,136,66,utRho05
1188,puuP,2718746,2718746,2718374,372,1632,utRho05
1189,pykA,3874988,3875298,3874988,310,82,utRho05
1190,pykF,3510934,3511396,3510934,462,1442,utRho05
1191,pyrC,2245286,2245286,2245214,72,138,utRho05
1192,pyrD,2009464,2009536,2009464,72,32,utRho05
1193,pyrE,7631970,7631970,7631536,434,120,utRho05
1194,pyrF,2683740,2683842,2683740,102,304,utRho05
1195,pyrG,5819594,5819594,5819332,262,2216,utRho05
1196,pyrH,383624,383710,383624,86,2394,utRho05
1197,pyrL,8945490,8945490,8945066,424,80,utRho05
1198,qmcA,1031646,1031646,1031546,100,134,utRho05
1199,qor,8528608,8528608,8528462,146,200,utRho05
1200,qseB,6339502,6339656,6339502,154,56,utRho05
1201,queA,849970,850022,849970,52,546,utRho05
1202,queE,5811212,5811212,5810836,376,0,utRho05
1203,queF,5850642,5850696,5850642,54,52,utRho05
1204,queG,8788184,8788184,8788134,50,928,utRho05
1205,racC,2835630,2835630,2835526,104,0,utRho05
1206,racR,2840898,2840898,2840482,416,0,utRho05
1207,raiA,5474208,5474308,5474208,100,120,utRho05
1208,rarD,8008594,8008594,8008356,238,446,utRho05
1209,ravA,7862256,7862256,7862186,70,62,utRho05
1210,rayT,495088,495274,495088,186,40,utRho05
1211,rbn,4763162,4763216,4763162,54,0,utRho05
1212,rbsD,7866644,7866702,7866644,58,14,utRho05
1213,rcnA,4371654,4371834,4371654,180,2,utRho05
1214,rcnB,4373768,4373920,4373768,152,120,utRho05
1215,rcnR,4371806,4371806,4371592,214,2,utRho05
1216,rcsA,4047672,4047936,4047672,264,196,utRho05
1217,rcsB,4631390,4632354,4631390,964,1238,utRho05
1218,rcsC,4640162,4640162,4639656,506,140,utRho05
1219,rcsD,4626904,4626976,4626904,72,420,utRho05
1220,rdgB,6193240,6193362,6193240,122,320,utRho05
1221,rdlA,2538646,2538646,2538646,0,0,utRho05
1222,rdlB,2539712,2539716,2539712,4,0,utRho05
1223,rdlC,2540782,2540786,2540782,4,0,utRho05
1224,rdlD,7400272,7400272,7400272,0,0,utRho05
1225,rdoA,8084782,8084830,8084782,48,270,utRho05
1226,recA,11295276,11295276,11295076,200,1260,utRho05
1227,recC,5925014,5925014,5924856,158,76,utRho05
1228,recF,7763722,7763722,7762442,1280,9848,utRho05
1229,recN,5503518,5503590,5503518,72,0,utRho05
1230,recQ,8011666,8011728,8011666,62,0,utRho05
1231,relA,5828554,5828554,5827302,1252,508,utRho05
1232,relB,3291806,3291806,3291744,62,68,utRho05
1233,rem,3289950,3289950,3289804,146,16,utRho05
1234,rep,7921294,7921354,7921294,60,0,utRho05
1235,rfaD,7587730,7587974,7587730,244,356,utRho05
1236,rfaE,6393852,6393852,6393506,346,0,utRho05
1237,rfaH,8049930,8049930,8049642,288,2144,utRho05
1238,rfbX,4219436,4219436,4219168,268,3048,utRho05
1239,rfe,7935600,7935832,7935600,232,118,utRho05
1240,rhaB,8194944,8194944,8194896,48,0,utRho05
1241,rhaD,8188770,8188770,8188544,226,0,utRho05
1242,rhaS,8195422,8195472,8195422,50,0,utRho05
1243,rhaT,8201132,8201132,8201050,82,0,utRho05
1244,rhlE,1661566,1661744,1661566,178,588,utRho05
1245,rhoL,47593944,47594772,47593944,828,310944,utRho05
1246,rhsB,7238006,7238384,7238006,378,154,utRho05
1247,rhsC,1458758,1459166,1458758,408,2,utRho05
1248,rhsD,1046132,1046522,1046132,390,0,utRho05
1249,rhtA,1700608,1700608,1700194,414,44,utRho05
1250,rhtC,8015478,8015514,8015478,36,2888,utRho05
1251,ribA,2678468,2678468,2678320,148,0,utRho05
1252,ribC,3486916,3486916,3486484,432,328,utRho05
1253,ribE,869008,869294,869008,286,9866,utRho05
1254,ribF,42766,42814,42766,48,0,utRho05
1255,ridA,8941892,8941892,8941826,66,42,utRho05
1256,rihA,1369204,1369204,1368824,380,1286,utRho05
1257,rihB,4510504,4510504,4510372,132,0,utRho05
1258,rimJ,2251044,2251124,2251044,80,0,utRho05
1259,rimK,1783752,1783934,1783752,182,318,utRho05
1260,rimL,2997486,2997876,2997486,390,2,utRho05
1261,rimO,1756140,1756140,1756070,70,34,utRho05
1262,rimP,6636350,6636350,6636012,338,880,utRho05
1263,rlmA,3814172,3814172,3814120,52,346,utRho05
1264,rlmD,5830086,5830086,5830000,86,8,utRho05
1265,rlmE,6655520,6655520,6655328,192,2848,utRho05
1266,rlmF,1684384,1684664,1684384,280,0,utRho05
1267,rlmG,6471784,6471784,6471750,34,104,utRho05
1268,rlmI,2060002,2060002,2059938,64,88,utRho05
1269,rlmJ,7290700,7290770,7290700,70,234,utRho05
1270,rlmL,2015344,2015688,2015344,344,2272,utRho05
1271,rlpA,1330444,1330444,1330380,64,252,utRho05
1272,rluA,120900,120900,120692,208,146,utRho05
1273,rluF,8460324,8460708,8460324,384,0,utRho05
1274,rmf,2031006,2031430,2031006,424,1326,utRho05
1275,rna,1290068,1290068,1290006,62,8,utRho05
1276,rnb,2698258,2698258,2697824,434,2246,utRho05
1277,rnc,10816892,10816892,10816252,640,16364,utRho05
1278,rnd,3776122,3776122,3775982,140,302,utRho05
1279,rne,2289746,2289746,2288734,1012,10984,utRho05
1280,rnhA,472082,472082,472004,78,510,utRho05
1281,rnk,1288360,1288360,1287934,426,124,utRho05
1282,rnlA,5531788,5531836,5531788,48,98,utRho05
1283,rnlB,5533414,5533968,5533414,554,2986,utRho05
1284,rnpB,19623552,19623552,19623552,0,0,utRho05
1285,rob,9270706,9270706,9270620,86,82,utRho05
1286,rodZ,5285868,5285868,5285688,180,122,utRho05
1287,rpe,7030306,7030306,7030118,188,236,utRho05
1288,rph,15266320,15266320,15266196,124,108,utRho05
1289,rpiA,6118706,6118706,6118650,56,2,utRho05
1290,rpiB,8626514,8626700,8626514,186,18,utRho05
1291,rpiR,8626274,8626274,8625982,292,0,utRho05
1292,rplJ,8359246,8359992,8359246,746,10764,utRho05
1293,rplK,8356708,8356894,8356708,186,618,utRho05
1294,rplM,6757344,6757344,6757302,42,6720,utRho05
1295,rplN,6896444,6896444,6896298,146,11134,utRho05
1296,rplS,5489284,5489284,5489060,224,16008,utRho05
1297,rplT,7199052,7199052,7198996,56,1540,utRho05
1298,rplU,6667036,6667036,6666902,134,62,utRho05
1299,rplY,4564866,4565034,4564866,168,154,utRho05
1300,rpmA,6666450,6666450,6666238,212,1696,utRho05
1301,rpmB,15247980,15247980,15246696,1284,130804,utRho05
1302,rpmE,8253816,8254026,8253816,210,1298,utRho05
1303,rpmF,2294676,2294734,2294676,58,67738,utRho05
1304,rpmH,7768130,7768672,7768130,542,7962,utRho05
1305,rpmI,3600854,3600854,3599998,856,13350,utRho05
1306,rpoB,8362126,8362490,8362126,364,668,utRho05
1307,rpoD,6424946,6426094,6424946,1148,24166,utRho05
1308,rpoE,5420372,5420372,5420024,348,184,utRho05
1309,rpoH,7202006,7202006,7201566,440,22294,utRho05
1310,rpoN,6689324,6689434,6689324,110,46,utRho05
1311,rpoS,5736236,5736236,5735102,1134,3696,utRho05
1312,rpoZ,7644154,7644212,7644154,58,814,utRho05
1313,rppH,5937986,5937986,5937954,32,0,utRho05
1314,rprA,3540744,3540744,3540744,0,0,utRho05
1315,rpsA,1923434,1923990,1923434,556,206608,utRho05
1316,rpsF,8850050,8850236,8850050,186,41378,utRho05
1317,rpsI,6756580,6756580,6756414,166,12180,utRho05
1318,rpsJ,6906884,6906884,6906540,344,11082,utRho05
1319,rpsL,6949242,6949242,6949104,138,616,utRho05
1320,rpsM,6885130,6885130,6884942,188,1860,utRho05
1321,rpsO,13247144,13247144,13246736,408,2580,utRho05
1322,rpsP,5492508,5492508,5492370,138,298,utRho05
1323,rpsT,42420,42420,42156,264,636,utRho05
1324,rpsU,12842584,12843124,12842584,540,3092,utRho05
1325,rraA,8238716,8238716,8238660,56,332,utRho05
1326,rraB,8956768,8956946,8956768,178,0,utRho05
1327,rrsA,8070478,8071062,8070478,584,9668,utRho05
1328,rrsB,16665468,16666636,16665468,1168,20828,utRho05
1329,rrsC,7883032,7883616,7883032,584,10314,utRho05
1330,rrsD,6858094,6858094,6857524,570,600,utRho05
1331,rrsE,8415726,8416294,8415726,568,1852,utRho05
1332,rrsG,5462896,5462896,5462314,582,7878,utRho05
1333,rrsH,446970,447542,446970,572,2294,utRho05
1334,rsd,8393908,8393908,8393616,292,148,utRho05
1335,rseA,5419264,5419264,5418808,456,884,utRho05
1336,rseP,392940,393092,392940,152,36,utRho05
1337,rseX,4067298,4067298,4067298,0,0,utRho05
1338,rsfS,1338144,1338144,1338072,72,352,utRho05
1339,rsgA,8783132,8783132,8783018,114,24,utRho05
1340,rsmA,105176,105176,104860,316,5390,utRho05
1341,rsmB,6869982,6870414,6869982,432,442,utRho05
1342,rsmC,9215736,9215736,9215400,336,664,utRho05
1343,rsmD,7208594,7208786,7208594,192,2,utRho05
1344,rsmE,6182036,6182268,6182036,232,346,utRho05
1345,rsmG,7847512,7847512,7847360,152,1694,utRho05
1346,rsmH,180020,180188,180020,168,248,utRho05
1347,rsmI,6587106,6587106,6586670,436,1242,utRho05
1348,rssA,2578212,2578412,2578212,200,486,utRho05
1349,rssB,2580440,2580484,2580440,44,136,utRho05
1350,rstA,3364276,3364300,3364276,24,0,utRho05
1351,rsuA,4561096,4561096,4560966,130,334,utRho05
1352,rsxA,3411510,3411534,3411510,24,110,utRho05
1353,rtcA,7114004,7114004,7113698,306,84,utRho05
1354,rtcB,7116214,7116214,7116158,56,0,utRho05
1355,rtn,4541356,4541452,4541356,96,132,utRho05
1356,rutA,2148052,2148052,2148022,30,0,utRho05
1357,rutG,2140090,2140090,2139678,412,0,utRho05
1358,rutR,2148226,2148484,2148226,258,0,utRho05
1359,ruvA,7784096,7784096,7783904,192,36,utRho05
1360,ruvB,7782176,7782176,7781424,752,552,utRho05
1361,ruvC,3894878,3894878,3894752,126,42,utRho05
1362,rybB,1776114,1776114,1776114,0,0,utRho05
1363,rydB,3529860,3529860,3529322,538,126,utRho05
1364,rydC,2983012,2983012,2983012,0,0,utRho05
1365,ryfA,5307398,5307710,5307398,312,42,utRho05
1366,ryfD,5468590,5468590,5468590,0,0,utRho05
1367,ryhB,7162032,7162032,7162032,0,0,utRho05
1368,ryjA,8556132,8556132,8556132,0,0,utRho05
1369,ryjB,9055954,9055954,9055954,0,0,utRho05
1370,sad,3229598,3229598,3229406,192,372,utRho05
1371,safA,3168056,3168056,3167918,138,0,utRho05
1372,sanA,4465368,4465756,4465368,388,260,utRho05
1373,sapF,2705314,2705314,2705268,46,112,utRho05
1374,sbcB,4165456,4165512,4165456,56,0,utRho05
1375,sbcC,831694,831694,831506,188,240,utRho05
1376,sbcD,833954,833954,833904,50,104,utRho05
1377,sbmA,793106,793278,793106,172,8,utRho05
1378,sbmC,4162650,4162650,4162524,126,0,utRho05
1379,sdaA,3793618,3793864,3793618,246,234,utRho05
1380,sdaC,5856070,5856458,5856070,388,1212,utRho05
1381,sdhC,1509916,1510354,1509916,438,35226,utRho05
1382,sdhD,1510808,1511120,1510808,312,6072,utRho05
1383,sdiA,3993834,3993834,3993664,170,66,utRho05
1384,secE,8354354,8354716,8354354,362,318,utRho05
1385,secG,6645180,6645180,6645010,170,2172,utRho05
1386,selA,7522594,7522594,7522498,96,642,utRho05
1387,selB,7519850,7519850,7519722,128,106,utRho05
1388,selC,7672396,7672444,7672396,48,0,utRho05
1389,selD,3696058,3696058,3696016,42,4010,utRho05
1390,seqA,1425884,1425974,1425884,90,628,utRho05
1391,serA,6117098,6117098,6116820,278,186,utRho05
1392,serB,9249712,9249790,9249712,78,12,utRho05
1393,serC,3830380,3830612,3830380,232,64,utRho05
1394,serS,1878730,1878856,1878730,126,2948,utRho05
1395,serT,2063438,2063438,2063424,14,0,utRho05
1396,serU,4087124,4087124,4087114,10,80,utRho05
1397,serV,5637394,5637394,5637290,104,242,utRho05
1398,serW,1852014,1852014,1851942,72,232,utRho05
1399,serX,2195352,2195352,2195304,48,26,utRho05
1400,setB,4527426,4527726,4527426,300,0,utRho05
1401,setC,7673488,7673906,7673488,418,0,utRho05
1402,sfmA,1116124,1116424,1116124,300,0,utRho05
1403,sfmC,1117606,1117948,1117606,342,0,utRho05
1404,sfsA,323030,323030,322972,58,454,utRho05
1405,sfsB,6669592,6669818,6669592,226,188,utRho05
1406,sgrR,154676,154676,154598,78,112,utRho05
1407,sgrS,154734,154734,154734,0,0,utRho05
1408,shiA,4107068,4107286,4107068,218,0,utRho05
1409,sibA,4306622,4306622,4306622,0,0,utRho05
1410,sibB,4307292,4307292,4307292,0,0,utRho05
1411,sibC,6113702,6113702,6113702,0,0,utRho05
1412,sibD,6389730,6389730,6389730,0,0,utRho05
1413,sibE,6390480,6390480,6390480,0,0,utRho05
1414,sixA,4913998,4913998,4913624,374,0,utRho05
1415,slp,7307872,7307922,7307872,50,0,utRho05
1416,slt,9261400,9261466,9261400,66,0,utRho05
1417,slyA,3442028,3442028,3441648,380,0,utRho05
1418,slyB,3439496,3439752,3439496,256,110,utRho05
1419,slyD,6957398,6957398,6956994,404,254,utRho05
1420,slyX,6954862,6955280,6954862,418,9156,utRho05
1421,smf,6867372,6867372,6867120,252,164,utRho05
1422,smpB,5509534,5509792,5509534,258,2106,utRho05
1423,smrA,2811872,2811958,2811872,86,286,utRho05
1424,smrB,4896872,4897212,4896872,340,72,utRho05
1425,smtA,1946808,1947074,1946808,266,2,utRho05
1426,sodA,8201518,8201620,8201518,102,6590,utRho05
1427,sodB,3470646,3470756,3470646,110,4,utRho05
1428,sodC,3449358,3449358,3449310,48,0,utRho05
1429,sohB,2658568,2658664,2658568,96,30,utRho05
1430,sokB,2984232,2984238,2984232,6,22,utRho05
1431,solA,2241218,2241218,2241172,46,0,utRho05
1432,soxR,8554894,8554938,8554894,44,0,utRho05
1433,soxS,8554846,8554846,8554766,80,0,utRho05
1434,speA,6172096,6172096,6171822,274,130,utRho05
1435,speB,6167892,6167892,6167594,298,416,utRho05
1436,speC,6218350,6218350,6218310,40,14,utRho05
1437,spf,8099798,8099798,8099798,0,0,utRho05
1438,sppA,3697422,3697674,3697422,252,0,utRho05
1439,spy,3651376,3651376,3651250,126,0,utRho05
1440,sra,3112092,3112092,3111926,166,92,utRho05
1441,sraB,2293178,2293178,2293178,0,0,utRho05
1442,sraC,3846132,3846132,3846132,0,0,utRho05
1443,srlA,5651582,5651664,5651582,82,48,utRho05
1444,srlR,5657720,5658094,5657720,374,1144,utRho05
1445,srmB,5425752,5425792,5425752,40,284,utRho05
1446,sroA,151216,151216,151216,0,0,utRho05
1447,sroG,6369436,6369436,6369436,0,0,utRho05
1448,sroH,8380974,8380974,8380974,0,0,utRho05
1449,ssb,8548022,8548250,8548022,228,172,utRho05
1450,sseA,5304782,5304988,5304782,206,4842,utRho05
1451,sspA,6755138,6755138,6754840,298,500,utRho05
1452,ssrA,5511014,5511186,5511014,172,262,utRho05
1453,ssrS,12223036,12223932,12223036,896,2108,utRho05
1454,sstT,6479726,6479888,6479726,162,100,utRho05
1455,ssuB,1988282,1988282,1988088,194,0,utRho05
1456,ssuE,1995126,1995126,1995024,102,0,utRho05
1457,sthA,8321604,8321604,8321580,24,2126,utRho05
1458,stpA,5597156,5597156,5596990,166,46,utRho05
1459,sucA,3034344,3034824,3034344,480,2612,utRho05
1460,sufA,3528836,3528836,3528772,64,0,utRho05
1461,sufE,3518962,3518962,3518580,382,1150,utRho05
1462,sugE,8753588,8753750,8753588,162,560,utRho05
1463,sulA,2041894,2041894,2041838,56,136,utRho05
1464,syd,5850738,5850738,5850560,178,396,utRho05
1465,symE,9159834,9159834,9159680,154,208,utRho05
1466,symR,9159670,9159670,9159670,0,0,utRho05
1467,tabA,8949566,8949724,8949566,158,0,utRho05
1468,talA,5157140,5157332,5157140,192,0,utRho05
1469,talB,16382,16476,16382,94,7042,utRho05
1470,tam,3214442,3214692,3214442,250,14,utRho05
1471,tamA,8884540,8884764,8884540,224,78,utRho05
1472,tar,3945432,3945432,3945382,50,0,utRho05
1473,tas,5943138,5943194,5943138,56,100,utRho05
1474,tatA,16087636,16087780,16087636,144,644,utRho05
1475,tatE,1317742,1317894,1317742,152,64,utRho05
1476,tauA,770410,770464,770410,54,0,utRho05
1477,tdcA,6534186,6534186,6534130,56,0,utRho05
1478,tdcG,6519652,6519652,6519298,354,70,utRho05
1479,tdcR,6534380,6534760,6534380,380,0,utRho05
1480,tdk,2586986,2587054,2586986,68,0,utRho05
1481,tehA,3001072,3001146,3001072,74,0,utRho05
1482,tesA,1039898,1039898,1039530,368,392,utRho05
1483,tesB,950402,950402,950322,80,0,utRho05
1484,tfaE,2418532,2418532,2418238,294,0,utRho05
1485,tfaQ,3269912,3269912,3269770,142,2,utRho05
1486,tff,379424,379256,379424,168,14,utRho05
1487,tgt,852110,852274,852110,164,2,utRho05
1488,thiD,4369346,4369346,4369032,314,32,utRho05
1489,thiI,882936,883098,882936,162,170,utRho05
1490,thiM,4370902,4370902,4370602,300,634,utRho05
1491,thiQ,146170,146170,145854,316,398,utRho05
1492,thrL,592,760,592,168,544,utRho05
1493,thrS,7210932,7210932,7210280,652,3564,utRho05
1494,thrU,8350762,8350776,8350762,14,38,utRho05
1495,thrV,6847414,6847414,6847310,104,155414,utRho05
1496,thrW,525682,525742,525682,60,998,utRho05
1497,thyA,5930696,5930696,5930310,386,3156,utRho05
1498,tig,909986,910266,909986,280,1134,utRho05
1499,tisB,7706674,7707106,7706674,432,896,utRho05
1500,tktA,6163414,6163414,6163270,144,78,utRho05
1501,tktB,5158616,5159272,5158616,656,946,utRho05
1502,tldD,6784368,6784368,6784056,312,0,utRho05
1503,tmcA,5191876,5191876,5191718,158,0,utRho05
1504,tnaC,15553644,15553740,15553644,96,516,utRho05
1505,tolB,1555074,1555480,1555074,406,226,utRho05
1506,tolC,6356008,6356230,6356008,222,1066,utRho05
1507,tomB,961588,961588,961416,172,6874,utRho05
1508,tonB,2622108,2622178,2622108,70,0,utRho05
1509,topA,2661578,2662096,2661578,518,2086,utRho05
1510,torC,2116112,2116168,2116112,56,80,utRho05
1511,torR,2115968,2115968,2115908,60,50,utRho05
1512,torS,2112364,2112364,2112356,8,0,utRho05
1513,torT,2112414,2112522,2112414,108,0,utRho05
1514,tpiA,8223138,8223138,8223014,124,34,utRho05
1515,tppB,3425342,3425538,3425342,196,6182,utRho05
1516,tpr,2574376,2574376,2574376,0,0,utRho05
1517,tpx,2777688,2777688,2777622,66,1366,utRho05
1518,tqsA,3347780,3347826,3347780,46,0,utRho05
1519,treA,2494850,2494850,2494752,98,66,utRho05
1520,treB,8932420,8932420,8932360,60,28,utRho05
1521,treF,7339102,7339184,7339102,82,214,utRho05
1522,treR,8934694,8934694,8934492,202,0,utRho05
1523,trg,2984878,2984940,2984878,62,42,utRho05
1524,trkG,2847342,2847564,2847342,222,0,utRho05
1525,trmA,8326590,8326590,8326540,50,102,utRho05
1526,trpA,2634678,2634678,2634444,234,742,utRho05
1527,trpC,2639888,2639888,2639570,318,272,utRho05
1528,trpL,5292432,5292432,5292328,104,0,utRho05
1529,trpR,9265408,9265520,9265408,112,208,utRho05
1530,trpS,7027394,7027394,7027276,118,770,utRho05
1531,trpT,7893560,7893914,7893560,354,106496,utRho05
1532,trxA,7931294,7931522,7931294,228,526,utRho05
1533,trxB,1864156,1864156,1864100,56,66,utRho05
1534,trxC,5437350,5437470,5437350,120,286,utRho05
1535,tsaD,6421256,6421256,6421086,170,26,utRho05
1536,tsgA,6985038,6985136,6985038,98,48,utRho05
1537,tsr,9182824,9183314,9182824,490,266,utRho05
1538,tsx,864490,864490,864026,464,868,utRho05
1539,ttcA,2823970,2823970,2823896,74,5032,utRho05
1540,ttdA,6412848,6412926,6412848,78,0,utRho05
1541,ttdR,6412760,6412760,6412512,248,4,utRho05
1542,tufA,6943448,6943448,6942658,790,154040,utRho05
1543,tus,3368346,3368518,3368346,172,144,utRho05
1544,tusA,7218040,7218040,7217992,48,116,utRho05
1545,tusB,6950218,6950218,6949930,288,1072,utRho05
1546,tynA,2902996,2902996,2902698,298,0,utRho05
1547,typA,8116460,8116814,8116460,354,8480,utRho05
1548,tyrB,8534164,8534228,8534164,64,2396,utRho05
1549,tyrP,3979004,3979362,3979004,358,72,utRho05
1550,tyrR,2773384,2773440,2773384,56,38,utRho05
1551,tyrS,3434566,3434566,3434444,122,50,utRho05
1552,tyrT,2575330,2575330,2575244,86,68,utRho05
1553,uacT,6062378,6062734,6062378,356,4,utRho05
1554,ubiC,8504886,8505012,8504886,126,226,utRho05
1555,ubiD,8049618,8049976,8049618,358,2206,utRho05
1556,ubiE,8037494,8037710,8037494,216,24,utRho05
1557,ubiG,4679078,4679134,4679078,56,0,utRho05
1558,ucpA,5089342,5089342,5089246,96,0,utRho05
1559,udp,8032782,8032862,8032782,80,54,utRho05
1560,ugd,4199470,4199470,4199226,244,0,utRho05
1561,ugpB,7184852,7184852,7184650,202,258,utRho05
1562,ugpQ,7176600,7176600,7176226,374,46,utRho05
1563,uhpT,7694396,7694396,7694334,62,40,utRho05
1564,uidA,3392304,3392304,3392142,162,0,utRho05
1565,uidC,3386012,3386012,3385702,310,0,utRho05
1566,uidR,3394150,3394150,3394104,46,32,utRho05
1567,ulaA,8839854,8839960,8839854,106,160,utRho05
1568,ulaG,8839350,8839350,8839250,100,0,utRho05
1569,ulaR,8837124,8837124,8836906,218,26,utRho05
1570,umpG,5741372,5741372,5740548,824,172,utRho05
1571,umpH,1400704,1400704,1400652,52,64,utRho05
1572,umuD,2461476,2461534,2461476,58,0,utRho05
1573,ung,5433476,5433508,5433476,32,76,utRho05
1574,uof,2843316,2843316,2842900,416,6556,utRho05
1575,upp,5241818,5241818,5241744,74,174,utRho05
1576,usg,4873780,4873780,4873298,482,200,utRho05
1577,ushA,1009772,1009828,1009772,56,2,utRho05
1578,uspA,7279966,7280222,7279966,256,962,utRho05
1579,uspB,7279696,7279696,7279440,256,664,utRho05
1580,uspC,3959172,3959506,3959172,334,28,utRho05
1581,uspE,2797318,2797318,2797244,74,104,utRho05
1582,uspF,2871282,2871282,2871238,44,130,utRho05
1583,uspG,1283806,1283806,1283734,72,458,utRho05
1584,uvrA,8547872,8547872,8547742,130,376,utRho05
1585,uvrB,1626304,1627052,1626304,748,1456,utRho05
1586,uvrC,3989758,3989758,3989412,346,222,utRho05
1587,uvrD,7995814,7995966,7995814,152,238,utRho05
1588,uvrY,3990812,3990812,3990718,94,44,utRho05
1589,uxaB,3221474,3221474,3221360,114,0,utRho05
1590,uxaC,6489714,6489714,6489482,232,0,utRho05
1591,uxuA,9103036,9103272,9103036,236,368,utRho05
1592,uxuR,9108916,9109152,9108916,236,104,utRho05
1593,valS,8967854,8967854,8967674,180,390,utRho05
1594,valU,5041848,5041862,5041848,14,0,utRho05
1595,valV,3492830,3492870,3492830,40,22,utRho05
1596,ves,3649968,3649968,3649874,94,82,utRho05
1597,waaA,7616512,7617080,7616512,568,260,utRho05
1598,waaH,7580298,7580298,7580162,136,0,utRho05
1599,waaQ,7616476,7616476,7616196,280,54,utRho05
1600,waaU,7598996,7598996,7598624,372,30,utRho05
1601,waaY,7602272,7602272,7601930,342,6162,utRho05
1602,wbbH,4214888,4214888,4214452,436,3138,utRho05
1603,wbbK,4209212,4209212,4209018,194,478,utRho05
1604,wcaM,4231868,4231868,4231792,76,70,utRho05
1605,wrbA,2135516,2135516,2135416,100,0,utRho05
1606,wza,4275166,4275166,4274486,680,0,utRho05
1607,wzxC,4240674,4240674,4240316,358,88,utRho05
1608,wzzB,4196950,4196950,4196602,348,218,utRho05
1609,xanP,7657642,7657890,7657642,248,0,utRho05
1610,xanQ,6048520,6048702,6048520,182,0,utRho05
1611,xapA,5049820,5049820,5049756,64,0,utRho05
1612,xapR,10090252,10090252,10089908,344,0,utRho05
1613,xdhA,6000514,6000690,6000514,176,2,utRho05
1614,xerD,6079702,6079702,6079486,216,34,utRho05
1615,xseA,5268394,5268464,5268394,70,304,utRho05
1616,xseB,882746,882746,882686,60,166,utRho05
1617,xthA,3664798,3664856,3664798,58,0,utRho05
1618,xylA,7461614,7461614,7461530,84,142,utRho05
1619,xylE,8484540,8484540,8484508,32,0,utRho05
1620,xylF,7462138,7462262,7462138,124,4,utRho05
1621,xylR,7469812,7469958,7469812,146,0,utRho05
1622,yaaA,13230,13230,12918,312,110,utRho05
1623,yaaI,23876,23876,23572,304,2,utRho05
1624,yaaJ,16034,16034,15918,116,78,utRho05
1625,yaaU,91184,91614,91184,430,0,utRho05
1626,yaaW,23084,23084,22712,372,0,utRho05
1627,yaaX,10060,10468,10060,408,66,utRho05
1628,yabI,142542,142702,142542,160,0,utRho05
1629,yacC,273880,273880,273834,46,3304,utRho05
1630,yacH,262932,262932,262520,412,34,utRho05
1631,yacL,268678,268776,268678,98,24,utRho05
1632,yadD,293796,293936,293796,140,44,utRho05
1633,yadE,289930,290162,289930,232,382,utRho05
1634,yadN,314110,314110,313766,344,50,utRho05
1635,yadS,355572,355572,355248,324,358,utRho05
1636,yadV,312470,312470,312402,68,2,utRho05
1637,yaeF,434270,434270,434006,264,0,utRho05
1638,yaeP,428374,428374,428250,124,34,utRho05
1639,yaeQ,428176,428582,428176,406,118,utRho05
1640,yaeR,423716,423754,423716,38,2,utRho05
1641,yafC,462166,462166,461762,404,322,utRho05
1642,yafD,462128,462244,462128,116,260,utRho05
1643,yafK,491986,491986,491610,376,1814,utRho05
1644,yafL,493282,493424,493282,142,0,utRho05
1645,yafN,503938,504010,503938,72,0,utRho05
1646,yafS,469568,469632,469568,64,456,utRho05
1647,yafT,474470,474670,474470,200,4,utRho05
1648,yafV,480432,480432,480378,54,2,utRho05
1649,yafZ,536052,536052,536010,42,0,utRho05
1650,yagE,564446,564556,564446,110,2,utRho05
1651,yagG,570414,570790,570414,376,8,utRho05
1652,yagI,578384,578384,578324,60,2,utRho05
1653,yagK,586236,586236,585896,340,26,utRho05
1654,yagL,588062,588062,587836,226,8,utRho05
1655,yagN,591342,591342,591158,184,664,utRho05
1656,yahA,663746,664742,663746,996,468,utRho05
1657,yahC,670136,670136,670044,92,4,utRho05
1658,yahE,671478,671850,671478,372,2,utRho05
1659,yahM,690504,690808,690504,304,44,utRho05
1660,yahN,692872,692872,692674,198,152,utRho05
1661,yahO,692864,692968,692864,104,74,utRho05
1662,yaiE,816296,816354,816296,58,54,utRho05
1663,yaiI,811396,811528,811396,132,0,utRho05
1664,yaiO,761946,761946,761684,262,0,utRho05
1665,yaiP,767970,767970,767870,100,0,utRho05
1666,yaiS,769660,769660,769232,428,0,utRho05
1667,yaiV,788922,788922,788922,0,0,utRho05
1668,yaiY,799094,799094,798666,428,234,utRho05
1669,yaiZ,798888,799186,798888,298,1048,utRho05
1670,yajC,854410,854574,854410,164,722,utRho05
1671,yajD,860938,861210,860938,272,806,utRho05
1672,yajI,866068,866068,865702,366,386,utRho05
1673,yajL,887496,887496,887282,214,606,utRho05
1674,yajQ,889316,889366,889316,50,2,utRho05
1675,yajR,893374,893374,893332,42,434,utRho05
1676,ybaB,987418,988152,987418,734,2812,utRho05
1677,ybaL,1006590,1006590,1006476,114,126,utRho05
1678,ybaM,980648,980648,980542,106,660,utRho05
1679,ybaN,981436,981764,981436,328,578,utRho05
1680,ybaO,936704,936766,936704,62,0,utRho05
1681,ybaP,1016568,1016568,1016160,408,968,utRho05
1682,ybaQ,1016348,1016436,1016348,88,106,utRho05
1683,ybaS,1023146,1023282,1023146,136,2,utRho05
1684,ybaV,927504,927874,927504,370,80,utRho05
1685,ybaY,950490,950758,950490,268,58,utRho05
1686,ybbB,1062724,1062724,1062452,272,8,utRho05
1687,ybbJ,1030154,1030154,1029718,436,462,utRho05
1688,ybbL,1031784,1031838,1031784,54,0,utRho05
1689,ybbN,1037136,1037136,1036558,578,1476,utRho05
1690,ybbO,1038658,1038658,1038298,360,1656,utRho05
1691,ybbY,1080718,1081130,1080718,412,0,utRho05
1692,ybcH,1176140,1176140,1175962,178,2,utRho05
1693,ybcI,1113264,1113264,1113106,158,2310,utRho05
1694,ybcJ,1114050,1114050,1113746,304,126,utRho05
1695,ybcK,1137502,1137804,1137502,302,2,utRho05
1696,ybcL,1141690,1141786,1141690,96,0,utRho05
1697,ybcN,1144628,1144932,1144628,304,0,utRho05
1698,ybcQ,1147548,1147912,1147548,364,2,utRho05
1699,ybcW,1159610,1159760,1159610,150,0,utRho05
1700,ybdD,1263982,1264364,1263982,382,264,utRho05
1701,ybdF,1212106,1212106,1211772,334,52,utRho05
1702,ybdH,1267048,1267048,1266954,94,30,utRho05
1703,ybdJ,1212822,1212822,1212398,424,0,utRho05
1704,ybdK,1215122,1215122,1214766,356,428,utRho05
1705,ybdL,1267114,1267172,1267114,58,62,utRho05
1706,ybdM,1271110,1271110,1270752,358,184,utRho05
1707,ybdN,1273372,1273372,1273138,234,10,utRho05
1708,ybdR,1283844,1284176,1283844,332,542,utRho05
1709,ybeD,1325412,1325412,1325284,128,572,utRho05
1710,ybeF,1323090,1323090,1322756,334,330,utRho05
1711,ybeL,1349986,1350036,1349986,50,40,utRho05
1712,ybeQ,1353412,1353412,1353094,318,0,utRho05
1713,ybeR,1353120,1353422,1353120,302,0,utRho05
1714,ybeT,1358832,1358832,1358812,20,0,utRho05
1715,ybeU,1358924,1359016,1358924,92,0,utRho05
1716,ybeZ,1386938,1386938,1386834,104,2570,utRho05
1717,ybfA,1458074,1458268,1458074,194,8,utRho05
1718,ybfE,1423878,1423878,1423796,82,486,utRho05
1719,ybfF,1425692,1425692,1425604,88,746,utRho05
1720,ybfH,1433282,1433282,1433194,88,0,utRho05
1721,ybgA,1477840,1478002,1477840,162,0,utRho05
1722,ybgC,1549288,1549504,1549288,216,22,utRho05
1723,ybgD,1505916,1505916,1505590,326,88,utRho05
1724,ybgI,1485238,1485654,1485238,416,0,utRho05
1725,ybgO,1498370,1498370,1497964,406,0,utRho05
1726,ybgS,1570992,1570992,1570634,358,78,utRho05
1727,ybhA,1597184,1597184,1596862,322,100,utRho05
1728,ybhB,1616070,1616070,1615818,252,106,utRho05
1729,ybhC,1614642,1614642,1614562,80,1064,utRho05
1730,ybhD,1601418,1601418,1601276,142,0,utRho05
1731,ybhH,1601104,1601518,1601104,414,0,utRho05
1732,ybhK,1633384,1633384,1633294,90,62,utRho05
1733,ybhM,1641556,1641586,1641556,30,0,utRho05
1734,ybhN,1645296,1645296,1644996,300,16,utRho05
1735,ybhQ,1649202,1649260,1649202,58,78,utRho05
1736,ybiA,1665920,1665920,1665900,20,112,utRho05
1737,ybiI,1676968,1676968,1676912,56,344,utRho05
1738,ybiO,1691328,1691328,1690960,368,244,utRho05
1739,ybiP,1705252,1705252,1705194,58,2244,utRho05
1740,ybiS,1711572,1711572,1711488,84,598,utRho05
1741,ybiT,1711894,1711926,1711894,32,0,utRho05
1742,ybiU,1718212,1718212,1718122,90,24,utRho05
1743,ybiV,1720176,1720176,1720056,120,0,utRho05
1744,ybiW,1725566,1725566,1725212,354,8,utRho05
1745,ybiX,1678548,1678548,1678414,134,1744,utRho05
1746,ybjC,1781784,1781826,1781784,42,0,utRho05
1747,ybjE,1830154,1830154,1829714,440,0,utRho05
1748,ybjG,1767016,1767016,1766776,240,700,utRho05
1749,ybjL,1779882,1779882,1779638,244,328,utRho05
1750,ybjM,1779770,1780178,1779770,408,210,utRho05
1751,ybjO,1795704,1795978,1795704,274,0,utRho05
1752,ybjP,1809046,1809046,1808934,112,0,utRho05
1753,ybjQ,1809034,1809186,1809034,152,0,utRho05
1754,ybjS,1813796,1813796,1813506,290,94,utRho05
1755,ybjX,1838206,1838206,1838168,38,32,utRho05
1756,ycaD,1891438,1891742,1891438,304,0,utRho05
1757,ycaI,1928210,1928640,1928210,430,240,utRho05
1758,ycaK,1899094,1899336,1899094,242,22,utRho05
1759,ycaL,1920264,1920528,1920264,264,16,utRho05
1760,ycaM,1894240,1894458,1894240,218,48,utRho05
1761,ycaR,1941284,1941346,1941284,62,2288,utRho05
1762,ycbB,1961862,1962094,1961862,232,42,utRho05
1763,ycbJ,1943344,1943504,1943344,160,0,utRho05
1764,ycbK,1966046,1966150,1966046,104,892,utRho05
1765,ycbZ,2036920,2036920,2036598,322,58,utRho05
1766,yccA,2062886,2062886,2062836,50,570,utRho05
1767,yccF,2048730,2048730,2048696,34,54,utRho05
1768,yccS,2047988,2047988,2047766,222,66,utRho05
1769,yccT,2055674,2055674,2055546,128,0,utRho05
1770,yccX,2059960,2060128,2059960,168,106,utRho05
1771,ycdT,2185682,2185752,2185682,70,0,utRho05
1772,ycdU,2191266,2191686,2191266,420,0,utRho05
1773,ycdZ,2200504,2200592,2200504,88,16,utRho05
1774,yceA,2233544,2233614,2233544,70,98,utRho05
1775,yceD,2293298,2293588,2293298,290,6990,utRho05
1776,yceF,2293522,2293522,2293190,332,4594,utRho05
1777,yceH,2252154,2252314,2252154,160,822,utRho05
1778,yceI,2237282,2237282,2236952,330,274,utRho05
1779,yceJ,2238142,2238142,2238092,50,132,utRho05
1780,yceM,2253208,2253612,2253208,404,112,utRho05
1781,yceO,2239264,2239264,2238894,370,218,utRho05
1782,yceQ,2288760,2289004,2288760,244,8104,utRho05
1783,ycfD,2376540,2376540,2376480,60,262,utRho05
1784,ycfJ,2334814,2335198,2334814,384,298,utRho05
1785,ycfS,2340834,2340834,2340748,86,0,utRho05
1786,ycfT,2350658,2350658,2350330,328,2,utRho05
1787,ycfZ,2362760,2362760,2362534,226,158,utRho05
1788,ycgB,2474570,2474570,2474482,88,36,utRho05
1789,ycgG,2434614,2434656,2434614,42,2,utRho05
1790,ycgJ,2452956,2453200,2452956,244,28,utRho05
1791,ycgL,2455218,2455362,2455218,144,0,utRho05
1792,ycgN,2457366,2457660,2457366,294,54,utRho05
1793,ycgR,2489112,2489112,2489054,58,62,utRho05
1794,ycgV,2512222,2512222,2511904,318,166,utRho05
1795,ycgX,2426568,2426568,2426214,354,21890,utRho05
1796,ycgY,2490166,2490320,2490166,154,28,utRho05
1797,ycgZ,2431504,2431578,2431504,74,16,utRho05
1798,ychE,2596904,2597196,2596904,292,242,utRho05
1799,ychF,2515764,2515764,2515624,140,0,utRho05
1800,ychH,2517476,2517582,2517476,106,368,utRho05
1801,ychJ,2578354,2578354,2578264,90,54,utRho05
1802,ychN,2547310,2547310,2547198,112,64,utRho05
1803,ychO,2547520,2547850,2547520,330,696,utRho05
1804,ychQ,2533798,2533848,2533798,50,36,utRho05
1805,yciA,2624828,2624828,2624492,336,300,utRho05
1806,yciB,2626110,2626110,2625780,330,3032,utRho05
1807,yciC,2627396,2627396,2627326,70,26,utRho05
1808,yciE,2630794,2630794,2630448,346,0,utRho05
1809,yciG,5264368,5264368,5264140,228,0,utRho05
1810,yciI,2621784,2621784,2621730,54,0,utRho05
1811,yciN,2661606,2661606,2661336,270,66,utRho05
1812,yciS,2680270,2680486,2680270,216,84,utRho05
1813,yciT,2689088,2689088,2688692,396,240,utRho05
1814,yciU,2614718,2614718,2614300,418,3436,utRho05
1815,yciV,2646376,2646440,2646376,64,24,utRho05
1816,yciW,2700472,2700472,2700214,258,856,utRho05
1817,yciZ,2689276,2689276,2689218,58,352,utRho05
1818,ycjD,2703792,2703792,2703520,272,62,utRho05
1819,ycjG,2777748,2777860,2777748,112,76,utRho05
1820,ycjM,2740006,2740432,2740006,426,10,utRho05
1821,ycjW,2767982,2767982,2767922,60,0,utRho05
1822,ycjX,2768138,2768234,2768138,96,112,utRho05
1823,ycjY,5568288,5568288,5567460,828,152,utRho05
1824,ydaE,2836438,2836438,2836016,422,0,utRho05
1825,ydaN,2816048,2816100,2816048,52,24,utRho05
1826,ydaS,2840340,2840730,2840340,390,82,utRho05
1827,ydbC,2948376,2948442,2948376,66,0,utRho05
1828,ydbD,2950132,2950288,2950132,156,0,utRho05
1829,ydbH,2885800,2886102,2885800,302,0,utRho05
1830,ydbJ,2881712,2882116,2881712,404,2,utRho05
1831,ydbK,2881692,2881692,2881568,124,90,utRho05
1832,ydcA,2983294,2983354,2983294,60,0,utRho05
1833,ydcF,2974404,2974470,2974404,66,2,utRho05
1834,ydcI,2990268,2990268,2990142,126,60,utRho05
1835,ydcJ,2990266,2990576,2990266,310,0,utRho05
1836,ydcK,3001280,3001280,3000898,382,0,utRho05
1837,ydcL,3004646,3004914,3004646,268,0,utRho05
1838,ydcN,3012308,3012344,3012308,36,2,utRho05
1839,ydcP,3013508,3013562,3013508,54,84,utRho05
1840,ydcR,3019956,3020006,3019956,50,0,utRho05
1841,ydcS,3022906,3023308,3022906,402,8,utRho05
1842,ydcX,3034442,3034778,3034442,336,184,utRho05
1843,ydcY,3035220,3035296,3035220,76,82,utRho05
1844,ydcZ,3036750,3036750,3036662,88,188,utRho05
1845,yddB,3155332,3155332,3155238,94,0,utRho05
1846,yddE,3071738,3071738,3071716,22,0,utRho05
1847,yddG,3094410,3094410,3094338,72,0,utRho05
1848,yddJ,3089732,3089732,3089438,294,4,utRho05
1849,yddW,3137704,3137704,3137646,58,0,utRho05
1850,ydeA,3233910,3234056,3233910,146,226,utRho05
1851,ydeE,3242528,3242664,3242528,136,22,utRho05
1852,ydeI,3249118,3249118,3248994,124,0,utRho05
1853,ydeJ,3249376,3249546,3249376,170,0,utRho05
1854,ydeN,3165458,3165458,3165048,410,2,utRho05
1855,ydeP,3173328,3173328,3172972,356,4,utRho05
1856,ydeR,3176596,3176596,3176592,4,0,utRho05
1857,ydfA,3296872,3297016,3296872,144,98,utRho05
1858,ydfG,3254982,3255034,3254982,52,0,utRho05
1859,ydfH,3256652,3256704,3256652,52,12,utRho05
1860,ydfK,3265446,3266144,3265446,698,43568,utRho05
1861,ydgA,3379588,3379704,3379588,116,0,utRho05
1862,ydgC,3364124,3364124,3364060,64,38,utRho05
1863,ydgD,3343906,3343920,3343906,14,100,utRho05
1864,ydgH,3356754,3356854,3356754,100,16,utRho05
1865,ydgJ,3408798,3408798,3408616,182,16,utRho05
1866,ydgK,3410414,3410500,3410414,86,80,utRho05
1867,ydhB,3479618,3479618,3479596,22,0,utRho05
1868,ydhC,3479698,3479822,3479698,124,28,utRho05
1869,ydhF,3451310,3451310,3451264,46,0,utRho05
1870,ydhI,3441996,3442050,3441996,54,0,utRho05
1871,ydhL,3451864,3451864,3451840,24,6,utRho05
1872,ydhQ,3492404,3492404,3492254,150,0,utRho05
1873,ydhS,3494136,3494262,3494136,126,334,utRho05
1874,ydhT,3499138,3499138,3499118,20,0,utRho05
1875,ydhY,3509284,3509284,3508954,330,0,utRho05
1876,ydhZ,3510418,3510418,3510282,136,2,utRho05
1877,ydiE,3579206,3579226,3579206,20,0,utRho05
1878,ydiH,3530582,3530582,3530406,176,0,utRho05
1879,ydiM,3541852,3542142,3541852,290,0,utRho05
1880,ydiN,3544818,3545024,3544818,206,0,utRho05
1881,ydiP,3558656,3558656,3558602,54,4,utRho05
1882,ydiU,3582508,3582508,3582488,20,22,utRho05
1883,ydiV,3584174,3584174,3584040,134,114,utRho05
1884,ydiY,3612500,3612500,3612166,334,70,utRho05
1885,ydjA,3697400,3697400,3697352,48,56,utRho05
1886,ydjE,3708082,3708082,3707958,124,0,utRho05
1887,ydjF,3709848,3709848,3709708,140,0,utRho05
1888,ydjM,3620340,3620422,3620340,82,0,utRho05
1889,ydjO,3626696,3626696,3626288,408,0,utRho05
1890,ydjX,3666434,3666802,3666434,368,2016,utRho05
1891,yeaE,3731448,3731448,3731272,176,70,utRho05
1892,yeaG,3733530,3733816,3733530,286,0,utRho05
1893,yeaI,3740486,3740770,3740486,284,0,utRho05
1894,yeaJ,3743874,3744082,3743874,208,120,utRho05
1895,yeaL,3748646,3748704,3748646,58,226,utRho05
1896,yeaM,3751296,3751296,3751152,144,0,utRho05
1897,yeaN,3750926,3751346,3750926,420,0,utRho05
1898,yeaO,3753554,3753818,3753554,264,24,utRho05
1899,yeaP,3755314,3755430,3755314,116,684,utRho05
1900,yeaQ,3758780,3758780,3758510,270,144,utRho05
1901,yeaR,3759988,3759988,3759896,92,22,utRho05
1902,yeaY,3781122,3781122,3781064,58,120,utRho05
1903,yebB,3892220,3892502,3892220,282,2,utRho05
1904,yebC,3896370,3896370,3896302,68,50,utRho05
1905,yebE,3859464,3859464,3859414,50,438,utRho05
1906,yebG,3861530,3861530,3861494,36,0,utRho05
1907,yebK,3873180,3873304,3873180,124,20,utRho05
1908,yebQ,3820314,3820552,3820314,238,44,utRho05
1909,yebS,3832238,3832516,3832238,278,6,utRho05
1910,yebV,3843430,3843560,3843430,130,0,utRho05
1911,yebW,3843914,3844242,3843914,328,1720,utRho05
1912,yecC,3995646,3995646,3995628,18,0,utRho05
1913,yecD,3901272,3901664,3901272,392,270,utRho05
1914,yecF,3991434,3991636,3991434,202,358,utRho05
1915,yecH,3979304,3979304,3978980,324,72,utRho05
1916,yecJ,3975604,3975604,3975516,88,0,utRho05
1917,yecM,3919968,3919968,3919692,276,0,utRho05
1918,yecR,3976400,3976444,3976400,44,124,utRho05
1919,yecT,3923862,3923944,3923862,82,176,utRho05
1920,yedD,4016522,4016522,4016180,342,180,utRho05
1921,yedE,4016310,4016554,4016310,244,110,utRho05
1922,yedI,4058922,4058922,4058732,190,0,utRho05
1923,yedJ,4066446,4066446,4066158,288,110,utRho05
1924,yedV,4076404,4076404,4076304,100,112,utRho05
1925,yedX,4077680,4077912,4077680,232,0,utRho05
1926,yedY,4078572,4078956,4078572,384,84,utRho05
1927,yeeA,4161322,4161322,4161182,140,76,utRho05
1928,yeeE,4171104,4171104,4171050,54,0,utRho05
1929,yeeJ,4089526,4089822,4089526,296,614,utRho05
1930,yeeN,4113508,4113716,4113508,208,56,utRho05
1931,yeeO,4119444,4119444,4119692,248,0,utRho05
1932,yeeX,4158834,4158834,4158722,112,518,utRho05
1933,yeeZ,4178422,4178422,4178256,166,0,utRho05
1934,yefM,4179466,4179466,4179426,40,62,utRho05
1935,yegD,4295288,4295348,4295288,60,4,utRho05
1936,yegH,4275726,4275804,4275726,78,0,utRho05
1937,yegI,4302154,4302154,4301970,184,0,utRho05
1938,yegJ,4302032,4302370,4302032,338,0,utRho05
1939,yegQ,4331182,4331336,4331182,154,42,utRho05
1940,yegR,4336698,4336698,4336612,86,0,utRho05
1941,yegS,4337086,4337424,4337086,338,0,utRho05
1942,yegT,4357562,4357642,4357562,80,2,utRho05
1943,yegX,4367640,4367640,4367302,338,2,utRho05
1944,yehA,4376944,4376944,4376828,116,0,utRho05
1945,yehE,4385818,4385818,4385592,226,0,utRho05
1946,yehK,4407568,4407944,4407568,376,0,utRho05
1947,yehL,4408804,4409192,4408804,388,0,utRho05
1948,yeiB,4486146,4486146,4485934,212,82,utRho05
1949,yeiE,4499422,4499422,4499236,186,0,utRho05
1950,yeiG,4487776,4487820,4487776,44,398,utRho05
1951,yeiH,4499332,4499434,4499332,102,0,utRho05
1952,yeiI,4503306,4503400,4503306,94,116,utRho05
1953,yeiL,4510580,4510710,4510580,130,0,utRho05
1954,yeiP,4530834,4530900,4530834,66,470,utRho05
1955,yeiQ,4532328,4532490,4532328,162,104,utRho05
1956,yeiR,4535484,4535658,4535484,174,44,utRho05
1957,yeiW,4530840,4530840,4530590,250,770,utRho05
1958,yejA,4544624,4544728,4544624,104,2,utRho05
1959,yejG,4556892,4556892,4556474,418,4510,utRho05
1960,yejH,4561244,4561264,4561244,20,0,utRho05
1961,yejK,4568218,4568218,4567894,324,432,utRho05
1962,yejO,4578352,4578352,4577800,552,126,utRho05
1963,yfaD,4713380,4713808,4713380,428,1246,utRho05
1964,yfaE,4696676,4697028,4696676,352,1390,utRho05
1965,yfaL,4688568,4688568,4688338,230,2,utRho05
1966,yfaP,4656398,4656398,4656286,112,0,utRho05
1967,yfaU,4717892,4717892,4717690,202,0,utRho05
1968,yfaY,4727310,4727310,4727266,44,8,utRho05
1969,yfaZ,4728744,4728744,4728550,194,48,utRho05
1970,yfbK,4771810,4771810,4771444,366,2,utRho05
1971,yfbL,4771500,4771720,4771500,220,0,utRho05
1972,yfbN,4777174,4777174,4776852,322,0,utRho05
1973,yfbO,4776916,4777162,4776916,246,0,utRho05
1974,yfbP,4777990,4778232,4777990,242,752,utRho05
1975,yfbR,4817662,4817724,4817662,62,16,utRho05
1976,yfcI,4847424,4847424,4847078,346,146,utRho05
1977,yfcJ,4880482,4880482,4880240,242,276,utRho05
1978,yfcL,4888502,4888502,4888338,164,16,utRho05
1979,yfcV,4911642,4911642,4911292,350,0,utRho05
1980,yfcZ,4921958,4921958,4921868,90,136,utRho05
1981,yfdF,4925604,4926024,4925604,420,192,utRho05
1982,yfdG,4935474,4935710,4935474,236,20,utRho05
1983,yfdP,4946844,4947040,4946844,196,0,utRho05
1984,yfdX,4988866,4988866,4988804,62,0,utRho05
1985,yfdY,4990672,4990672,4990584,88,2,utRho05
1986,yfeA,5035784,5035784,5035664,120,41068,utRho05
1987,yfeC,5036668,5036934,5036668,266,114,utRho05
1988,yfeH,5053818,5053892,5053818,74,0,utRho05
1989,yfeK,5074630,5074684,5074630,54,44,utRho05
1990,yfeO,5018906,5019260,5018906,354,120,utRho05
1991,yfeR,5054078,5054078,5053712,366,74,utRho05
1992,yfeX,5101356,5101356,5101090,266,62,utRho05
1993,yfeY,5102486,5102486,5102432,54,0,utRho05
1994,yfeZ,5103842,5103842,5103452,390,2,utRho05
1995,yffO,5123804,5124222,5123804,418,0,utRho05
1996,yffQ,5126778,5127154,5126778,376,36,utRho05
1997,yffS,5128800,5128986,5128800,186,74,utRho05
1998,yfgC,5232052,5232188,5232052,136,42,utRho05
1999,yfgF,5258062,5258062,5257876,186,42,utRho05
2000,yfgG,5258170,5258580,5258170,410,260,utRho05
2001,yfgH,5259344,5259584,5259344,240,4,utRho05
2002,yfgM,5278866,5278866,5278566,300,768,utRho05
2003,yfhH,5397414,5397518,5397414,104,0,utRho05
2004,yfhM,5304648,5304648,5304574,74,0,utRho05
2005,yfhR,5328408,5328726,5328408,318,4848,utRho05
2006,yfiC,5425610,5425610,5425528,82,0,utRho05
2007,yfiE,5430688,5430688,5430640,48,0,utRho05
2008,yfiL,5482630,5482720,5482630,90,0,utRho05
2009,yfiM,5448066,5448358,5448066,292,19512,utRho05
2010,yfiR,5483354,5483750,5483354,396,178,utRho05
2011,yfjH,5517326,5517326,5517200,126,0,utRho05
2012,yfjI,5517710,5517970,5517710,260,2,utRho05
2013,yfjJ,5521014,5521094,5521014,80,0,utRho05
2014,yfjM,5531970,5531970,5531552,418,680,utRho05
2015,yfjP,5535080,5535420,5535080,340,58,utRho05
2016,yfjW,5546570,5546636,5546570,66,0,utRho05
2017,yfjX,5551776,5551838,5551776,62,0,utRho05
2018,ygaC,5601180,5601180,5599988,1192,1394,utRho05
2019,ygaM,5600242,5600292,5600242,50,348,utRho05
2020,ygaU,5593628,5593628,5593572,56,22,utRho05
2021,ygaZ,5619190,5619234,5619190,44,1118,utRho05
2022,ygbA,5713656,5713656,5713612,44,0,utRho05
2023,ygbE,5746784,5746784,5746674,110,94,utRho05
2024,ygbI,5722882,5722882,5722528,354,2,utRho05
2025,ygbK,5724394,5724670,5724394,276,82,utRho05
2026,ygbL,5727074,5727186,5727074,112,14,utRho05
2027,ygbN,5729814,5730202,5729814,388,22,utRho05
2028,ygcG,5811210,5811422,5811210,212,0,utRho05
2029,ygcN,5785144,5785314,5785144,170,50,utRho05
2030,ygcU,5799214,5799214,5798836,378,80,utRho05
2031,ygcW,5800942,5800942,5800546,396,0,utRho05
2032,ygdD,5883442,5883442,5883262,180,32,utRho05
2033,ygdG,5861746,5861930,5861746,184,634,utRho05
2034,ygdI,5886526,5886526,5886290,236,40,utRho05
2035,ygdQ,5940784,5940840,5940784,56,30,utRho05
2036,ygdR,5942494,5942542,5942494,48,0,utRho05
2037,ygeA,5961606,5961606,5961270,336,72,utRho05
2038,ygeH,5983758,5984188,5983758,430,2,utRho05
2039,ygeI,5987162,5987276,5987162,114,66,utRho05
2040,ygeR,6000078,6000078,5999782,296,126,utRho05
2041,ygeV,6011694,6011694,6011572,122,0,utRho05
2042,ygeW,6012234,6012524,6012234,290,0,utRho05
2043,ygfB,6110946,6110946,6110888,58,26,utRho05
2044,ygfK,6031984,6032120,6031984,136,0,utRho05
2045,ygfS,6058328,6058328,6058024,304,116,utRho05
2046,ygfZ,6082564,6082626,6082564,62,2,utRho05
2047,yggC,6149512,6149512,6149378,134,112,utRho05
2048,yggE,6136370,6136370,6136160,210,0,utRho05
2049,yggI,6179176,6179510,6179176,334,94,utRho05
2050,yggL,6204508,6204508,6204266,242,90,utRho05
2051,yggM,6199514,6199514,6199130,384,32,utRho05
2052,yggN,6203596,6203596,6203246,350,32,utRho05
2053,yggX,18623958,18624558,18623958,600,696,utRho05
2054,yghA,6298966,6299324,6298966,358,0,utRho05
2055,yghB,6307058,6307126,6307058,68,76,utRho05
2056,yghD,6222614,6222614,6222252,362,2,utRho05
2057,yghF,6225798,6225798,6225840,42,12,utRho05
2058,yghJ,6238640,6238640,6238224,416,2,utRho05
2059,yghQ,6265186,6265186,6264816,370,0,utRho05
2060,yghT,6267830,6268262,6267830,432,0,utRho05
2061,yghU,6277400,6277454,6277400,54,186,utRho05
2062,yghW,6293506,6293506,6293474,32,0,utRho05
2063,yghZ,6295562,6295794,6295562,232,4,utRho05
2064,ygiD,6365122,6365122,6364868,254,982,utRho05
2065,ygiH,6409066,6409388,6409066,322,2,utRho05
2066,ygiL,6370622,6370828,6370622,206,0,utRho05
2067,ygiM,6402084,6402414,6402084,330,60,utRho05
2068,ygiN,6346156,6346284,6346156,128,824,utRho05
2069,ygiQ,6322620,6322620,6322292,328,464,utRho05
2070,ygiS,6335462,6335462,6335436,26,22,utRho05
2071,ygiV,6338582,6338582,6338462,120,0,utRho05
2072,ygiW,6339774,6339774,6339352,422,116,utRho05
2073,ygiZ,6344506,6344506,6344422,84,0,utRho05
2074,ygjH,6442528,6442528,6442494,34,0,utRho05
2075,ygjI,6452140,6452468,6452140,328,0,utRho05
2076,ygjQ,6472730,6473080,6472730,350,466,utRho05
2077,ygjR,6474564,6474586,6474564,22,0,utRho05
2078,ygjV,6483638,6483638,6483488,150,128,utRho05
2079,yhaB,6535632,6535708,6535632,76,0,utRho05
2080,yhaH,6504498,6504608,6504498,110,0,utRho05
2081,yhaI,6505400,6505822,6505400,422,0,utRho05
2082,yhaJ,6508560,6508560,6508428,132,18,utRho05
2083,yhaK,6508538,6508638,6508538,100,2,utRho05
2084,yhbQ,6599878,6599932,6599878,54,124,utRho05
2085,yhbT,6602736,6602736,6602552,184,48,utRho05
2086,yhbU,6602558,6602970,6602558,412,100,utRho05
2087,yhbX,6643302,6643302,6643226,76,0,utRho05
2088,yhbY,6655518,6655580,6655518,62,1758,utRho05
2089,yhcA,6723956,6724224,6723956,268,12,utRho05
2090,yhcB,6760364,6760382,6760364,18,108,utRho05
2091,yhcC,6708470,6708470,6708100,370,536,utRho05
2092,yhcF,6733440,6733852,6733440,412,48,utRho05
2093,yhcH,6739124,6739124,6738956,168,36,utRho05
2094,yhcM,6760312,6760312,6759994,318,134,utRho05
2095,yhcN,6770812,6771076,6770812,264,858,utRho05
2096,yhcO,6772606,6772606,6772258,348,0,utRho05
2097,yhdH,6806560,6806968,6806560,408,122,utRho05
2098,yhdJ,6823234,6823306,6823234,72,0,utRho05
2099,yhdN,6879092,6879092,6879018,74,2616,utRho05
2100,yhdT,6814702,6814750,6814702,48,588,utRho05
2101,yhdU,6824994,6825242,6824994,248,244,utRho05
2102,yhdV,6836392,6836780,6836392,388,4,utRho05
2103,yhdW,6837944,6838298,6837944,354,0,utRho05
2104,yheO,6953082,6953082,6952880,202,1172,utRho05
2105,yheV,6957970,6957970,6957584,386,100,utRho05
2106,yhfA,6971902,6971902,6971636,266,266,utRho05
2107,yhfG,6983294,6983294,6983240,54,302,utRho05
2108,yhfL,6998622,6998896,6998622,274,38,utRho05
2109,yhfY,7023244,7023244,7022844,400,0,utRho05
2110,yhgA,7086294,7086334,7086294,40,0,utRho05
2111,yhgE,7065176,7065176,7064878,298,108,utRho05
2112,yhgF,7074352,7074770,7074352,418,1664,utRho05
2113,yhhA,7173458,7173886,7173458,428,160,utRho05
2114,yhhI,7248346,7248756,7248346,410,0,utRho05
2115,yhhJ,7253696,7253696,7253606,90,0,utRho05
2116,yhhM,7211588,7211588,7211220,368,520,utRho05
2117,yhhN,7211150,7211502,7211150,352,538,utRho05
2118,yhhQ,7218238,7218434,7218238,196,588,utRho05
2119,yhhT,7223682,7223730,7223682,48,0,utRho05
2120,yhhX,7162032,7162032,7161610,422,740,utRho05
2121,yhhY,7162222,7162276,7162222,54,30,utRho05
2122,yhhZ,7163516,7163726,7163516,210,2,utRho05
2123,yhiD,7312220,7312220,7311804,416,2492,utRho05
2124,yhiJ,7265190,7265190,7265180,10,0,utRho05
2125,yhiM,7269270,7269682,7269270,412,124,utRho05
2126,yhiN,7275000,7275000,7274820,180,134,utRho05
2127,yhjA,7338522,7338522,7338376,146,0,utRho05
2128,yhjB,7344090,7344090,7343788,302,34,utRho05
2129,yhjC,7344272,7344684,7344272,412,0,utRho05
2130,yhjD,7346660,7346724,7346660,64,0,utRho05
2131,yhjE,7349274,7349572,7349274,298,0,utRho05
2132,yhjG,7356824,7356824,7356730,94,0,utRho05
2133,yhjH,7358458,7358458,7358374,84,0,utRho05
2134,yhjJ,7364032,7364032,7363880,152,178,utRho05
2135,yhjK,7371296,7371296,7371158,138,0,utRho05
2136,yhjR,7392750,7392750,7392370,380,32,utRho05
2137,yhjV,7400796,7401126,7400796,330,964,utRho05
2138,yhjX,7424194,7424194,7424014,180,0,utRho05
2139,yhjY,7425966,7425966,7425868,98,0,utRho05
2140,yiaB,7455654,7455654,7455496,158,0,utRho05
2141,yiaD,7432712,7433094,7432712,382,116,utRho05
2142,yiaF,7438194,7438194,7438088,106,106,utRho05
2143,yiaG,7438862,7438956,7438862,94,134,utRho05
2144,yiaJ,7485236,7485236,7485064,172,4,utRho05
2145,yiaK,7485348,7485466,7485348,118,0,utRho05
2146,yiaT,7503924,7503924,7503736,188,0,utRho05
2147,yiaU,7503792,7503984,7503792,192,0,utRho05
2148,yiaY,7515856,7515856,7515654,202,36,utRho05
2149,yibF,7523950,7523950,7523910,40,0,utRho05
2150,yibG,7536128,7536354,7536128,226,0,utRho05
2151,yibL,7553194,7553330,7553194,136,152,utRho05
2152,yibN,7570112,7570112,7570030,82,222,utRho05
2153,yibT,7552848,7552848,7552760,88,110,utRho05
2154,yicC,7633290,7633352,7633290,62,8,utRho05
2155,yicH,7660862,7660914,7660862,52,0,utRho05
2156,yicJ,7673328,7673328,7671858,1470,1266,utRho05
2157,yicN,7685018,7685018,7684804,214,0,utRho05
2158,yicO,7687914,7687914,7687578,336,0,utRho05
2159,yicR,15250308,15250308,15250236,72,0,utRho05
2160,yidB,7755230,7755230,7754930,300,0,utRho05
2161,yidE,7732780,7732780,7732546,234,0,utRho05
2162,yidF,7711580,7711580,7711222,358,188,utRho05
2163,yidQ,7735088,7735456,7735088,368,616,utRho05
2164,yidR,7738824,7738824,7738618,206,0,utRho05
2165,yieE,7787658,7787738,7787658,80,204,utRho05
2166,yieH,7793314,7793548,7793314,234,2,utRho05
2167,yieK,7798928,7798928,7798786,142,0,utRho05
2168,yifB,7900350,7900350,7899998,352,118,utRho05
2169,yifL,7988984,7989044,7988984,60,112,utRho05
2170,yigF,8005750,8005750,8005598,152,200,utRho05
2171,yigI,8009448,8009448,8009394,54,44,utRho05
2172,yigM,8022100,8022152,8022100,52,82,utRho05
2173,yihA,8101970,8101970,8101458,512,494,utRho05
2174,yihD,8084098,8084138,8084098,40,72,utRho05
2175,yihF,8088110,8088398,8088110,288,0,utRho05
2176,yihG,8093304,8093304,8093204,100,0,utRho05
2177,yihI,8102616,8102694,8102616,78,0,utRho05
2178,yihL,8120506,8120894,8120506,388,34,utRho05
2179,yihN,8124332,8124494,8124332,162,2,utRho05
2180,yihO,8131942,8131942,8131532,410,0,utRho05
2181,yihQ,8138892,8138892,8138552,340,2,utRho05
2182,yihV,8147064,8147478,8147064,414,0,utRho05
2183,yihX,8151096,8151106,8151096,10,120,utRho05
2184,yiiE,8158192,8158582,8158192,390,0,utRho05
2185,yiiF,8159124,8159502,8159124,378,28,utRho05
2186,yiiG,8173762,8174004,8173762,242,0,utRho05
2187,yiiM,8205506,8205644,8205506,138,128,utRho05
2188,yiiQ,8224624,8224624,8224428,196,0,utRho05
2189,yiiS,8225738,8225934,8225738,196,38,utRho05
2190,yijE,8272178,8272216,8272178,38,0,utRho05
2191,yijF,8275728,8275728,8275314,414,104,utRho05
2192,yijO,8296858,8296858,8296634,224,0,utRho05
2193,yjaA,8426240,8426468,8426240,228,101326,utRho05
2194,yjaB,8428312,8428312,8428246,66,472,utRho05
2195,yjaG,8398746,8399008,8398746,262,1396,utRho05
2196,yjaH,8401022,8401132,8401022,110,78,utRho05
2197,yjaZ,8379506,8379572,8379506,66,14,utRho05
2198,yjbB,8455204,8455462,8455204,258,0,utRho05
2199,yjbE,16943432,16943624,16943432,192,0,utRho05
2200,yjbL,8520318,8520642,8520318,324,0,utRho05
2201,yjbQ,8540428,8540476,8540428,48,2,utRho05
2202,yjcB,8550328,8550328,8550082,246,11850,utRho05
2203,yjcC,8550836,8550942,8550836,106,82,utRho05
2204,yjcD,8556628,8556958,8556628,330,370,utRho05
2205,yjcE,8559658,8559960,8559658,302,84,utRho05
2206,yjcF,8566212,8566212,8566150,62,0,utRho05
2207,yjcO,8594660,8594660,8594250,410,0,utRho05
2208,yjdA,8654128,8654270,8654128,142,0,utRho05
2209,yjdC,8726660,8726660,8726616,44,54,utRho05
2210,yjdK,8704780,8705168,8704780,388,224,utRho05
2211,yjdL,8713034,8713034,8712822,212,0,utRho05
2212,yjdM,8653672,8653672,8653468,204,2,utRho05
2213,yjeF,8787354,8788132,8787354,778,10542,utRho05
2214,yjeI,8745522,8745618,8745522,96,68,utRho05
2215,yjeJ,8748806,8748806,8748468,338,44,utRho05
2216,yjeV,8785472,8785784,8785472,312,282,utRho05
2217,yjfP,8833512,8833904,8833512,392,74,utRho05
2218,yjfY,8849656,8849656,8849582,74,22,utRho05
2219,yjfZ,8855052,8855052,8854844,208,0,utRho05
2220,yjgA,8916162,8916162,8915730,432,114,utRho05
2221,yjgL,8950802,8950874,8950802,72,0,utRho05
2222,yjgM,8959342,8959342,8959074,268,0,utRho05
2223,yjgN,8959132,8959460,8959132,328,0,utRho05
2224,yjgR,8980170,8980170,8980126,44,2,utRho05
2225,yjgZ,9002116,9002520,9002116,404,696,utRho05
2226,yjhB,9007764,9008116,9007764,352,2,utRho05
2227,yjhG,9048452,9048452,9048188,264,326,utRho05
2228,yjhU,9041080,9041080,9040648,432,550,utRho05
2229,yjiA,9178096,9178096,9177730,366,954,utRho05
2230,yjiJ,9125364,9125364,9125350,14,0,utRho05
2231,yjiK,9127270,9127270,9127422,152,128,utRho05
2232,yjiL,9129604,9129604,9129378,226,0,utRho05
2233,yjiS,9143410,9143502,9143410,92,18,utRho05
2234,yjiY,9182734,9182734,9182558,176,68,utRho05
2235,yjjA,9200674,9200674,9200378,296,486,utRho05
2236,yjjB,18408708,18408708,18407800,908,216,utRho05
2237,yjjJ,9243314,9243538,9243314,224,24,utRho05
2238,yjjK,9261132,9261132,9261044,88,66,utRho05
2239,yjjL,9189764,9189764,9189444,320,6,utRho05
2240,yjjM,9191894,9191894,9191702,192,0,utRho05
2241,yjjP,9206068,9206068,9205716,352,130,utRho05
2242,yjjQ,9206638,9206954,9206638,316,6,utRho05
2243,yjjX,9267798,9267798,9267490,308,632,utRho05
2244,yjjY,9280716,9280804,9280716,88,748,utRho05
2245,yjjZ,9211554,9211608,9211554,54,1912,utRho05
2246,yjtD,9281676,9281884,9281676,208,0,utRho05
2247,ykfB,532454,532454,532174,280,334,utRho05
2248,ykfI,527636,527636,527338,298,96,utRho05
2249,ykgB,637050,637050,636638,412,0,utRho05
2250,ykgC,640430,640430,640002,428,0,utRho05
2251,ykgD,640232,640454,640232,222,2,utRho05
2252,ykgE,642962,643216,642962,254,4,utRho05
2253,ykgJ,608524,608524,608364,160,34,utRho05
2254,ykgL,623878,624224,623878,346,4,utRho05
2255,ykgM,625610,625610,625554,56,4,utRho05
2256,ykgR,626570,626570,626484,86,0,utRho05
2257,ylaC,958576,958576,958502,74,1268,utRho05
2258,yliE,1745938,1745958,1745938,20,0,utRho05
2259,ymcE,2103660,2103694,2103660,34,874,utRho05
2260,ymdA,2210450,2210828,2210450,378,36,utRho05
2261,ymdB,2211428,2211640,2211428,212,54,utRho05
2262,ymfD,2395322,2395322,2395064,258,28,utRho05
2263,ymfI,2402880,2402994,2402880,114,0,utRho05
2264,ymfJ,2404518,2404518,2404168,350,62,utRho05
2265,ymfK,2406176,2406176,2405866,310,172,utRho05
2266,ymfT,2405766,2406048,2405766,282,174,utRho05
2267,ymgE,2489110,2489456,2489110,346,300,utRho05
2268,ymgF,2437628,2437966,2437628,338,0,utRho05
2269,ymiA,2670112,2670320,2670112,208,176,utRho05
2270,ymjA,2715620,2715620,2715336,284,1208,utRho05
2271,ynaI,2791946,2791946,2791844,102,0,utRho05
2272,ynaK,2850438,2850754,2850438,316,2,utRho05
2273,ynbA,2954924,2955242,2954924,318,0,utRho05
2274,yncD,3046552,3046552,3046130,422,194,utRho05
2275,yncE,3046454,3046614,3046454,160,0,utRho05
2276,yncG,3052456,3052494,3052456,38,10,utRho05
2277,yncL,3034492,3034492,3034388,104,94,utRho05
2278,yneE,3218364,3218364,3218044,320,6,utRho05
2279,yneF,3223748,3223748,3223708,40,0,utRho05
2280,yneJ,3229560,3229608,3229560,48,178,utRho05
2281,yneK,3231100,3231526,3231100,426,0,utRho05
2282,yneM,3245176,3245292,3245176,116,144,utRho05
2283,ynfA,3311398,3311398,3311346,52,0,utRho05
2284,ynfB,3311418,3311616,3311418,198,118,utRho05
2285,ynfC,3315094,3315094,3314914,180,0,utRho05
2286,ynfD,3314828,3315130,3314828,302,0,utRho05
2287,ynfE,3316006,3316138,3316006,132,30,utRho05
2288,ynfK,3334670,3334670,3334438,232,110,utRho05
2289,ynfL,3339304,3339304,3339184,120,0,utRho05
2290,ynfM,3339260,3339398,3339260,138,0,utRho05
2291,ynfN,3276598,3276598,3276218,380,1502,utRho05
2292,ynfO,3273454,3273512,3273454,58,4,utRho05
2293,ynhG,3517890,3517890,3517450,440,532,utRho05
2294,yniA,3615158,3615592,3615158,434,0,utRho05
2295,yniB,3618526,3618526,3618466,60,0,utRho05
2296,yniC,3618652,3618760,3618652,108,0,utRho05
2297,yniD,3610202,3610330,3610202,128,0,utRho05
2298,ynjE,3678880,3678934,3678880,54,0,utRho05
2299,ynjF,3683222,3683222,3682806,416,42,utRho05
2300,ynjH,3684376,3684376,3684270,106,44,utRho05
2301,ynjI,3690022,3690022,3689742,280,58,utRho05
2302,yoaB,3786642,3786734,3786642,92,88,utRho05
2303,yoaC,3787932,3788146,3787932,214,406,utRho05
2304,yoaE,3803544,3803544,3803170,374,52,utRho05
2305,yoaF,3755444,3755444,3755064,380,818,utRho05
2306,yoaH,3789866,3789866,3789462,404,384,utRho05
2307,yobB,3850418,3850880,3850418,462,862,utRho05
2308,yobF,3815586,3815586,3815182,404,58,utRho05
2309,yobH,3817800,3817850,3817800,50,0,utRho05
2310,yodB,4084352,4084736,4084352,384,48,utRho05
2311,yodC,4057008,4057008,4056740,268,0,utRho05
2312,yohC,4451358,4451358,4451262,96,8,utRho05
2313,yohD,4451526,4451602,4451526,76,0,utRho05
2314,yohJ,4460986,4461248,4460986,262,0,utRho05
2315,yohO,4431172,4431314,4431172,142,0,utRho05
2316,yojI,4617282,4617282,4617230,52,0,utRho05
2317,ypdI,4988988,4989396,4988988,408,60,utRho05
2318,ypfG,5165786,5165786,5165554,232,0,utRho05
2319,ypfM,5182140,5182140,5181732,408,154,utRho05
2320,yphB,5349590,5349590,5349376,214,0,utRho05
2321,ypjA,5565644,5565644,5565452,192,4,utRho05
2322,ypjB,5569636,5569636,5568858,778,0,utRho05
2323,ypjD,5495860,5495774,5495860,86,0,utRho05
2324,yqaE,5594170,5594170,5594056,114,0,utRho05
2325,yqcA,5846100,5846100,5845968,132,4,utRho05
2326,yqcE,5800944,5801184,5800944,240,0,utRho05
2327,yqeC,6030468,6030468,6030114,354,56,utRho05
2328,yqeF,5971618,5971618,5971184,434,14,utRho05
2329,yqeG,5971438,5971694,5971438,256,16,utRho05
2330,yqeH,5975016,5975072,5975016,56,14,utRho05
2331,yqeI,5976688,5977004,5976688,316,0,utRho05
2332,yqeK,5981140,5981140,5980720,420,10,utRho05
2333,yqfA,6086728,6086728,6086296,432,20,utRho05
2334,yqgA,6219042,6219106,6219042,64,0,utRho05
2335,yqgB,6172500,6172500,6172102,398,1934,utRho05
2336,yqgE,6185768,6185874,6185768,106,710,utRho05
2337,yqhA,6299150,6299150,6298942,208,0,utRho05
2338,yqhC,6310768,6310768,6310436,332,158,utRho05
2339,yqhD,6310604,6310710,6310604,106,92,utRho05
2340,yqhH,6316842,6317254,6316842,412,982,utRho05
2341,yqiC,6369662,6369680,6369662,18,2,utRho05
2342,yqiJ,6384108,6384416,6384108,308,440,utRho05
2343,yqjA,6495096,6495546,6495096,450,8842,utRho05
2344,yqjF,6500932,6501124,6500932,192,222,utRho05
2345,yqjG,6501948,6502048,6501948,100,0,utRho05
2346,yqjH,6433078,6433078,6432982,96,44,utRho05
2347,yqjI,6433506,6433558,6433506,52,0,utRho05
2348,yraH,6574552,6574852,6574552,300,0,utRho05
2349,yraP,6592144,6592818,6592144,674,248,utRho05
2350,yraQ,6596414,6596414,6596276,138,0,utRho05
2351,yraR,6598024,6598024,6597692,332,2,utRho05
2352,yrbG,13360844,13361100,13360844,256,112,utRho05
2353,yrbL,6696842,6696904,6696842,62,200,utRho05
2354,yrbN,6616172,6616172,6615866,306,23814,utRho05
2355,yrdB,6860176,6860176,6860046,130,160,utRho05
2356,yrfF,7052548,7052938,7052548,390,250,utRho05
2357,yrhB,7169440,7169518,7169440,78,0,utRho05
2358,ysaB,7451804,7451804,7451424,380,102,utRho05
2359,ysgA,8032686,8032686,8032338,348,160,utRho05
2360,ytfB,8857638,8857638,8857434,204,148,utRho05
2361,ytfE,8864018,8864018,8863966,52,52,utRho05
2362,ytfF,8866296,8866296,8866130,166,0,utRho05
2363,ytfH,8868164,8868226,8868164,62,0,utRho05
2364,ytfI,8875234,8875414,8875234,180,2,utRho05
2365,ytfJ,8878572,8878572,8878524,48,0,utRho05
2366,ytfK,8879022,8879174,8879022,152,174,utRho05
2367,ytfL,8882642,8882642,8882430,212,84,utRho05
2368,ytfQ,8899634,8899924,8899634,290,26,utRho05
2369,ytjB,9249598,9249598,9249578,20,50,utRho05
2370,yzfA,8896588,8896588,8896490,98,0,utRho05
2371,zapA,6111102,6111224,6111102,122,8984,utRho05
2372,zapB,8236772,8237030,8236772,258,90,utRho05
2373,zapC,2011700,2011904,2011700,204,30,utRho05
2374,zinT,4082692,4082750,4082692,58,0,utRho05
2375,zipA,5062814,5062814,5062466,348,48,utRho05
2376,zitB,1569716,1569716,1569646,70,26,utRho05
2377,zntA,7212844,7212902,7212844,58,106,utRho05
2378,zntR,6878336,6878336,6878260,76,24,utRho05
2379,znuA,3885322,3885322,3885166,156,66,utRho05
2380,znuC,3885268,3885324,3885268,56,66,utRho05
2381,zraP,8403424,8403424,8403376,48,0,utRho05
2382,zraS,8403810,8403852,8403810,42,0,utRho05
2383,zupT,6364866,6365100,6364866,234,896,utRho05
2384,zur,8520282,8520282,8520006,276,2662,utRho05
2385,zwf,3872752,3872752,3872628,124,88,utRho05
0,C0343,2818676,2818728,2818676,52,0,utRho06
1,aaeB,6776526,6776526,6776376,150,0,utRho06
2,aaeR,6778762,6779040,6778762,278,34,utRho06
3,aaeX,6778860,6778860,6778674,186,68,utRho06
4,aat,1854920,1854920,1854864,56,66,utRho06
5,accA,416822,417242,416822,420,1426,utRho06
6,accB,6810280,6810872,6810280,592,4916,utRho06
7,accD,4868030,4868030,4867852,178,296,utRho06
8,aceB,8430804,8430956,8430804,152,0,utRho06
9,aceE,245938,246034,245938,96,438,utRho06
10,ackA,4826918,4826940,4826918,22,1182,utRho06
11,acnA,2670848,2671662,2670848,814,668,utRho06
12,acnB,263038,263230,263038,192,360,utRho06
13,acpP,2303148,2303230,2303148,82,118,utRho06
14,acpS,5402324,5402324,5401996,328,142,utRho06
15,acrA,971396,971396,971238,158,172,utRho06
16,acrB,969370,969370,968806,564,2068,utRho06
17,acrD,5174950,5175190,5174950,240,40,utRho06
18,acrE,6827404,6827728,6827404,324,0,utRho06
19,acrR,971398,971522,971398,124,102,utRho06
20,acrZ,1589502,1589546,1589502,44,0,utRho06
21,acs,8575190,8575190,8574742,448,22,utRho06
22,actP,8569870,8569870,8569804,66,0,utRho06
23,ada,4620854,4620854,4620810,44,0,utRho06
24,add,3404404,3404466,3404404,62,28,utRho06
25,ade,7687802,7687928,7687802,126,0,utRho06
26,adhE,2596826,2596826,2596242,584,20,utRho06
27,adhP,3107988,3107988,3107676,312,608,utRho06
28,adiA,8681112,8681112,8681042,70,10,utRho06
29,adiC,8674404,8674404,8674062,342,0,utRho06
30,adiY,8676084,8676084,8675858,226,0,utRho06
31,adk,994278,994350,994278,72,94,utRho06
32,adrA,807374,807406,807374,32,0,utRho06
33,aer,6438240,6438240,6438152,88,44,utRho06
34,aes,1000102,1000102,999946,156,4,utRho06
35,agaR,6557406,6557406,6557330,76,0,utRho06
36,agaS,6563778,6563952,6563778,174,14,utRho06
37,agp,2131118,2131170,2131118,52,0,utRho06
38,agrA,7296126,7296126,7296126,0,0,utRho06
39,agrB,7296588,7296588,7296588,0,0,utRho06
40,ahpC,1277386,1277890,1277386,504,606,utRho06
41,ahpF,1278004,1279506,1278004,1502,35450,utRho06
42,ahr,8992698,8992698,8992418,280,0,utRho06
43,aidB,8828494,8828550,8828494,56,56,utRho06
44,ais,4731512,4731512,4731240,272,0,utRho06
45,alaA,4814816,4815122,4814816,306,2,utRho06
46,alaC,4996798,4996798,4996590,208,0,utRho06
47,alaE,5598140,5598328,5598140,188,48,utRho06
48,alaS,5644180,5644180,5644022,158,1116,utRho06
49,alaW,5036612,5036612,5036462,150,0,utRho06
50,aldA,2976380,2976464,2976380,84,158,utRho06
51,aldB,7513070,7513070,7513022,48,58,utRho06
52,alkA,4295118,4295118,4295080,38,0,utRho06
53,alkB,4618890,4618890,4618682,208,0,utRho06
54,allA,1064780,1064902,1064780,122,0,utRho06
55,allD,1092822,1092822,1092726,96,0,utRho06
56,allE,1088112,1088112,1088092,20,22,utRho06
57,allS,1064600,1064600,1064442,158,0,utRho06
58,alr,8531178,8531564,8531178,386,1746,utRho06
59,alsE,8617334,8617334,8616956,378,22,utRho06
60,alsK,8615990,8615990,8615598,392,28,utRho06
61,alx,6476740,6477160,6476740,420,0,utRho06
62,amiA,5104482,5104704,5104482,222,40,utRho06
63,amiC,5898378,5898378,5898020,358,0,utRho06
64,amn,4110062,4110122,4110062,60,0,utRho06
65,ampC,8758006,8758006,8757888,118,0,utRho06
66,ampD,237362,237466,237362,104,70,utRho06
67,ampG,907372,907372,907090,282,262,utRho06
68,ampH,792726,792726,792574,152,116,utRho06
69,amyA,4012230,4012312,4012230,82,14,utRho06
70,anmK,3439346,3439346,3439204,142,0,utRho06
71,ansB,6201580,6201580,6201456,124,108,utRho06
72,ansP,3052040,3052040,3051960,80,128,utRho06
73,apaG,104068,104068,103212,856,3664,utRho06
74,apaH,102586,102586,102444,142,5026,utRho06
75,apbE,4623188,4623188,4623068,120,78,utRho06
76,appA,2081198,2081234,2081198,36,20,utRho06
77,appC,2075420,2075480,2075420,60,0,utRho06
78,appY,1167134,1167362,1167134,228,0,utRho06
79,apt,982620,982824,982620,204,236,utRho06
80,aqpZ,1832424,1832424,1832094,330,0,utRho06
81,araB,140150,140150,140096,54,0,utRho06
82,araC,140482,140774,140482,292,22,utRho06
83,araE,5964416,5964416,5964364,52,0,utRho06
84,araF,3972476,3972476,3972256,220,0,utRho06
85,araH,3967120,3967120,3967086,34,2,utRho06
86,araJ,825058,825058,824962,96,2,utRho06
87,arcA,9281602,9281602,9280612,990,3968,utRho06
88,arcB,6706098,6706098,6706050,48,0,utRho06
89,arcZ,6701154,6701154,6701154,0,0,utRho06
90,arfA,6877346,6877346,6877298,48,424,utRho06
91,argA,5898312,5898484,5898312,172,0,utRho06
92,argC,8309770,8310002,8309770,232,120,utRho06
93,argD,6980442,6980442,6980360,82,0,utRho06
94,argE,8310156,8310156,8309694,462,120,utRho06
95,argF,580680,580680,580610,70,0,utRho06
96,argG,6637124,6637274,6637124,150,12,utRho06
97,argI,8956688,8956688,8956622,66,8,utRho06
98,argO,6137672,6137672,6137616,56,210,utRho06
99,argP,6119460,6119506,6119460,46,0,utRho06
100,argR,6769204,6769406,6769204,202,52,utRho06
101,argS,3920002,3920124,3920002,122,0,utRho06
102,argT,4855698,4855698,4855582,116,168,utRho06
103,argU,1129406,1129446,1129406,40,0,utRho06
104,argW,4932616,4932618,4932616,2,36,utRho06
105,argX,7964728,7964750,7964728,22,42,utRho06
106,aroF,5482402,5482402,5482300,102,54,utRho06
107,aroG,1571182,1571266,1571182,84,148,utRho06
108,aroH,3576636,3576870,3576636,234,322,utRho06
109,aroK,7038760,7038760,7038128,632,2182,utRho06
110,aroL,812560,812810,812560,250,140,utRho06
111,aroP,243342,243342,243102,240,0,utRho06
112,arpA,8445382,8445382,8444974,408,142,utRho06
113,arrS,7316108,7316108,7316108,0,0,utRho06
114,arsR,7297024,7297056,7297024,32,26,utRho06
115,artJ,1801252,1801252,1801150,102,0,utRho06
116,artP,1807686,1807686,1807468,218,0,utRho06
117,ascF,5678858,5679048,5678858,190,0,utRho06
118,ascG,5678574,5678574,5678528,46,0,utRho06
119,aslB,7965562,7965916,7965562,354,25434,utRho06
120,asnA,7854258,7854310,7854258,52,74,utRho06
121,asnB,1398444,1398444,1398354,90,206,utRho06
122,asnC,23562186,23562186,23562018,168,192,utRho06
123,asnS,1978088,1978088,1977970,118,7050,utRho06
124,asnT,4089082,4089098,4089082,16,38,utRho06
125,asnU,4119690,4119702,4119690,12,0,utRho06
126,asnV,4124504,4124520,4124504,16,0,utRho06
127,aspA,17473728,17473728,17473308,420,64,utRho06
128,aspC,1971486,1971486,1971418,68,298,utRho06
129,aspS,3901402,3901402,3901044,358,58,utRho06
130,aspT,7893560,7893744,7893560,184,92464,utRho06
131,aspV,473826,473862,473826,36,26,utRho06
132,asr,3342654,3342752,3342654,98,54,utRho06
133,astC,3664088,3664088,3663964,124,0,utRho06
134,astE,3654138,3654138,3653846,292,0,utRho06
135,atoD,4646824,4646894,4646824,70,4,utRho06
136,atpB,7844540,7844540,7844102,438,496,utRho06
137,atpC,7832118,7832118,7831944,174,1220,utRho06
138,atpI,7845050,7845050,7844880,170,0,utRho06
139,avtA,7479348,7479410,7479348,62,354,utRho06
140,azoR,2965982,2965982,2965720,262,56,utRho06
141,azuC,3976002,3976002,3975918,84,96,utRho06
142,bacA,6408350,6408350,6408262,88,2,utRho06
143,bamA,394052,395856,394052,1804,870,utRho06
144,bamB,5277950,5277950,5277304,646,1988,utRho06
145,bamC,5198028,5198028,5197730,298,1488,utRho06
146,bamD,5471922,5472292,5471922,370,4006,utRho06
147,bamE,5506972,5507210,5506972,238,784,utRho06
148,basS,8666954,8666954,8666544,410,428,utRho06
149,bax,7474468,7474468,7474354,114,150,utRho06
150,bcp,5200874,5200956,5200874,82,994,utRho06
151,bcsB,7385346,7385346,7385214,132,0,utRho06
152,bcsE,7392644,7392916,7392644,272,0,utRho06
153,bdcA,8948128,8948128,8948106,22,32,utRho06
154,bdcR,8948192,8948248,8948192,56,26,utRho06
155,bdm,3112680,3112680,3112560,120,0,utRho06
156,betA,654522,654522,654494,28,202,utRho06
157,betI,658722,658722,658668,54,14,utRho06
158,betT,658842,658926,658842,84,14,utRho06
159,bfr,6933498,6933498,6933450,48,0,utRho06
160,bglG,23440182,23440182,23439402,780,6,utRho06
161,bglX,4444240,4444240,4443978,262,0,utRho06
162,bhsA,2337962,2338146,2337962,184,114,utRho06
163,bioA,1618584,1618584,1618514,70,0,utRho06
164,bioB,1618604,1618688,1618604,84,0,utRho06
165,bioH,7089716,7089716,7089688,28,0,utRho06
166,bisC,7433026,7433026,7432788,238,0,utRho06
167,blc,8755490,8755490,8755444,46,0,utRho06
168,blr,3409024,3409102,3409024,78,142,utRho06
169,bluF,2431226,2431226,2430950,276,1482,utRho06
170,bluR,2428226,2428226,2428118,108,0,utRho06
171,bolA,908698,908944,908698,246,0,utRho06
172,borD,1157842,1157842,1157786,56,0,utRho06
173,brnQ,838976,839182,838976,206,1858,utRho06
174,bssR,1756492,1756496,1756492,4,0,utRho06
175,bssS,2242116,2242116,2241910,206,376,utRho06
176,btuB,8326798,8327278,8326798,480,2232,utRho06
177,cadB,8720212,8720212,8720062,150,0,utRho06
178,cadC,8723926,8723926,8723868,58,0,utRho06
179,caiE,70998,70998,70742,256,0,utRho06
180,caiF,68436,68600,68436,164,0,utRho06
181,caiT,84074,84074,83862,212,0,utRho06
182,can,285406,285406,285340,66,80,utRho06
183,carA,59102,59302,59102,200,0,utRho06
184,carB,61550,61634,61550,84,20,utRho06
185,cas2,5757830,5757830,5757706,124,2,utRho06
186,casA,5768638,5768638,5768276,362,0,utRho06
187,cbl,4121882,4121882,4121828,54,2,utRho06
188,cbpA,2128074,2128074,2127550,524,222,utRho06
189,cbrA,7738628,7738754,7738628,126,0,utRho06
190,cbrB,7794958,7795012,7794958,54,12,utRho06
191,ccmH,4585242,4585242,4584820,422,0,utRho06
192,cdaR,364894,364926,364894,32,0,utRho06
193,cdd,4463638,4463688,4463638,50,40,utRho06
194,cdh,8219814,8219860,8219814,46,54,utRho06
195,cdsA,391110,391354,391110,244,1930,utRho06
196,cedA,3627484,3627484,3627326,158,0,utRho06
197,cfa,3482402,3482826,3482402,424,250,utRho06
198,chaC,2544844,2544972,2544844,128,0,utRho06
199,chbB,3643452,3643452,3643238,214,0,utRho06
200,chbG,3634624,3634624,3634270,354,4,utRho06
201,cheW,3946924,3946924,3946678,246,280,utRho06
202,chiA,6939792,6939792,6939706,86,0,utRho06
203,chiP,1416472,1416668,1416472,196,0,utRho06
204,cho,3646984,3647030,3646984,46,30,utRho06
205,chpS,8896804,8896894,8896804,90,0,utRho06
206,cirA,4493884,4493884,4493538,346,384,utRho06
207,citC,1304078,1304078,1303712,366,0,utRho06
208,citT,1293264,1293264,1293160,104,0,utRho06
209,clcA,350104,350214,350104,110,28,utRho06
210,clpA,1846160,1846528,1846160,368,4,utRho06
211,clpB,5468410,5468410,5468346,64,62,utRho06
212,clpP,913154,913354,913154,200,300,utRho06
213,clpS,1845500,1845826,1845500,326,0,utRho06
214,clpX,914404,914852,914404,448,710,utRho06
215,clsA,2617346,2617346,2617290,56,58,utRho06
216,clsC,2212584,2212710,2212584,126,366,utRho06
217,cmk,1922330,1922402,1922330,72,174,utRho06
218,cnu,3409522,3409898,3409522,376,430,utRho06
219,coaA,8350214,8350214,8350052,162,546,utRho06
220,cobC,1340092,1340092,1339814,278,428,utRho06
221,cobT,4129202,4129202,4128934,268,76,utRho06
222,cobU,4131944,4131944,4131528,416,72,utRho06
223,codB,709768,709844,709768,76,0,utRho06
224,comR,2337726,2337726,2337664,62,28,utRho06
225,copA,1022822,1022822,1022758,64,0,utRho06
226,corA,8002388,8002852,8002388,464,3566,utRho06
227,cpdB,8873258,8873258,8873130,128,74,utRho06
228,cptB,6082198,6082198,6082140,58,6,utRho06
229,cpxA,8210202,8210202,8209950,252,586,utRho06
230,cpxP,8211570,8211640,8211570,70,34,utRho06
231,cpxR,8211372,8211372,8211340,32,0,utRho06
232,cra,175894,176056,175894,162,0,utRho06
233,crcB,1316016,1316016,1315876,140,0,utRho06
234,creA,9270486,9271042,9270486,556,682,utRho06
235,creD,9276320,9276356,9276320,36,34,utRho06
236,crl,515620,515658,515620,38,1272,utRho06
237,crp,6971906,6972240,6971906,334,4522,utRho06
238,crr,5070960,5071668,5070960,708,3314,utRho06
239,csdA,5886414,5886674,5886414,260,52,utRho06
240,csgB,2207718,2207902,2207718,184,2,utRho06
241,csgD,2206688,2206688,2206392,296,0,utRho06
242,csgG,2203510,2203510,2203368,142,50,utRho06
243,csiD,5577854,5577970,5577854,116,2,utRho06
244,csiE,5330802,5330870,5330802,68,18,utRho06
245,csiR,5590942,5591348,5590942,406,0,utRho06
246,cspA,7439778,7440098,7439778,320,369996,utRho06
247,cspB,3283430,3283430,3283108,322,556,utRho06
248,cspC,3815018,3815018,3814870,148,608,utRho06
249,cspD,1845352,1845352,1845180,172,416,utRho06
250,cspE,1314294,1314584,1314294,290,24,utRho06
251,cspF,3283380,3283710,3283380,330,52,utRho06
252,cspG,2102610,2102922,2102610,312,106514,utRho06
253,cspH,2102746,2102746,2102350,396,334,utRho06
254,cspI,3277624,3277624,3277334,290,254,utRho06
255,csrA,5638746,5638746,5638292,454,1040,utRho06
256,csrB,5849048,5849048,5849048,0,0,utRho06
257,csrC,8102072,8102072,8102072,0,0,utRho06
258,csrD,6806850,6806850,6806664,186,0,utRho06
259,cstA,1259710,1259788,1259710,78,0,utRho06
260,cueO,274090,274166,274090,76,0,utRho06
261,cueR,1027948,1027986,1027948,38,26,utRho06
262,curA,3037784,3038054,3037784,270,0,utRho06
263,cusC,1191146,1191200,1191146,54,0,utRho06
264,cusR,1190924,1190924,1190886,38,12,utRho06
265,cutA,8730784,8730784,8730712,72,286,utRho06
266,cutC,3918534,3918534,3917920,614,164,utRho06
267,cvpA,4861600,4861600,4861526,74,106,utRho06
268,cvrA,2484328,2484328,2484142,186,246,utRho06
269,cyaA,7981548,7982306,7981548,758,1056,utRho06
270,cyaR,4334228,4334224,4334228,4,0,utRho06
271,cyaY,7988166,7988166,7988118,48,46,utRho06
272,cybB,2981522,2981804,2981522,282,60,utRho06
273,cycA,8859560,8859728,8859560,168,404,utRho06
274,cydA,1542340,1542916,1542340,576,160,utRho06
275,cydC,1858800,1858800,1858390,410,90,utRho06
276,cydD,1862062,1862062,1861924,138,96,utRho06
277,cydX,1548300,1548392,1548300,92,218,utRho06
278,cynR,717418,717418,717380,38,0,utRho06
279,cynT,1435092,1435196,1435092,104,0,utRho06
280,cyoA,903306,903306,903220,86,1324,utRho06
281,cyoE,895540,895540,895410,130,418,utRho06
282,cysB,2667576,2667710,2667576,134,308,utRho06
283,cysC,5748056,5748056,5747984,72,0,utRho06
284,cysD,5752736,5752736,5752658,78,0,utRho06
285,cysE,7565362,7565362,7565124,238,738,utRho06
286,cysG,6995508,6995656,6995508,148,0,utRho06
287,cysJ,5783928,5783928,5783796,132,1576,utRho06
288,cysK,5064688,5064818,5064688,130,0,utRho06
289,cysP,5087114,5087114,5087056,58,180,utRho06
290,cysS,1109154,1109222,1109154,68,52,utRho06
291,cysT,3984100,3984100,3983974,126,306,utRho06
292,cysZ,5062766,5062926,5062766,160,188,utRho06
293,cytR,8249018,8249018,8248912,106,120,utRho06
294,dacA,1328002,1328002,1327926,76,106,utRho06
295,dacB,6657714,6657926,6657714,212,60,utRho06
296,dacC,1761306,1761454,1761306,148,0,utRho06
297,dadA,2475018,2475142,2475018,124,0,utRho06
298,dam,7032504,7032504,7031826,678,1104,utRho06
299,damX,7035200,7035200,7034612,588,476,utRho06
300,dapA,5199568,5199568,5199520,48,0,utRho06
301,dapB,56576,56748,56576,172,8,utRho06
302,dapD,371954,371954,371894,60,54,utRho06
303,dapE,5183120,5183214,5183120,94,450,utRho06
304,dcp,3254844,3254844,3254760,84,6,utRho06
305,dcrB,7219534,7219910,7219534,376,66,utRho06
306,dctA,7366996,7366996,7366894,102,580,utRho06
307,dcuA,8733686,8733686,8733546,140,0,utRho06
308,dcuB,8698182,8698182,8697488,694,16,utRho06
309,dcuC,1312166,1312166,1311936,230,0,utRho06
310,dcuD,6749166,6749738,6749166,572,0,utRho06
311,dcuR,8701130,8701130,8700068,1062,384,utRho06
312,dcuS,8703370,8703370,8703324,46,4,utRho06
313,dcyD,3999016,3999016,3998960,56,0,utRho06
314,ddpX,3126498,3126498,3126152,346,0,utRho06
315,deaD,6615818,6615818,6615720,98,4236,utRho06
316,dedA,4869880,4869880,4869482,398,9008,utRho06
317,dedD,4863750,4863750,4863368,382,72,utRho06
318,def,6867300,6867380,6867300,80,66,utRho06
319,degP,361690,361768,361690,78,0,utRho06
320,degQ,6761308,6761486,6761308,178,2664,utRho06
321,deoB,9239134,9239206,9239134,72,0,utRho06
322,deoC,9233358,9234646,9233358,1288,24,utRho06
323,dfp,7625406,7625462,7625406,56,18,utRho06
324,dgcZ,3247758,3247758,3247700,58,0,utRho06
325,dgkA,8512914,8513274,8512914,360,366,utRho06
326,dgt,358392,358474,358392,82,52,utRho06
327,dhaK,2501888,2501888,2501676,212,82,utRho06
328,dhaR,2502006,2502132,2502006,126,0,utRho06
329,dicB,3299194,3299218,3299194,24,0,utRho06
330,dicC,3295752,3295752,3295700,52,0,utRho06
331,dinB,501760,501796,501760,36,0,utRho06
332,dinD,7635398,7635520,7635398,122,284,utRho06
333,dinG,1666146,1666140,1666146,6,22,utRho06
334,dinI,2243018,2243018,2242974,44,14,utRho06
335,dinJ,493230,493230,493004,226,6,utRho06
336,dinQ,7295964,7295964,7295576,388,1258,utRho06
337,djlA,114536,114728,114536,192,0,utRho06
338,dkgA,6313142,6313246,6313142,104,2,utRho06
339,dkgB,458196,458334,458196,138,380,utRho06
340,dksA,321502,321502,321208,294,204,utRho06
341,dld,4444164,4444370,4444164,206,0,utRho06
342,dmlA,3763424,3763824,3763424,400,42,utRho06
343,dmlR,3763710,3763710,3763618,92,20,utRho06
344,dmsA,1881646,1881918,1881646,272,34,utRho06
345,dnaA,7767922,7767922,7767458,464,5198,utRho06
346,dnaB,8528566,8528628,8528566,62,192,utRho06
347,dnaK,24096,24326,24096,230,68,utRho06
348,dnaN,7765466,7765466,7764642,824,874,utRho06
349,dnaQ,471868,472134,471868,266,786,utRho06
350,dnaT,18406460,18406460,18406068,392,76,utRho06
351,dnaX,984112,984184,984112,72,616,utRho06
352,dosP,3131486,3131486,3131466,20,0,utRho06
353,dpiB,1303968,1304470,1303968,502,0,utRho06
354,dppA,7415740,7415740,7415410,330,1382,utRho06
355,dps,1697900,1697900,1697822,78,64,utRho06
356,dsbA,8086754,8086836,8086754,82,2012,utRho06
357,dsbB,2466294,2466294,2466060,234,58,utRho06
358,dsbC,6079266,6079266,6077644,1622,1206,utRho06
359,dsbG,1277600,1277600,1277146,454,266,utRho06
360,dsdA,4958242,4958404,4958242,162,56,utRho06
361,dsdC,4955492,4955492,4955258,234,0,utRho06
362,dsdX,4955642,4955694,4955642,52,0,utRho06
363,dsrA,4050626,4050626,4050626,0,0,utRho06
364,dsrB,4049686,4049686,4049646,40,66,utRho06
365,dtpD,1485340,1485340,1485112,228,24,utRho06
366,dusA,8523200,8523338,8523200,138,3360,utRho06
367,dusB,6820492,6820560,6820492,68,74,utRho06
368,dusC,4460790,4460790,4460770,20,0,utRho06
369,dut,7627704,7627864,7627704,160,928,utRho06
370,dxr,386670,387042,386670,372,490,utRho06
371,ebgA,6445102,6445266,6445102,164,8,utRho06
372,ebgR,6442874,6442932,6442874,58,80,utRho06
373,ecnB,8753018,8753106,8753018,88,340,utRho06
374,eco,4607594,4607810,4607594,216,2,utRho06
375,ecpA,621594,621594,621342,252,0,utRho06
376,ecpB,620238,620238,620052,186,0,utRho06
377,ecpR,622964,622964,622672,292,0,utRho06
378,eda,3866218,3866218,3865512,706,72,utRho06
379,edd,3869426,3869426,3869208,218,74,utRho06
380,efeO,2164308,2164486,2164308,178,32,utRho06
381,efeU_1,2162614,2162712,2162614,98,10,utRho06
382,efp,8751134,8751398,8751134,264,7400,utRho06
383,elaA,4763372,4763372,4763086,286,76,utRho06
384,elaD,4765308,4765426,4765308,118,46,utRho06
385,elfA,1995530,1995736,1995530,206,0,utRho06
386,elfD,1996642,1996980,1996642,338,0,utRho06
387,emrD,7707690,7707844,7707690,154,0,utRho06
388,emrK,4966896,4966896,4966678,218,0,utRho06
389,emrY,4964668,4964668,4964352,316,0,utRho06
390,emtA,2486250,2486360,2486250,110,0,utRho06
391,endA,12361100,12361388,12361100,288,0,utRho06
392,eno,5817692,5817692,5815882,1810,2710,utRho06
393,entC,1249662,1249770,1249662,108,50,utRho06
394,entD,1220508,1220508,1220158,350,272,utRho06
395,entH,1258584,1258600,1258584,16,84,utRho06
396,entS,1244506,1244600,1244506,94,0,utRho06
397,envR,6827266,6827266,6826930,336,0,utRho06
398,epd,12295292,12295292,12294764,528,360,utRho06
399,epmA,8765236,8765286,8765236,50,38,utRho06
400,epmB,8751406,8751406,8751314,92,4854,utRho06
401,eptB,7421162,7421162,7420950,212,442,utRho06
402,eptC,8300622,8300622,8300530,92,274,utRho06
403,erfK,4126708,4126708,4126646,62,1360,utRho06
404,erpA,353122,353220,353122,98,104,utRho06
405,esrE,8039956,8039956,8039956,0,0,utRho06
406,essD,1153746,1154796,1153746,1050,228,utRho06
407,etk,2088606,2088606,2088420,186,0,utRho06
408,evgA,4967262,4967510,4967262,248,44,utRho06
409,exbB,6304028,6304028,6303968,60,0,utRho06
410,exbD,6302780,6302780,6302486,294,78,utRho06
411,exuR,6493016,6493304,6493016,288,176,utRho06
412,exuT,6490004,6490208,6490004,204,0,utRho06
413,fabA,2032996,2032996,2032940,56,152,utRho06
414,fabB,4883282,4883282,4883210,72,78,utRho06
415,fabH,2297032,2297518,2297032,486,2316,utRho06
416,fabI,2702236,2702236,2702078,158,2,utRho06
417,fadB,8062026,8062026,8061942,84,0,utRho06
418,fadD,3779614,3779614,3779492,122,0,utRho06
419,fadE,486812,486812,486606,206,0,utRho06
420,fadH,6463248,6463330,6463248,82,0,utRho06
421,fadI,4921022,4921022,4920938,84,84,utRho06
422,fadL,4922410,4922600,4922410,190,34,utRho06
423,fadM,928720,928804,928720,84,36,utRho06
424,fadR,2469810,2469876,2469810,66,14,utRho06
425,fbaB,4357334,4357334,4357128,206,0,utRho06
426,fdhE,8162722,8162722,8162456,266,994,utRho06
427,fdhF,8598814,8598814,8598732,82,0,utRho06
428,fdnG,3094744,3094802,3094744,58,44,utRho06
429,fdrA,1093012,1093360,1093012,348,0,utRho06
430,feaB,2894994,2895038,2894994,44,0,utRho06
431,feaR,2894734,2894734,2894566,168,40,utRho06
432,fecA,9033454,9033454,9033354,100,302,utRho06
433,fecE,9023288,9023288,9022914,374,6694,utRho06
434,fecI,9036564,9036564,9036470,94,118,utRho06
435,feoA,7080114,7080326,7080114,212,134,utRho06
436,fepA,1225334,1225334,1224988,346,104,utRho06
437,fepB,1249454,1249454,1249020,434,680,utRho06
438,fepD,1244468,1244468,1244378,90,66,utRho06
439,fes,1225374,1225630,1225374,256,228,utRho06
440,ffh,5495706,5495706,5495590,116,1250,utRho06
441,ffs,952576,952848,952576,272,0,utRho06
442,fhuA,334884,334968,334884,84,220,utRho06
443,fhuE,2323294,2323294,2323102,192,214,utRho06
444,fhuF,9211504,9211504,9211326,178,2882,utRho06
445,fic,6983296,6983296,6982926,370,262,utRho06
446,fieF,8212864,8212938,8212864,74,84,utRho06
447,fimA,9085388,9086230,9085388,842,32,utRho06
448,fimB,9081334,9081914,9081334,580,190,utRho06
449,fimE,9083742,9084074,9083742,332,46,utRho06
450,fimZ,1129214,1129214,1128960,254,0,utRho06
451,fiu,1683296,1683296,1683062,234,162,utRho06
452,fixA,84650,84806,84650,156,0,utRho06
453,fkpA,6955050,6955050,6954838,212,6492,utRho06
454,fldA,2846084,2846084,2845860,224,2808,utRho06
455,fldB,6079644,6079710,6079644,66,116,utRho06
456,flgA,2261770,2261770,2261726,44,74,utRho06
457,flgB,2261986,2262036,2261986,50,0,utRho06
458,flgK,2276702,2276756,2276702,54,1106,utRho06
459,flgM,2260330,2260330,2260256,74,292,utRho06
460,flgN,2259828,2259828,2259660,168,162,utRho06
461,flhB,3932432,3932432,3932382,50,122,utRho06
462,flhC,3955864,3955864,3955688,176,2,utRho06
463,flhD,3957154,3957154,3956394,760,514,utRho06
464,fliA,4003638,4003638,4003578,60,36,utRho06
465,fliC,4007352,4007352,4007212,140,182,utRho06
466,fliD,4007634,4007744,4007634,110,358,utRho06
467,fliE,4026186,4026186,4026028,158,20,utRho06
468,fliF,4026292,4026458,4026292,166,154,utRho06
469,fliL,4039168,4039236,4039168,68,116,utRho06
470,flk,4875824,4875900,4875824,76,144,utRho06
471,flu,4142634,4143078,4142634,444,92,utRho06
472,flxA,3292776,3292810,3292776,34,0,utRho06
473,fnr,2799104,2799104,2799052,52,246,utRho06
474,fnrS,2818258,2818258,2818258,0,0,utRho06
475,focA,1909628,1909628,1908932,696,148,utRho06
476,folA,99598,99646,99598,48,0,utRho06
477,folB,6409296,6409296,6409178,118,0,utRho06
478,folD,1115562,1115562,1115482,80,158,utRho06
479,folE,4487696,4487696,4487304,392,2120,utRho06
480,fpr,8228998,8228998,8228944,54,58,utRho06
481,frc,4986878,4986878,4986508,370,0,utRho06
482,frdA,8764824,8764824,8764636,188,80,utRho06
483,frdD,8758948,8758948,8758732,216,66,utRho06
484,fre,8052886,8053054,8052886,168,1548,utRho06
485,frlA,6999518,6999820,6999518,302,0,utRho06
486,frr,385624,385744,385624,120,426,utRho06
487,frsA,513004,513054,513004,50,148,utRho06
488,fruB,4527194,4527194,4526990,204,0,utRho06
489,frvR,8179804,8179804,8179710,94,0,utRho06
490,fryA,5008986,5008986,5008970,16,2,utRho06
491,fsaA,1727060,1727284,1727060,224,0,utRho06
492,fsr,1009710,1009710,1009392,318,18,utRho06
493,ftnA,3977364,3977432,3977364,68,0,utRho06
494,ftnB,3973550,3973850,3973550,300,0,utRho06
495,ftsA,207122,207964,207122,842,320,utRho06
496,ftsB,5745802,5745802,5745640,162,42,utRho06
497,ftsH,6654204,6654204,6653870,334,1022,utRho06
498,ftsK,1865858,1866448,1865858,590,1402,utRho06
499,ftsL,181376,182064,181376,688,1076,utRho06
500,ftsP,6325732,6325732,6325338,394,284,utRho06
501,ftsQ,205484,206310,205484,826,766,utRho06
502,ftsX,7204512,7204512,7204172,340,636,utRho06
503,ftsZ,209272,210610,209272,1338,160,utRho06
504,fucA,5867708,5867708,5867376,332,0,utRho06
505,fucP,5868238,5868470,5868238,232,0,utRho06
506,fumA,6753760,6753760,6753508,252,1648,utRho06
507,fumB,8694696,8694696,8694652,44,0,utRho06
508,fumC,3373418,3373418,3373176,242,0,utRho06
509,fur,2842892,2842892,2842584,308,5280,utRho06
510,fusA,6947370,6947370,6947028,342,16300,utRho06
511,fxsA,8737206,8737328,8737206,122,162,utRho06
512,gabD,5581824,5582546,5581824,722,412,utRho06
513,gadA,7335214,7335214,7335160,54,0,utRho06
514,gadB,3144144,3144144,3144090,54,0,utRho06
515,gadC,3141168,3141168,3140978,190,54,utRho06
516,gadE,7315600,7316732,7315600,1132,0,utRho06
517,gadW,7329562,7329562,7329236,326,6,utRho06
518,gadX,14663356,14663356,14663240,116,0,utRho06
519,gadY,7329728,7329728,7329728,0,0,utRho06
520,galE,1584354,1584354,1584110,244,0,utRho06
521,galF,4228702,4228702,4228654,48,162,utRho06
522,galM,1577796,1577796,1577674,122,342,utRho06
523,galP,6176510,6176568,6176510,58,0,utRho06
524,galR,5953138,5953198,5953138,60,76,utRho06
525,galS,4483420,4483420,4483336,84,0,utRho06
526,galU,2582810,2582914,2582810,104,160,utRho06
527,gapA,3724480,3725542,3724480,1062,3302,utRho06
528,garP,6549868,6549868,6549814,54,30,utRho06
529,gatY,4354468,4354468,4354408,60,30,utRho06
530,gatZ,4352864,4352864,4352642,222,5162,utRho06
531,gcd,282558,282558,282450,108,0,utRho06
532,gcl,1067814,1067832,1067814,18,0,utRho06
533,gcvA,5885278,5885278,5885134,144,0,utRho06
534,gcvB,5885392,5885392,5885392,0,0,utRho06
535,gcvR,5199758,5199812,5199758,54,14,utRho06
536,gcvT,6101544,6101544,6101334,210,330,utRho06
537,gdhA,3684616,3684742,3684616,126,18,utRho06
538,gfcA,2099668,2099668,2099488,180,112,utRho06
539,gfcD,2096236,2096236,2095890,346,16,utRho06
540,ghrA,2195648,2195772,2195648,124,212,utRho06
541,ghrB,7434378,7434620,7434378,242,460,utRho06
542,glcA,6242728,6242728,6242558,170,0,utRho06
543,glcC,6256412,6256544,6256412,132,0,utRho06
544,glcD,6256152,6256152,6256042,110,28,utRho06
545,gldA,8278092,8278092,8278070,22,0,utRho06
546,glgA,7136784,7136784,7136066,718,2,utRho06
547,glgB,7147314,7147314,7147004,310,250,utRho06
548,glgC,7139142,7139142,7138656,486,18,utRho06
549,glgP,7133546,7133546,7133162,384,4,utRho06
550,glgS,6384024,6384024,6383878,146,0,utRho06
551,glgX,7142838,7142838,7142638,200,0,utRho06
552,glk,5018922,5018922,5018852,70,82,utRho06
553,glmS,7827622,7827622,7827336,286,4482,utRho06
554,glmU,7830652,7830652,7830400,252,478,utRho06
555,glmY,10765360,10765360,10765360,0,0,utRho06
556,glmZ,7972864,7972864,7972864,0,0,utRho06
557,glnA,16232888,16232888,16232136,752,468,utRho06
558,glnB,5375052,5375052,5374816,236,14,utRho06
559,glnD,377310,377310,377300,10,30,utRho06
560,glnE,6399602,6399602,6399282,320,0,utRho06
561,glnH,1696396,1696396,1696008,388,2,utRho06
562,glnK,945112,945196,945112,84,0,utRho06
563,glnL,8112742,8112742,8112678,64,2,utRho06
564,glnQ,1693262,1693262,1692926,336,426,utRho06
565,glnS,1411998,1412186,1411998,188,718,utRho06
566,gloA,3455602,3455674,3455602,72,0,utRho06
567,gloB,469852,469852,469564,288,810,utRho06
568,glpA,4705166,4705294,4705166,128,0,utRho06
569,glpD,7123942,7124026,7123942,84,64,utRho06
570,glpE,7123698,7123698,7123646,52,116,utRho06
571,glpF,8236322,8236322,8236180,142,80,utRho06
572,glpG,7122960,7122960,7122904,56,294,utRho06
573,glpR,7121782,7121782,7121210,572,138,utRho06
574,glpT,4704902,4704902,4704748,154,242,utRho06
575,glpX,8231212,8231212,8231158,54,6354,utRho06
576,glrK,5382246,5382246,5382196,50,262,utRho06
577,gltA,1509534,1509534,1508936,598,10844,utRho06
578,gltB,6709018,6709264,6709018,246,304,utRho06
579,gltI,1375792,1375792,1375494,298,1758,utRho06
580,gltP,8588536,8588962,8588536,426,1254,utRho06
581,gltS,7657382,7657382,7657330,52,134,utRho06
582,gltX,5041568,5041568,5041344,224,136,utRho06
583,gluQ,320286,320286,320224,62,68,utRho06
584,glyA,5371148,5371148,5371014,134,100,utRho06
585,glyQ,7450708,7450708,7450636,72,96,utRho06
586,glyS,7448990,7448990,7448794,196,1124,utRho06
587,glyU,5998128,5998128,5998114,14,0,utRho06
588,glyV,8784626,8784720,8784626,94,174,utRho06
589,glyW,3984360,3984360,3984234,126,18,utRho06
590,gmhB,445612,445666,445612,54,0,utRho06
591,gmk,7642776,7642856,7642776,80,26,utRho06
592,gmr,2693686,2693686,2693484,202,48,utRho06
593,gnd,4202648,4202648,4202536,112,422,utRho06
594,gnsB,3275692,3275692,3275564,128,86,utRho06
595,gntK,14310580,14310580,14310368,212,616,utRho06
596,gntP,9102668,9102668,9102592,76,0,utRho06
597,gntR,7157760,7157760,7157452,308,252,utRho06
598,gntT,7092810,7093118,7092810,308,156,utRho06
599,gntU,7154170,7154170,7154122,48,0,utRho06
600,gntX,7089334,7089764,7089334,430,34,utRho06
601,gor,7292224,7292598,7292224,374,1066,utRho06
602,gpmA,1575340,1575340,1575190,150,0,utRho06
603,gpmM,7570374,7570520,7570374,146,0,utRho06
604,gpsA,7567620,7567620,7567322,298,4342,utRho06
605,gpt,511828,511954,511828,126,418,utRho06
606,grcA,5433046,5433046,5432898,148,52,utRho06
607,greA,6657728,6657728,6657430,298,1686,utRho06
608,greB,7073488,7073624,7073488,136,64,utRho06
609,groL,8741566,8742050,8741566,484,302,utRho06
610,groS,8741232,8741376,8741232,144,176,utRho06
611,grpE,5501494,5501494,5501416,78,194,utRho06
612,grxA,1781552,1781552,1781506,46,0,utRho06
613,grxB,2248206,2248206,2248108,98,124,utRho06
614,grxC,7569152,7569152,7568884,268,3396,utRho06
615,grxD,3468324,3468324,3468202,122,5804,utRho06
616,gspA,6911268,6911268,6910796,472,2,utRho06
617,gspC,6910964,6911156,6910964,192,0,utRho06
618,gss,6277220,6277220,6277044,176,24,utRho06
619,gstA,3428654,3428754,3428654,100,8,utRho06
620,gstB,1761038,1761038,1760960,78,28,utRho06
621,guaB,5268214,5268214,5268140,74,50,utRho06
622,gudD,5839026,5839026,5838770,256,0,utRho06
623,gyrA,4678914,4678914,4678840,74,0,utRho06
624,gyrB,7760300,7760300,7760238,62,142,utRho06
625,hcaE,5337964,5338064,5337964,100,8,utRho06
626,hcaR,5337928,5337928,5337792,136,8,utRho06
627,hcaT,5336106,5336106,5335692,414,106,utRho06
628,hchA,4071260,4071670,4071260,410,0,utRho06
629,hcp,1828258,1828258,1827628,630,40,utRho06
630,hcr,1824400,1824400,1824300,100,8,utRho06
631,hdeA,7313582,7313582,7313480,102,0,utRho06
632,hdeD,7313920,7313990,7313920,70,0,utRho06
633,hdfR,7896320,7896320,7895934,386,72,utRho06
634,hdhA,3396244,3396244,3396080,164,30,utRho06
635,helD,2048876,2048942,2048876,66,0,utRho06
636,hemA,2527166,2527428,2527166,262,102,utRho06
637,hemB,779722,779722,779454,268,72,utRho06
638,hemF,5106410,5106450,5106410,40,106,utRho06
639,hemH,996062,996110,996062,48,118,utRho06
640,hemL,349882,349882,349764,118,14,utRho06
641,hemN,8103886,8104090,8103886,204,26,utRho06
642,hepA,127176,127176,126528,648,2668,utRho06
643,hflD,2385372,2385372,2385262,110,1298,utRho06
644,hfq,8799602,8800576,8799602,974,1834,utRho06
645,hha,961006,961006,960616,390,270,utRho06
646,hicA,3018442,3018572,3018442,130,14,utRho06
647,higA,6468682,6468682,6468288,394,100,utRho06
648,higB,6468960,6468960,6468910,50,28,utRho06
649,hinT,2323642,2323770,2323642,128,0,utRho06
650,hipB,3184964,3184964,3184884,80,0,utRho06
651,hisB,4186720,4186936,4186720,216,252,utRho06
652,hisJ,4853674,4853674,4853576,98,40,utRho06
653,hisL,8359856,8359984,8359856,128,712,utRho06
654,hisS,5281284,5281284,5281150,134,332,utRho06
655,hlpA,400910,400964,400910,54,128,utRho06
656,hlyE,2460932,2460932,2460788,144,0,utRho06
657,hmp,5371594,5371670,5371594,76,0,utRho06
658,hns,2585916,2585916,2585844,72,870,utRho06
659,hofM,7045856,7045856,7045502,354,0,utRho06
660,hokA,7441620,7441620,7441200,420,3858,utRho06
661,hokC,33902,33902,33806,96,138,utRho06
662,hokE,1215462,1215672,1215462,210,0,utRho06
663,holC,8968546,8968546,8968560,14,670,utRho06
664,holD,9215562,9215606,9215562,44,16,utRho06
665,holE,3850040,3850216,3850040,176,786,utRho06
666,hpt,282720,282862,282720,142,120,utRho06
667,hrpB,324150,324210,324150,60,70,utRho06
668,hscB,5319048,5319048,5318934,114,836,utRho06
669,hscC,1367188,1367188,1366786,402,216,utRho06
670,hsdS,9163004,9163004,9162924,80,4,utRho06
671,hslJ,2883560,2883560,2883486,74,32,utRho06
672,hslO,7059344,7059548,7059344,204,5206,utRho06
673,hslR,7058220,7058696,7058220,476,912,utRho06
674,hslV,8244708,8244708,8244574,134,96,utRho06
675,hsrA,7881412,7881412,7881224,188,162,utRho06
676,htgA,21286,21660,21286,374,804,utRho06
677,htpG,989634,990240,989634,606,4182,utRho06
678,htpX,3825236,3825236,3825152,84,0,utRho06
679,htrE,311036,311036,310852,184,2,utRho06
680,htrL,7587668,7587668,7587366,302,36,utRho06
681,hupA,8400352,8400562,8400352,210,408,utRho06
682,hupB,1845220,1845804,1845220,584,144,utRho06
683,hyaA,2063968,2064278,2063968,310,0,utRho06
684,hybO,6292726,6292726,6292522,204,748,utRho06
685,hycA,5700922,5700922,5700870,52,0,utRho06
686,hycI,5686204,5686204,5686086,118,40,utRho06
687,hydN,5676264,5676264,5676210,54,0,utRho06
688,hyfA,5202342,5202402,5202342,60,0,utRho06
689,hypA,11402508,11402588,11402508,80,0,utRho06
690,hypB,11403356,11404004,11403356,648,0,utRho06
691,hypF,5676210,5676210,5674850,1360,848,utRho06
692,hypT,9116634,9116634,9116578,56,0,utRho06
693,hyuA,6019660,6020056,6019660,396,0,utRho06
694,iaaA,1733074,1733136,1733074,62,0,utRho06
695,iadA,9119074,9119074,9119052,22,76,utRho06
696,iap,5753072,5753162,5753072,90,10,utRho06
697,ibaG,6673966,6673966,6673606,360,168,utRho06
698,ibpA,7735036,7735036,7734844,192,170,utRho06
699,ibpB,7733962,7733962,7733794,168,380,utRho06
700,icd,2389922,2390246,2389922,324,246,utRho06
701,iclR,8447304,8447304,8447256,48,8,utRho06
702,idi,6065876,6066130,6065876,254,0,utRho06
703,idnD,8988870,8988870,8988812,58,0,utRho06
704,idnK,8989194,8989246,8989194,52,0,utRho06
705,ihfA,3591442,3591442,3591104,338,888,utRho06
706,ihfB,1927498,1927656,1927498,158,356,utRho06
707,ileS,43666,44782,43666,1116,3006,utRho06
708,ileX,6431194,6431196,6431194,2,4,utRho06
709,ilvA,15820940,15821324,15820940,384,88,utRho06
710,ilvC,7915824,7915940,7915824,116,20,utRho06
711,ilvE,15809552,15809936,15809552,384,384,utRho06
712,ilvI,170840,171260,170840,420,8,utRho06
713,ilvL,23701308,23701932,23701308,624,36,utRho06
714,ilvY,7915734,7915734,7915640,94,0,utRho06
715,inaA,4698998,4698998,4698944,54,34,utRho06
716,infA,1853370,1853370,1852886,484,2986,utRho06
717,infC,3602692,3602692,3601276,1416,5210,utRho06
718,insA-5,3958452,3958452,3958430,22,32,utRho06
719,insA-7,9036758,9037054,9036758,296,200,utRho06
720,insC-5,6372080,6372284,6372080,204,96,utRho06
721,insEF-2,785238,785238,785820,582,262,utRho06
722,insEF-4,2190310,2190310,2190892,582,182,utRho06
723,insG,9007098,9007098,9006862,236,4,utRho06
724,insH-1,550596,550596,550234,362,94,utRho06
725,insH-11,7306538,7306538,7306396,142,28,utRho06
726,insH-2,1151548,1151548,1151506,42,20,utRho06
727,insH-3,1378444,1378444,1378026,418,62,utRho06
728,insH-4,2791942,2792152,2791942,210,24,utRho06
729,insH-5,2857852,2857852,2857452,400,0,utRho06
730,insH-6,4135022,4135022,4134642,380,268,utRho06
731,insH-7,4206186,4206186,4205822,364,5138,utRho06
732,insH-9,6260050,6260356,6260050,306,72,utRho06
733,insI-3,9017372,9017372,9017234,138,0,utRho06
734,insJ,7441188,7441360,7441188,172,1784,utRho06
735,insK,7442130,7442308,7442130,178,0,utRho06
736,insL-1,30760,30890,30760,130,464,utRho06
737,insL-2,1216112,1216130,1216112,18,88,utRho06
738,insL-3,5028644,5028662,5028644,18,158,utRho06
739,insN-1,540452,540484,540452,32,0,utRho06
740,intD,1132202,1132202,1131956,246,22,utRho06
741,intR,2826520,2826520,2826470,50,0,utRho06
742,intS,4933026,4933090,4933026,64,538,utRho06
743,intZ,5117386,5117542,5117386,156,34,utRho06
744,iraD,9113152,9113986,9113152,834,0,utRho06
745,iraM,2424246,2424246,2424006,240,0,utRho06
746,iraP,802638,802772,802638,134,0,utRho06
747,iscA,5319924,5319924,5319772,152,1450,utRho06
748,iscR,5324398,5324398,5324262,136,19120,utRho06
749,iscX,5313834,5313834,5313472,362,1780,utRho06
750,ispF,5743968,5743968,5743560,408,1194,utRho06
751,ispG,5283908,5283908,5283608,300,580,utRho06
752,ispU,389568,389806,389568,238,108,utRho06
753,isrA,2811502,2811502,2811618,116,34,utRho06
754,istr-1,7706384,7706384,7706384,0,0,utRho06
755,istr-2,7706514,7706514,7706514,0,0,utRho06
756,ivbL,15412092,15412092,15411952,140,336,utRho06
757,ivy,480638,480686,480638,48,0,utRho06
758,katE,3627628,3627734,3627628,106,8,utRho06
759,katG,8267624,8267670,8267624,46,106,utRho06
760,kbaZ,6557732,6557828,6557732,96,0,utRho06
761,kbl,7585154,7585154,7585102,52,378,utRho06
762,kch,2621046,2621046,2620538,508,0,utRho06
763,kdgR,3820506,3820506,3820198,308,0,utRho06
764,kdpE,1443788,1443788,1443466,322,56,utRho06
765,kdpF,1457698,1457698,1457642,56,0,utRho06
766,kdsA,2535708,2536330,2535708,622,2486,utRho06
767,kdsC,6683438,6684546,6683438,1108,2450,utRho06
768,kduI,5968388,5968388,5968248,140,810,utRho06
769,kefF,94160,94492,94160,332,0,utRho06
770,kgtP,5451624,5451624,5451492,132,1056,utRho06
771,kup,7862206,7862632,7862206,426,112,utRho06
772,lacI,735076,735076,735020,56,0,utRho06
773,lacZ,1465508,1465508,1465220,288,140,utRho06
774,ldcA,2486394,2486394,2486160,234,0,utRho06
775,ldhA,2885830,2885830,2885686,144,0,utRho06
776,ldrA,2538954,2538954,2538550,404,1894,utRho06
777,ldrB,2540024,2540024,2539620,404,842,utRho06
778,ldrC,2541092,2541092,2540690,402,1306,utRho06
779,ldrD,7400544,7400544,7400174,370,1256,utRho06
780,lepA,5414392,5414392,5414248,144,172,utRho06
781,lepB,5410928,5410928,5410618,310,602,utRho06
782,leuD,159188,159188,158906,282,56,utRho06
783,leuE,3761600,3761600,3761518,82,0,utRho06
784,leuL,168048,168048,167416,632,0,utRho06
785,leuO,168308,168736,168308,428,0,utRho06
786,leuQ,9212864,9212864,9212802,62,18,utRho06
787,leuU,6644556,6644556,6644316,240,3992,utRho06
788,leuV,9212546,9212546,9212330,216,666,utRho06
789,leuX,8992772,8992810,8992772,38,0,utRho06
790,lexA,8514174,8514230,8514174,56,30,utRho06
791,lhr,3456706,3458174,3456706,1468,2524,utRho06
792,ligA,5060402,5060402,5060352,50,6,utRho06
793,ligB,7642576,7642576,7642340,236,0,utRho06
794,lipA,1320602,1320602,1320432,170,132,utRho06
795,lipB,1324802,1324802,1324556,246,2086,utRho06
796,lit,2397032,2397390,2397032,358,38,utRho06
797,livJ,7199524,7199524,7199316,208,1636,utRho06
798,livK,7195510,7195510,7195120,390,120,utRho06
799,lldP,7554578,7554798,7554578,220,1454,utRho06
800,lnt,1381968,1381968,1381762,206,242,utRho06
801,loiP,6163784,6163826,6163784,42,0,utRho06
802,lolA,1874656,1874738,1874656,82,406,utRho06
803,lolB,2527112,2527112,2527000,112,142,utRho06
804,lolC,2350748,2350854,2350748,106,0,utRho06
805,lon,917630,917776,917630,146,840,utRho06
806,lpcA,486936,487086,486936,150,0,utRho06
807,lpd,255434,255824,255434,390,1716,utRho06
808,lplA,9248476,9248476,9248234,242,668,utRho06
809,lplT,5947878,5947878,5947724,154,8,utRho06
810,lpoA,6586422,6586800,6586422,378,48,utRho06
811,lpp,3514592,3514842,3514592,250,54,utRho06
812,lptA,6686598,6686760,6686598,162,1052,utRho06
813,lptB,6686792,6687888,6686792,1096,1212,utRho06
814,lptD,114672,114672,114218,454,2068,utRho06
815,lptF,8972244,8972436,8972244,192,0,utRho06
816,lpxC,213016,213114,213016,98,17758,utRho06
817,lpxD,401920,401942,401920,22,70,utRho06
818,lpxL,2233418,2233418,2233164,254,100,utRho06
819,lpxM,3880456,3880456,3880386,70,138,utRho06
820,lpxP,4991156,4991290,4991156,134,304,utRho06
821,lrhA,4813312,4813312,4813282,30,0,utRho06
822,lrp,1864656,1865190,1864656,534,714,utRho06
823,lspA,50028,50414,50028,386,474,utRho06
824,lsrA,3202920,3202980,3202920,60,0,utRho06
825,lsrR,3202514,3202514,3202482,32,0,utRho06
826,ltaE,1818640,1818640,1818588,52,0,utRho06
827,luxS,5630130,5630130,5629466,664,1226,utRho06
828,lysA,5957902,5957902,5957798,104,0,utRho06
829,lysC,8467232,8467232,8466466,766,384,utRho06
830,lysP,4497120,4497120,4497064,56,0,utRho06
831,lysR,5957900,5958042,5957900,142,0,utRho06
832,lysT,1561028,1561108,1561028,80,292,utRho06
833,lysU,8709610,8709610,8709434,176,0,utRho06
834,macB,1840188,1840694,1840188,506,252,utRho06
835,maeA,3111484,3111484,3111338,146,1962,utRho06
836,mak,820236,820288,820236,52,0,utRho06
837,malE,8492928,8492928,8492838,90,0,utRho06
838,malI,3398456,3398456,3398360,96,32,utRho06
839,malK,8493472,8493568,8493472,96,0,utRho06
840,malP,7105020,7105020,7104946,74,42,utRho06
841,malQ,7100798,7100798,7100140,658,104,utRho06
842,malS,14949880,14949988,14949880,108,0,utRho06
843,malT,7106048,7106170,7106048,122,120,utRho06
844,malX,3398626,3398710,3398626,84,0,utRho06
845,malZ,1689980,1690072,1689980,92,1568,utRho06
846,manA,3377102,3377152,3377102,50,0,utRho06
847,manX,3803866,3804096,3803866,230,0,utRho06
848,marC,3237882,3237882,3237816,66,142,utRho06
849,marR,3238186,3238240,3238186,54,96,utRho06
850,matP,2036918,2036970,2036918,52,54,utRho06
851,mazE,5822736,5822736,5822678,58,0,utRho06
852,mazG,5821720,5821720,5821370,350,2874,utRho06
853,mcbA,1684306,1684306,1684112,194,0,utRho06
854,mcbR,3040192,3040524,3040192,332,0,utRho06
855,mcrA,2420278,2420692,2420278,414,36,utRho06
856,mcrC,9156124,9156124,9155916,208,80,utRho06
857,mdaB,6344814,6345060,6344814,246,26,utRho06
858,mdfA,1767138,1767346,1767138,208,0,utRho06
859,mdh,6768940,6768940,6768536,404,6,utRho06
860,mdoB,9198988,9198988,9198882,106,308,utRho06
861,mdoD,2993290,2993712,2993290,422,34,utRho06
862,mdoG,2218514,2218670,2218514,156,64,utRho06
863,mdtA,4307958,4308032,4307958,74,0,utRho06
864,mdtE,7318168,7318464,7318168,296,22,utRho06
865,mdtK,3486538,3486914,3486538,376,126,utRho06
866,mdtP,8602472,8602472,8602060,412,56,utRho06
867,melA,8683774,8683822,8683774,48,0,utRho06
868,melR,8683300,8683300,8683256,44,0,utRho06
869,menA,8240812,8240812,8240698,114,14,utRho06
870,menB,4753774,4753774,4753638,136,238,utRho06
871,mepH,3468714,3468870,3468714,156,0,utRho06
872,mepM,3883666,3883666,3883270,396,732,utRho06
873,mepS,4539840,4539958,4539840,118,1056,utRho06
874,metA,8428318,8428560,8428318,242,128,utRho06
875,metB,8257272,8257344,8257272,72,614,utRho06
876,metC,6304150,6304472,6304150,322,56,utRho06
877,metE,8025768,8026106,8025768,338,168,utRho06
878,metF,8265092,8265232,8265092,140,100,utRho06
879,metG,4388538,4388600,4388538,62,126,utRho06
880,metH,8447010,8447656,8447010,646,5242,utRho06
881,metJ,8257116,8257116,8256790,326,62,utRho06
882,metK,6173154,6173412,6173154,258,48,utRho06
883,metN,445428,445428,445290,138,0,utRho06
884,metR,8025710,8025710,8025632,78,0,utRho06
885,metT,1394326,1394326,1394266,60,74,utRho06
886,metY,19910250,19910250,19909734,516,8046,utRho06
887,metZ,11789528,11789548,11789528,20,120,utRho06
888,mfd,2348056,2348056,2347928,128,82,utRho06
889,mglA,4478782,4478782,4478578,204,244,utRho06
890,mglB,4481132,4481132,4480696,436,3860,utRho06
891,mglC,4475918,4475918,4475506,412,6,utRho06
892,mgrB,3817584,3817584,3817532,52,0,utRho06
893,mgrR,3245828,3245828,3245828,0,0,utRho06
894,mgsA,2054082,2054082,2054030,52,0,utRho06
895,mgtL,8934560,8934862,8934560,302,116,utRho06
896,mhpA,737038,737222,737038,184,0,utRho06
897,mhpR,737072,737072,736840,232,16,utRho06
898,mhpT,750772,750918,750772,146,56,utRho06
899,miaA,8797964,8798504,8797964,540,480,utRho06
900,micA,5629604,5629604,5629604,0,0,utRho06
901,micC,2874242,2874238,2874242,4,0,utRho06
902,micF,4626168,4626168,4626168,0,0,utRho06
903,micM,1014408,1014408,1014408,0,0,utRho06
904,minE,2449422,2449422,2449090,332,558,utRho06
905,mioC,7852950,7852950,7852910,40,0,utRho06
906,mipA,3733012,3733012,3732944,68,2426,utRho06
907,mlaA,4930270,4930270,4930014,256,14,utRho06
908,mlc,3337206,3337206,3337128,78,2,utRho06
909,mlrA,4429498,4429732,4429498,234,0,utRho06
910,mltA,5894546,5894546,5894356,190,6,utRho06
911,mltD,468050,468050,467910,140,84,utRho06
912,mltF,5391534,5391602,5391534,68,0,utRho06
913,mmuP,550238,550650,550238,412,96,utRho06
914,mngA,1531622,1531968,1531622,346,0,utRho06
915,mngR,1531852,1531852,1531750,102,0,utRho06
916,mnmG,7851348,7851348,7851266,82,6732,utRho06
917,mntH,5025470,5025470,5025412,58,34,utRho06
918,mntP,3810918,3811376,3810918,458,720,utRho06
919,mntR,1706160,1706366,1706160,206,0,utRho06
920,mntS,1706128,1706128,1705994,134,138,utRho06
921,moaA,1633654,1634088,1633654,434,984,utRho06
922,moaB,1635954,1636110,1635954,156,980,utRho06
923,mobA,8084242,8084242,8083998,244,114,utRho06
924,mocA,6030112,6030320,6030112,208,0,utRho06
925,modA,1589990,1590178,1589990,188,210,utRho06
926,moeA,1732788,1732788,1732728,60,146,utRho06
927,mokB,2984610,2984610,2984258,352,482,utRho06
928,molR_1,4392888,4392948,4392888,60,134,utRho06
929,motA,3954604,3954604,3954278,326,84,utRho06
930,mpaA,2781278,2781278,2781196,82,124,utRho06
931,mpl,8911456,8911570,8911456,114,0,utRho06
932,mppA,2786108,2786454,2786108,346,46,utRho06
933,mprA,5621494,5621540,5621494,46,296,utRho06
934,mqo,4613848,4613848,4613508,340,1168,utRho06
935,mqsA,6336742,6336742,6336492,250,42,utRho06
936,mqsR,6337306,6337306,6337088,218,146,utRho06
937,mraZ,179192,179268,179192,76,18,utRho06
938,mrcA,7045652,7045742,7045652,90,0,utRho06
939,mrcB,329442,329460,329442,18,0,utRho06
940,mreB,13605424,13605424,13604348,1076,1860,utRho06
941,mreD,6798166,6798166,6797750,416,210,utRho06
942,mrp,4388360,4388360,4388336,24,2,utRho06
943,mscK,972984,973072,972984,88,58,utRho06
944,mscL,6876002,6876048,6876002,46,418,utRho06
945,mscS,6139742,6139742,6139614,128,76,utRho06
946,msrA,8884522,8884522,8884352,170,76,utRho06
947,msrB,3725168,3725168,3724858,310,28,utRho06
948,msyB,2228426,2228426,2228362,64,24,utRho06
949,mtfA,4087236,4087302,4087236,66,1090,utRho06
950,mtgA,6699662,6699662,6699618,44,138,utRho06
951,mtlA,30177504,30178248,30177504,744,304,utRho06
952,mtn,358366,358366,358306,60,52,utRho06
953,mtr,6611864,6611864,6611634,230,98,utRho06
954,mug,6430992,6430992,6430946,46,30,utRho06
955,murQ,5091466,5091546,5091466,80,0,utRho06
956,murR,5091586,5091586,5091218,368,0,utRho06
957,mutH,5939164,5939324,5939164,160,616,utRho06
958,mutL,8794092,8794824,8794092,732,692,utRho06
959,mutM,7622554,7622554,7622304,250,760,utRho06
960,mutS,5714038,5714186,5714038,148,348,utRho06
961,mutY,18617466,18618078,18617466,612,156,utRho06
962,nac,4123956,4123956,4123866,90,0,utRho06
963,nadA,1564122,1564170,1564122,48,66,utRho06
964,nadB,5420714,5420840,5420714,126,30,utRho06
965,nadC,237326,237326,237290,36,0,utRho06
966,nadE,3644604,3644916,3644604,312,90,utRho06
967,nadK,5501526,5501662,5501526,136,208,utRho06
968,nagA,1406350,1406350,1405502,848,1970,utRho06
969,nagB,1407416,1407416,1407222,194,36,utRho06
970,nagC,1404016,1404016,1403188,828,372,utRho06
971,nagE,1407680,1407888,1407680,208,0,utRho06
972,nagK,2357080,2357186,2357080,106,90,utRho06
973,nanA,6747240,6747240,6747152,88,2,utRho06
974,nanC,9079856,9079856,9079002,854,72,utRho06
975,nanR,6749406,6749406,6748978,428,68,utRho06
976,nanS,9075406,9075406,9075188,218,0,utRho06
977,napF,4607390,4607390,4606994,396,0,utRho06
978,narG,2559614,2559728,2559614,114,0,utRho06
979,narK,2555642,2555914,2555642,272,48,utRho06
980,narP,4580844,4581000,4580844,156,16,utRho06
981,narQ,5171154,5171462,5171154,308,36,utRho06
982,narU,3088326,3088326,3088120,206,0,utRho06
983,narW,3077374,3077374,3074618,2756,8,utRho06
984,narX,2555554,2555554,2555236,318,0,utRho06
985,narZ,3085380,3085380,3085180,200,0,utRho06
986,ndh,2331984,2332170,2331984,186,58,utRho06
987,ndk,5289920,5289920,5289728,192,186,utRho06
988,nemR,6904084,6904092,6904084,8,0,utRho06
989,nepI,7683542,7683542,7683478,64,198,utRho06
990,nfo,4501612,4501680,4501612,68,24,utRho06
991,nfsB,1210906,1210906,1210848,58,30,utRho06
992,nfuA,7090916,7091248,7090916,332,318,utRho06
993,nhaA,34634,34978,34634,344,22,utRho06
994,nhaB,2469534,2469534,2469434,100,0,utRho06
995,nhoA,3067926,3068048,3067926,122,0,utRho06
996,nikA,7226878,7227334,7226878,456,2320,utRho06
997,nikR,7237074,7237176,7237074,102,102,utRho06
998,nirB,6987974,6988022,6987974,48,18,utRho06
999,nlpA,7680034,7680034,7679986,48,0,utRho06
1000,nlpC,3585654,3585654,3585462,192,16,utRho06
1001,nlpD,5737658,5737658,5737506,152,90,utRho06
1002,nlpI,6618080,6618080,6617848,232,50,utRho06
1003,nmpC,1153740,1153740,1153650,90,0,utRho06
1004,nohA,3273206,3273206,3272734,472,0,utRho06
1005,norR,5664614,5664614,5664578,36,0,utRho06
1006,norV,5664878,5664952,5664878,74,8,utRho06
1007,nrdA,4689510,4689730,4689510,220,8226,utRho06
1008,nrdD,8925676,8925676,8925320,356,2956,utRho06
1009,nrdH,5601312,5601446,5601312,134,674,utRho06
1010,nrdR,865954,866004,865954,50,0,utRho06
1011,nrfA,8575342,8575528,8575342,186,0,utRho06
1012,nsrR,8812088,8812380,8812088,292,46570,utRho06
1013,nudB,3897348,3897348,3897264,84,70,utRho06
1014,nudC,8393428,8393806,8393428,378,116,utRho06
1015,nudE,7052658,7052658,7052298,360,4876,utRho06
1016,nudG,3682876,3682980,3682876,104,4,utRho06
1017,nudI,4729050,4729108,4729050,58,0,utRho06
1018,nudJ,2388874,2388874,2388576,298,1024,utRho06
1019,nuoA,4810670,4810670,4810144,526,2082,utRho06
1020,nuoN,4783434,4783434,4783010,424,1140,utRho06
1021,nupC,5026018,5026084,5026018,66,0,utRho06
1022,nupG,6211302,6211428,6211302,126,0,utRho06
1023,ogrK,4335096,4335096,4335040,56,0,utRho06
1024,ogt,2800568,2800568,2800472,96,40,utRho06
1025,ohsC,5401036,5401040,5401036,4,0,utRho06
1026,ompA,2040382,2040382,2040106,276,10308,utRho06
1027,ompC,4625774,4625774,4625498,276,84,utRho06
1028,ompF,1974184,1974184,1973964,220,64,utRho06
1029,ompL,8128958,8128958,8128590,368,0,utRho06
1030,ompN,2874158,2874158,2873786,372,0,utRho06
1031,ompR,7073510,7073510,7073168,342,0,utRho06
1032,ompT,1171330,1171330,1171266,64,60,utRho06
1033,ompW,2627982,2628040,2627982,58,0,utRho06
1034,ompX,1700418,1700900,1700418,482,724,utRho06
1035,omrA,5952378,5952378,5952378,0,0,utRho06
1036,omrB,5952770,5952770,5952770,0,0,utRho06
1037,oppA,2602170,2602364,2602170,194,17116,utRho06
1038,orn,8783168,8783208,8783168,40,78,utRho06
1039,osmB,2686952,2686952,2686656,296,196,utRho06
1040,osmC,3113192,3113250,3113192,58,8,utRho06
1041,osmE,3644566,3644566,3644512,54,0,utRho06
1042,osmF,4439046,4439046,4438962,84,474,utRho06
1043,osmY,9222306,9222792,9222306,486,4,utRho06
1044,otsA,3963302,3963302,3963224,78,0,utRho06
1045,otsB,3964930,3964930,3964774,156,60,utRho06
1046,oxc,4984288,4984288,4983900,388,0,utRho06
1047,oxyR,8316914,8316980,8316914,66,0,utRho06
1048,oxyS,8316788,8316788,8316788,0,0,utRho06
1049,paaA,2907730,2907854,2907730,124,0,utRho06
1050,paaX,2927018,2927078,2927018,60,0,utRho06
1051,paaZ,2907340,2907340,2907284,56,0,utRho06
1052,pabA,6981702,6981702,6981658,44,0,utRho06
1053,pabB,3789256,3789610,3789256,354,220,utRho06
1054,pabC,2306186,2306600,2306186,414,168,utRho06
1055,pagP,1313052,1313114,1313052,62,0,utRho06
1056,panB,299260,299260,299202,58,148,utRho06
1057,panC,297840,297840,297590,250,224,utRho06
1058,panD,293490,293490,293388,102,4,utRho06
1059,panZ,7195656,7195968,7195656,312,132,utRho06
1060,parC,6332060,6332060,6331946,114,200,utRho06
1061,patA,6438916,6438988,6438916,72,0,utRho06
1062,patD,3030830,3031156,3030830,326,0,utRho06
1063,pbpC,5294986,5294986,5294650,336,4,utRho06
1064,pbpG,4450132,4450132,4449740,392,52,utRho06
1065,pck,7065358,7065636,7065358,278,2518,utRho06
1066,pcnB,318782,318782,318252,530,782,utRho06
1067,pdhR,244068,244184,244068,116,164,utRho06
1068,pdxB,4875768,4875768,4875702,66,0,utRho06
1069,pdxH,3436068,3436068,3436014,54,58,utRho06
1070,pdxJ,5403626,5403626,5403458,168,158,utRho06
1071,pdxK,5074638,5074638,5074474,164,20,utRho06
1072,pepA,8972278,8972278,8971902,376,44,utRho06
1073,pepD,511618,511618,511432,186,2752,utRho06
1074,pepN,1981182,1981244,1981182,62,0,utRho06
1075,pepQ,8062294,8062322,8062294,28,0,utRho06
1076,pepT,2371646,2371688,2371646,42,0,utRho06
1077,pfkA,8214948,8215104,8214948,156,178,utRho06
1078,pfkB,3612646,3612740,3612646,94,0,utRho06
1079,pflA,1902456,1902456,1902160,296,36,utRho06
1080,pflB,1907850,1907850,1907108,742,466,utRho06
1081,pflD,8287716,8287990,8287716,274,0,utRho06
1082,pgaA,2185046,2185046,2184578,468,12,utRho06
1083,pgi,8467444,8467516,8467444,72,0,utRho06
1084,pgk,12291428,12291428,12290488,940,4236,utRho06
1085,pgl,1597078,1597172,1597078,94,66,utRho06
1086,pgpB,2678324,2678660,2678324,336,2,utRho06
1087,pgpC,5397276,5397276,5397100,176,0,utRho06
1088,pgrR,2783744,2783982,2783744,238,0,utRho06
1089,pheL,5475158,5475198,5475158,40,0,utRho06
1090,pheM,7197204,7197204,7197080,124,188,utRho06
1091,pheP,1203858,1203918,1203858,60,2,utRho06
1092,pheU,8725254,8725254,8725252,2,0,utRho06
1093,pheV,6220730,6220732,6220730,2,0,utRho06
1094,phnC,8650412,8650412,8650330,82,0,utRho06
1095,phoA,803414,803494,803414,80,2,utRho06
1096,phoB,834202,834284,834202,82,0,utRho06
1097,phoE,520316,520316,520200,116,0,utRho06
1098,phoH,2169730,2169984,2169730,254,482,utRho06
1099,phoP,2381016,2381016,2380894,122,854,utRho06
1100,phoQ,2379880,2379880,2379552,328,672,utRho06
1101,phoU,7815330,7815330,7815156,174,114,utRho06
1102,phr,1478842,1479014,1478842,172,0,utRho06
1103,pinE,2419054,2419370,2419054,316,36,utRho06
1104,pinQ,3267168,3267244,3267168,76,524,utRho06
1105,pinR,2867424,2867424,2867348,76,470,utRho06
1106,pitA,7275224,7275284,7275224,60,16,utRho06
1107,pitB,6272806,6272806,6272742,64,0,utRho06
1108,pka,5439862,5439906,5439862,44,0,utRho06
1109,plaP,4174476,4174476,4174124,352,732,utRho06
1110,pldA,8009628,8009724,8009628,96,30,utRho06
1111,pldB,8018028,8018340,8018028,312,212,utRho06
1112,plsB,8513196,8513196,8512932,264,248,utRho06
1113,pmbA,8915890,8915918,8915890,28,12,utRho06
1114,pmrD,4747148,4747148,4747076,72,0,utRho06
1115,pncB,1980828,1980828,1980712,116,8,utRho06
1116,pncC,5648788,5648788,5648692,96,0,utRho06
1117,pnp,6622652,6622652,6622336,316,170,utRho06
1118,pntA,3355950,3355950,3355806,144,0,utRho06
1119,pntB,3353096,3353096,3352720,376,0,utRho06
1120,polA,8093880,8093932,8093880,52,50,utRho06
1121,polB,131606,131606,131560,46,0,utRho06
1122,potD,2365700,2365700,2365658,42,6,utRho06
1123,potE,1436688,1436688,1436530,158,0,utRho06
1124,potF,1787268,1787568,1787268,300,44,utRho06
1125,poxB,1822152,1822152,1822098,54,12,utRho06
1126,ppa,8899372,8899372,8899304,68,74,utRho06
1127,ppc,8306380,8306380,8306196,184,112,utRho06
1128,ppdA,5928440,5928440,5928354,86,788,utRho06
1129,ppdD,235410,235410,235098,312,460,utRho06
1130,pphA,3846770,3846770,3845938,832,1694,utRho06
1131,pphB,5719474,5719520,5719474,46,0,utRho06
1132,ppiA,6984898,6984898,6984594,304,0,utRho06
1133,ppiC,7919682,7919682,7919626,56,84,utRho06
1134,ppiD,923638,923830,923638,192,1014,utRho06
1135,ppk,5245748,5246088,5245748,340,304,utRho06
1136,pppA,6228958,6228958,6228704,254,28,utRho06
1137,ppsA,3574322,3574322,3574224,98,64,utRho06
1138,ppsR,3574678,3574890,3574678,212,0,utRho06
1139,pptA,3065716,3066104,3065716,388,50,utRho06
1140,pqiA,2023318,2024002,2023318,684,30,utRho06
1141,prc,3830054,3830054,3829632,422,19934,utRho06
1142,preT,4467978,4468066,4467978,88,8,utRho06
1143,prfC,9218688,9218828,9218688,140,852,utRho06
1144,prkB,6968622,6968980,6968622,358,864,utRho06
1145,prlC,7290476,7290476,7290364,112,162,utRho06
1146,prlF,6553944,6554004,6553944,60,68,utRho06
1147,proB,520432,520776,520432,344,76,utRho06
1148,proC,811372,811372,811288,84,0,utRho06
1149,proK,7417388,7417388,7417384,4,0,utRho06
1150,proL,4572414,4572422,4572414,8,44,utRho06
1151,proP,8660640,8661004,8660640,364,3112,utRho06
1152,proS,437674,437674,437550,124,560,utRho06
1153,proV,5609126,5609630,5609126,504,34,utRho06
1154,prpB,697292,697364,697292,72,0,utRho06
1155,prpR,696942,696942,696886,56,0,utRho06
1156,prs,2524354,2524354,2523750,604,39826,utRho06
1157,psd,8781276,8781276,8780720,556,3278,utRho06
1158,psiE,8480600,8480650,8480600,50,0,utRho06
1159,pspA,2736076,2736158,2736076,82,0,utRho06
1160,pspF,2736080,2736080,2735824,256,0,utRho06
1161,pspG,8525632,8525680,8525632,48,12,utRho06
1162,pssA,5445156,5445454,5445156,298,1906,utRho06
1163,pstB,7817112,7817112,7816732,380,0,utRho06
1164,pstC,7821084,7821084,7820796,288,76,utRho06
1165,pstS,23469408,23469408,23469150,258,330,utRho06
1166,psuG,4517114,4517114,4516734,380,108,utRho06
1167,psuT,4514992,4514992,4514670,322,30,utRho06
1168,pth,2517084,2517084,2517026,58,44,utRho06
1169,ptrA,5918022,5918022,5917768,254,0,utRho06
1170,ptrB,3857730,3857730,3857678,52,5926,utRho06
1171,ptsG,2315252,2315738,2315252,486,1822,utRho06
1172,ptsH,5066996,5067528,5066996,532,1872,utRho06
1173,purA,8809328,8809374,8809328,46,0,utRho06
1174,purC,5195562,5195562,5195236,326,0,utRho06
1175,purD,8411972,8411972,8411862,110,0,utRho06
1176,purE,1106284,1106284,1106200,84,1158,utRho06
1177,purH,8415254,8415254,8415064,190,12,utRho06
1178,purL,5391178,5391178,5391086,92,160,utRho06
1179,purM,5242306,5242394,5242306,88,0,utRho06
1180,purR,3475378,3475688,3475378,310,486,utRho06
1181,purT,3861438,3861762,3861438,324,60,utRho06
1182,purU,2577512,2577512,2577248,264,366,utRho06
1183,putA,2157850,2157850,2157764,86,0,utRho06
1184,putP,2158336,2158610,2158336,274,198,utRho06
1185,puuA,2721936,2721936,2721816,120,22,utRho06
1186,puuC,2725456,2725486,2725456,30,0,utRho06
1187,puuD,2722104,2722240,2722104,136,4,utRho06
1188,puuP,2718746,2718746,2718374,372,584,utRho06
1189,pykA,3874988,3875298,3874988,310,74,utRho06
1190,pykF,3510934,3511396,3510934,462,948,utRho06
1191,pyrC,2245286,2245286,2245214,72,168,utRho06
1192,pyrD,2009464,2009536,2009464,72,0,utRho06
1193,pyrE,7631970,7631970,7631536,434,158,utRho06
1194,pyrF,2683740,2683842,2683740,102,172,utRho06
1195,pyrG,5819594,5819594,5819332,262,1204,utRho06
1196,pyrH,383624,383710,383624,86,1518,utRho06
1197,pyrL,8945490,8945490,8945066,424,52,utRho06
1198,qmcA,1031646,1031646,1031546,100,40,utRho06
1199,qor,8528608,8528608,8528462,146,198,utRho06
1200,qseB,6339502,6339656,6339502,154,116,utRho06
1201,queA,849970,850022,849970,52,658,utRho06
1202,queE,5811212,5811212,5810836,376,46,utRho06
1203,queF,5850642,5850696,5850642,54,28,utRho06
1204,queG,8788184,8788184,8788134,50,828,utRho06
1205,racC,2835630,2835630,2835526,104,0,utRho06
1206,racR,2840898,2840898,2840482,416,234,utRho06
1207,raiA,5474208,5474308,5474208,100,130,utRho06
1208,rarD,8008594,8008594,8008356,238,222,utRho06
1209,ravA,7862256,7862256,7862186,70,2,utRho06
1210,rayT,495088,495274,495088,186,0,utRho06
1211,rbn,4763162,4763216,4763162,54,0,utRho06
1212,rbsD,7866644,7866702,7866644,58,0,utRho06
1213,rcnA,4371654,4371834,4371654,180,78,utRho06
1214,rcnB,4373768,4373920,4373768,152,68,utRho06
1215,rcnR,4371806,4371806,4371592,214,78,utRho06
1216,rcsA,4047672,4047936,4047672,264,232,utRho06
1217,rcsB,4631390,4632354,4631390,964,748,utRho06
1218,rcsC,4640162,4640162,4639656,506,368,utRho06
1219,rcsD,4626904,4626976,4626904,72,130,utRho06
1220,rdgB,6193240,6193362,6193240,122,254,utRho06
1221,rdlA,2538646,2538646,2538646,0,0,utRho06
1222,rdlB,2539712,2539716,2539712,4,14,utRho06
1223,rdlC,2540782,2540786,2540782,4,0,utRho06
1224,rdlD,7400272,7400272,7400272,0,0,utRho06
1225,rdoA,8084782,8084830,8084782,48,28,utRho06
1226,recA,11295276,11295276,11295076,200,536,utRho06
1227,recC,5925014,5925014,5924856,158,56,utRho06
1228,recF,7763722,7763722,7762442,1280,8408,utRho06
1229,recN,5503518,5503590,5503518,72,0,utRho06
1230,recQ,8011666,8011728,8011666,62,0,utRho06
1231,relA,5828554,5828554,5827302,1252,466,utRho06
1232,relB,3291806,3291806,3291744,62,0,utRho06
1233,rem,3289950,3289950,3289804,146,80,utRho06
1234,rep,7921294,7921354,7921294,60,28,utRho06
1235,rfaD,7587730,7587974,7587730,244,206,utRho06
1236,rfaE,6393852,6393852,6393506,346,0,utRho06
1237,rfaH,8049930,8049930,8049642,288,1384,utRho06
1238,rfbX,4219436,4219436,4219168,268,2644,utRho06
1239,rfe,7935600,7935832,7935600,232,92,utRho06
1240,rhaB,8194944,8194944,8194896,48,0,utRho06
1241,rhaD,8188770,8188770,8188544,226,2,utRho06
1242,rhaS,8195422,8195472,8195422,50,0,utRho06
1243,rhaT,8201132,8201132,8201050,82,32,utRho06
1244,rhlE,1661566,1661744,1661566,178,424,utRho06
1245,rhoL,47593944,47594772,47593944,828,262344,utRho06
1246,rhsB,7238006,7238384,7238006,378,126,utRho06
1247,rhsC,1458758,1459166,1458758,408,0,utRho06
1248,rhsD,1046132,1046522,1046132,390,0,utRho06
1249,rhtA,1700608,1700608,1700194,414,0,utRho06
1250,rhtC,8015478,8015514,8015478,36,1816,utRho06
1251,ribA,2678468,2678468,2678320,148,0,utRho06
1252,ribC,3486916,3486916,3486484,432,242,utRho06
1253,ribE,869008,869294,869008,286,6052,utRho06
1254,ribF,42766,42814,42766,48,28,utRho06
1255,ridA,8941892,8941892,8941826,66,50,utRho06
1256,rihA,1369204,1369204,1368824,380,652,utRho06
1257,rihB,4510504,4510504,4510372,132,0,utRho06
1258,rimJ,2251044,2251124,2251044,80,18,utRho06
1259,rimK,1783752,1783934,1783752,182,92,utRho06
1260,rimL,2997486,2997876,2997486,390,42,utRho06
1261,rimO,1756140,1756140,1756070,70,0,utRho06
1262,rimP,6636350,6636350,6636012,338,1300,utRho06
1263,rlmA,3814172,3814172,3814120,52,376,utRho06
1264,rlmD,5830086,5830086,5830000,86,30,utRho06
1265,rlmE,6655520,6655520,6655328,192,1496,utRho06
1266,rlmF,1684384,1684664,1684384,280,68,utRho06
1267,rlmG,6471784,6471784,6471750,34,0,utRho06
1268,rlmI,2060002,2060002,2059938,64,24,utRho06
1269,rlmJ,7290700,7290770,7290700,70,130,utRho06
1270,rlmL,2015344,2015688,2015344,344,802,utRho06
1271,rlpA,1330444,1330444,1330380,64,184,utRho06
1272,rluA,120900,120900,120692,208,300,utRho06
1273,rluF,8460324,8460708,8460324,384,0,utRho06
1274,rmf,2031006,2031430,2031006,424,1920,utRho06
1275,rna,1290068,1290068,1290006,62,78,utRho06
1276,rnb,2698258,2698258,2697824,434,2438,utRho06
1277,rnc,10816892,10816892,10816252,640,12504,utRho06
1278,rnd,3776122,3776122,3775982,140,352,utRho06
1279,rne,2289746,2289746,2288734,1012,7460,utRho06
1280,rnhA,472082,472082,472004,78,318,utRho06
1281,rnk,1288360,1288360,1287934,426,60,utRho06
1282,rnlA,5531788,5531836,5531788,48,156,utRho06
1283,rnlB,5533414,5533968,5533414,554,2252,utRho06
1284,rnpB,19623552,19623552,19623552,0,0,utRho06
1285,rob,9270706,9270706,9270620,86,60,utRho06
1286,rodZ,5285868,5285868,5285688,180,112,utRho06
1287,rpe,7030306,7030306,7030118,188,228,utRho06
1288,rph,15266320,15266320,15266196,124,232,utRho06
1289,rpiA,6118706,6118706,6118650,56,0,utRho06
1290,rpiB,8626514,8626700,8626514,186,18,utRho06
1291,rpiR,8626274,8626274,8625982,292,0,utRho06
1292,rplJ,8359246,8359992,8359246,746,8734,utRho06
1293,rplK,8356708,8356894,8356708,186,420,utRho06
1294,rplM,6757344,6757344,6757302,42,4858,utRho06
1295,rplN,6896444,6896444,6896298,146,7008,utRho06
1296,rplS,5489284,5489284,5489060,224,12228,utRho06
1297,rplT,7199052,7199052,7198996,56,628,utRho06
1298,rplU,6667036,6667036,6666902,134,98,utRho06
1299,rplY,4564866,4565034,4564866,168,96,utRho06
1300,rpmA,6666450,6666450,6666238,212,936,utRho06
1301,rpmB,15247980,15247980,15246696,1284,105404,utRho06
1302,rpmE,8253816,8254026,8253816,210,718,utRho06
1303,rpmF,2294676,2294734,2294676,58,43996,utRho06
1304,rpmH,7768130,7768672,7768130,542,6032,utRho06
1305,rpmI,3600854,3600854,3599998,856,9130,utRho06
1306,rpoB,8362126,8362490,8362126,364,748,utRho06
1307,rpoD,6424946,6426094,6424946,1148,16138,utRho06
1308,rpoE,5420372,5420372,5420024,348,74,utRho06
1309,rpoH,7202006,7202006,7201566,440,17760,utRho06
1310,rpoN,6689324,6689434,6689324,110,104,utRho06
1311,rpoS,5736236,5736236,5735102,1134,2242,utRho06
1312,rpoZ,7644154,7644212,7644154,58,834,utRho06
1313,rppH,5937986,5937986,5937954,32,28,utRho06
1314,rprA,3540744,3540744,3540744,0,0,utRho06
1315,rpsA,1923434,1923990,1923434,556,147406,utRho06
1316,rpsF,8850050,8850236,8850050,186,28292,utRho06
1317,rpsI,6756580,6756580,6756414,166,6412,utRho06
1318,rpsJ,6906884,6906884,6906540,344,10000,utRho06
1319,rpsL,6949242,6949242,6949104,138,324,utRho06
1320,rpsM,6885130,6885130,6884942,188,1982,utRho06
1321,rpsO,13247144,13247144,13246736,408,1008,utRho06
1322,rpsP,5492508,5492508,5492370,138,100,utRho06
1323,rpsT,42420,42420,42156,264,1152,utRho06
1324,rpsU,12842584,12843124,12842584,540,2316,utRho06
1325,rraA,8238716,8238716,8238660,56,140,utRho06
1326,rraB,8956768,8956946,8956768,178,58,utRho06
1327,rrsA,8070478,8071062,8070478,584,8702,utRho06
1328,rrsB,16665468,16666636,16665468,1168,17912,utRho06
1329,rrsC,7883032,7883616,7883032,584,9166,utRho06
1330,rrsD,6858094,6858094,6857524,570,510,utRho06
1331,rrsE,8415726,8416294,8415726,568,1812,utRho06
1332,rrsG,5462896,5462896,5462314,582,7232,utRho06
1333,rrsH,446970,447542,446970,572,1478,utRho06
1334,rsd,8393908,8393908,8393616,292,112,utRho06
1335,rseA,5419264,5419264,5418808,456,294,utRho06
1336,rseP,392940,393092,392940,152,134,utRho06
1337,rseX,4067298,4067298,4067298,0,0,utRho06
1338,rsfS,1338144,1338144,1338072,72,226,utRho06
1339,rsgA,8783132,8783132,8783018,114,64,utRho06
1340,rsmA,105176,105176,104860,316,2850,utRho06
1341,rsmB,6869982,6870414,6869982,432,224,utRho06
1342,rsmC,9215736,9215736,9215400,336,634,utRho06
1343,rsmD,7208594,7208786,7208594,192,150,utRho06
1344,rsmE,6182036,6182268,6182036,232,96,utRho06
1345,rsmG,7847512,7847512,7847360,152,1316,utRho06
1346,rsmH,180020,180188,180020,168,146,utRho06
1347,rsmI,6587106,6587106,6586670,436,396,utRho06
1348,rssA,2578212,2578412,2578212,200,276,utRho06
1349,rssB,2580440,2580484,2580440,44,156,utRho06
1350,rstA,3364276,3364300,3364276,24,0,utRho06
1351,rsuA,4561096,4561096,4560966,130,212,utRho06
1352,rsxA,3411510,3411534,3411510,24,12,utRho06
1353,rtcA,7114004,7114004,7113698,306,42,utRho06
1354,rtcB,7116214,7116214,7116158,56,32,utRho06
1355,rtn,4541356,4541452,4541356,96,322,utRho06
1356,rutA,2148052,2148052,2148022,30,0,utRho06
1357,rutG,2140090,2140090,2139678,412,0,utRho06
1358,rutR,2148226,2148484,2148226,258,0,utRho06
1359,ruvA,7784096,7784096,7783904,192,0,utRho06
1360,ruvB,7782176,7782176,7781424,752,448,utRho06
1361,ruvC,3894878,3894878,3894752,126,72,utRho06
1362,rybB,1776114,1776114,1776114,0,0,utRho06
1363,rydB,3529860,3529860,3529322,538,50,utRho06
1364,rydC,2983012,2983012,2983012,0,0,utRho06
1365,ryfA,5307398,5307710,5307398,312,66,utRho06
1366,ryfD,5468590,5468590,5468590,0,0,utRho06
1367,ryhB,7162032,7162032,7162032,0,0,utRho06
1368,ryjA,8556132,8556132,8556132,0,0,utRho06
1369,ryjB,9055954,9055954,9055954,0,0,utRho06
1370,sad,3229598,3229598,3229406,192,296,utRho06
1371,safA,3168056,3168056,3167918,138,0,utRho06
1372,sanA,4465368,4465756,4465368,388,84,utRho06
1373,sapF,2705314,2705314,2705268,46,22,utRho06
1374,sbcB,4165456,4165512,4165456,56,8,utRho06
1375,sbcC,831694,831694,831506,188,144,utRho06
1376,sbcD,833954,833954,833904,50,22,utRho06
1377,sbmA,793106,793278,793106,172,98,utRho06
1378,sbmC,4162650,4162650,4162524,126,0,utRho06
1379,sdaA,3793618,3793864,3793618,246,176,utRho06
1380,sdaC,5856070,5856458,5856070,388,500,utRho06
1381,sdhC,1509916,1510354,1509916,438,24614,utRho06
1382,sdhD,1510808,1511120,1510808,312,5266,utRho06
1383,sdiA,3993834,3993834,3993664,170,6,utRho06
1384,secE,8354354,8354716,8354354,362,82,utRho06
1385,secG,6645180,6645180,6645010,170,1846,utRho06
1386,selA,7522594,7522594,7522498,96,546,utRho06
1387,selB,7519850,7519850,7519722,128,174,utRho06
1388,selC,7672396,7672444,7672396,48,0,utRho06
1389,selD,3696058,3696058,3696016,42,2832,utRho06
1390,seqA,1425884,1425974,1425884,90,340,utRho06
1391,serA,6117098,6117098,6116820,278,0,utRho06
1392,serB,9249712,9249790,9249712,78,44,utRho06
1393,serC,3830380,3830612,3830380,232,0,utRho06
1394,serS,1878730,1878856,1878730,126,2714,utRho06
1395,serT,2063438,2063438,2063424,14,0,utRho06
1396,serU,4087124,4087124,4087114,10,98,utRho06
1397,serV,5637394,5637394,5637290,104,54,utRho06
1398,serW,1852014,1852014,1851942,72,204,utRho06
1399,serX,2195352,2195352,2195304,48,14,utRho06
1400,setB,4527426,4527726,4527426,300,32,utRho06
1401,setC,7673488,7673906,7673488,418,2,utRho06
1402,sfmA,1116124,1116424,1116124,300,0,utRho06
1403,sfmC,1117606,1117948,1117606,342,0,utRho06
1404,sfsA,323030,323030,322972,58,328,utRho06
1405,sfsB,6669592,6669818,6669592,226,254,utRho06
1406,sgrR,154676,154676,154598,78,0,utRho06
1407,sgrS,154734,154734,154734,0,0,utRho06
1408,shiA,4107068,4107286,4107068,218,112,utRho06
1409,sibA,4306622,4306622,4306622,0,0,utRho06
1410,sibB,4307292,4307292,4307292,0,0,utRho06
1411,sibC,6113702,6113702,6113702,0,0,utRho06
1412,sibD,6389730,6389730,6389730,0,0,utRho06
1413,sibE,6390480,6390480,6390480,0,0,utRho06
1414,sixA,4913998,4913998,4913624,374,46,utRho06
1415,slp,7307872,7307922,7307872,50,0,utRho06
1416,slt,9261400,9261466,9261400,66,2,utRho06
1417,slyA,3442028,3442028,3441648,380,56,utRho06
1418,slyB,3439496,3439752,3439496,256,152,utRho06
1419,slyD,6957398,6957398,6956994,404,214,utRho06
1420,slyX,6954862,6955280,6954862,418,6952,utRho06
1421,smf,6867372,6867372,6867120,252,204,utRho06
1422,smpB,5509534,5509792,5509534,258,1242,utRho06
1423,smrA,2811872,2811958,2811872,86,286,utRho06
1424,smrB,4896872,4897212,4896872,340,0,utRho06
1425,smtA,1946808,1947074,1946808,266,40,utRho06
1426,sodA,8201518,8201620,8201518,102,5506,utRho06
1427,sodB,3470646,3470756,3470646,110,30,utRho06
1428,sodC,3449358,3449358,3449310,48,0,utRho06
1429,sohB,2658568,2658664,2658568,96,0,utRho06
1430,sokB,2984232,2984238,2984232,6,62,utRho06
1431,solA,2241218,2241218,2241172,46,0,utRho06
1432,soxR,8554894,8554938,8554894,44,38,utRho06
1433,soxS,8554846,8554846,8554766,80,0,utRho06
1434,speA,6172096,6172096,6171822,274,182,utRho06
1435,speB,6167892,6167892,6167594,298,172,utRho06
1436,speC,6218350,6218350,6218310,40,40,utRho06
1437,spf,8099798,8099798,8099798,0,0,utRho06
1438,sppA,3697422,3697674,3697422,252,36,utRho06
1439,spy,3651376,3651376,3651250,126,0,utRho06
1440,sra,3112092,3112092,3111926,166,0,utRho06
1441,sraB,2293178,2293178,2293178,0,0,utRho06
1442,sraC,3846132,3846132,3846132,0,0,utRho06
1443,srlA,5651582,5651664,5651582,82,32,utRho06
1444,srlR,5657720,5658094,5657720,374,772,utRho06
1445,srmB,5425752,5425792,5425752,40,160,utRho06
1446,sroA,151216,151216,151216,0,0,utRho06
1447,sroG,6369436,6369436,6369436,0,0,utRho06
1448,sroH,8380974,8380974,8380974,0,0,utRho06
1449,ssb,8548022,8548250,8548022,228,218,utRho06
1450,sseA,5304782,5304988,5304782,206,3646,utRho06
1451,sspA,6755138,6755138,6754840,298,462,utRho06
1452,ssrA,5511014,5511186,5511014,172,162,utRho06
1453,ssrS,12223036,12223932,12223036,896,2004,utRho06
1454,sstT,6479726,6479888,6479726,162,126,utRho06
1455,ssuB,1988282,1988282,1988088,194,2,utRho06
1456,ssuE,1995126,1995126,1995024,102,0,utRho06
1457,sthA,8321604,8321604,8321580,24,1306,utRho06
1458,stpA,5597156,5597156,5596990,166,102,utRho06
1459,sucA,3034344,3034824,3034344,480,1236,utRho06
1460,sufA,3528836,3528836,3528772,64,14,utRho06
1461,sufE,3518962,3518962,3518580,382,558,utRho06
1462,sugE,8753588,8753750,8753588,162,272,utRho06
1463,sulA,2041894,2041894,2041838,56,218,utRho06
1464,syd,5850738,5850738,5850560,178,70,utRho06
1465,symE,9159834,9159834,9159680,154,182,utRho06
1466,symR,9159670,9159670,9159670,0,0,utRho06
1467,tabA,8949566,8949724,8949566,158,38,utRho06
1468,talA,5157140,5157332,5157140,192,0,utRho06
1469,talB,16382,16476,16382,94,4516,utRho06
1470,tam,3214442,3214692,3214442,250,0,utRho06
1471,tamA,8884540,8884764,8884540,224,76,utRho06
1472,tar,3945432,3945432,3945382,50,0,utRho06
1473,tas,5943138,5943194,5943138,56,170,utRho06
1474,tatA,16087636,16087780,16087636,144,64,utRho06
1475,tatE,1317742,1317894,1317742,152,78,utRho06
1476,tauA,770410,770464,770410,54,0,utRho06
1477,tdcA,6534186,6534186,6534130,56,0,utRho06
1478,tdcG,6519652,6519652,6519298,354,2,utRho06
1479,tdcR,6534380,6534760,6534380,380,48,utRho06
1480,tdk,2586986,2587054,2586986,68,24,utRho06
1481,tehA,3001072,3001146,3001072,74,0,utRho06
1482,tesA,1039898,1039898,1039530,368,242,utRho06
1483,tesB,950402,950402,950322,80,0,utRho06
1484,tfaE,2418532,2418532,2418238,294,0,utRho06
1485,tfaQ,3269912,3269912,3269770,142,0,utRho06
1486,tff,379424,379256,379424,168,38,utRho06
1487,tgt,852110,852274,852110,164,106,utRho06
1488,thiD,4369346,4369346,4369032,314,0,utRho06
1489,thiI,882936,883098,882936,162,142,utRho06
1490,thiM,4370902,4370902,4370602,300,380,utRho06
1491,thiQ,146170,146170,145854,316,260,utRho06
1492,thrL,592,760,592,168,568,utRho06
1493,thrS,7210932,7210932,7210280,652,2152,utRho06
1494,thrU,8350762,8350776,8350762,14,0,utRho06
1495,thrV,6847414,6847414,6847310,104,136942,utRho06
1496,thrW,525682,525742,525682,60,900,utRho06
1497,thyA,5930696,5930696,5930310,386,2258,utRho06
1498,tig,909986,910266,909986,280,824,utRho06
1499,tisB,7706674,7707106,7706674,432,234,utRho06
1500,tktA,6163414,6163414,6163270,144,110,utRho06
1501,tktB,5158616,5159272,5158616,656,724,utRho06
1502,tldD,6784368,6784368,6784056,312,0,utRho06
1503,tmcA,5191876,5191876,5191718,158,26,utRho06
1504,tnaC,15553644,15553740,15553644,96,328,utRho06
1505,tolB,1555074,1555480,1555074,406,134,utRho06
1506,tolC,6356008,6356230,6356008,222,258,utRho06
1507,tomB,961588,961588,961416,172,4668,utRho06
1508,tonB,2622108,2622178,2622108,70,0,utRho06
1509,topA,2661578,2662096,2661578,518,962,utRho06
1510,torC,2116112,2116168,2116112,56,2,utRho06
1511,torR,2115968,2115968,2115908,60,2,utRho06
1512,torS,2112364,2112364,2112356,8,0,utRho06
1513,torT,2112414,2112522,2112414,108,0,utRho06
1514,tpiA,8223138,8223138,8223014,124,80,utRho06
1515,tppB,3425342,3425538,3425342,196,4512,utRho06
1516,tpr,2574376,2574376,2574376,0,0,utRho06
1517,tpx,2777688,2777688,2777622,66,586,utRho06
1518,tqsA,3347780,3347826,3347780,46,12,utRho06
1519,treA,2494850,2494850,2494752,98,70,utRho06
1520,treB,8932420,8932420,8932360,60,38,utRho06
1521,treF,7339102,7339184,7339102,82,0,utRho06
1522,treR,8934694,8934694,8934492,202,32,utRho06
1523,trg,2984878,2984940,2984878,62,0,utRho06
1524,trkG,2847342,2847564,2847342,222,0,utRho06
1525,trmA,8326590,8326590,8326540,50,70,utRho06
1526,trpA,2634678,2634678,2634444,234,328,utRho06
1527,trpC,2639888,2639888,2639570,318,170,utRho06
1528,trpL,5292432,5292432,5292328,104,0,utRho06
1529,trpR,9265408,9265520,9265408,112,8,utRho06
1530,trpS,7027394,7027394,7027276,118,780,utRho06
1531,trpT,7893560,7893914,7893560,354,92992,utRho06
1532,trxA,7931294,7931522,7931294,228,710,utRho06
1533,trxB,1864156,1864156,1864100,56,72,utRho06
1534,trxC,5437350,5437470,5437350,120,208,utRho06
1535,tsaD,6421256,6421256,6421086,170,66,utRho06
1536,tsgA,6985038,6985136,6985038,98,26,utRho06
1537,tsr,9182824,9183314,9182824,490,108,utRho06
1538,tsx,864490,864490,864026,464,556,utRho06
1539,ttcA,2823970,2823970,2823896,74,3538,utRho06
1540,ttdA,6412848,6412926,6412848,78,0,utRho06
1541,ttdR,6412760,6412760,6412512,248,58,utRho06
1542,tufA,6943448,6943448,6942658,790,101850,utRho06
1543,tus,3368346,3368518,3368346,172,46,utRho06
1544,tusA,7218040,7218040,7217992,48,22,utRho06
1545,tusB,6950218,6950218,6949930,288,1106,utRho06
1546,tynA,2902996,2902996,2902698,298,0,utRho06
1547,typA,8116460,8116814,8116460,354,4596,utRho06
1548,tyrB,8534164,8534228,8534164,64,1580,utRho06
1549,tyrP,3979004,3979362,3979004,358,8,utRho06
1550,tyrR,2773384,2773440,2773384,56,0,utRho06
1551,tyrS,3434566,3434566,3434444,122,0,utRho06
1552,tyrT,2575330,2575330,2575244,86,34,utRho06
1553,uacT,6062378,6062734,6062378,356,4,utRho06
1554,ubiC,8504886,8505012,8504886,126,40,utRho06
1555,ubiD,8049618,8049976,8049618,358,1506,utRho06
1556,ubiE,8037494,8037710,8037494,216,72,utRho06
1557,ubiG,4679078,4679134,4679078,56,0,utRho06
1558,ucpA,5089342,5089342,5089246,96,14,utRho06
1559,udp,8032782,8032862,8032782,80,66,utRho06
1560,ugd,4199470,4199470,4199226,244,0,utRho06
1561,ugpB,7184852,7184852,7184650,202,136,utRho06
1562,ugpQ,7176600,7176600,7176226,374,0,utRho06
1563,uhpT,7694396,7694396,7694334,62,0,utRho06
1564,uidA,3392304,3392304,3392142,162,40,utRho06
1565,uidC,3386012,3386012,3385702,310,0,utRho06
1566,uidR,3394150,3394150,3394104,46,22,utRho06
1567,ulaA,8839854,8839960,8839854,106,44,utRho06
1568,ulaG,8839350,8839350,8839250,100,24,utRho06
1569,ulaR,8837124,8837124,8836906,218,20,utRho06
1570,umpG,5741372,5741372,5740548,824,168,utRho06
1571,umpH,1400704,1400704,1400652,52,0,utRho06
1572,umuD,2461476,2461534,2461476,58,0,utRho06
1573,ung,5433476,5433508,5433476,32,0,utRho06
1574,uof,2843316,2843316,2842900,416,5232,utRho06
1575,upp,5241818,5241818,5241744,74,82,utRho06
1576,usg,4873780,4873780,4873298,482,276,utRho06
1577,ushA,1009772,1009828,1009772,56,0,utRho06
1578,uspA,7279966,7280222,7279966,256,446,utRho06
1579,uspB,7279696,7279696,7279440,256,516,utRho06
1580,uspC,3959172,3959506,3959172,334,0,utRho06
1581,uspE,2797318,2797318,2797244,74,28,utRho06
1582,uspF,2871282,2871282,2871238,44,0,utRho06
1583,uspG,1283806,1283806,1283734,72,418,utRho06
1584,uvrA,8547872,8547872,8547742,130,320,utRho06
1585,uvrB,1626304,1627052,1626304,748,1306,utRho06
1586,uvrC,3989758,3989758,3989412,346,118,utRho06
1587,uvrD,7995814,7995966,7995814,152,240,utRho06
1588,uvrY,3990812,3990812,3990718,94,44,utRho06
1589,uxaB,3221474,3221474,3221360,114,54,utRho06
1590,uxaC,6489714,6489714,6489482,232,0,utRho06
1591,uxuA,9103036,9103272,9103036,236,36,utRho06
1592,uxuR,9108916,9109152,9108916,236,0,utRho06
1593,valS,8967854,8967854,8967674,180,280,utRho06
1594,valU,5041848,5041862,5041848,14,14,utRho06
1595,valV,3492830,3492870,3492830,40,2,utRho06
1596,ves,3649968,3649968,3649874,94,0,utRho06
1597,waaA,7616512,7617080,7616512,568,180,utRho06
1598,waaH,7580298,7580298,7580162,136,0,utRho06
1599,waaQ,7616476,7616476,7616196,280,36,utRho06
1600,waaU,7598996,7598996,7598624,372,108,utRho06
1601,waaY,7602272,7602272,7601930,342,4182,utRho06
1602,wbbH,4214888,4214888,4214452,436,2922,utRho06
1603,wbbK,4209212,4209212,4209018,194,232,utRho06
1604,wcaM,4231868,4231868,4231792,76,18,utRho06
1605,wrbA,2135516,2135516,2135416,100,0,utRho06
1606,wza,4275166,4275166,4274486,680,4,utRho06
1607,wzxC,4240674,4240674,4240316,358,18,utRho06
1608,wzzB,4196950,4196950,4196602,348,74,utRho06
1609,xanP,7657642,7657890,7657642,248,0,utRho06
1610,xanQ,6048520,6048702,6048520,182,0,utRho06
1611,xapA,5049820,5049820,5049756,64,0,utRho06
1612,xapR,10090252,10090252,10089908,344,0,utRho06
1613,xdhA,6000514,6000690,6000514,176,94,utRho06
1614,xerD,6079702,6079702,6079486,216,174,utRho06
1615,xseA,5268394,5268464,5268394,70,328,utRho06
1616,xseB,882746,882746,882686,60,140,utRho06
1617,xthA,3664798,3664856,3664798,58,0,utRho06
1618,xylA,7461614,7461614,7461530,84,58,utRho06
1619,xylE,8484540,8484540,8484508,32,0,utRho06
1620,xylF,7462138,7462262,7462138,124,0,utRho06
1621,xylR,7469812,7469958,7469812,146,0,utRho06
1622,yaaA,13230,13230,12918,312,60,utRho06
1623,yaaI,23876,23876,23572,304,32,utRho06
1624,yaaJ,16034,16034,15918,116,52,utRho06
1625,yaaU,91184,91614,91184,430,0,utRho06
1626,yaaW,23084,23084,22712,372,4,utRho06
1627,yaaX,10060,10468,10060,408,50,utRho06
1628,yabI,142542,142702,142542,160,40,utRho06
1629,yacC,273880,273880,273834,46,2226,utRho06
1630,yacH,262932,262932,262520,412,0,utRho06
1631,yacL,268678,268776,268678,98,64,utRho06
1632,yadD,293796,293936,293796,140,48,utRho06
1633,yadE,289930,290162,289930,232,378,utRho06
1634,yadN,314110,314110,313766,344,0,utRho06
1635,yadS,355572,355572,355248,324,106,utRho06
1636,yadV,312470,312470,312402,68,0,utRho06
1637,yaeF,434270,434270,434006,264,56,utRho06
1638,yaeP,428374,428374,428250,124,32,utRho06
1639,yaeQ,428176,428582,428176,406,56,utRho06
1640,yaeR,423716,423754,423716,38,0,utRho06
1641,yafC,462166,462166,461762,404,144,utRho06
1642,yafD,462128,462244,462128,116,136,utRho06
1643,yafK,491986,491986,491610,376,1330,utRho06
1644,yafL,493282,493424,493282,142,0,utRho06
1645,yafN,503938,504010,503938,72,8,utRho06
1646,yafS,469568,469632,469568,64,360,utRho06
1647,yafT,474470,474670,474470,200,0,utRho06
1648,yafV,480432,480432,480378,54,20,utRho06
1649,yafZ,536052,536052,536010,42,0,utRho06
1650,yagE,564446,564556,564446,110,22,utRho06
1651,yagG,570414,570790,570414,376,0,utRho06
1652,yagI,578384,578384,578324,60,0,utRho06
1653,yagK,586236,586236,585896,340,78,utRho06
1654,yagL,588062,588062,587836,226,56,utRho06
1655,yagN,591342,591342,591158,184,648,utRho06
1656,yahA,663746,664742,663746,996,326,utRho06
1657,yahC,670136,670136,670044,92,2,utRho06
1658,yahE,671478,671850,671478,372,0,utRho06
1659,yahM,690504,690808,690504,304,82,utRho06
1660,yahN,692872,692872,692674,198,0,utRho06
1661,yahO,692864,692968,692864,104,0,utRho06
1662,yaiE,816296,816354,816296,58,28,utRho06
1663,yaiI,811396,811528,811396,132,0,utRho06
1664,yaiO,761946,761946,761684,262,0,utRho06
1665,yaiP,767970,767970,767870,100,0,utRho06
1666,yaiS,769660,769660,769232,428,0,utRho06
1667,yaiV,788922,788922,788922,0,0,utRho06
1668,yaiY,799094,799094,798666,428,172,utRho06
1669,yaiZ,798888,799186,798888,298,476,utRho06
1670,yajC,854410,854574,854410,164,696,utRho06
1671,yajD,860938,861210,860938,272,532,utRho06
1672,yajI,866068,866068,865702,366,170,utRho06
1673,yajL,887496,887496,887282,214,152,utRho06
1674,yajQ,889316,889366,889316,50,84,utRho06
1675,yajR,893374,893374,893332,42,278,utRho06
1676,ybaB,987418,988152,987418,734,2322,utRho06
1677,ybaL,1006590,1006590,1006476,114,172,utRho06
1678,ybaM,980648,980648,980542,106,588,utRho06
1679,ybaN,981436,981764,981436,328,202,utRho06
1680,ybaO,936704,936766,936704,62,0,utRho06
1681,ybaP,1016568,1016568,1016160,408,594,utRho06
1682,ybaQ,1016348,1016436,1016348,88,38,utRho06
1683,ybaS,1023146,1023282,1023146,136,0,utRho06
1684,ybaV,927504,927874,927504,370,0,utRho06
1685,ybaY,950490,950758,950490,268,34,utRho06
1686,ybbB,1062724,1062724,1062452,272,40,utRho06
1687,ybbJ,1030154,1030154,1029718,436,426,utRho06
1688,ybbL,1031784,1031838,1031784,54,0,utRho06
1689,ybbN,1037136,1037136,1036558,578,592,utRho06
1690,ybbO,1038658,1038658,1038298,360,852,utRho06
1691,ybbY,1080718,1081130,1080718,412,16,utRho06
1692,ybcH,1176140,1176140,1175962,178,2,utRho06
1693,ybcI,1113264,1113264,1113106,158,1272,utRho06
1694,ybcJ,1114050,1114050,1113746,304,148,utRho06
1695,ybcK,1137502,1137804,1137502,302,0,utRho06
1696,ybcL,1141690,1141786,1141690,96,0,utRho06
1697,ybcN,1144628,1144932,1144628,304,0,utRho06
1698,ybcQ,1147548,1147912,1147548,364,0,utRho06
1699,ybcW,1159610,1159760,1159610,150,0,utRho06
1700,ybdD,1263982,1264364,1263982,382,120,utRho06
1701,ybdF,1212106,1212106,1211772,334,150,utRho06
1702,ybdH,1267048,1267048,1266954,94,52,utRho06
1703,ybdJ,1212822,1212822,1212398,424,0,utRho06
1704,ybdK,1215122,1215122,1214766,356,92,utRho06
1705,ybdL,1267114,1267172,1267114,58,52,utRho06
1706,ybdM,1271110,1271110,1270752,358,12,utRho06
1707,ybdN,1273372,1273372,1273138,234,0,utRho06
1708,ybdR,1283844,1284176,1283844,332,482,utRho06
1709,ybeD,1325412,1325412,1325284,128,110,utRho06
1710,ybeF,1323090,1323090,1322756,334,108,utRho06
1711,ybeL,1349986,1350036,1349986,50,28,utRho06
1712,ybeQ,1353412,1353412,1353094,318,0,utRho06
1713,ybeR,1353120,1353422,1353120,302,0,utRho06
1714,ybeT,1358832,1358832,1358812,20,0,utRho06
1715,ybeU,1358924,1359016,1358924,92,0,utRho06
1716,ybeZ,1386938,1386938,1386834,104,2310,utRho06
1717,ybfA,1458074,1458268,1458074,194,6,utRho06
1718,ybfE,1423878,1423878,1423796,82,288,utRho06
1719,ybfF,1425692,1425692,1425604,88,898,utRho06
1720,ybfH,1433282,1433282,1433194,88,0,utRho06
1721,ybgA,1477840,1478002,1477840,162,0,utRho06
1722,ybgC,1549288,1549504,1549288,216,0,utRho06
1723,ybgD,1505916,1505916,1505590,326,474,utRho06
1724,ybgI,1485238,1485654,1485238,416,0,utRho06
1725,ybgO,1498370,1498370,1497964,406,24,utRho06
1726,ybgS,1570992,1570992,1570634,358,32,utRho06
1727,ybhA,1597184,1597184,1596862,322,66,utRho06
1728,ybhB,1616070,1616070,1615818,252,48,utRho06
1729,ybhC,1614642,1614642,1614562,80,1048,utRho06
1730,ybhD,1601418,1601418,1601276,142,0,utRho06
1731,ybhH,1601104,1601518,1601104,414,0,utRho06
1732,ybhK,1633384,1633384,1633294,90,60,utRho06
1733,ybhM,1641556,1641586,1641556,30,0,utRho06
1734,ybhN,1645296,1645296,1644996,300,2,utRho06
1735,ybhQ,1649202,1649260,1649202,58,4,utRho06
1736,ybiA,1665920,1665920,1665900,20,0,utRho06
1737,ybiI,1676968,1676968,1676912,56,74,utRho06
1738,ybiO,1691328,1691328,1690960,368,222,utRho06
1739,ybiP,1705252,1705252,1705194,58,1584,utRho06
1740,ybiS,1711572,1711572,1711488,84,274,utRho06
1741,ybiT,1711894,1711926,1711894,32,0,utRho06
1742,ybiU,1718212,1718212,1718122,90,34,utRho06
1743,ybiV,1720176,1720176,1720056,120,0,utRho06
1744,ybiW,1725566,1725566,1725212,354,0,utRho06
1745,ybiX,1678548,1678548,1678414,134,664,utRho06
1746,ybjC,1781784,1781826,1781784,42,0,utRho06
1747,ybjE,1830154,1830154,1829714,440,28,utRho06
1748,ybjG,1767016,1767016,1766776,240,592,utRho06
1749,ybjL,1779882,1779882,1779638,244,244,utRho06
1750,ybjM,1779770,1780178,1779770,408,122,utRho06
1751,ybjO,1795704,1795978,1795704,274,0,utRho06
1752,ybjP,1809046,1809046,1808934,112,0,utRho06
1753,ybjQ,1809034,1809186,1809034,152,0,utRho06
1754,ybjS,1813796,1813796,1813506,290,160,utRho06
1755,ybjX,1838206,1838206,1838168,38,0,utRho06
1756,ycaD,1891438,1891742,1891438,304,0,utRho06
1757,ycaI,1928210,1928640,1928210,430,150,utRho06
1758,ycaK,1899094,1899336,1899094,242,68,utRho06
1759,ycaL,1920264,1920528,1920264,264,28,utRho06
1760,ycaM,1894240,1894458,1894240,218,28,utRho06
1761,ycaR,1941284,1941346,1941284,62,1542,utRho06
1762,ycbB,1961862,1962094,1961862,232,0,utRho06
1763,ycbJ,1943344,1943504,1943344,160,0,utRho06
1764,ycbK,1966046,1966150,1966046,104,272,utRho06
1765,ycbZ,2036920,2036920,2036598,322,64,utRho06
1766,yccA,2062886,2062886,2062836,50,250,utRho06
1767,yccF,2048730,2048730,2048696,34,0,utRho06
1768,yccS,2047988,2047988,2047766,222,6,utRho06
1769,yccT,2055674,2055674,2055546,128,0,utRho06
1770,yccX,2059960,2060128,2059960,168,184,utRho06
1771,ycdT,2185682,2185752,2185682,70,0,utRho06
1772,ycdU,2191266,2191686,2191266,420,0,utRho06
1773,ycdZ,2200504,2200592,2200504,88,0,utRho06
1774,yceA,2233544,2233614,2233544,70,210,utRho06
1775,yceD,2293298,2293588,2293298,290,5024,utRho06
1776,yceF,2293522,2293522,2293190,332,3238,utRho06
1777,yceH,2252154,2252314,2252154,160,358,utRho06
1778,yceI,2237282,2237282,2236952,330,172,utRho06
1779,yceJ,2238142,2238142,2238092,50,62,utRho06
1780,yceM,2253208,2253612,2253208,404,60,utRho06
1781,yceO,2239264,2239264,2238894,370,246,utRho06
1782,yceQ,2288760,2289004,2288760,244,5772,utRho06
1783,ycfD,2376540,2376540,2376480,60,192,utRho06
1784,ycfJ,2334814,2335198,2334814,384,380,utRho06
1785,ycfS,2340834,2340834,2340748,86,20,utRho06
1786,ycfT,2350658,2350658,2350330,328,38,utRho06
1787,ycfZ,2362760,2362760,2362534,226,214,utRho06
1788,ycgB,2474570,2474570,2474482,88,0,utRho06
1789,ycgG,2434614,2434656,2434614,42,28,utRho06
1790,ycgJ,2452956,2453200,2452956,244,106,utRho06
1791,ycgL,2455218,2455362,2455218,144,0,utRho06
1792,ycgN,2457366,2457660,2457366,294,30,utRho06
1793,ycgR,2489112,2489112,2489054,58,0,utRho06
1794,ycgV,2512222,2512222,2511904,318,148,utRho06
1795,ycgX,2426568,2426568,2426214,354,13590,utRho06
1796,ycgY,2490166,2490320,2490166,154,2,utRho06
1797,ycgZ,2431504,2431578,2431504,74,16,utRho06
1798,ychE,2596904,2597196,2596904,292,24,utRho06
1799,ychF,2515764,2515764,2515624,140,50,utRho06
1800,ychH,2517476,2517582,2517476,106,238,utRho06
1801,ychJ,2578354,2578354,2578264,90,0,utRho06
1802,ychN,2547310,2547310,2547198,112,0,utRho06
1803,ychO,2547520,2547850,2547520,330,262,utRho06
1804,ychQ,2533798,2533848,2533798,50,140,utRho06
1805,yciA,2624828,2624828,2624492,336,98,utRho06
1806,yciB,2626110,2626110,2625780,330,3104,utRho06
1807,yciC,2627396,2627396,2627326,70,0,utRho06
1808,yciE,2630794,2630794,2630448,346,0,utRho06
1809,yciG,5264368,5264368,5264140,228,0,utRho06
1810,yciI,2621784,2621784,2621730,54,0,utRho06
1811,yciN,2661606,2661606,2661336,270,12,utRho06
1812,yciS,2680270,2680486,2680270,216,156,utRho06
1813,yciT,2689088,2689088,2688692,396,372,utRho06
1814,yciU,2614718,2614718,2614300,418,2066,utRho06
1815,yciV,2646376,2646440,2646376,64,0,utRho06
1816,yciW,2700472,2700472,2700214,258,352,utRho06
1817,yciZ,2689276,2689276,2689218,58,256,utRho06
1818,ycjD,2703792,2703792,2703520,272,18,utRho06
1819,ycjG,2777748,2777860,2777748,112,214,utRho06
1820,ycjM,2740006,2740432,2740006,426,0,utRho06
1821,ycjW,2767982,2767982,2767922,60,26,utRho06
1822,ycjX,2768138,2768234,2768138,96,20,utRho06
1823,ycjY,5568288,5568288,5567460,828,156,utRho06
1824,ydaE,2836438,2836438,2836016,422,0,utRho06
1825,ydaN,2816048,2816100,2816048,52,18,utRho06
1826,ydaS,2840340,2840730,2840340,390,188,utRho06
1827,ydbC,2948376,2948442,2948376,66,0,utRho06
1828,ydbD,2950132,2950288,2950132,156,0,utRho06
1829,ydbH,2885800,2886102,2885800,302,0,utRho06
1830,ydbJ,2881712,2882116,2881712,404,62,utRho06
1831,ydbK,2881692,2881692,2881568,124,52,utRho06
1832,ydcA,2983294,2983354,2983294,60,0,utRho06
1833,ydcF,2974404,2974470,2974404,66,38,utRho06
1834,ydcI,2990268,2990268,2990142,126,10,utRho06
1835,ydcJ,2990266,2990576,2990266,310,0,utRho06
1836,ydcK,3001280,3001280,3000898,382,0,utRho06
1837,ydcL,3004646,3004914,3004646,268,0,utRho06
1838,ydcN,3012308,3012344,3012308,36,0,utRho06
1839,ydcP,3013508,3013562,3013508,54,0,utRho06
1840,ydcR,3019956,3020006,3019956,50,0,utRho06
1841,ydcS,3022906,3023308,3022906,402,0,utRho06
1842,ydcX,3034442,3034778,3034442,336,44,utRho06
1843,ydcY,3035220,3035296,3035220,76,68,utRho06
1844,ydcZ,3036750,3036750,3036662,88,122,utRho06
1845,yddB,3155332,3155332,3155238,94,2,utRho06
1846,yddE,3071738,3071738,3071716,22,0,utRho06
1847,yddG,3094410,3094410,3094338,72,0,utRho06
1848,yddJ,3089732,3089732,3089438,294,2,utRho06
1849,yddW,3137704,3137704,3137646,58,0,utRho06
1850,ydeA,3233910,3234056,3233910,146,178,utRho06
1851,ydeE,3242528,3242664,3242528,136,0,utRho06
1852,ydeI,3249118,3249118,3248994,124,0,utRho06
1853,ydeJ,3249376,3249546,3249376,170,0,utRho06
1854,ydeN,3165458,3165458,3165048,410,0,utRho06
1855,ydeP,3173328,3173328,3172972,356,0,utRho06
1856,ydeR,3176596,3176596,3176592,4,0,utRho06
1857,ydfA,3296872,3297016,3296872,144,0,utRho06
1858,ydfG,3254982,3255034,3254982,52,0,utRho06
1859,ydfH,3256652,3256704,3256652,52,124,utRho06
1860,ydfK,3265446,3266144,3265446,698,39644,utRho06
1861,ydgA,3379588,3379704,3379588,116,10,utRho06
1862,ydgC,3364124,3364124,3364060,64,12,utRho06
1863,ydgD,3343906,3343920,3343906,14,0,utRho06
1864,ydgH,3356754,3356854,3356754,100,0,utRho06
1865,ydgJ,3408798,3408798,3408616,182,88,utRho06
1866,ydgK,3410414,3410500,3410414,86,152,utRho06
1867,ydhB,3479618,3479618,3479596,22,0,utRho06
1868,ydhC,3479698,3479822,3479698,124,0,utRho06
1869,ydhF,3451310,3451310,3451264,46,0,utRho06
1870,ydhI,3441996,3442050,3441996,54,0,utRho06
1871,ydhL,3451864,3451864,3451840,24,0,utRho06
1872,ydhQ,3492404,3492404,3492254,150,0,utRho06
1873,ydhS,3494136,3494262,3494136,126,168,utRho06
1874,ydhT,3499138,3499138,3499118,20,0,utRho06
1875,ydhY,3509284,3509284,3508954,330,0,utRho06
1876,ydhZ,3510418,3510418,3510282,136,0,utRho06
1877,ydiE,3579206,3579226,3579206,20,0,utRho06
1878,ydiH,3530582,3530582,3530406,176,0,utRho06
1879,ydiM,3541852,3542142,3541852,290,0,utRho06
1880,ydiN,3544818,3545024,3544818,206,0,utRho06
1881,ydiP,3558656,3558656,3558602,54,0,utRho06
1882,ydiU,3582508,3582508,3582488,20,84,utRho06
1883,ydiV,3584174,3584174,3584040,134,84,utRho06
1884,ydiY,3612500,3612500,3612166,334,0,utRho06
1885,ydjA,3697400,3697400,3697352,48,0,utRho06
1886,ydjE,3708082,3708082,3707958,124,0,utRho06
1887,ydjF,3709848,3709848,3709708,140,0,utRho06
1888,ydjM,3620340,3620422,3620340,82,0,utRho06
1889,ydjO,3626696,3626696,3626288,408,0,utRho06
1890,ydjX,3666434,3666802,3666434,368,1626,utRho06
1891,yeaE,3731448,3731448,3731272,176,84,utRho06
1892,yeaG,3733530,3733816,3733530,286,60,utRho06
1893,yeaI,3740486,3740770,3740486,284,0,utRho06
1894,yeaJ,3743874,3744082,3743874,208,20,utRho06
1895,yeaL,3748646,3748704,3748646,58,202,utRho06
1896,yeaM,3751296,3751296,3751152,144,0,utRho06
1897,yeaN,3750926,3751346,3750926,420,0,utRho06
1898,yeaO,3753554,3753818,3753554,264,22,utRho06
1899,yeaP,3755314,3755430,3755314,116,344,utRho06
1900,yeaQ,3758780,3758780,3758510,270,32,utRho06
1901,yeaR,3759988,3759988,3759896,92,0,utRho06
1902,yeaY,3781122,3781122,3781064,58,80,utRho06
1903,yebB,3892220,3892502,3892220,282,0,utRho06
1904,yebC,3896370,3896370,3896302,68,86,utRho06
1905,yebE,3859464,3859464,3859414,50,344,utRho06
1906,yebG,3861530,3861530,3861494,36,26,utRho06
1907,yebK,3873180,3873304,3873180,124,24,utRho06
1908,yebQ,3820314,3820552,3820314,238,0,utRho06
1909,yebS,3832238,3832516,3832238,278,42,utRho06
1910,yebV,3843430,3843560,3843430,130,74,utRho06
1911,yebW,3843914,3844242,3843914,328,1042,utRho06
1912,yecC,3995646,3995646,3995628,18,0,utRho06
1913,yecD,3901272,3901664,3901272,392,88,utRho06
1914,yecF,3991434,3991636,3991434,202,134,utRho06
1915,yecH,3979304,3979304,3978980,324,40,utRho06
1916,yecJ,3975604,3975604,3975516,88,20,utRho06
1917,yecM,3919968,3919968,3919692,276,64,utRho06
1918,yecR,3976400,3976444,3976400,44,52,utRho06
1919,yecT,3923862,3923944,3923862,82,140,utRho06
1920,yedD,4016522,4016522,4016180,342,88,utRho06
1921,yedE,4016310,4016554,4016310,244,34,utRho06
1922,yedI,4058922,4058922,4058732,190,0,utRho06
1923,yedJ,4066446,4066446,4066158,288,0,utRho06
1924,yedV,4076404,4076404,4076304,100,76,utRho06
1925,yedX,4077680,4077912,4077680,232,0,utRho06
1926,yedY,4078572,4078956,4078572,384,32,utRho06
1927,yeeA,4161322,4161322,4161182,140,94,utRho06
1928,yeeE,4171104,4171104,4171050,54,0,utRho06
1929,yeeJ,4089526,4089822,4089526,296,328,utRho06
1930,yeeN,4113508,4113716,4113508,208,4,utRho06
1931,yeeO,4119444,4119444,4119692,248,0,utRho06
1932,yeeX,4158834,4158834,4158722,112,82,utRho06
1933,yeeZ,4178422,4178422,4178256,166,0,utRho06
1934,yefM,4179466,4179466,4179426,40,66,utRho06
1935,yegD,4295288,4295348,4295288,60,0,utRho06
1936,yegH,4275726,4275804,4275726,78,0,utRho06
1937,yegI,4302154,4302154,4301970,184,0,utRho06
1938,yegJ,4302032,4302370,4302032,338,0,utRho06
1939,yegQ,4331182,4331336,4331182,154,104,utRho06
1940,yegR,4336698,4336698,4336612,86,0,utRho06
1941,yegS,4337086,4337424,4337086,338,0,utRho06
1942,yegT,4357562,4357642,4357562,80,0,utRho06
1943,yegX,4367640,4367640,4367302,338,28,utRho06
1944,yehA,4376944,4376944,4376828,116,0,utRho06
1945,yehE,4385818,4385818,4385592,226,0,utRho06
1946,yehK,4407568,4407944,4407568,376,0,utRho06
1947,yehL,4408804,4409192,4408804,388,0,utRho06
1948,yeiB,4486146,4486146,4485934,212,34,utRho06
1949,yeiE,4499422,4499422,4499236,186,56,utRho06
1950,yeiG,4487776,4487820,4487776,44,474,utRho06
1951,yeiH,4499332,4499434,4499332,102,0,utRho06
1952,yeiI,4503306,4503400,4503306,94,72,utRho06
1953,yeiL,4510580,4510710,4510580,130,0,utRho06
1954,yeiP,4530834,4530900,4530834,66,240,utRho06
1955,yeiQ,4532328,4532490,4532328,162,58,utRho06
1956,yeiR,4535484,4535658,4535484,174,48,utRho06
1957,yeiW,4530840,4530840,4530590,250,430,utRho06
1958,yejA,4544624,4544728,4544624,104,88,utRho06
1959,yejG,4556892,4556892,4556474,418,2730,utRho06
1960,yejH,4561244,4561264,4561244,20,10,utRho06
1961,yejK,4568218,4568218,4567894,324,414,utRho06
1962,yejO,4578352,4578352,4577800,552,84,utRho06
1963,yfaD,4713380,4713808,4713380,428,1018,utRho06
1964,yfaE,4696676,4697028,4696676,352,1298,utRho06
1965,yfaL,4688568,4688568,4688338,230,0,utRho06
1966,yfaP,4656398,4656398,4656286,112,22,utRho06
1967,yfaU,4717892,4717892,4717690,202,14,utRho06
1968,yfaY,4727310,4727310,4727266,44,34,utRho06
1969,yfaZ,4728744,4728744,4728550,194,2,utRho06
1970,yfbK,4771810,4771810,4771444,366,38,utRho06
1971,yfbL,4771500,4771720,4771500,220,38,utRho06
1972,yfbN,4777174,4777174,4776852,322,0,utRho06
1973,yfbO,4776916,4777162,4776916,246,0,utRho06
1974,yfbP,4777990,4778232,4777990,242,522,utRho06
1975,yfbR,4817662,4817724,4817662,62,112,utRho06
1976,yfcI,4847424,4847424,4847078,346,34,utRho06
1977,yfcJ,4880482,4880482,4880240,242,234,utRho06
1978,yfcL,4888502,4888502,4888338,164,114,utRho06
1979,yfcV,4911642,4911642,4911292,350,0,utRho06
1980,yfcZ,4921958,4921958,4921868,90,26,utRho06
1981,yfdF,4925604,4926024,4925604,420,418,utRho06
1982,yfdG,4935474,4935710,4935474,236,0,utRho06
1983,yfdP,4946844,4947040,4946844,196,0,utRho06
1984,yfdX,4988866,4988866,4988804,62,0,utRho06
1985,yfdY,4990672,4990672,4990584,88,0,utRho06
1986,yfeA,5035784,5035784,5035664,120,34978,utRho06
1987,yfeC,5036668,5036934,5036668,266,210,utRho06
1988,yfeH,5053818,5053892,5053818,74,12,utRho06
1989,yfeK,5074630,5074684,5074630,54,0,utRho06
1990,yfeO,5018906,5019260,5018906,354,172,utRho06
1991,yfeR,5054078,5054078,5053712,366,24,utRho06
1992,yfeX,5101356,5101356,5101090,266,0,utRho06
1993,yfeY,5102486,5102486,5102432,54,0,utRho06
1994,yfeZ,5103842,5103842,5103452,390,0,utRho06
1995,yffO,5123804,5124222,5123804,418,0,utRho06
1996,yffQ,5126778,5127154,5126778,376,6,utRho06
1997,yffS,5128800,5128986,5128800,186,62,utRho06
1998,yfgC,5232052,5232188,5232052,136,2,utRho06
1999,yfgF,5258062,5258062,5257876,186,36,utRho06
2000,yfgG,5258170,5258580,5258170,410,56,utRho06
2001,yfgH,5259344,5259584,5259344,240,8,utRho06
2002,yfgM,5278866,5278866,5278566,300,648,utRho06
2003,yfhH,5397414,5397518,5397414,104,0,utRho06
2004,yfhM,5304648,5304648,5304574,74,0,utRho06
2005,yfhR,5328408,5328726,5328408,318,4692,utRho06
2006,yfiC,5425610,5425610,5425528,82,0,utRho06
2007,yfiE,5430688,5430688,5430640,48,30,utRho06
2008,yfiL,5482630,5482720,5482630,90,0,utRho06
2009,yfiM,5448066,5448358,5448066,292,14604,utRho06
2010,yfiR,5483354,5483750,5483354,396,176,utRho06
2011,yfjH,5517326,5517326,5517200,126,14,utRho06
2012,yfjI,5517710,5517970,5517710,260,26,utRho06
2013,yfjJ,5521014,5521094,5521014,80,2,utRho06
2014,yfjM,5531970,5531970,5531552,418,746,utRho06
2015,yfjP,5535080,5535420,5535080,340,272,utRho06
2016,yfjW,5546570,5546636,5546570,66,36,utRho06
2017,yfjX,5551776,5551838,5551776,62,0,utRho06
2018,ygaC,5601180,5601180,5599988,1192,1080,utRho06
2019,ygaM,5600242,5600292,5600242,50,328,utRho06
2020,ygaU,5593628,5593628,5593572,56,0,utRho06
2021,ygaZ,5619190,5619234,5619190,44,1230,utRho06
2022,ygbA,5713656,5713656,5713612,44,0,utRho06
2023,ygbE,5746784,5746784,5746674,110,204,utRho06
2024,ygbI,5722882,5722882,5722528,354,0,utRho06
2025,ygbK,5724394,5724670,5724394,276,82,utRho06
2026,ygbL,5727074,5727186,5727074,112,16,utRho06
2027,ygbN,5729814,5730202,5729814,388,122,utRho06
2028,ygcG,5811210,5811422,5811210,212,0,utRho06
2029,ygcN,5785144,5785314,5785144,170,2,utRho06
2030,ygcU,5799214,5799214,5798836,378,0,utRho06
2031,ygcW,5800942,5800942,5800546,396,0,utRho06
2032,ygdD,5883442,5883442,5883262,180,156,utRho06
2033,ygdG,5861746,5861930,5861746,184,900,utRho06
2034,ygdI,5886526,5886526,5886290,236,98,utRho06
2035,ygdQ,5940784,5940840,5940784,56,14,utRho06
2036,ygdR,5942494,5942542,5942494,48,14,utRho06
2037,ygeA,5961606,5961606,5961270,336,0,utRho06
2038,ygeH,5983758,5984188,5983758,430,4,utRho06
2039,ygeI,5987162,5987276,5987162,114,2,utRho06
2040,ygeR,6000078,6000078,5999782,296,180,utRho06
2041,ygeV,6011694,6011694,6011572,122,12,utRho06
2042,ygeW,6012234,6012524,6012234,290,0,utRho06
2043,ygfB,6110946,6110946,6110888,58,28,utRho06
2044,ygfK,6031984,6032120,6031984,136,0,utRho06
2045,ygfS,6058328,6058328,6058024,304,2,utRho06
2046,ygfZ,6082564,6082626,6082564,62,14,utRho06
2047,yggC,6149512,6149512,6149378,134,2,utRho06
2048,yggE,6136370,6136370,6136160,210,32,utRho06
2049,yggI,6179176,6179510,6179176,334,174,utRho06
2050,yggL,6204508,6204508,6204266,242,56,utRho06
2051,yggM,6199514,6199514,6199130,384,160,utRho06
2052,yggN,6203596,6203596,6203246,350,0,utRho06
2053,yggX,18623958,18624558,18623958,600,1008,utRho06
2054,yghA,6298966,6299324,6298966,358,48,utRho06
2055,yghB,6307058,6307126,6307058,68,26,utRho06
2056,yghD,6222614,6222614,6222252,362,158,utRho06
2057,yghF,6225798,6225798,6225840,42,0,utRho06
2058,yghJ,6238640,6238640,6238224,416,0,utRho06
2059,yghQ,6265186,6265186,6264816,370,0,utRho06
2060,yghT,6267830,6268262,6267830,432,0,utRho06
2061,yghU,6277400,6277454,6277400,54,28,utRho06
2062,yghW,6293506,6293506,6293474,32,0,utRho06
2063,yghZ,6295562,6295794,6295562,232,0,utRho06
2064,ygiD,6365122,6365122,6364868,254,382,utRho06
2065,ygiH,6409066,6409388,6409066,322,0,utRho06
2066,ygiL,6370622,6370828,6370622,206,114,utRho06
2067,ygiM,6402084,6402414,6402084,330,40,utRho06
2068,ygiN,6346156,6346284,6346156,128,734,utRho06
2069,ygiQ,6322620,6322620,6322292,328,698,utRho06
2070,ygiS,6335462,6335462,6335436,26,4,utRho06
2071,ygiV,6338582,6338582,6338462,120,36,utRho06
2072,ygiW,6339774,6339774,6339352,422,226,utRho06
2073,ygiZ,6344506,6344506,6344422,84,0,utRho06
2074,ygjH,6442528,6442528,6442494,34,0,utRho06
2075,ygjI,6452140,6452468,6452140,328,0,utRho06
2076,ygjQ,6472730,6473080,6472730,350,144,utRho06
2077,ygjR,6474564,6474586,6474564,22,0,utRho06
2078,ygjV,6483638,6483638,6483488,150,0,utRho06
2079,yhaB,6535632,6535708,6535632,76,0,utRho06
2080,yhaH,6504498,6504608,6504498,110,46,utRho06
2081,yhaI,6505400,6505822,6505400,422,0,utRho06
2082,yhaJ,6508560,6508560,6508428,132,24,utRho06
2083,yhaK,6508538,6508638,6508538,100,24,utRho06
2084,yhbQ,6599878,6599932,6599878,54,134,utRho06
2085,yhbT,6602736,6602736,6602552,184,70,utRho06
2086,yhbU,6602558,6602970,6602558,412,92,utRho06
2087,yhbX,6643302,6643302,6643226,76,0,utRho06
2088,yhbY,6655518,6655580,6655518,62,830,utRho06
2089,yhcA,6723956,6724224,6723956,268,0,utRho06
2090,yhcB,6760364,6760382,6760364,18,68,utRho06
2091,yhcC,6708470,6708470,6708100,370,330,utRho06
2092,yhcF,6733440,6733852,6733440,412,46,utRho06
2093,yhcH,6739124,6739124,6738956,168,102,utRho06
2094,yhcM,6760312,6760312,6759994,318,160,utRho06
2095,yhcN,6770812,6771076,6770812,264,628,utRho06
2096,yhcO,6772606,6772606,6772258,348,0,utRho06
2097,yhdH,6806560,6806968,6806560,408,52,utRho06
2098,yhdJ,6823234,6823306,6823234,72,0,utRho06
2099,yhdN,6879092,6879092,6879018,74,3246,utRho06
2100,yhdT,6814702,6814750,6814702,48,414,utRho06
2101,yhdU,6824994,6825242,6824994,248,124,utRho06
2102,yhdV,6836392,6836780,6836392,388,0,utRho06
2103,yhdW,6837944,6838298,6837944,354,0,utRho06
2104,yheO,6953082,6953082,6952880,202,762,utRho06
2105,yheV,6957970,6957970,6957584,386,28,utRho06
2106,yhfA,6971902,6971902,6971636,266,12,utRho06
2107,yhfG,6983294,6983294,6983240,54,128,utRho06
2108,yhfL,6998622,6998896,6998622,274,56,utRho06
2109,yhfY,7023244,7023244,7022844,400,20,utRho06
2110,yhgA,7086294,7086334,7086294,40,0,utRho06
2111,yhgE,7065176,7065176,7064878,298,108,utRho06
2112,yhgF,7074352,7074770,7074352,418,1352,utRho06
2113,yhhA,7173458,7173886,7173458,428,72,utRho06
2114,yhhI,7248346,7248756,7248346,410,0,utRho06
2115,yhhJ,7253696,7253696,7253606,90,0,utRho06
2116,yhhM,7211588,7211588,7211220,368,324,utRho06
2117,yhhN,7211150,7211502,7211150,352,282,utRho06
2118,yhhQ,7218238,7218434,7218238,196,606,utRho06
2119,yhhT,7223682,7223730,7223682,48,2,utRho06
2120,yhhX,7162032,7162032,7161610,422,706,utRho06
2121,yhhY,7162222,7162276,7162222,54,78,utRho06
2122,yhhZ,7163516,7163726,7163516,210,0,utRho06
2123,yhiD,7312220,7312220,7311804,416,1448,utRho06
2124,yhiJ,7265190,7265190,7265180,10,0,utRho06
2125,yhiM,7269270,7269682,7269270,412,148,utRho06
2126,yhiN,7275000,7275000,7274820,180,30,utRho06
2127,yhjA,7338522,7338522,7338376,146,0,utRho06
2128,yhjB,7344090,7344090,7343788,302,28,utRho06
2129,yhjC,7344272,7344684,7344272,412,0,utRho06
2130,yhjD,7346660,7346724,7346660,64,0,utRho06
2131,yhjE,7349274,7349572,7349274,298,62,utRho06
2132,yhjG,7356824,7356824,7356730,94,2,utRho06
2133,yhjH,7358458,7358458,7358374,84,2,utRho06
2134,yhjJ,7364032,7364032,7363880,152,166,utRho06
2135,yhjK,7371296,7371296,7371158,138,0,utRho06
2136,yhjR,7392750,7392750,7392370,380,0,utRho06
2137,yhjV,7400796,7401126,7400796,330,592,utRho06
2138,yhjX,7424194,7424194,7424014,180,34,utRho06
2139,yhjY,7425966,7425966,7425868,98,4,utRho06
2140,yiaB,7455654,7455654,7455496,158,0,utRho06
2141,yiaD,7432712,7433094,7432712,382,0,utRho06
2142,yiaF,7438194,7438194,7438088,106,54,utRho06
2143,yiaG,7438862,7438956,7438862,94,206,utRho06
2144,yiaJ,7485236,7485236,7485064,172,0,utRho06
2145,yiaK,7485348,7485466,7485348,118,0,utRho06
2146,yiaT,7503924,7503924,7503736,188,0,utRho06
2147,yiaU,7503792,7503984,7503792,192,0,utRho06
2148,yiaY,7515856,7515856,7515654,202,44,utRho06
2149,yibF,7523950,7523950,7523910,40,0,utRho06
2150,yibG,7536128,7536354,7536128,226,0,utRho06
2151,yibL,7553194,7553330,7553194,136,108,utRho06
2152,yibN,7570112,7570112,7570030,82,162,utRho06
2153,yibT,7552848,7552848,7552760,88,44,utRho06
2154,yicC,7633290,7633352,7633290,62,0,utRho06
2155,yicH,7660862,7660914,7660862,52,0,utRho06
2156,yicJ,7673328,7673328,7671858,1470,702,utRho06
2157,yicN,7685018,7685018,7684804,214,0,utRho06
2158,yicO,7687914,7687914,7687578,336,0,utRho06
2159,yicR,15250308,15250308,15250236,72,0,utRho06
2160,yidB,7755230,7755230,7754930,300,24,utRho06
2161,yidE,7732780,7732780,7732546,234,0,utRho06
2162,yidF,7711580,7711580,7711222,358,164,utRho06
2163,yidQ,7735088,7735456,7735088,368,594,utRho06
2164,yidR,7738824,7738824,7738618,206,0,utRho06
2165,yieE,7787658,7787738,7787658,80,210,utRho06
2166,yieH,7793314,7793548,7793314,234,16,utRho06
2167,yieK,7798928,7798928,7798786,142,2,utRho06
2168,yifB,7900350,7900350,7899998,352,208,utRho06
2169,yifL,7988984,7989044,7988984,60,4,utRho06
2170,yigF,8005750,8005750,8005598,152,98,utRho06
2171,yigI,8009448,8009448,8009394,54,68,utRho06
2172,yigM,8022100,8022152,8022100,52,0,utRho06
2173,yihA,8101970,8101970,8101458,512,72,utRho06
2174,yihD,8084098,8084138,8084098,40,22,utRho06
2175,yihF,8088110,8088398,8088110,288,0,utRho06
2176,yihG,8093304,8093304,8093204,100,0,utRho06
2177,yihI,8102616,8102694,8102616,78,92,utRho06
2178,yihL,8120506,8120894,8120506,388,56,utRho06
2179,yihN,8124332,8124494,8124332,162,0,utRho06
2180,yihO,8131942,8131942,8131532,410,48,utRho06
2181,yihQ,8138892,8138892,8138552,340,0,utRho06
2182,yihV,8147064,8147478,8147064,414,0,utRho06
2183,yihX,8151096,8151106,8151096,10,4,utRho06
2184,yiiE,8158192,8158582,8158192,390,0,utRho06
2185,yiiF,8159124,8159502,8159124,378,0,utRho06
2186,yiiG,8173762,8174004,8173762,242,0,utRho06
2187,yiiM,8205506,8205644,8205506,138,4,utRho06
2188,yiiQ,8224624,8224624,8224428,196,16,utRho06
2189,yiiS,8225738,8225934,8225738,196,0,utRho06
2190,yijE,8272178,8272216,8272178,38,0,utRho06
2191,yijF,8275728,8275728,8275314,414,12,utRho06
2192,yijO,8296858,8296858,8296634,224,94,utRho06
2193,yjaA,8426240,8426468,8426240,228,88612,utRho06
2194,yjaB,8428312,8428312,8428246,66,196,utRho06
2195,yjaG,8398746,8399008,8398746,262,1126,utRho06
2196,yjaH,8401022,8401132,8401022,110,98,utRho06
2197,yjaZ,8379506,8379572,8379506,66,112,utRho06
2198,yjbB,8455204,8455462,8455204,258,0,utRho06
2199,yjbE,16943432,16943624,16943432,192,0,utRho06
2200,yjbL,8520318,8520642,8520318,324,0,utRho06
2201,yjbQ,8540428,8540476,8540428,48,38,utRho06
2202,yjcB,8550328,8550328,8550082,246,7830,utRho06
2203,yjcC,8550836,8550942,8550836,106,104,utRho06
2204,yjcD,8556628,8556958,8556628,330,46,utRho06
2205,yjcE,8559658,8559960,8559658,302,28,utRho06
2206,yjcF,8566212,8566212,8566150,62,0,utRho06
2207,yjcO,8594660,8594660,8594250,410,52,utRho06
2208,yjdA,8654128,8654270,8654128,142,4,utRho06
2209,yjdC,8726660,8726660,8726616,44,0,utRho06
2210,yjdK,8704780,8705168,8704780,388,62,utRho06
2211,yjdL,8713034,8713034,8712822,212,0,utRho06
2212,yjdM,8653672,8653672,8653468,204,0,utRho06
2213,yjeF,8787354,8788132,8787354,778,7818,utRho06
2214,yjeI,8745522,8745618,8745522,96,6,utRho06
2215,yjeJ,8748806,8748806,8748468,338,0,utRho06
2216,yjeV,8785472,8785784,8785472,312,420,utRho06
2217,yjfP,8833512,8833904,8833512,392,0,utRho06
2218,yjfY,8849656,8849656,8849582,74,0,utRho06
2219,yjfZ,8855052,8855052,8854844,208,0,utRho06
2220,yjgA,8916162,8916162,8915730,432,134,utRho06
2221,yjgL,8950802,8950874,8950802,72,0,utRho06
2222,yjgM,8959342,8959342,8959074,268,0,utRho06
2223,yjgN,8959132,8959460,8959132,328,0,utRho06
2224,yjgR,8980170,8980170,8980126,44,32,utRho06
2225,yjgZ,9002116,9002520,9002116,404,650,utRho06
2226,yjhB,9007764,9008116,9007764,352,134,utRho06
2227,yjhG,9048452,9048452,9048188,264,402,utRho06
2228,yjhU,9041080,9041080,9040648,432,150,utRho06
2229,yjiA,9178096,9178096,9177730,366,366,utRho06
2230,yjiJ,9125364,9125364,9125350,14,0,utRho06
2231,yjiK,9127270,9127270,9127422,152,62,utRho06
2232,yjiL,9129604,9129604,9129378,226,0,utRho06
2233,yjiS,9143410,9143502,9143410,92,0,utRho06
2234,yjiY,9182734,9182734,9182558,176,68,utRho06
2235,yjjA,9200674,9200674,9200378,296,238,utRho06
2236,yjjB,18408708,18408708,18407800,908,20,utRho06
2237,yjjJ,9243314,9243538,9243314,224,0,utRho06
2238,yjjK,9261132,9261132,9261044,88,178,utRho06
2239,yjjL,9189764,9189764,9189444,320,0,utRho06
2240,yjjM,9191894,9191894,9191702,192,2,utRho06
2241,yjjP,9206068,9206068,9205716,352,48,utRho06
2242,yjjQ,9206638,9206954,9206638,316,8,utRho06
2243,yjjX,9267798,9267798,9267490,308,294,utRho06
2244,yjjY,9280716,9280804,9280716,88,450,utRho06
2245,yjjZ,9211554,9211608,9211554,54,1820,utRho06
2246,yjtD,9281676,9281884,9281676,208,58,utRho06
2247,ykfB,532454,532454,532174,280,232,utRho06
2248,ykfI,527636,527636,527338,298,0,utRho06
2249,ykgB,637050,637050,636638,412,6,utRho06
2250,ykgC,640430,640430,640002,428,2,utRho06
2251,ykgD,640232,640454,640232,222,2,utRho06
2252,ykgE,642962,643216,642962,254,78,utRho06
2253,ykgJ,608524,608524,608364,160,60,utRho06
2254,ykgL,623878,624224,623878,346,0,utRho06
2255,ykgM,625610,625610,625554,56,0,utRho06
2256,ykgR,626570,626570,626484,86,0,utRho06
2257,ylaC,958576,958576,958502,74,1216,utRho06
2258,yliE,1745938,1745958,1745938,20,0,utRho06
2259,ymcE,2103660,2103694,2103660,34,250,utRho06
2260,ymdA,2210450,2210828,2210450,378,20,utRho06
2261,ymdB,2211428,2211640,2211428,212,0,utRho06
2262,ymfD,2395322,2395322,2395064,258,40,utRho06
2263,ymfI,2402880,2402994,2402880,114,0,utRho06
2264,ymfJ,2404518,2404518,2404168,350,110,utRho06
2265,ymfK,2406176,2406176,2405866,310,8,utRho06
2266,ymfT,2405766,2406048,2405766,282,10,utRho06
2267,ymgE,2489110,2489456,2489110,346,42,utRho06
2268,ymgF,2437628,2437966,2437628,338,0,utRho06
2269,ymiA,2670112,2670320,2670112,208,82,utRho06
2270,ymjA,2715620,2715620,2715336,284,570,utRho06
2271,ynaI,2791946,2791946,2791844,102,0,utRho06
2272,ynaK,2850438,2850754,2850438,316,76,utRho06
2273,ynbA,2954924,2955242,2954924,318,0,utRho06
2274,yncD,3046552,3046552,3046130,422,72,utRho06
2275,yncE,3046454,3046614,3046454,160,0,utRho06
2276,yncG,3052456,3052494,3052456,38,32,utRho06
2277,yncL,3034492,3034492,3034388,104,66,utRho06
2278,yneE,3218364,3218364,3218044,320,52,utRho06
2279,yneF,3223748,3223748,3223708,40,14,utRho06
2280,yneJ,3229560,3229608,3229560,48,124,utRho06
2281,yneK,3231100,3231526,3231100,426,0,utRho06
2282,yneM,3245176,3245292,3245176,116,50,utRho06
2283,ynfA,3311398,3311398,3311346,52,0,utRho06
2284,ynfB,3311418,3311616,3311418,198,230,utRho06
2285,ynfC,3315094,3315094,3314914,180,0,utRho06
2286,ynfD,3314828,3315130,3314828,302,0,utRho06
2287,ynfE,3316006,3316138,3316006,132,6,utRho06
2288,ynfK,3334670,3334670,3334438,232,12,utRho06
2289,ynfL,3339304,3339304,3339184,120,0,utRho06
2290,ynfM,3339260,3339398,3339260,138,0,utRho06
2291,ynfN,3276598,3276598,3276218,380,1474,utRho06
2292,ynfO,3273454,3273512,3273454,58,0,utRho06
2293,ynhG,3517890,3517890,3517450,440,466,utRho06
2294,yniA,3615158,3615592,3615158,434,0,utRho06
2295,yniB,3618526,3618526,3618466,60,0,utRho06
2296,yniC,3618652,3618760,3618652,108,0,utRho06
2297,yniD,3610202,3610330,3610202,128,0,utRho06
2298,ynjE,3678880,3678934,3678880,54,40,utRho06
2299,ynjF,3683222,3683222,3682806,416,4,utRho06
2300,ynjH,3684376,3684376,3684270,106,50,utRho06
2301,ynjI,3690022,3690022,3689742,280,144,utRho06
2302,yoaB,3786642,3786734,3786642,92,76,utRho06
2303,yoaC,3787932,3788146,3787932,214,136,utRho06
2304,yoaE,3803544,3803544,3803170,374,272,utRho06
2305,yoaF,3755444,3755444,3755064,380,432,utRho06
2306,yoaH,3789866,3789866,3789462,404,208,utRho06
2307,yobB,3850418,3850880,3850418,462,642,utRho06
2308,yobF,3815586,3815586,3815182,404,92,utRho06
2309,yobH,3817800,3817850,3817800,50,14,utRho06
2310,yodB,4084352,4084736,4084352,384,38,utRho06
2311,yodC,4057008,4057008,4056740,268,0,utRho06
2312,yohC,4451358,4451358,4451262,96,56,utRho06
2313,yohD,4451526,4451602,4451526,76,58,utRho06
2314,yohJ,4460986,4461248,4460986,262,0,utRho06
2315,yohO,4431172,4431314,4431172,142,72,utRho06
2316,yojI,4617282,4617282,4617230,52,4,utRho06
2317,ypdI,4988988,4989396,4988988,408,22,utRho06
2318,ypfG,5165786,5165786,5165554,232,110,utRho06
2319,ypfM,5182140,5182140,5181732,408,72,utRho06
2320,yphB,5349590,5349590,5349376,214,4,utRho06
2321,ypjA,5565644,5565644,5565452,192,2,utRho06
2322,ypjB,5569636,5569636,5568858,778,0,utRho06
2323,ypjD,5495860,5495774,5495860,86,0,utRho06
2324,yqaE,5594170,5594170,5594056,114,22,utRho06
2325,yqcA,5846100,5846100,5845968,132,22,utRho06
2326,yqcE,5800944,5801184,5800944,240,0,utRho06
2327,yqeC,6030468,6030468,6030114,354,6,utRho06
2328,yqeF,5971618,5971618,5971184,434,32,utRho06
2329,yqeG,5971438,5971694,5971438,256,16,utRho06
2330,yqeH,5975016,5975072,5975016,56,6,utRho06
2331,yqeI,5976688,5977004,5976688,316,6,utRho06
2332,yqeK,5981140,5981140,5980720,420,2,utRho06
2333,yqfA,6086728,6086728,6086296,432,64,utRho06
2334,yqgA,6219042,6219106,6219042,64,0,utRho06
2335,yqgB,6172500,6172500,6172102,398,1200,utRho06
2336,yqgE,6185768,6185874,6185768,106,474,utRho06
2337,yqhA,6299150,6299150,6298942,208,48,utRho06
2338,yqhC,6310768,6310768,6310436,332,158,utRho06
2339,yqhD,6310604,6310710,6310604,106,30,utRho06
2340,yqhH,6316842,6317254,6316842,412,592,utRho06
2341,yqiC,6369662,6369680,6369662,18,30,utRho06
2342,yqiJ,6384108,6384416,6384108,308,136,utRho06
2343,yqjA,6495096,6495546,6495096,450,6476,utRho06
2344,yqjF,6500932,6501124,6500932,192,80,utRho06
2345,yqjG,6501948,6502048,6501948,100,0,utRho06
2346,yqjH,6433078,6433078,6432982,96,0,utRho06
2347,yqjI,6433506,6433558,6433506,52,0,utRho06
2348,yraH,6574552,6574852,6574552,300,0,utRho06
2349,yraP,6592144,6592818,6592144,674,182,utRho06
2350,yraQ,6596414,6596414,6596276,138,0,utRho06
2351,yraR,6598024,6598024,6597692,332,0,utRho06
2352,yrbG,13360844,13361100,13360844,256,176,utRho06
2353,yrbL,6696842,6696904,6696842,62,566,utRho06
2354,yrbN,6616172,6616172,6615866,306,13834,utRho06
2355,yrdB,6860176,6860176,6860046,130,38,utRho06
2356,yrfF,7052548,7052938,7052548,390,686,utRho06
2357,yrhB,7169440,7169518,7169440,78,0,utRho06
2358,ysaB,7451804,7451804,7451424,380,32,utRho06
2359,ysgA,8032686,8032686,8032338,348,80,utRho06
2360,ytfB,8857638,8857638,8857434,204,80,utRho06
2361,ytfE,8864018,8864018,8863966,52,0,utRho06
2362,ytfF,8866296,8866296,8866130,166,0,utRho06
2363,ytfH,8868164,8868226,8868164,62,0,utRho06
2364,ytfI,8875234,8875414,8875234,180,0,utRho06
2365,ytfJ,8878572,8878572,8878524,48,38,utRho06
2366,ytfK,8879022,8879174,8879022,152,208,utRho06
2367,ytfL,8882642,8882642,8882430,212,16,utRho06
2368,ytfQ,8899634,8899924,8899634,290,60,utRho06
2369,ytjB,9249598,9249598,9249578,20,0,utRho06
2370,yzfA,8896588,8896588,8896490,98,2,utRho06
2371,zapA,6111102,6111224,6111102,122,4762,utRho06
2372,zapB,8236772,8237030,8236772,258,102,utRho06
2373,zapC,2011700,2011904,2011700,204,34,utRho06
2374,zinT,4082692,4082750,4082692,58,0,utRho06
2375,zipA,5062814,5062814,5062466,348,80,utRho06
2376,zitB,1569716,1569716,1569646,70,36,utRho06
2377,zntA,7212844,7212902,7212844,58,30,utRho06
2378,zntR,6878336,6878336,6878260,76,62,utRho06
2379,znuA,3885322,3885322,3885166,156,0,utRho06
2380,znuC,3885268,3885324,3885268,56,0,utRho06
2381,zraP,8403424,8403424,8403376,48,0,utRho06
2382,zraS,8403810,8403852,8403810,42,0,utRho06
2383,zupT,6364866,6365100,6364866,234,382,utRho06
2384,zur,8520282,8520282,8520006,276,1292,utRho06
2385,zwf,3872752,3872752,3872628,124,108,utRho06
0,C0343,2818676,2818728,2818676,52,0,utRho07
1,aaeB,6776526,6776526,6776376,150,0,utRho07
2,aaeR,6778762,6779040,6778762,278,100,utRho07
3,aaeX,6778860,6778860,6778674,186,140,utRho07
4,aat,1854920,1854920,1854864,56,0,utRho07
5,accA,416822,417242,416822,420,1938,utRho07
6,accB,6810280,6810872,6810280,592,10912,utRho07
7,accD,4868030,4868030,4867852,178,722,utRho07
8,aceB,8430804,8430956,8430804,152,0,utRho07
9,aceE,245938,246034,245938,96,216,utRho07
10,ackA,4826918,4826940,4826918,22,1194,utRho07
11,acnA,2670848,2671662,2670848,814,428,utRho07
12,acnB,263038,263230,263038,192,758,utRho07
13,acpP,2303148,2303230,2303148,82,280,utRho07
14,acpS,5402324,5402324,5401996,328,120,utRho07
15,acrA,971396,971396,971238,158,142,utRho07
16,acrB,969370,969370,968806,564,3210,utRho07
17,acrD,5174950,5175190,5174950,240,50,utRho07
18,acrE,6827404,6827728,6827404,324,0,utRho07
19,acrR,971398,971522,971398,124,202,utRho07
20,acrZ,1589502,1589546,1589502,44,0,utRho07
21,acs,8575190,8575190,8574742,448,38,utRho07
22,actP,8569870,8569870,8569804,66,10,utRho07
23,ada,4620854,4620854,4620810,44,0,utRho07
24,add,3404404,3404466,3404404,62,0,utRho07
25,ade,7687802,7687928,7687802,126,0,utRho07
26,adhE,2596826,2596826,2596242,584,112,utRho07
27,adhP,3107988,3107988,3107676,312,1266,utRho07
28,adiA,8681112,8681112,8681042,70,44,utRho07
29,adiC,8674404,8674404,8674062,342,0,utRho07
30,adiY,8676084,8676084,8675858,226,0,utRho07
31,adk,994278,994350,994278,72,100,utRho07
32,adrA,807374,807406,807374,32,0,utRho07
33,aer,6438240,6438240,6438152,88,222,utRho07
34,aes,1000102,1000102,999946,156,0,utRho07
35,agaR,6557406,6557406,6557330,76,0,utRho07
36,agaS,6563778,6563952,6563778,174,30,utRho07
37,agp,2131118,2131170,2131118,52,0,utRho07
38,agrA,7296126,7296126,7296126,0,0,utRho07
39,agrB,7296588,7296588,7296588,0,0,utRho07
40,ahpC,1277386,1277890,1277386,504,654,utRho07
41,ahpF,1278004,1279506,1278004,1502,66284,utRho07
42,ahr,8992698,8992698,8992418,280,0,utRho07
43,aidB,8828494,8828550,8828494,56,0,utRho07
44,ais,4731512,4731512,4731240,272,0,utRho07
45,alaA,4814816,4815122,4814816,306,22,utRho07
46,alaC,4996798,4996798,4996590,208,38,utRho07
47,alaE,5598140,5598328,5598140,188,0,utRho07
48,alaS,5644180,5644180,5644022,158,2208,utRho07
49,alaW,5036612,5036612,5036462,150,0,utRho07
50,aldA,2976380,2976464,2976380,84,148,utRho07
51,aldB,7513070,7513070,7513022,48,0,utRho07
52,alkA,4295118,4295118,4295080,38,0,utRho07
53,alkB,4618890,4618890,4618682,208,0,utRho07
54,allA,1064780,1064902,1064780,122,0,utRho07
55,allD,1092822,1092822,1092726,96,0,utRho07
56,allE,1088112,1088112,1088092,20,16,utRho07
57,allS,1064600,1064600,1064442,158,0,utRho07
58,alr,8531178,8531564,8531178,386,1400,utRho07
59,alsE,8617334,8617334,8616956,378,4,utRho07
60,alsK,8615990,8615990,8615598,392,0,utRho07
61,alx,6476740,6477160,6476740,420,0,utRho07
62,amiA,5104482,5104704,5104482,222,20,utRho07
63,amiC,5898378,5898378,5898020,358,48,utRho07
64,amn,4110062,4110122,4110062,60,0,utRho07
65,ampC,8758006,8758006,8757888,118,0,utRho07
66,ampD,237362,237466,237362,104,28,utRho07
67,ampG,907372,907372,907090,282,516,utRho07
68,ampH,792726,792726,792574,152,22,utRho07
69,amyA,4012230,4012312,4012230,82,110,utRho07
70,anmK,3439346,3439346,3439204,142,0,utRho07
71,ansB,6201580,6201580,6201456,124,0,utRho07
72,ansP,3052040,3052040,3051960,80,114,utRho07
73,apaG,104068,104068,103212,856,3968,utRho07
74,apaH,102586,102586,102444,142,2844,utRho07
75,apbE,4623188,4623188,4623068,120,22,utRho07
76,appA,2081198,2081234,2081198,36,0,utRho07
77,appC,2075420,2075480,2075420,60,0,utRho07
78,appY,1167134,1167362,1167134,228,0,utRho07
79,apt,982620,982824,982620,204,318,utRho07
80,aqpZ,1832424,1832424,1832094,330,0,utRho07
81,araB,140150,140150,140096,54,0,utRho07
82,araC,140482,140774,140482,292,144,utRho07
83,araE,5964416,5964416,5964364,52,0,utRho07
84,araF,3972476,3972476,3972256,220,0,utRho07
85,araH,3967120,3967120,3967086,34,0,utRho07
86,araJ,825058,825058,824962,96,2,utRho07
87,arcA,9281602,9281602,9280612,990,5304,utRho07
88,arcB,6706098,6706098,6706050,48,0,utRho07
89,arcZ,6701154,6701154,6701154,0,0,utRho07
90,arfA,6877346,6877346,6877298,48,0,utRho07
91,argA,5898312,5898484,5898312,172,36,utRho07
92,argC,8309770,8310002,8309770,232,30,utRho07
93,argD,6980442,6980442,6980360,82,8,utRho07
94,argE,8310156,8310156,8309694,462,118,utRho07
95,argF,580680,580680,580610,70,0,utRho07
96,argG,6637124,6637274,6637124,150,4,utRho07
97,argI,8956688,8956688,8956622,66,0,utRho07
98,argO,6137672,6137672,6137616,56,20,utRho07
99,argP,6119460,6119506,6119460,46,0,utRho07
100,argR,6769204,6769406,6769204,202,4,utRho07
101,argS,3920002,3920124,3920002,122,0,utRho07
102,argT,4855698,4855698,4855582,116,26,utRho07
103,argU,1129406,1129446,1129406,40,0,utRho07
104,argW,4932616,4932618,4932616,2,0,utRho07
105,argX,7964728,7964750,7964728,22,52,utRho07
106,aroF,5482402,5482402,5482300,102,0,utRho07
107,aroG,1571182,1571266,1571182,84,146,utRho07
108,aroH,3576636,3576870,3576636,234,350,utRho07
109,aroK,7038760,7038760,7038128,632,1298,utRho07
110,aroL,812560,812810,812560,250,94,utRho07
111,aroP,243342,243342,243102,240,0,utRho07
112,arpA,8445382,8445382,8444974,408,0,utRho07
113,arrS,7316108,7316108,7316108,0,0,utRho07
114,arsR,7297024,7297056,7297024,32,0,utRho07
115,artJ,1801252,1801252,1801150,102,0,utRho07
116,artP,1807686,1807686,1807468,218,0,utRho07
117,ascF,5678858,5679048,5678858,190,0,utRho07
118,ascG,5678574,5678574,5678528,46,0,utRho07
119,aslB,7965562,7965916,7965562,354,1246,utRho07
120,asnA,7854258,7854310,7854258,52,40,utRho07
121,asnB,1398444,1398444,1398354,90,170,utRho07
122,asnC,23562186,23562186,23562018,168,120,utRho07
123,asnS,1978088,1978088,1977970,118,8224,utRho07
124,asnT,4089082,4089098,4089082,16,160,utRho07
125,asnU,4119690,4119702,4119690,12,0,utRho07
126,asnV,4124504,4124520,4124504,16,24,utRho07
127,aspA,17473728,17473728,17473308,420,0,utRho07
128,aspC,1971486,1971486,1971418,68,700,utRho07
129,aspS,3901402,3901402,3901044,358,96,utRho07
130,aspT,7893560,7893744,7893560,184,120214,utRho07
131,aspV,473826,473862,473826,36,8,utRho07
132,asr,3342654,3342752,3342654,98,0,utRho07
133,astC,3664088,3664088,3663964,124,0,utRho07
134,astE,3654138,3654138,3653846,292,0,utRho07
135,atoD,4646824,4646894,4646824,70,0,utRho07
136,atpB,7844540,7844540,7844102,438,864,utRho07
137,atpC,7832118,7832118,7831944,174,3008,utRho07
138,atpI,7845050,7845050,7844880,170,108,utRho07
139,avtA,7479348,7479410,7479348,62,84,utRho07
140,azoR,2965982,2965982,2965720,262,84,utRho07
141,azuC,3976002,3976002,3975918,84,0,utRho07
142,bacA,6408350,6408350,6408262,88,2,utRho07
143,bamA,394052,395856,394052,1804,964,utRho07
144,bamB,5277950,5277950,5277304,646,2102,utRho07
145,bamC,5198028,5198028,5197730,298,1700,utRho07
146,bamD,5471922,5472292,5471922,370,7988,utRho07
147,bamE,5506972,5507210,5506972,238,192,utRho07
148,basS,8666954,8666954,8666544,410,334,utRho07
149,bax,7474468,7474468,7474354,114,22,utRho07
150,bcp,5200874,5200956,5200874,82,1824,utRho07
151,bcsB,7385346,7385346,7385214,132,48,utRho07
152,bcsE,7392644,7392916,7392644,272,0,utRho07
153,bdcA,8948128,8948128,8948106,22,6,utRho07
154,bdcR,8948192,8948248,8948192,56,0,utRho07
155,bdm,3112680,3112680,3112560,120,0,utRho07
156,betA,654522,654522,654494,28,250,utRho07
157,betI,658722,658722,658668,54,0,utRho07
158,betT,658842,658926,658842,84,0,utRho07
159,bfr,6933498,6933498,6933450,48,0,utRho07
160,bglG,23440182,23440182,23439402,780,0,utRho07
161,bglX,4444240,4444240,4443978,262,0,utRho07
162,bhsA,2337962,2338146,2337962,184,0,utRho07
163,bioA,1618584,1618584,1618514,70,0,utRho07
164,bioB,1618604,1618688,1618604,84,0,utRho07
165,bioH,7089716,7089716,7089688,28,0,utRho07
166,bisC,7433026,7433026,7432788,238,128,utRho07
167,blc,8755490,8755490,8755444,46,0,utRho07
168,blr,3409024,3409102,3409024,78,0,utRho07
169,bluF,2431226,2431226,2430950,276,160,utRho07
170,bluR,2428226,2428226,2428118,108,0,utRho07
171,bolA,908698,908944,908698,246,0,utRho07
172,borD,1157842,1157842,1157786,56,0,utRho07
173,brnQ,838976,839182,838976,206,652,utRho07
174,bssR,1756492,1756496,1756492,4,0,utRho07
175,bssS,2242116,2242116,2241910,206,66,utRho07
176,btuB,8326798,8327278,8326798,480,3342,utRho07
177,cadB,8720212,8720212,8720062,150,0,utRho07
178,cadC,8723926,8723926,8723868,58,0,utRho07
179,caiE,70998,70998,70742,256,0,utRho07
180,caiF,68436,68600,68436,164,16,utRho07
181,caiT,84074,84074,83862,212,0,utRho07
182,can,285406,285406,285340,66,0,utRho07
183,carA,59102,59302,59102,200,0,utRho07
184,carB,61550,61634,61550,84,158,utRho07
185,cas2,5757830,5757830,5757706,124,10,utRho07
186,casA,5768638,5768638,5768276,362,0,utRho07
187,cbl,4121882,4121882,4121828,54,0,utRho07
188,cbpA,2128074,2128074,2127550,524,66,utRho07
189,cbrA,7738628,7738754,7738628,126,0,utRho07
190,cbrB,7794958,7795012,7794958,54,2,utRho07
191,ccmH,4585242,4585242,4584820,422,0,utRho07
192,cdaR,364894,364926,364894,32,0,utRho07
193,cdd,4463638,4463688,4463638,50,0,utRho07
194,cdh,8219814,8219860,8219814,46,0,utRho07
195,cdsA,391110,391354,391110,244,1382,utRho07
196,cedA,3627484,3627484,3627326,158,10,utRho07
197,cfa,3482402,3482826,3482402,424,6,utRho07
198,chaC,2544844,2544972,2544844,128,0,utRho07
199,chbB,3643452,3643452,3643238,214,0,utRho07
200,chbG,3634624,3634624,3634270,354,0,utRho07
201,cheW,3946924,3946924,3946678,246,2130,utRho07
202,chiA,6939792,6939792,6939706,86,0,utRho07
203,chiP,1416472,1416668,1416472,196,4,utRho07
204,cho,3646984,3647030,3646984,46,32,utRho07
205,chpS,8896804,8896894,8896804,90,0,utRho07
206,cirA,4493884,4493884,4493538,346,20,utRho07
207,citC,1304078,1304078,1303712,366,0,utRho07
208,citT,1293264,1293264,1293160,104,0,utRho07
209,clcA,350104,350214,350104,110,0,utRho07
210,clpA,1846160,1846528,1846160,368,8,utRho07
211,clpB,5468410,5468410,5468346,64,14,utRho07
212,clpP,913154,913354,913154,200,248,utRho07
213,clpS,1845500,1845826,1845500,326,0,utRho07
214,clpX,914404,914852,914404,448,1184,utRho07
215,clsA,2617346,2617346,2617290,56,0,utRho07
216,clsC,2212584,2212710,2212584,126,260,utRho07
217,cmk,1922330,1922402,1922330,72,46,utRho07
218,cnu,3409522,3409898,3409522,376,314,utRho07
219,coaA,8350214,8350214,8350052,162,560,utRho07
220,cobC,1340092,1340092,1339814,278,176,utRho07
221,cobT,4129202,4129202,4128934,268,0,utRho07
222,cobU,4131944,4131944,4131528,416,0,utRho07
223,codB,709768,709844,709768,76,0,utRho07
224,comR,2337726,2337726,2337664,62,0,utRho07
225,copA,1022822,1022822,1022758,64,0,utRho07
226,corA,8002388,8002852,8002388,464,5350,utRho07
227,cpdB,8873258,8873258,8873130,128,176,utRho07
228,cptB,6082198,6082198,6082140,58,70,utRho07
229,cpxA,8210202,8210202,8209950,252,492,utRho07
230,cpxP,8211570,8211640,8211570,70,86,utRho07
231,cpxR,8211372,8211372,8211340,32,0,utRho07
232,cra,175894,176056,175894,162,12,utRho07
233,crcB,1316016,1316016,1315876,140,0,utRho07
234,creA,9270486,9271042,9270486,556,332,utRho07
235,creD,9276320,9276356,9276320,36,4,utRho07
236,crl,515620,515658,515620,38,750,utRho07
237,crp,6971906,6972240,6971906,334,3356,utRho07
238,crr,5070960,5071668,5070960,708,4574,utRho07
239,csdA,5886414,5886674,5886414,260,0,utRho07
240,csgB,2207718,2207902,2207718,184,0,utRho07
241,csgD,2206688,2206688,2206392,296,0,utRho07
242,csgG,2203510,2203510,2203368,142,40,utRho07
243,csiD,5577854,5577970,5577854,116,26,utRho07
244,csiE,5330802,5330870,5330802,68,0,utRho07
245,csiR,5590942,5591348,5590942,406,0,utRho07
246,cspA,7439778,7440098,7439778,320,33560,utRho07
247,cspB,3283430,3283430,3283108,322,0,utRho07
248,cspC,3815018,3815018,3814870,148,264,utRho07
249,cspD,1845352,1845352,1845180,172,728,utRho07
250,cspE,1314294,1314584,1314294,290,28,utRho07
251,cspF,3283380,3283710,3283380,330,26,utRho07
252,cspG,2102610,2102922,2102610,312,766,utRho07
253,cspH,2102746,2102746,2102350,396,56,utRho07
254,cspI,3277624,3277624,3277334,290,0,utRho07
255,csrA,5638746,5638746,5638292,454,1338,utRho07
256,csrB,5849048,5849048,5849048,0,0,utRho07
257,csrC,8102072,8102072,8102072,0,0,utRho07
258,csrD,6806850,6806850,6806664,186,92,utRho07
259,cstA,1259710,1259788,1259710,78,52,utRho07
260,cueO,274090,274166,274090,76,0,utRho07
261,cueR,1027948,1027986,1027948,38,0,utRho07
262,curA,3037784,3038054,3037784,270,0,utRho07
263,cusC,1191146,1191200,1191146,54,0,utRho07
264,cusR,1190924,1190924,1190886,38,54,utRho07
265,cutA,8730784,8730784,8730712,72,72,utRho07
266,cutC,3918534,3918534,3917920,614,30,utRho07
267,cvpA,4861600,4861600,4861526,74,104,utRho07
268,cvrA,2484328,2484328,2484142,186,80,utRho07
269,cyaA,7981548,7982306,7981548,758,218,utRho07
270,cyaR,4334228,4334224,4334228,4,16,utRho07
271,cyaY,7988166,7988166,7988118,48,0,utRho07
272,cybB,2981522,2981804,2981522,282,14,utRho07
273,cycA,8859560,8859728,8859560,168,238,utRho07
274,cydA,1542340,1542916,1542340,576,106,utRho07
275,cydC,1858800,1858800,1858390,410,148,utRho07
276,cydD,1862062,1862062,1861924,138,4,utRho07
277,cydX,1548300,1548392,1548300,92,102,utRho07
278,cynR,717418,717418,717380,38,0,utRho07
279,cynT,1435092,1435196,1435092,104,0,utRho07
280,cyoA,903306,903306,903220,86,2552,utRho07
281,cyoE,895540,895540,895410,130,416,utRho07
282,cysB,2667576,2667710,2667576,134,172,utRho07
283,cysC,5748056,5748056,5747984,72,0,utRho07
284,cysD,5752736,5752736,5752658,78,0,utRho07
285,cysE,7565362,7565362,7565124,238,528,utRho07
286,cysG,6995508,6995656,6995508,148,0,utRho07
287,cysJ,5783928,5783928,5783796,132,804,utRho07
288,cysK,5064688,5064818,5064688,130,36,utRho07
289,cysP,5087114,5087114,5087056,58,32,utRho07
290,cysS,1109154,1109222,1109154,68,68,utRho07
291,cysT,3984100,3984100,3983974,126,62,utRho07
292,cysZ,5062766,5062926,5062766,160,48,utRho07
293,cytR,8249018,8249018,8248912,106,0,utRho07
294,dacA,1328002,1328002,1327926,76,222,utRho07
295,dacB,6657714,6657926,6657714,212,22,utRho07
296,dacC,1761306,1761454,1761306,148,0,utRho07
297,dadA,2475018,2475142,2475018,124,78,utRho07
298,dam,7032504,7032504,7031826,678,2212,utRho07
299,damX,7035200,7035200,7034612,588,528,utRho07
300,dapA,5199568,5199568,5199520,48,0,utRho07
301,dapB,56576,56748,56576,172,76,utRho07
302,dapD,371954,371954,371894,60,144,utRho07
303,dapE,5183120,5183214,5183120,94,468,utRho07
304,dcp,3254844,3254844,3254760,84,36,utRho07
305,dcrB,7219534,7219910,7219534,376,54,utRho07
306,dctA,7366996,7366996,7366894,102,228,utRho07
307,dcuA,8733686,8733686,8733546,140,2,utRho07
308,dcuB,8698182,8698182,8697488,694,0,utRho07
309,dcuC,1312166,1312166,1311936,230,0,utRho07
310,dcuD,6749166,6749738,6749166,572,0,utRho07
311,dcuR,8701130,8701130,8700068,1062,418,utRho07
312,dcuS,8703370,8703370,8703324,46,24,utRho07
313,dcyD,3999016,3999016,3998960,56,0,utRho07
314,ddpX,3126498,3126498,3126152,346,0,utRho07
315,deaD,6615818,6615818,6615720,98,1374,utRho07
316,dedA,4869880,4869880,4869482,398,13180,utRho07
317,dedD,4863750,4863750,4863368,382,70,utRho07
318,def,6867300,6867380,6867300,80,0,utRho07
319,degP,361690,361768,361690,78,0,utRho07
320,degQ,6761308,6761486,6761308,178,500,utRho07
321,deoB,9239134,9239206,9239134,72,0,utRho07
322,deoC,9233358,9234646,9233358,1288,192,utRho07
323,dfp,7625406,7625462,7625406,56,0,utRho07
324,dgcZ,3247758,3247758,3247700,58,0,utRho07
325,dgkA,8512914,8513274,8512914,360,448,utRho07
326,dgt,358392,358474,358392,82,0,utRho07
327,dhaK,2501888,2501888,2501676,212,426,utRho07
328,dhaR,2502006,2502132,2502006,126,0,utRho07
329,dicB,3299194,3299218,3299194,24,0,utRho07
330,dicC,3295752,3295752,3295700,52,0,utRho07
331,dinB,501760,501796,501760,36,0,utRho07
332,dinD,7635398,7635520,7635398,122,132,utRho07
333,dinG,1666146,1666140,1666146,6,0,utRho07
334,dinI,2243018,2243018,2242974,44,6,utRho07
335,dinJ,493230,493230,493004,226,16,utRho07
336,dinQ,7295964,7295964,7295576,388,1420,utRho07
337,djlA,114536,114728,114536,192,0,utRho07
338,dkgA,6313142,6313246,6313142,104,36,utRho07
339,dkgB,458196,458334,458196,138,2,utRho07
340,dksA,321502,321502,321208,294,394,utRho07
341,dld,4444164,4444370,4444164,206,0,utRho07
342,dmlA,3763424,3763824,3763424,400,20,utRho07
343,dmlR,3763710,3763710,3763618,92,0,utRho07
344,dmsA,1881646,1881918,1881646,272,0,utRho07
345,dnaA,7767922,7767922,7767458,464,452,utRho07
346,dnaB,8528566,8528628,8528566,62,72,utRho07
347,dnaK,24096,24326,24096,230,346,utRho07
348,dnaN,7765466,7765466,7764642,824,560,utRho07
349,dnaQ,471868,472134,471868,266,522,utRho07
350,dnaT,18406460,18406460,18406068,392,16,utRho07
351,dnaX,984112,984184,984112,72,410,utRho07
352,dosP,3131486,3131486,3131466,20,40,utRho07
353,dpiB,1303968,1304470,1303968,502,0,utRho07
354,dppA,7415740,7415740,7415410,330,2116,utRho07
355,dps,1697900,1697900,1697822,78,0,utRho07
356,dsbA,8086754,8086836,8086754,82,2220,utRho07
357,dsbB,2466294,2466294,2466060,234,24,utRho07
358,dsbC,6079266,6079266,6077644,1622,790,utRho07
359,dsbG,1277600,1277600,1277146,454,256,utRho07
360,dsdA,4958242,4958404,4958242,162,60,utRho07
361,dsdC,4955492,4955492,4955258,234,0,utRho07
362,dsdX,4955642,4955694,4955642,52,0,utRho07
363,dsrA,4050626,4050626,4050626,0,0,utRho07
364,dsrB,4049686,4049686,4049646,40,0,utRho07
365,dtpD,1485340,1485340,1485112,228,82,utRho07
366,dusA,8523200,8523338,8523200,138,1192,utRho07
367,dusB,6820492,6820560,6820492,68,176,utRho07
368,dusC,4460790,4460790,4460770,20,0,utRho07
369,dut,7627704,7627864,7627704,160,1546,utRho07
370,dxr,386670,387042,386670,372,990,utRho07
371,ebgA,6445102,6445266,6445102,164,48,utRho07
372,ebgR,6442874,6442932,6442874,58,94,utRho07
373,ecnB,8753018,8753106,8753018,88,200,utRho07
374,eco,4607594,4607810,4607594,216,0,utRho07
375,ecpA,621594,621594,621342,252,0,utRho07
376,ecpB,620238,620238,620052,186,8,utRho07
377,ecpR,622964,622964,622672,292,0,utRho07
378,eda,3866218,3866218,3865512,706,118,utRho07
379,edd,3869426,3869426,3869208,218,138,utRho07
380,efeO,2164308,2164486,2164308,178,8,utRho07
381,efeU_1,2162614,2162712,2162614,98,80,utRho07
382,efp,8751134,8751398,8751134,264,2978,utRho07
383,elaA,4763372,4763372,4763086,286,174,utRho07
384,elaD,4765308,4765426,4765308,118,0,utRho07
385,elfA,1995530,1995736,1995530,206,0,utRho07
386,elfD,1996642,1996980,1996642,338,0,utRho07
387,emrD,7707690,7707844,7707690,154,2,utRho07
388,emrK,4966896,4966896,4966678,218,0,utRho07
389,emrY,4964668,4964668,4964352,316,44,utRho07
390,emtA,2486250,2486360,2486250,110,0,utRho07
391,endA,12361100,12361388,12361100,288,0,utRho07
392,eno,5817692,5817692,5815882,1810,4596,utRho07
393,entC,1249662,1249770,1249662,108,0,utRho07
394,entD,1220508,1220508,1220158,350,0,utRho07
395,entH,1258584,1258600,1258584,16,0,utRho07
396,entS,1244506,1244600,1244506,94,0,utRho07
397,envR,6827266,6827266,6826930,336,0,utRho07
398,epd,12295292,12295292,12294764,528,56,utRho07
399,epmA,8765236,8765286,8765236,50,0,utRho07
400,epmB,8751406,8751406,8751314,92,1528,utRho07
401,eptB,7421162,7421162,7420950,212,0,utRho07
402,eptC,8300622,8300622,8300530,92,24,utRho07
403,erfK,4126708,4126708,4126646,62,56,utRho07
404,erpA,353122,353220,353122,98,32,utRho07
405,esrE,8039956,8039956,8039956,0,0,utRho07
406,essD,1153746,1154796,1153746,1050,20,utRho07
407,etk,2088606,2088606,2088420,186,0,utRho07
408,evgA,4967262,4967510,4967262,248,42,utRho07
409,exbB,6304028,6304028,6303968,60,0,utRho07
410,exbD,6302780,6302780,6302486,294,0,utRho07
411,exuR,6493016,6493304,6493016,288,124,utRho07
412,exuT,6490004,6490208,6490004,204,0,utRho07
413,fabA,2032996,2032996,2032940,56,98,utRho07
414,fabB,4883282,4883282,4883210,72,0,utRho07
415,fabH,2297032,2297518,2297032,486,2802,utRho07
416,fabI,2702236,2702236,2702078,158,92,utRho07
417,fadB,8062026,8062026,8061942,84,0,utRho07
418,fadD,3779614,3779614,3779492,122,0,utRho07
419,fadE,486812,486812,486606,206,0,utRho07
420,fadH,6463248,6463330,6463248,82,0,utRho07
421,fadI,4921022,4921022,4920938,84,0,utRho07
422,fadL,4922410,4922600,4922410,190,0,utRho07
423,fadM,928720,928804,928720,84,0,utRho07
424,fadR,2469810,2469876,2469810,66,0,utRho07
425,fbaB,4357334,4357334,4357128,206,0,utRho07
426,fdhE,8162722,8162722,8162456,266,1332,utRho07
427,fdhF,8598814,8598814,8598732,82,0,utRho07
428,fdnG,3094744,3094802,3094744,58,0,utRho07
429,fdrA,1093012,1093360,1093012,348,0,utRho07
430,feaB,2894994,2895038,2894994,44,0,utRho07
431,feaR,2894734,2894734,2894566,168,28,utRho07
432,fecA,9033454,9033454,9033354,100,4,utRho07
433,fecE,9023288,9023288,9022914,374,4640,utRho07
434,fecI,9036564,9036564,9036470,94,0,utRho07
435,feoA,7080114,7080326,7080114,212,0,utRho07
436,fepA,1225334,1225334,1224988,346,0,utRho07
437,fepB,1249454,1249454,1249020,434,8,utRho07
438,fepD,1244468,1244468,1244378,90,0,utRho07
439,fes,1225374,1225630,1225374,256,2,utRho07
440,ffh,5495706,5495706,5495590,116,828,utRho07
441,ffs,952576,952848,952576,272,2,utRho07
442,fhuA,334884,334968,334884,84,0,utRho07
443,fhuE,2323294,2323294,2323102,192,0,utRho07
444,fhuF,9211504,9211504,9211326,178,140,utRho07
445,fic,6983296,6983296,6982926,370,230,utRho07
446,fieF,8212864,8212938,8212864,74,0,utRho07
447,fimA,9085388,9086230,9085388,842,32,utRho07
448,fimB,9081334,9081914,9081334,580,324,utRho07
449,fimE,9083742,9084074,9083742,332,78,utRho07
450,fimZ,1129214,1129214,1128960,254,0,utRho07
451,fiu,1683296,1683296,1683062,234,0,utRho07
452,fixA,84650,84806,84650,156,0,utRho07
453,fkpA,6955050,6955050,6954838,212,8020,utRho07
454,fldA,2846084,2846084,2845860,224,2576,utRho07
455,fldB,6079644,6079710,6079644,66,0,utRho07
456,flgA,2261770,2261770,2261726,44,2,utRho07
457,flgB,2261986,2262036,2261986,50,0,utRho07
458,flgK,2276702,2276756,2276702,54,1050,utRho07
459,flgM,2260330,2260330,2260256,74,388,utRho07
460,flgN,2259828,2259828,2259660,168,18,utRho07
461,flhB,3932432,3932432,3932382,50,290,utRho07
462,flhC,3955864,3955864,3955688,176,82,utRho07
463,flhD,3957154,3957154,3956394,760,204,utRho07
464,fliA,4003638,4003638,4003578,60,128,utRho07
465,fliC,4007352,4007352,4007212,140,1190,utRho07
466,fliD,4007634,4007744,4007634,110,298,utRho07
467,fliE,4026186,4026186,4026028,158,4,utRho07
468,fliF,4026292,4026458,4026292,166,324,utRho07
469,fliL,4039168,4039236,4039168,68,94,utRho07
470,flk,4875824,4875900,4875824,76,0,utRho07
471,flu,4142634,4143078,4142634,444,0,utRho07
472,flxA,3292776,3292810,3292776,34,42,utRho07
473,fnr,2799104,2799104,2799052,52,28,utRho07
474,fnrS,2818258,2818258,2818258,0,0,utRho07
475,focA,1909628,1909628,1908932,696,360,utRho07
476,folA,99598,99646,99598,48,0,utRho07
477,folB,6409296,6409296,6409178,118,0,utRho07
478,folD,1115562,1115562,1115482,80,196,utRho07
479,folE,4487696,4487696,4487304,392,2846,utRho07
480,fpr,8228998,8228998,8228944,54,0,utRho07
481,frc,4986878,4986878,4986508,370,0,utRho07
482,frdA,8764824,8764824,8764636,188,0,utRho07
483,frdD,8758948,8758948,8758732,216,588,utRho07
484,fre,8052886,8053054,8052886,168,1790,utRho07
485,frlA,6999518,6999820,6999518,302,0,utRho07
486,frr,385624,385744,385624,120,1132,utRho07
487,frsA,513004,513054,513004,50,118,utRho07
488,fruB,4527194,4527194,4526990,204,40,utRho07
489,frvR,8179804,8179804,8179710,94,0,utRho07
490,fryA,5008986,5008986,5008970,16,0,utRho07
491,fsaA,1727060,1727284,1727060,224,0,utRho07
492,fsr,1009710,1009710,1009392,318,68,utRho07
493,ftnA,3977364,3977432,3977364,68,0,utRho07
494,ftnB,3973550,3973850,3973550,300,0,utRho07
495,ftsA,207122,207964,207122,842,316,utRho07
496,ftsB,5745802,5745802,5745640,162,0,utRho07
497,ftsH,6654204,6654204,6653870,334,606,utRho07
498,ftsK,1865858,1866448,1865858,590,1544,utRho07
499,ftsL,181376,182064,181376,688,2094,utRho07
500,ftsP,6325732,6325732,6325338,394,288,utRho07
501,ftsQ,205484,206310,205484,826,508,utRho07
502,ftsX,7204512,7204512,7204172,340,712,utRho07
503,ftsZ,209272,210610,209272,1338,148,utRho07
504,fucA,5867708,5867708,5867376,332,0,utRho07
505,fucP,5868238,5868470,5868238,232,2,utRho07
506,fumA,6753760,6753760,6753508,252,4816,utRho07
507,fumB,8694696,8694696,8694652,44,14,utRho07
508,fumC,3373418,3373418,3373176,242,0,utRho07
509,fur,2842892,2842892,2842584,308,7868,utRho07
510,fusA,6947370,6947370,6947028,342,35414,utRho07
511,fxsA,8737206,8737328,8737206,122,0,utRho07
512,gabD,5581824,5582546,5581824,722,920,utRho07
513,gadA,7335214,7335214,7335160,54,0,utRho07
514,gadB,3144144,3144144,3144090,54,4,utRho07
515,gadC,3141168,3141168,3140978,190,0,utRho07
516,gadE,7315600,7316732,7315600,1132,4,utRho07
517,gadW,7329562,7329562,7329236,326,0,utRho07
518,gadX,14663356,14663356,14663240,116,0,utRho07
519,gadY,7329728,7329728,7329728,0,0,utRho07
520,galE,1584354,1584354,1584110,244,0,utRho07
521,galF,4228702,4228702,4228654,48,0,utRho07
522,galM,1577796,1577796,1577674,122,446,utRho07
523,galP,6176510,6176568,6176510,58,0,utRho07
524,galR,5953138,5953198,5953138,60,88,utRho07
525,galS,4483420,4483420,4483336,84,0,utRho07
526,galU,2582810,2582914,2582810,104,454,utRho07
527,gapA,3724480,3725542,3724480,1062,4720,utRho07
528,garP,6549868,6549868,6549814,54,54,utRho07
529,gatY,4354468,4354468,4354408,60,104,utRho07
530,gatZ,4352864,4352864,4352642,222,16220,utRho07
531,gcd,282558,282558,282450,108,0,utRho07
532,gcl,1067814,1067832,1067814,18,0,utRho07
533,gcvA,5885278,5885278,5885134,144,0,utRho07
534,gcvB,5885392,5885392,5885392,0,0,utRho07
535,gcvR,5199758,5199812,5199758,54,34,utRho07
536,gcvT,6101544,6101544,6101334,210,1532,utRho07
537,gdhA,3684616,3684742,3684616,126,26,utRho07
538,gfcA,2099668,2099668,2099488,180,8,utRho07
539,gfcD,2096236,2096236,2095890,346,0,utRho07
540,ghrA,2195648,2195772,2195648,124,2,utRho07
541,ghrB,7434378,7434620,7434378,242,530,utRho07
542,glcA,6242728,6242728,6242558,170,4,utRho07
543,glcC,6256412,6256544,6256412,132,14,utRho07
544,glcD,6256152,6256152,6256042,110,0,utRho07
545,gldA,8278092,8278092,8278070,22,40,utRho07
546,glgA,7136784,7136784,7136066,718,454,utRho07
547,glgB,7147314,7147314,7147004,310,22,utRho07
548,glgC,7139142,7139142,7138656,486,66,utRho07
549,glgP,7133546,7133546,7133162,384,0,utRho07
550,glgS,6384024,6384024,6383878,146,0,utRho07
551,glgX,7142838,7142838,7142638,200,0,utRho07
552,glk,5018922,5018922,5018852,70,22,utRho07
553,glmS,7827622,7827622,7827336,286,6100,utRho07
554,glmU,7830652,7830652,7830400,252,116,utRho07
555,glmY,10765360,10765360,10765360,0,0,utRho07
556,glmZ,7972864,7972864,7972864,0,0,utRho07
557,glnA,16232888,16232888,16232136,752,736,utRho07
558,glnB,5375052,5375052,5374816,236,172,utRho07
559,glnD,377310,377310,377300,10,0,utRho07
560,glnE,6399602,6399602,6399282,320,0,utRho07
561,glnH,1696396,1696396,1696008,388,60,utRho07
562,glnK,945112,945196,945112,84,0,utRho07
563,glnL,8112742,8112742,8112678,64,20,utRho07
564,glnQ,1693262,1693262,1692926,336,342,utRho07
565,glnS,1411998,1412186,1411998,188,464,utRho07
566,gloA,3455602,3455674,3455602,72,0,utRho07
567,gloB,469852,469852,469564,288,430,utRho07
568,glpA,4705166,4705294,4705166,128,42,utRho07
569,glpD,7123942,7124026,7123942,84,24,utRho07
570,glpE,7123698,7123698,7123646,52,38,utRho07
571,glpF,8236322,8236322,8236180,142,306,utRho07
572,glpG,7122960,7122960,7122904,56,392,utRho07
573,glpR,7121782,7121782,7121210,572,132,utRho07
574,glpT,4704902,4704902,4704748,154,238,utRho07
575,glpX,8231212,8231212,8231158,54,2926,utRho07
576,glrK,5382246,5382246,5382196,50,0,utRho07
577,gltA,1509534,1509534,1508936,598,11270,utRho07
578,gltB,6709018,6709264,6709018,246,232,utRho07
579,gltI,1375792,1375792,1375494,298,1900,utRho07
580,gltP,8588536,8588962,8588536,426,786,utRho07
581,gltS,7657382,7657382,7657330,52,320,utRho07
582,gltX,5041568,5041568,5041344,224,184,utRho07
583,gluQ,320286,320286,320224,62,104,utRho07
584,glyA,5371148,5371148,5371014,134,88,utRho07
585,glyQ,7450708,7450708,7450636,72,150,utRho07
586,glyS,7448990,7448990,7448794,196,4218,utRho07
587,glyU,5998128,5998128,5998114,14,0,utRho07
588,glyV,8784626,8784720,8784626,94,66,utRho07
589,glyW,3984360,3984360,3984234,126,0,utRho07
590,gmhB,445612,445666,445612,54,26,utRho07
591,gmk,7642776,7642856,7642776,80,42,utRho07
592,gmr,2693686,2693686,2693484,202,0,utRho07
593,gnd,4202648,4202648,4202536,112,784,utRho07
594,gnsB,3275692,3275692,3275564,128,0,utRho07
595,gntK,14310580,14310580,14310368,212,60,utRho07
596,gntP,9102668,9102668,9102592,76,0,utRho07
597,gntR,7157760,7157760,7157452,308,226,utRho07
598,gntT,7092810,7093118,7092810,308,0,utRho07
599,gntU,7154170,7154170,7154122,48,0,utRho07
600,gntX,7089334,7089764,7089334,430,0,utRho07
601,gor,7292224,7292598,7292224,374,1294,utRho07
602,gpmA,1575340,1575340,1575190,150,0,utRho07
603,gpmM,7570374,7570520,7570374,146,0,utRho07
604,gpsA,7567620,7567620,7567322,298,11290,utRho07
605,gpt,511828,511954,511828,126,1010,utRho07
606,grcA,5433046,5433046,5432898,148,28,utRho07
607,greA,6657728,6657728,6657430,298,1586,utRho07
608,greB,7073488,7073624,7073488,136,68,utRho07
609,groL,8741566,8742050,8741566,484,1732,utRho07
610,groS,8741232,8741376,8741232,144,750,utRho07
611,grpE,5501494,5501494,5501416,78,42,utRho07
612,grxA,1781552,1781552,1781506,46,0,utRho07
613,grxB,2248206,2248206,2248108,98,36,utRho07
614,grxC,7569152,7569152,7568884,268,8442,utRho07
615,grxD,3468324,3468324,3468202,122,9336,utRho07
616,gspA,6911268,6911268,6910796,472,4,utRho07
617,gspC,6910964,6911156,6910964,192,2,utRho07
618,gss,6277220,6277220,6277044,176,4,utRho07
619,gstA,3428654,3428754,3428654,100,0,utRho07
620,gstB,1761038,1761038,1760960,78,0,utRho07
621,guaB,5268214,5268214,5268140,74,136,utRho07
622,gudD,5839026,5839026,5838770,256,0,utRho07
623,gyrA,4678914,4678914,4678840,74,0,utRho07
624,gyrB,7760300,7760300,7760238,62,68,utRho07
625,hcaE,5337964,5338064,5337964,100,32,utRho07
626,hcaR,5337928,5337928,5337792,136,68,utRho07
627,hcaT,5336106,5336106,5335692,414,178,utRho07
628,hchA,4071260,4071670,4071260,410,44,utRho07
629,hcp,1828258,1828258,1827628,630,0,utRho07
630,hcr,1824400,1824400,1824300,100,0,utRho07
631,hdeA,7313582,7313582,7313480,102,0,utRho07
632,hdeD,7313920,7313990,7313920,70,0,utRho07
633,hdfR,7896320,7896320,7895934,386,68,utRho07
634,hdhA,3396244,3396244,3396080,164,80,utRho07
635,helD,2048876,2048942,2048876,66,0,utRho07
636,hemA,2527166,2527428,2527166,262,52,utRho07
637,hemB,779722,779722,779454,268,22,utRho07
638,hemF,5106410,5106450,5106410,40,44,utRho07
639,hemH,996062,996110,996062,48,32,utRho07
640,hemL,349882,349882,349764,118,16,utRho07
641,hemN,8103886,8104090,8103886,204,104,utRho07
642,hepA,127176,127176,126528,648,1146,utRho07
643,hflD,2385372,2385372,2385262,110,642,utRho07
644,hfq,8799602,8800576,8799602,974,3044,utRho07
645,hha,961006,961006,960616,390,28,utRho07
646,hicA,3018442,3018572,3018442,130,0,utRho07
647,higA,6468682,6468682,6468288,394,54,utRho07
648,higB,6468960,6468960,6468910,50,0,utRho07
649,hinT,2323642,2323770,2323642,128,12,utRho07
650,hipB,3184964,3184964,3184884,80,24,utRho07
651,hisB,4186720,4186936,4186720,216,814,utRho07
652,hisJ,4853674,4853674,4853576,98,52,utRho07
653,hisL,8359856,8359984,8359856,128,128,utRho07
654,hisS,5281284,5281284,5281150,134,246,utRho07
655,hlpA,400910,400964,400910,54,110,utRho07
656,hlyE,2460932,2460932,2460788,144,44,utRho07
657,hmp,5371594,5371670,5371594,76,0,utRho07
658,hns,2585916,2585916,2585844,72,1262,utRho07
659,hofM,7045856,7045856,7045502,354,0,utRho07
660,hokA,7441620,7441620,7441200,420,136,utRho07
661,hokC,33902,33902,33806,96,408,utRho07
662,hokE,1215462,1215672,1215462,210,0,utRho07
663,holC,8968546,8968546,8968560,14,850,utRho07
664,holD,9215562,9215606,9215562,44,26,utRho07
665,holE,3850040,3850216,3850040,176,194,utRho07
666,hpt,282720,282862,282720,142,24,utRho07
667,hrpB,324150,324210,324150,60,158,utRho07
668,hscB,5319048,5319048,5318934,114,1466,utRho07
669,hscC,1367188,1367188,1366786,402,458,utRho07
670,hsdS,9163004,9163004,9162924,80,38,utRho07
671,hslJ,2883560,2883560,2883486,74,126,utRho07
672,hslO,7059344,7059548,7059344,204,7650,utRho07
673,hslR,7058220,7058696,7058220,476,1534,utRho07
674,hslV,8244708,8244708,8244574,134,310,utRho07
675,hsrA,7881412,7881412,7881224,188,32,utRho07
676,htgA,21286,21660,21286,374,140,utRho07
677,htpG,989634,990240,989634,606,4820,utRho07
678,htpX,3825236,3825236,3825152,84,8,utRho07
679,htrE,311036,311036,310852,184,0,utRho07
680,htrL,7587668,7587668,7587366,302,24,utRho07
681,hupA,8400352,8400562,8400352,210,102,utRho07
682,hupB,1845220,1845804,1845220,584,308,utRho07
683,hyaA,2063968,2064278,2063968,310,0,utRho07
684,hybO,6292726,6292726,6292522,204,386,utRho07
685,hycA,5700922,5700922,5700870,52,0,utRho07
686,hycI,5686204,5686204,5686086,118,4,utRho07
687,hydN,5676264,5676264,5676210,54,0,utRho07
688,hyfA,5202342,5202402,5202342,60,0,utRho07
689,hypA,11402508,11402588,11402508,80,0,utRho07
690,hypB,11403356,11404004,11403356,648,268,utRho07
691,hypF,5676210,5676210,5674850,1360,290,utRho07
692,hypT,9116634,9116634,9116578,56,0,utRho07
693,hyuA,6019660,6020056,6019660,396,0,utRho07
694,iaaA,1733074,1733136,1733074,62,0,utRho07
695,iadA,9119074,9119074,9119052,22,32,utRho07
696,iap,5753072,5753162,5753072,90,20,utRho07
697,ibaG,6673966,6673966,6673606,360,336,utRho07
698,ibpA,7735036,7735036,7734844,192,46,utRho07
699,ibpB,7733962,7733962,7733794,168,124,utRho07
700,icd,2389922,2390246,2389922,324,430,utRho07
701,iclR,8447304,8447304,8447256,48,12,utRho07
702,idi,6065876,6066130,6065876,254,0,utRho07
703,idnD,8988870,8988870,8988812,58,0,utRho07
704,idnK,8989194,8989246,8989194,52,0,utRho07
705,ihfA,3591442,3591442,3591104,338,970,utRho07
706,ihfB,1927498,1927656,1927498,158,1000,utRho07
707,ileS,43666,44782,43666,1116,3864,utRho07
708,ileX,6431194,6431196,6431194,2,22,utRho07
709,ilvA,15820940,15821324,15820940,384,0,utRho07
710,ilvC,7915824,7915940,7915824,116,0,utRho07
711,ilvE,15809552,15809936,15809552,384,52,utRho07
712,ilvI,170840,171260,170840,420,0,utRho07
713,ilvL,23701308,23701932,23701308,624,12,utRho07
714,ilvY,7915734,7915734,7915640,94,0,utRho07
715,inaA,4698998,4698998,4698944,54,6,utRho07
716,infA,1853370,1853370,1852886,484,2502,utRho07
717,infC,3602692,3602692,3601276,1416,5316,utRho07
718,insA-5,3958452,3958452,3958430,22,2,utRho07
719,insA-7,9036758,9037054,9036758,296,36,utRho07
720,insC-5,6372080,6372284,6372080,204,98,utRho07
721,insEF-2,785238,785238,785820,582,64,utRho07
722,insEF-4,2190310,2190310,2190892,582,78,utRho07
723,insG,9007098,9007098,9006862,236,0,utRho07
724,insH-1,550596,550596,550234,362,32,utRho07
725,insH-11,7306538,7306538,7306396,142,38,utRho07
726,insH-2,1151548,1151548,1151506,42,26,utRho07
727,insH-3,1378444,1378444,1378026,418,36,utRho07
728,insH-4,2791942,2792152,2791942,210,28,utRho07
729,insH-5,2857852,2857852,2857452,400,0,utRho07
730,insH-6,4135022,4135022,4134642,380,0,utRho07
731,insH-7,4206186,4206186,4205822,364,5458,utRho07
732,insH-9,6260050,6260356,6260050,306,46,utRho07
733,insI-3,9017372,9017372,9017234,138,0,utRho07
734,insJ,7441188,7441360,7441188,172,48,utRho07
735,insK,7442130,7442308,7442130,178,0,utRho07
736,insL-1,30760,30890,30760,130,436,utRho07
737,insL-2,1216112,1216130,1216112,18,22,utRho07
738,insL-3,5028644,5028662,5028644,18,82,utRho07
739,insN-1,540452,540484,540452,32,0,utRho07
740,intD,1132202,1132202,1131956,246,8,utRho07
741,intR,2826520,2826520,2826470,50,0,utRho07
742,intS,4933026,4933090,4933026,64,94,utRho07
743,intZ,5117386,5117542,5117386,156,12,utRho07
744,iraD,9113152,9113986,9113152,834,0,utRho07
745,iraM,2424246,2424246,2424006,240,18,utRho07
746,iraP,802638,802772,802638,134,0,utRho07
747,iscA,5319924,5319924,5319772,152,2484,utRho07
748,iscR,5324398,5324398,5324262,136,15748,utRho07
749,iscX,5313834,5313834,5313472,362,3522,utRho07
750,ispF,5743968,5743968,5743560,408,1446,utRho07
751,ispG,5283908,5283908,5283608,300,574,utRho07
752,ispU,389568,389806,389568,238,288,utRho07
753,isrA,2811502,2811502,2811618,116,78,utRho07
754,istr-1,7706384,7706384,7706384,0,0,utRho07
755,istr-2,7706514,7706514,7706514,0,0,utRho07
756,ivbL,15412092,15412092,15411952,140,1112,utRho07
757,ivy,480638,480686,480638,48,0,utRho07
758,katE,3627628,3627734,3627628,106,30,utRho07
759,katG,8267624,8267670,8267624,46,12,utRho07
760,kbaZ,6557732,6557828,6557732,96,0,utRho07
761,kbl,7585154,7585154,7585102,52,384,utRho07
762,kch,2621046,2621046,2620538,508,0,utRho07
763,kdgR,3820506,3820506,3820198,308,22,utRho07
764,kdpE,1443788,1443788,1443466,322,0,utRho07
765,kdpF,1457698,1457698,1457642,56,0,utRho07
766,kdsA,2535708,2536330,2535708,622,1554,utRho07
767,kdsC,6683438,6684546,6683438,1108,2648,utRho07
768,kduI,5968388,5968388,5968248,140,148,utRho07
769,kefF,94160,94492,94160,332,52,utRho07
770,kgtP,5451624,5451624,5451492,132,36,utRho07
771,kup,7862206,7862632,7862206,426,12,utRho07
772,lacI,735076,735076,735020,56,0,utRho07
773,lacZ,1465508,1465508,1465220,288,0,utRho07
774,ldcA,2486394,2486394,2486160,234,46,utRho07
775,ldhA,2885830,2885830,2885686,144,0,utRho07
776,ldrA,2538954,2538954,2538550,404,504,utRho07
777,ldrB,2540024,2540024,2539620,404,36,utRho07
778,ldrC,2541092,2541092,2540690,402,310,utRho07
779,ldrD,7400544,7400544,7400174,370,166,utRho07
780,lepA,5414392,5414392,5414248,144,108,utRho07
781,lepB,5410928,5410928,5410618,310,1106,utRho07
782,leuD,159188,159188,158906,282,66,utRho07
783,leuE,3761600,3761600,3761518,82,0,utRho07
784,leuL,168048,168048,167416,632,0,utRho07
785,leuO,168308,168736,168308,428,0,utRho07
786,leuQ,9212864,9212864,9212802,62,2,utRho07
787,leuU,6644556,6644556,6644316,240,2392,utRho07
788,leuV,9212546,9212546,9212330,216,1300,utRho07
789,leuX,8992772,8992810,8992772,38,0,utRho07
790,lexA,8514174,8514230,8514174,56,2,utRho07
791,lhr,3456706,3458174,3456706,1468,2044,utRho07
792,ligA,5060402,5060402,5060352,50,0,utRho07
793,ligB,7642576,7642576,7642340,236,0,utRho07
794,lipA,1320602,1320602,1320432,170,24,utRho07
795,lipB,1324802,1324802,1324556,246,1184,utRho07
796,lit,2397032,2397390,2397032,358,40,utRho07
797,livJ,7199524,7199524,7199316,208,36,utRho07
798,livK,7195510,7195510,7195120,390,44,utRho07
799,lldP,7554578,7554798,7554578,220,2816,utRho07
800,lnt,1381968,1381968,1381762,206,288,utRho07
801,loiP,6163784,6163826,6163784,42,44,utRho07
802,lolA,1874656,1874738,1874656,82,396,utRho07
803,lolB,2527112,2527112,2527000,112,56,utRho07
804,lolC,2350748,2350854,2350748,106,0,utRho07
805,lon,917630,917776,917630,146,672,utRho07
806,lpcA,486936,487086,486936,150,20,utRho07
807,lpd,255434,255824,255434,390,2146,utRho07
808,lplA,9248476,9248476,9248234,242,1244,utRho07
809,lplT,5947878,5947878,5947724,154,36,utRho07
810,lpoA,6586422,6586800,6586422,378,34,utRho07
811,lpp,3514592,3514842,3514592,250,144,utRho07
812,lptA,6686598,6686760,6686598,162,762,utRho07
813,lptB,6686792,6687888,6686792,1096,1460,utRho07
814,lptD,114672,114672,114218,454,2476,utRho07
815,lptF,8972244,8972436,8972244,192,36,utRho07
816,lpxC,213016,213114,213016,98,7824,utRho07
817,lpxD,401920,401942,401920,22,64,utRho07
818,lpxL,2233418,2233418,2233164,254,24,utRho07
819,lpxM,3880456,3880456,3880386,70,32,utRho07
820,lpxP,4991156,4991290,4991156,134,132,utRho07
821,lrhA,4813312,4813312,4813282,30,0,utRho07
822,lrp,1864656,1865190,1864656,534,670,utRho07
823,lspA,50028,50414,50028,386,510,utRho07
824,lsrA,3202920,3202980,3202920,60,0,utRho07
825,lsrR,3202514,3202514,3202482,32,0,utRho07
826,ltaE,1818640,1818640,1818588,52,0,utRho07
827,luxS,5630130,5630130,5629466,664,828,utRho07
828,lysA,5957902,5957902,5957798,104,0,utRho07
829,lysC,8467232,8467232,8466466,766,196,utRho07
830,lysP,4497120,4497120,4497064,56,38,utRho07
831,lysR,5957900,5958042,5957900,142,0,utRho07
832,lysT,1561028,1561108,1561028,80,96,utRho07
833,lysU,8709610,8709610,8709434,176,0,utRho07
834,macB,1840188,1840694,1840188,506,348,utRho07
835,maeA,3111484,3111484,3111338,146,3524,utRho07
836,mak,820236,820288,820236,52,0,utRho07
837,malE,8492928,8492928,8492838,90,0,utRho07
838,malI,3398456,3398456,3398360,96,0,utRho07
839,malK,8493472,8493568,8493472,96,0,utRho07
840,malP,7105020,7105020,7104946,74,166,utRho07
841,malQ,7100798,7100798,7100140,658,38,utRho07
842,malS,14949880,14949988,14949880,108,0,utRho07
843,malT,7106048,7106170,7106048,122,118,utRho07
844,malX,3398626,3398710,3398626,84,0,utRho07
845,malZ,1689980,1690072,1689980,92,332,utRho07
846,manA,3377102,3377152,3377102,50,56,utRho07
847,manX,3803866,3804096,3803866,230,0,utRho07
848,marC,3237882,3237882,3237816,66,38,utRho07
849,marR,3238186,3238240,3238186,54,0,utRho07
850,matP,2036918,2036970,2036918,52,4,utRho07
851,mazE,5822736,5822736,5822678,58,46,utRho07
852,mazG,5821720,5821720,5821370,350,2236,utRho07
853,mcbA,1684306,1684306,1684112,194,0,utRho07
854,mcbR,3040192,3040524,3040192,332,0,utRho07
855,mcrA,2420278,2420692,2420278,414,0,utRho07
856,mcrC,9156124,9156124,9155916,208,142,utRho07
857,mdaB,6344814,6345060,6344814,246,0,utRho07
858,mdfA,1767138,1767346,1767138,208,0,utRho07
859,mdh,6768940,6768940,6768536,404,246,utRho07
860,mdoB,9198988,9198988,9198882,106,660,utRho07
861,mdoD,2993290,2993712,2993290,422,0,utRho07
862,mdoG,2218514,2218670,2218514,156,10,utRho07
863,mdtA,4307958,4308032,4307958,74,44,utRho07
864,mdtE,7318168,7318464,7318168,296,122,utRho07
865,mdtK,3486538,3486914,3486538,376,122,utRho07
866,mdtP,8602472,8602472,8602060,412,0,utRho07
867,melA,8683774,8683822,8683774,48,0,utRho07
868,melR,8683300,8683300,8683256,44,0,utRho07
869,menA,8240812,8240812,8240698,114,24,utRho07
870,menB,4753774,4753774,4753638,136,354,utRho07
871,mepH,3468714,3468870,3468714,156,0,utRho07
872,mepM,3883666,3883666,3883270,396,496,utRho07
873,mepS,4539840,4539958,4539840,118,118,utRho07
874,metA,8428318,8428560,8428318,242,0,utRho07
875,metB,8257272,8257344,8257272,72,1374,utRho07
876,metC,6304150,6304472,6304150,322,0,utRho07
877,metE,8025768,8026106,8025768,338,250,utRho07
878,metF,8265092,8265232,8265092,140,0,utRho07
879,metG,4388538,4388600,4388538,62,230,utRho07
880,metH,8447010,8447656,8447010,646,2048,utRho07
881,metJ,8257116,8257116,8256790,326,26,utRho07
882,metK,6173154,6173412,6173154,258,134,utRho07
883,metN,445428,445428,445290,138,0,utRho07
884,metR,8025710,8025710,8025632,78,0,utRho07
885,metT,1394326,1394326,1394266,60,158,utRho07
886,metY,19910250,19910250,19909734,516,654,utRho07
887,metZ,11789528,11789548,11789528,20,96,utRho07
888,mfd,2348056,2348056,2347928,128,16,utRho07
889,mglA,4478782,4478782,4478578,204,158,utRho07
890,mglB,4481132,4481132,4480696,436,7446,utRho07
891,mglC,4475918,4475918,4475506,412,72,utRho07
892,mgrB,3817584,3817584,3817532,52,0,utRho07
893,mgrR,3245828,3245828,3245828,0,0,utRho07
894,mgsA,2054082,2054082,2054030,52,36,utRho07
895,mgtL,8934560,8934862,8934560,302,22,utRho07
896,mhpA,737038,737222,737038,184,0,utRho07
897,mhpR,737072,737072,736840,232,0,utRho07
898,mhpT,750772,750918,750772,146,52,utRho07
899,miaA,8797964,8798504,8797964,540,356,utRho07
900,micA,5629604,5629604,5629604,0,0,utRho07
901,micC,2874242,2874238,2874242,4,0,utRho07
902,micF,4626168,4626168,4626168,0,0,utRho07
903,micM,1014408,1014408,1014408,0,0,utRho07
904,minE,2449422,2449422,2449090,332,1038,utRho07
905,mioC,7852950,7852950,7852910,40,0,utRho07
906,mipA,3733012,3733012,3732944,68,3428,utRho07
907,mlaA,4930270,4930270,4930014,256,0,utRho07
908,mlc,3337206,3337206,3337128,78,0,utRho07
909,mlrA,4429498,4429732,4429498,234,0,utRho07
910,mltA,5894546,5894546,5894356,190,0,utRho07
911,mltD,468050,468050,467910,140,28,utRho07
912,mltF,5391534,5391602,5391534,68,0,utRho07
913,mmuP,550238,550650,550238,412,32,utRho07
914,mngA,1531622,1531968,1531622,346,0,utRho07
915,mngR,1531852,1531852,1531750,102,0,utRho07
916,mnmG,7851348,7851348,7851266,82,1952,utRho07
917,mntH,5025470,5025470,5025412,58,0,utRho07
918,mntP,3810918,3811376,3810918,458,194,utRho07
919,mntR,1706160,1706366,1706160,206,0,utRho07
920,mntS,1706128,1706128,1705994,134,0,utRho07
921,moaA,1633654,1634088,1633654,434,336,utRho07
922,moaB,1635954,1636110,1635954,156,964,utRho07
923,mobA,8084242,8084242,8083998,244,0,utRho07
924,mocA,6030112,6030320,6030112,208,0,utRho07
925,modA,1589990,1590178,1589990,188,92,utRho07
926,moeA,1732788,1732788,1732728,60,128,utRho07
927,mokB,2984610,2984610,2984258,352,336,utRho07
928,molR_1,4392888,4392948,4392888,60,24,utRho07
929,motA,3954604,3954604,3954278,326,106,utRho07
930,mpaA,2781278,2781278,2781196,82,0,utRho07
931,mpl,8911456,8911570,8911456,114,0,utRho07
932,mppA,2786108,2786454,2786108,346,0,utRho07
933,mprA,5621494,5621540,5621494,46,276,utRho07
934,mqo,4613848,4613848,4613508,340,4,utRho07
935,mqsA,6336742,6336742,6336492,250,184,utRho07
936,mqsR,6337306,6337306,6337088,218,144,utRho07
937,mraZ,179192,179268,179192,76,0,utRho07
938,mrcA,7045652,7045742,7045652,90,0,utRho07
939,mrcB,329442,329460,329442,18,0,utRho07
940,mreB,13605424,13605424,13604348,1076,1928,utRho07
941,mreD,6798166,6798166,6797750,416,234,utRho07
942,mrp,4388360,4388360,4388336,24,0,utRho07
943,mscK,972984,973072,972984,88,0,utRho07
944,mscL,6876002,6876048,6876002,46,124,utRho07
945,mscS,6139742,6139742,6139614,128,30,utRho07
946,msrA,8884522,8884522,8884352,170,262,utRho07
947,msrB,3725168,3725168,3724858,310,20,utRho07
948,msyB,2228426,2228426,2228362,64,28,utRho07
949,mtfA,4087236,4087302,4087236,66,2228,utRho07
950,mtgA,6699662,6699662,6699618,44,32,utRho07
951,mtlA,30177504,30178248,30177504,744,1000,utRho07
952,mtn,358366,358366,358306,60,0,utRho07
953,mtr,6611864,6611864,6611634,230,6,utRho07
954,mug,6430992,6430992,6430946,46,0,utRho07
955,murQ,5091466,5091546,5091466,80,0,utRho07
956,murR,5091586,5091586,5091218,368,0,utRho07
957,mutH,5939164,5939324,5939164,160,288,utRho07
958,mutL,8794092,8794824,8794092,732,676,utRho07
959,mutM,7622554,7622554,7622304,250,1660,utRho07
960,mutS,5714038,5714186,5714038,148,788,utRho07
961,mutY,18617466,18618078,18617466,612,54,utRho07
962,nac,4123956,4123956,4123866,90,0,utRho07
963,nadA,1564122,1564170,1564122,48,0,utRho07
964,nadB,5420714,5420840,5420714,126,0,utRho07
965,nadC,237326,237326,237290,36,18,utRho07
966,nadE,3644604,3644916,3644604,312,0,utRho07
967,nadK,5501526,5501662,5501526,136,118,utRho07
968,nagA,1406350,1406350,1405502,848,4524,utRho07
969,nagB,1407416,1407416,1407222,194,28,utRho07
970,nagC,1404016,1404016,1403188,828,82,utRho07
971,nagE,1407680,1407888,1407680,208,0,utRho07
972,nagK,2357080,2357186,2357080,106,62,utRho07
973,nanA,6747240,6747240,6747152,88,34,utRho07
974,nanC,9079856,9079856,9079002,854,4,utRho07
975,nanR,6749406,6749406,6748978,428,36,utRho07
976,nanS,9075406,9075406,9075188,218,0,utRho07
977,napF,4607390,4607390,4606994,396,0,utRho07
978,narG,2559614,2559728,2559614,114,0,utRho07
979,narK,2555642,2555914,2555642,272,0,utRho07
980,narP,4580844,4581000,4580844,156,64,utRho07
981,narQ,5171154,5171462,5171154,308,2,utRho07
982,narU,3088326,3088326,3088120,206,0,utRho07
983,narW,3077374,3077374,3074618,2756,116,utRho07
984,narX,2555554,2555554,2555236,318,0,utRho07
985,narZ,3085380,3085380,3085180,200,0,utRho07
986,ndh,2331984,2332170,2331984,186,4,utRho07
987,ndk,5289920,5289920,5289728,192,98,utRho07
988,nemR,6904084,6904092,6904084,8,0,utRho07
989,nepI,7683542,7683542,7683478,64,2,utRho07
990,nfo,4501612,4501680,4501612,68,0,utRho07
991,nfsB,1210906,1210906,1210848,58,8,utRho07
992,nfuA,7090916,7091248,7090916,332,666,utRho07
993,nhaA,34634,34978,34634,344,22,utRho07
994,nhaB,2469534,2469534,2469434,100,0,utRho07
995,nhoA,3067926,3068048,3067926,122,0,utRho07
996,nikA,7226878,7227334,7226878,456,1142,utRho07
997,nikR,7237074,7237176,7237074,102,206,utRho07
998,nirB,6987974,6988022,6987974,48,0,utRho07
999,nlpA,7680034,7680034,7679986,48,0,utRho07
1000,nlpC,3585654,3585654,3585462,192,50,utRho07
1001,nlpD,5737658,5737658,5737506,152,6,utRho07
1002,nlpI,6618080,6618080,6617848,232,40,utRho07
1003,nmpC,1153740,1153740,1153650,90,36,utRho07
1004,nohA,3273206,3273206,3272734,472,0,utRho07
1005,norR,5664614,5664614,5664578,36,0,utRho07
1006,norV,5664878,5664952,5664878,74,0,utRho07
1007,nrdA,4689510,4689730,4689510,220,10384,utRho07
1008,nrdD,8925676,8925676,8925320,356,1086,utRho07
1009,nrdH,5601312,5601446,5601312,134,146,utRho07
1010,nrdR,865954,866004,865954,50,0,utRho07
1011,nrfA,8575342,8575528,8575342,186,0,utRho07
1012,nsrR,8812088,8812380,8812088,292,854,utRho07
1013,nudB,3897348,3897348,3897264,84,106,utRho07
1014,nudC,8393428,8393806,8393428,378,64,utRho07
1015,nudE,7052658,7052658,7052298,360,662,utRho07
1016,nudG,3682876,3682980,3682876,104,0,utRho07
1017,nudI,4729050,4729108,4729050,58,0,utRho07
1018,nudJ,2388874,2388874,2388576,298,524,utRho07
1019,nuoA,4810670,4810670,4810144,526,4490,utRho07
1020,nuoN,4783434,4783434,4783010,424,1212,utRho07
1021,nupC,5026018,5026084,5026018,66,0,utRho07
1022,nupG,6211302,6211428,6211302,126,24,utRho07
1023,ogrK,4335096,4335096,4335040,56,0,utRho07
1024,ogt,2800568,2800568,2800472,96,72,utRho07
1025,ohsC,5401036,5401040,5401036,4,0,utRho07
1026,ompA,2040382,2040382,2040106,276,25358,utRho07
1027,ompC,4625774,4625774,4625498,276,32,utRho07
1028,ompF,1974184,1974184,1973964,220,318,utRho07
1029,ompL,8128958,8128958,8128590,368,0,utRho07
1030,ompN,2874158,2874158,2873786,372,0,utRho07
1031,ompR,7073510,7073510,7073168,342,198,utRho07
1032,ompT,1171330,1171330,1171266,64,0,utRho07
1033,ompW,2627982,2628040,2627982,58,0,utRho07
1034,ompX,1700418,1700900,1700418,482,798,utRho07
1035,omrA,5952378,5952378,5952378,0,0,utRho07
1036,omrB,5952770,5952770,5952770,0,0,utRho07
1037,oppA,2602170,2602364,2602170,194,8196,utRho07
1038,orn,8783168,8783208,8783168,40,54,utRho07
1039,osmB,2686952,2686952,2686656,296,98,utRho07
1040,osmC,3113192,3113250,3113192,58,4,utRho07
1041,osmE,3644566,3644566,3644512,54,0,utRho07
1042,osmF,4439046,4439046,4438962,84,690,utRho07
1043,osmY,9222306,9222792,9222306,486,36,utRho07
1044,otsA,3963302,3963302,3963224,78,34,utRho07
1045,otsB,3964930,3964930,3964774,156,116,utRho07
1046,oxc,4984288,4984288,4983900,388,48,utRho07
1047,oxyR,8316914,8316980,8316914,66,0,utRho07
1048,oxyS,8316788,8316788,8316788,0,0,utRho07
1049,paaA,2907730,2907854,2907730,124,0,utRho07
1050,paaX,2927018,2927078,2927018,60,0,utRho07
1051,paaZ,2907340,2907340,2907284,56,0,utRho07
1052,pabA,6981702,6981702,6981658,44,0,utRho07
1053,pabB,3789256,3789610,3789256,354,176,utRho07
1054,pabC,2306186,2306600,2306186,414,510,utRho07
1055,pagP,1313052,1313114,1313052,62,0,utRho07
1056,panB,299260,299260,299202,58,54,utRho07
1057,panC,297840,297840,297590,250,586,utRho07
1058,panD,293490,293490,293388,102,0,utRho07
1059,panZ,7195656,7195968,7195656,312,18,utRho07
1060,parC,6332060,6332060,6331946,114,118,utRho07
1061,patA,6438916,6438988,6438916,72,0,utRho07
1062,patD,3030830,3031156,3030830,326,0,utRho07
1063,pbpC,5294986,5294986,5294650,336,16,utRho07
1064,pbpG,4450132,4450132,4449740,392,0,utRho07
1065,pck,7065358,7065636,7065358,278,3012,utRho07
1066,pcnB,318782,318782,318252,530,420,utRho07
1067,pdhR,244068,244184,244068,116,0,utRho07
1068,pdxB,4875768,4875768,4875702,66,26,utRho07
1069,pdxH,3436068,3436068,3436014,54,380,utRho07
1070,pdxJ,5403626,5403626,5403458,168,66,utRho07
1071,pdxK,5074638,5074638,5074474,164,0,utRho07
1072,pepA,8972278,8972278,8971902,376,86,utRho07
1073,pepD,511618,511618,511432,186,5776,utRho07
1074,pepN,1981182,1981244,1981182,62,28,utRho07
1075,pepQ,8062294,8062322,8062294,28,0,utRho07
1076,pepT,2371646,2371688,2371646,42,0,utRho07
1077,pfkA,8214948,8215104,8214948,156,300,utRho07
1078,pfkB,3612646,3612740,3612646,94,0,utRho07
1079,pflA,1902456,1902456,1902160,296,0,utRho07
1080,pflB,1907850,1907850,1907108,742,874,utRho07
1081,pflD,8287716,8287990,8287716,274,0,utRho07
1082,pgaA,2185046,2185046,2184578,468,2,utRho07
1083,pgi,8467444,8467516,8467444,72,0,utRho07
1084,pgk,12291428,12291428,12290488,940,4184,utRho07
1085,pgl,1597078,1597172,1597078,94,0,utRho07
1086,pgpB,2678324,2678660,2678324,336,72,utRho07
1087,pgpC,5397276,5397276,5397100,176,0,utRho07
1088,pgrR,2783744,2783982,2783744,238,0,utRho07
1089,pheL,5475158,5475198,5475158,40,0,utRho07
1090,pheM,7197204,7197204,7197080,124,132,utRho07
1091,pheP,1203858,1203918,1203858,60,0,utRho07
1092,pheU,8725254,8725254,8725252,2,0,utRho07
1093,pheV,6220730,6220732,6220730,2,0,utRho07
1094,phnC,8650412,8650412,8650330,82,0,utRho07
1095,phoA,803414,803494,803414,80,28,utRho07
1096,phoB,834202,834284,834202,82,0,utRho07
1097,phoE,520316,520316,520200,116,14,utRho07
1098,phoH,2169730,2169984,2169730,254,0,utRho07
1099,phoP,2381016,2381016,2380894,122,618,utRho07
1100,phoQ,2379880,2379880,2379552,328,1498,utRho07
1101,phoU,7815330,7815330,7815156,174,98,utRho07
1102,phr,1478842,1479014,1478842,172,0,utRho07
1103,pinE,2419054,2419370,2419054,316,0,utRho07
1104,pinQ,3267168,3267244,3267168,76,0,utRho07
1105,pinR,2867424,2867424,2867348,76,0,utRho07
1106,pitA,7275224,7275284,7275224,60,0,utRho07
1107,pitB,6272806,6272806,6272742,64,8,utRho07
1108,pka,5439862,5439906,5439862,44,28,utRho07
1109,plaP,4174476,4174476,4174124,352,1680,utRho07
1110,pldA,8009628,8009724,8009628,96,0,utRho07
1111,pldB,8018028,8018340,8018028,312,2,utRho07
1112,plsB,8513196,8513196,8512932,264,318,utRho07
1113,pmbA,8915890,8915918,8915890,28,0,utRho07
1114,pmrD,4747148,4747148,4747076,72,0,utRho07
1115,pncB,1980828,1980828,1980712,116,18,utRho07
1116,pncC,5648788,5648788,5648692,96,0,utRho07
1117,pnp,6622652,6622652,6622336,316,164,utRho07
1118,pntA,3355950,3355950,3355806,144,0,utRho07
1119,pntB,3353096,3353096,3352720,376,6,utRho07
1120,polA,8093880,8093932,8093880,52,72,utRho07
1121,polB,131606,131606,131560,46,0,utRho07
1122,potD,2365700,2365700,2365658,42,50,utRho07
1123,potE,1436688,1436688,1436530,158,0,utRho07
1124,potF,1787268,1787568,1787268,300,0,utRho07
1125,poxB,1822152,1822152,1822098,54,0,utRho07
1126,ppa,8899372,8899372,8899304,68,166,utRho07
1127,ppc,8306380,8306380,8306196,184,134,utRho07
1128,ppdA,5928440,5928440,5928354,86,56,utRho07
1129,ppdD,235410,235410,235098,312,64,utRho07
1130,pphA,3846770,3846770,3845938,832,1962,utRho07
1131,pphB,5719474,5719520,5719474,46,0,utRho07
1132,ppiA,6984898,6984898,6984594,304,0,utRho07
1133,ppiC,7919682,7919682,7919626,56,116,utRho07
1134,ppiD,923638,923830,923638,192,1168,utRho07
1135,ppk,5245748,5246088,5245748,340,354,utRho07
1136,pppA,6228958,6228958,6228704,254,0,utRho07
1137,ppsA,3574322,3574322,3574224,98,0,utRho07
1138,ppsR,3574678,3574890,3574678,212,0,utRho07
1139,pptA,3065716,3066104,3065716,388,8,utRho07
1140,pqiA,2023318,2024002,2023318,684,140,utRho07
1141,prc,3830054,3830054,3829632,422,30562,utRho07
1142,preT,4467978,4468066,4467978,88,0,utRho07
1143,prfC,9218688,9218828,9218688,140,1210,utRho07
1144,prkB,6968622,6968980,6968622,358,966,utRho07
1145,prlC,7290476,7290476,7290364,112,164,utRho07
1146,prlF,6553944,6554004,6553944,60,42,utRho07
1147,proB,520432,520776,520432,344,112,utRho07
1148,proC,811372,811372,811288,84,0,utRho07
1149,proK,7417388,7417388,7417384,4,2,utRho07
1150,proL,4572414,4572422,4572414,8,0,utRho07
1151,proP,8660640,8661004,8660640,364,378,utRho07
1152,proS,437674,437674,437550,124,594,utRho07
1153,proV,5609126,5609630,5609126,504,56,utRho07
1154,prpB,697292,697364,697292,72,0,utRho07
1155,prpR,696942,696942,696886,56,0,utRho07
1156,prs,2524354,2524354,2523750,604,61380,utRho07
1157,psd,8781276,8781276,8780720,556,2734,utRho07
1158,psiE,8480600,8480650,8480600,50,0,utRho07
1159,pspA,2736076,2736158,2736076,82,4,utRho07
1160,pspF,2736080,2736080,2735824,256,0,utRho07
1161,pspG,8525632,8525680,8525632,48,0,utRho07
1162,pssA,5445156,5445454,5445156,298,1528,utRho07
1163,pstB,7817112,7817112,7816732,380,52,utRho07
1164,pstC,7821084,7821084,7820796,288,4,utRho07
1165,pstS,23469408,23469408,23469150,258,0,utRho07
1166,psuG,4517114,4517114,4516734,380,144,utRho07
1167,psuT,4514992,4514992,4514670,322,0,utRho07
1168,pth,2517084,2517084,2517026,58,0,utRho07
1169,ptrA,5918022,5918022,5917768,254,0,utRho07
1170,ptrB,3857730,3857730,3857678,52,462,utRho07
1171,ptsG,2315252,2315738,2315252,486,1854,utRho07
1172,ptsH,5066996,5067528,5066996,532,3426,utRho07
1173,purA,8809328,8809374,8809328,46,8,utRho07
1174,purC,5195562,5195562,5195236,326,88,utRho07
1175,purD,8411972,8411972,8411862,110,26,utRho07
1176,purE,1106284,1106284,1106200,84,802,utRho07
1177,purH,8415254,8415254,8415064,190,52,utRho07
1178,purL,5391178,5391178,5391086,92,370,utRho07
1179,purM,5242306,5242394,5242306,88,68,utRho07
1180,purR,3475378,3475688,3475378,310,472,utRho07
1181,purT,3861438,3861762,3861438,324,0,utRho07
1182,purU,2577512,2577512,2577248,264,646,utRho07
1183,putA,2157850,2157850,2157764,86,0,utRho07
1184,putP,2158336,2158610,2158336,274,518,utRho07
1185,puuA,2721936,2721936,2721816,120,0,utRho07
1186,puuC,2725456,2725486,2725456,30,0,utRho07
1187,puuD,2722104,2722240,2722104,136,0,utRho07
1188,puuP,2718746,2718746,2718374,372,374,utRho07
1189,pykA,3874988,3875298,3874988,310,148,utRho07
1190,pykF,3510934,3511396,3510934,462,1072,utRho07
1191,pyrC,2245286,2245286,2245214,72,190,utRho07
1192,pyrD,2009464,2009536,2009464,72,0,utRho07
1193,pyrE,7631970,7631970,7631536,434,4,utRho07
1194,pyrF,2683740,2683842,2683740,102,386,utRho07
1195,pyrG,5819594,5819594,5819332,262,578,utRho07
1196,pyrH,383624,383710,383624,86,2646,utRho07
1197,pyrL,8945490,8945490,8945066,424,0,utRho07
1198,qmcA,1031646,1031646,1031546,100,0,utRho07
1199,qor,8528608,8528608,8528462,146,96,utRho07
1200,qseB,6339502,6339656,6339502,154,0,utRho07
1201,queA,849970,850022,849970,52,222,utRho07
1202,queE,5811212,5811212,5810836,376,38,utRho07
1203,queF,5850642,5850696,5850642,54,6,utRho07
1204,queG,8788184,8788184,8788134,50,512,utRho07
1205,racC,2835630,2835630,2835526,104,0,utRho07
1206,racR,2840898,2840898,2840482,416,0,utRho07
1207,raiA,5474208,5474308,5474208,100,0,utRho07
1208,rarD,8008594,8008594,8008356,238,0,utRho07
1209,ravA,7862256,7862256,7862186,70,0,utRho07
1210,rayT,495088,495274,495088,186,0,utRho07
1211,rbn,4763162,4763216,4763162,54,0,utRho07
1212,rbsD,7866644,7866702,7866644,58,0,utRho07
1213,rcnA,4371654,4371834,4371654,180,0,utRho07
1214,rcnB,4373768,4373920,4373768,152,0,utRho07
1215,rcnR,4371806,4371806,4371592,214,0,utRho07
1216,rcsA,4047672,4047936,4047672,264,126,utRho07
1217,rcsB,4631390,4632354,4631390,964,820,utRho07
1218,rcsC,4640162,4640162,4639656,506,194,utRho07
1219,rcsD,4626904,4626976,4626904,72,24,utRho07
1220,rdgB,6193240,6193362,6193240,122,602,utRho07
1221,rdlA,2538646,2538646,2538646,0,0,utRho07
1222,rdlB,2539712,2539716,2539712,4,0,utRho07
1223,rdlC,2540782,2540786,2540782,4,0,utRho07
1224,rdlD,7400272,7400272,7400272,0,0,utRho07
1225,rdoA,8084782,8084830,8084782,48,0,utRho07
1226,recA,11295276,11295276,11295076,200,412,utRho07
1227,recC,5925014,5925014,5924856,158,80,utRho07
1228,recF,7763722,7763722,7762442,1280,8602,utRho07
1229,recN,5503518,5503590,5503518,72,60,utRho07
1230,recQ,8011666,8011728,8011666,62,50,utRho07
1231,relA,5828554,5828554,5827302,1252,768,utRho07
1232,relB,3291806,3291806,3291744,62,0,utRho07
1233,rem,3289950,3289950,3289804,146,0,utRho07
1234,rep,7921294,7921354,7921294,60,4,utRho07
1235,rfaD,7587730,7587974,7587730,244,84,utRho07
1236,rfaE,6393852,6393852,6393506,346,0,utRho07
1237,rfaH,8049930,8049930,8049642,288,686,utRho07
1238,rfbX,4219436,4219436,4219168,268,2196,utRho07
1239,rfe,7935600,7935832,7935600,232,12,utRho07
1240,rhaB,8194944,8194944,8194896,48,0,utRho07
1241,rhaD,8188770,8188770,8188544,226,0,utRho07
1242,rhaS,8195422,8195472,8195422,50,0,utRho07
1243,rhaT,8201132,8201132,8201050,82,0,utRho07
1244,rhlE,1661566,1661744,1661566,178,308,utRho07
1245,rhoL,47593944,47594772,47593944,828,58272,utRho07
1246,rhsB,7238006,7238384,7238006,378,4,utRho07
1247,rhsC,1458758,1459166,1458758,408,0,utRho07
1248,rhsD,1046132,1046522,1046132,390,0,utRho07
1249,rhtA,1700608,1700608,1700194,414,32,utRho07
1250,rhtC,8015478,8015514,8015478,36,752,utRho07
1251,ribA,2678468,2678468,2678320,148,36,utRho07
1252,ribC,3486916,3486916,3486484,432,122,utRho07
1253,ribE,869008,869294,869008,286,7582,utRho07
1254,ribF,42766,42814,42766,48,0,utRho07
1255,ridA,8941892,8941892,8941826,66,0,utRho07
1256,rihA,1369204,1369204,1368824,380,76,utRho07
1257,rihB,4510504,4510504,4510372,132,0,utRho07
1258,rimJ,2251044,2251124,2251044,80,0,utRho07
1259,rimK,1783752,1783934,1783752,182,430,utRho07
1260,rimL,2997486,2997876,2997486,390,92,utRho07
1261,rimO,1756140,1756140,1756070,70,0,utRho07
1262,rimP,6636350,6636350,6636012,338,178,utRho07
1263,rlmA,3814172,3814172,3814120,52,322,utRho07
1264,rlmD,5830086,5830086,5830000,86,8,utRho07
1265,rlmE,6655520,6655520,6655328,192,1570,utRho07
1266,rlmF,1684384,1684664,1684384,280,44,utRho07
1267,rlmG,6471784,6471784,6471750,34,0,utRho07
1268,rlmI,2060002,2060002,2059938,64,32,utRho07
1269,rlmJ,7290700,7290770,7290700,70,168,utRho07
1270,rlmL,2015344,2015688,2015344,344,984,utRho07
1271,rlpA,1330444,1330444,1330380,64,228,utRho07
1272,rluA,120900,120900,120692,208,436,utRho07
1273,rluF,8460324,8460708,8460324,384,10,utRho07
1274,rmf,2031006,2031430,2031006,424,374,utRho07
1275,rna,1290068,1290068,1290006,62,0,utRho07
1276,rnb,2698258,2698258,2697824,434,2502,utRho07
1277,rnc,10816892,10816892,10816252,640,5332,utRho07
1278,rnd,3776122,3776122,3775982,140,154,utRho07
1279,rne,2289746,2289746,2288734,1012,10118,utRho07
1280,rnhA,472082,472082,472004,78,148,utRho07
1281,rnk,1288360,1288360,1287934,426,122,utRho07
1282,rnlA,5531788,5531836,5531788,48,36,utRho07
1283,rnlB,5533414,5533968,5533414,554,424,utRho07
1284,rnpB,19623552,19623552,19623552,0,0,utRho07
1285,rob,9270706,9270706,9270620,86,24,utRho07
1286,rodZ,5285868,5285868,5285688,180,158,utRho07
1287,rpe,7030306,7030306,7030118,188,36,utRho07
1288,rph,15266320,15266320,15266196,124,192,utRho07
1289,rpiA,6118706,6118706,6118650,56,28,utRho07
1290,rpiB,8626514,8626700,8626514,186,82,utRho07
1291,rpiR,8626274,8626274,8625982,292,0,utRho07
1292,rplJ,8359246,8359992,8359246,746,10862,utRho07
1293,rplK,8356708,8356894,8356708,186,542,utRho07
1294,rplM,6757344,6757344,6757302,42,11584,utRho07
1295,rplN,6896444,6896444,6896298,146,10192,utRho07
1296,rplS,5489284,5489284,5489060,224,20568,utRho07
1297,rplT,7199052,7199052,7198996,56,1124,utRho07
1298,rplU,6667036,6667036,6666902,134,68,utRho07
1299,rplY,4564866,4565034,4564866,168,40,utRho07
1300,rpmA,6666450,6666450,6666238,212,1068,utRho07
1301,rpmB,15247980,15247980,15246696,1284,175820,utRho07
1302,rpmE,8253816,8254026,8253816,210,474,utRho07
1303,rpmF,2294676,2294734,2294676,58,68294,utRho07
1304,rpmH,7768130,7768672,7768130,542,6856,utRho07
1305,rpmI,3600854,3600854,3599998,856,13748,utRho07
1306,rpoB,8362126,8362490,8362126,364,606,utRho07
1307,rpoD,6424946,6426094,6424946,1148,17992,utRho07
1308,rpoE,5420372,5420372,5420024,348,0,utRho07
1309,rpoH,7202006,7202006,7201566,440,2182,utRho07
1310,rpoN,6689324,6689434,6689324,110,68,utRho07
1311,rpoS,5736236,5736236,5735102,1134,3590,utRho07
1312,rpoZ,7644154,7644212,7644154,58,846,utRho07
1313,rppH,5937986,5937986,5937954,32,0,utRho07
1314,rprA,3540744,3540744,3540744,0,0,utRho07
1315,rpsA,1923434,1923990,1923434,556,193608,utRho07
1316,rpsF,8850050,8850236,8850050,186,63298,utRho07
1317,rpsI,6756580,6756580,6756414,166,13302,utRho07
1318,rpsJ,6906884,6906884,6906540,344,12508,utRho07
1319,rpsL,6949242,6949242,6949104,138,250,utRho07
1320,rpsM,6885130,6885130,6884942,188,2398,utRho07
1321,rpsO,13247144,13247144,13246736,408,1384,utRho07
1322,rpsP,5492508,5492508,5492370,138,254,utRho07
1323,rpsT,42420,42420,42156,264,496,utRho07
1324,rpsU,12842584,12843124,12842584,540,2340,utRho07
1325,rraA,8238716,8238716,8238660,56,190,utRho07
1326,rraB,8956768,8956946,8956768,178,0,utRho07
1327,rrsA,8070478,8071062,8070478,584,7834,utRho07
1328,rrsB,16665468,16666636,16665468,1168,18080,utRho07
1329,rrsC,7883032,7883616,7883032,584,9040,utRho07
1330,rrsD,6858094,6858094,6857524,570,466,utRho07
1331,rrsE,8415726,8416294,8415726,568,1338,utRho07
1332,rrsG,5462896,5462896,5462314,582,7104,utRho07
1333,rrsH,446970,447542,446970,572,1514,utRho07
1334,rsd,8393908,8393908,8393616,292,32,utRho07
1335,rseA,5419264,5419264,5418808,456,278,utRho07
1336,rseP,392940,393092,392940,152,116,utRho07
1337,rseX,4067298,4067298,4067298,0,0,utRho07
1338,rsfS,1338144,1338144,1338072,72,396,utRho07
1339,rsgA,8783132,8783132,8783018,114,96,utRho07
1340,rsmA,105176,105176,104860,316,2880,utRho07
1341,rsmB,6869982,6870414,6869982,432,578,utRho07
1342,rsmC,9215736,9215736,9215400,336,710,utRho07
1343,rsmD,7208594,7208786,7208594,192,100,utRho07
1344,rsmE,6182036,6182268,6182036,232,140,utRho07
1345,rsmG,7847512,7847512,7847360,152,714,utRho07
1346,rsmH,180020,180188,180020,168,378,utRho07
1347,rsmI,6587106,6587106,6586670,436,882,utRho07
1348,rssA,2578212,2578412,2578212,200,306,utRho07
1349,rssB,2580440,2580484,2580440,44,122,utRho07
1350,rstA,3364276,3364300,3364276,24,0,utRho07
1351,rsuA,4561096,4561096,4560966,130,176,utRho07
1352,rsxA,3411510,3411534,3411510,24,26,utRho07
1353,rtcA,7114004,7114004,7113698,306,0,utRho07
1354,rtcB,7116214,7116214,7116158,56,0,utRho07
1355,rtn,4541356,4541452,4541356,96,32,utRho07
1356,rutA,2148052,2148052,2148022,30,0,utRho07
1357,rutG,2140090,2140090,2139678,412,0,utRho07
1358,rutR,2148226,2148484,2148226,258,0,utRho07
1359,ruvA,7784096,7784096,7783904,192,40,utRho07
1360,ruvB,7782176,7782176,7781424,752,880,utRho07
1361,ruvC,3894878,3894878,3894752,126,6,utRho07
1362,rybB,1776114,1776114,1776114,0,0,utRho07
1363,rydB,3529860,3529860,3529322,538,120,utRho07
1364,rydC,2983012,2983012,2983012,0,0,utRho07
1365,ryfA,5307398,5307710,5307398,312,0,utRho07
1366,ryfD,5468590,5468590,5468590,0,0,utRho07
1367,ryhB,7162032,7162032,7162032,0,0,utRho07
1368,ryjA,8556132,8556132,8556132,0,0,utRho07
1369,ryjB,9055954,9055954,9055954,0,0,utRho07
1370,sad,3229598,3229598,3229406,192,76,utRho07
1371,safA,3168056,3168056,3167918,138,0,utRho07
1372,sanA,4465368,4465756,4465368,388,120,utRho07
1373,sapF,2705314,2705314,2705268,46,118,utRho07
1374,sbcB,4165456,4165512,4165456,56,0,utRho07
1375,sbcC,831694,831694,831506,188,134,utRho07
1376,sbcD,833954,833954,833904,50,0,utRho07
1377,sbmA,793106,793278,793106,172,4,utRho07
1378,sbmC,4162650,4162650,4162524,126,0,utRho07
1379,sdaA,3793618,3793864,3793618,246,162,utRho07
1380,sdaC,5856070,5856458,5856070,388,1282,utRho07
1381,sdhC,1509916,1510354,1509916,438,40116,utRho07
1382,sdhD,1510808,1511120,1510808,312,10610,utRho07
1383,sdiA,3993834,3993834,3993664,170,44,utRho07
1384,secE,8354354,8354716,8354354,362,140,utRho07
1385,secG,6645180,6645180,6645010,170,684,utRho07
1386,selA,7522594,7522594,7522498,96,554,utRho07
1387,selB,7519850,7519850,7519722,128,178,utRho07
1388,selC,7672396,7672444,7672396,48,0,utRho07
1389,selD,3696058,3696058,3696016,42,2664,utRho07
1390,seqA,1425884,1425974,1425884,90,692,utRho07
1391,serA,6117098,6117098,6116820,278,124,utRho07
1392,serB,9249712,9249790,9249712,78,150,utRho07
1393,serC,3830380,3830612,3830380,232,0,utRho07
1394,serS,1878730,1878856,1878730,126,1060,utRho07
1395,serT,2063438,2063438,2063424,14,0,utRho07
1396,serU,4087124,4087124,4087114,10,184,utRho07
1397,serV,5637394,5637394,5637290,104,0,utRho07
1398,serW,1852014,1852014,1851942,72,158,utRho07
1399,serX,2195352,2195352,2195304,48,0,utRho07
1400,setB,4527426,4527726,4527426,300,0,utRho07
1401,setC,7673488,7673906,7673488,418,0,utRho07
1402,sfmA,1116124,1116424,1116124,300,0,utRho07
1403,sfmC,1117606,1117948,1117606,342,0,utRho07
1404,sfsA,323030,323030,322972,58,488,utRho07
1405,sfsB,6669592,6669818,6669592,226,78,utRho07
1406,sgrR,154676,154676,154598,78,32,utRho07
1407,sgrS,154734,154734,154734,0,0,utRho07
1408,shiA,4107068,4107286,4107068,218,0,utRho07
1409,sibA,4306622,4306622,4306622,0,0,utRho07
1410,sibB,4307292,4307292,4307292,0,0,utRho07
1411,sibC,6113702,6113702,6113702,0,0,utRho07
1412,sibD,6389730,6389730,6389730,0,0,utRho07
1413,sibE,6390480,6390480,6390480,0,0,utRho07
1414,sixA,4913998,4913998,4913624,374,0,utRho07
1415,slp,7307872,7307922,7307872,50,0,utRho07
1416,slt,9261400,9261466,9261400,66,0,utRho07
1417,slyA,3442028,3442028,3441648,380,0,utRho07
1418,slyB,3439496,3439752,3439496,256,0,utRho07
1419,slyD,6957398,6957398,6956994,404,154,utRho07
1420,slyX,6954862,6955280,6954862,418,8432,utRho07
1421,smf,6867372,6867372,6867120,252,0,utRho07
1422,smpB,5509534,5509792,5509534,258,456,utRho07
1423,smrA,2811872,2811958,2811872,86,48,utRho07
1424,smrB,4896872,4897212,4896872,340,18,utRho07
1425,smtA,1946808,1947074,1946808,266,58,utRho07
1426,sodA,8201518,8201620,8201518,102,13124,utRho07
1427,sodB,3470646,3470756,3470646,110,52,utRho07
1428,sodC,3449358,3449358,3449310,48,90,utRho07
1429,sohB,2658568,2658664,2658568,96,0,utRho07
1430,sokB,2984232,2984238,2984232,6,40,utRho07
1431,solA,2241218,2241218,2241172,46,6,utRho07
1432,soxR,8554894,8554938,8554894,44,0,utRho07
1433,soxS,8554846,8554846,8554766,80,0,utRho07
1434,speA,6172096,6172096,6171822,274,482,utRho07
1435,speB,6167892,6167892,6167594,298,376,utRho07
1436,speC,6218350,6218350,6218310,40,34,utRho07
1437,spf,8099798,8099798,8099798,0,0,utRho07
1438,sppA,3697422,3697674,3697422,252,40,utRho07
1439,spy,3651376,3651376,3651250,126,0,utRho07
1440,sra,3112092,3112092,3111926,166,0,utRho07
1441,sraB,2293178,2293178,2293178,0,0,utRho07
1442,sraC,3846132,3846132,3846132,0,0,utRho07
1443,srlA,5651582,5651664,5651582,82,0,utRho07
1444,srlR,5657720,5658094,5657720,374,264,utRho07
1445,srmB,5425752,5425792,5425752,40,138,utRho07
1446,sroA,151216,151216,151216,0,0,utRho07
1447,sroG,6369436,6369436,6369436,0,0,utRho07
1448,sroH,8380974,8380974,8380974,0,0,utRho07
1449,ssb,8548022,8548250,8548022,228,0,utRho07
1450,sseA,5304782,5304988,5304782,206,10666,utRho07
1451,sspA,6755138,6755138,6754840,298,676,utRho07
1452,ssrA,5511014,5511186,5511014,172,92,utRho07
1453,ssrS,12223036,12223932,12223036,896,1028,utRho07
1454,sstT,6479726,6479888,6479726,162,0,utRho07
1455,ssuB,1988282,1988282,1988088,194,0,utRho07
1456,ssuE,1995126,1995126,1995024,102,0,utRho07
1457,sthA,8321604,8321604,8321580,24,1482,utRho07
1458,stpA,5597156,5597156,5596990,166,0,utRho07
1459,sucA,3034344,3034824,3034344,480,2908,utRho07
1460,sufA,3528836,3528836,3528772,64,54,utRho07
1461,sufE,3518962,3518962,3518580,382,138,utRho07
1462,sugE,8753588,8753750,8753588,162,98,utRho07
1463,sulA,2041894,2041894,2041838,56,212,utRho07
1464,syd,5850738,5850738,5850560,178,100,utRho07
1465,symE,9159834,9159834,9159680,154,0,utRho07
1466,symR,9159670,9159670,9159670,0,0,utRho07
1467,tabA,8949566,8949724,8949566,158,44,utRho07
1468,talA,5157140,5157332,5157140,192,0,utRho07
1469,talB,16382,16476,16382,94,9166,utRho07
1470,tam,3214442,3214692,3214442,250,0,utRho07
1471,tamA,8884540,8884764,8884540,224,86,utRho07
1472,tar,3945432,3945432,3945382,50,88,utRho07
1473,tas,5943138,5943194,5943138,56,106,utRho07
1474,tatA,16087636,16087780,16087636,144,148,utRho07
1475,tatE,1317742,1317894,1317742,152,0,utRho07
1476,tauA,770410,770464,770410,54,0,utRho07
1477,tdcA,6534186,6534186,6534130,56,0,utRho07
1478,tdcG,6519652,6519652,6519298,354,0,utRho07
1479,tdcR,6534380,6534760,6534380,380,0,utRho07
1480,tdk,2586986,2587054,2586986,68,50,utRho07
1481,tehA,3001072,3001146,3001072,74,0,utRho07
1482,tesA,1039898,1039898,1039530,368,118,utRho07
1483,tesB,950402,950402,950322,80,0,utRho07
1484,tfaE,2418532,2418532,2418238,294,0,utRho07
1485,tfaQ,3269912,3269912,3269770,142,24,utRho07
1486,tff,379424,379256,379424,168,14,utRho07
1487,tgt,852110,852274,852110,164,44,utRho07
1488,thiD,4369346,4369346,4369032,314,24,utRho07
1489,thiI,882936,883098,882936,162,190,utRho07
1490,thiM,4370902,4370902,4370602,300,230,utRho07
1491,thiQ,146170,146170,145854,316,0,utRho07
1492,thrL,592,760,592,168,360,utRho07
1493,thrS,7210932,7210932,7210280,652,996,utRho07
1494,thrU,8350762,8350776,8350762,14,2,utRho07
1495,thrV,6847414,6847414,6847310,104,211524,utRho07
1496,thrW,525682,525742,525682,60,112,utRho07
1497,thyA,5930696,5930696,5930310,386,2742,utRho07
1498,tig,909986,910266,909986,280,1094,utRho07
1499,tisB,7706674,7707106,7706674,432,390,utRho07
1500,tktA,6163414,6163414,6163270,144,90,utRho07
1501,tktB,5158616,5159272,5158616,656,710,utRho07
1502,tldD,6784368,6784368,6784056,312,16,utRho07
1503,tmcA,5191876,5191876,5191718,158,2,utRho07
1504,tnaC,15553644,15553740,15553644,96,532,utRho07
1505,tolB,1555074,1555480,1555074,406,248,utRho07
1506,tolC,6356008,6356230,6356008,222,412,utRho07
1507,tomB,961588,961588,961416,172,542,utRho07
1508,tonB,2622108,2622178,2622108,70,0,utRho07
1509,topA,2661578,2662096,2661578,518,340,utRho07
1510,torC,2116112,2116168,2116112,56,22,utRho07
1511,torR,2115968,2115968,2115908,60,22,utRho07
1512,torS,2112364,2112364,2112356,8,0,utRho07
1513,torT,2112414,2112522,2112414,108,0,utRho07
1514,tpiA,8223138,8223138,8223014,124,20,utRho07
1515,tppB,3425342,3425538,3425342,196,7984,utRho07
1516,tpr,2574376,2574376,2574376,0,0,utRho07
1517,tpx,2777688,2777688,2777622,66,650,utRho07
1518,tqsA,3347780,3347826,3347780,46,0,utRho07
1519,treA,2494850,2494850,2494752,98,12,utRho07
1520,treB,8932420,8932420,8932360,60,40,utRho07
1521,treF,7339102,7339184,7339102,82,32,utRho07
1522,treR,8934694,8934694,8934492,202,0,utRho07
1523,trg,2984878,2984940,2984878,62,0,utRho07
1524,trkG,2847342,2847564,2847342,222,26,utRho07
1525,trmA,8326590,8326590,8326540,50,78,utRho07
1526,trpA,2634678,2634678,2634444,234,1516,utRho07
1527,trpC,2639888,2639888,2639570,318,34,utRho07
1528,trpL,5292432,5292432,5292328,104,0,utRho07
1529,trpR,9265408,9265520,9265408,112,170,utRho07
1530,trpS,7027394,7027394,7027276,118,1736,utRho07
1531,trpT,7893560,7893914,7893560,354,120632,utRho07
1532,trxA,7931294,7931522,7931294,228,642,utRho07
1533,trxB,1864156,1864156,1864100,56,20,utRho07
1534,trxC,5437350,5437470,5437350,120,158,utRho07
1535,tsaD,6421256,6421256,6421086,170,0,utRho07
1536,tsgA,6985038,6985136,6985038,98,0,utRho07
1537,tsr,9182824,9183314,9182824,490,60,utRho07
1538,tsx,864490,864490,864026,464,148,utRho07
1539,ttcA,2823970,2823970,2823896,74,3056,utRho07
1540,ttdA,6412848,6412926,6412848,78,0,utRho07
1541,ttdR,6412760,6412760,6412512,248,0,utRho07
1542,tufA,6943448,6943448,6942658,790,189218,utRho07
1543,tus,3368346,3368518,3368346,172,0,utRho07
1544,tusA,7218040,7218040,7217992,48,16,utRho07
1545,tusB,6950218,6950218,6949930,288,760,utRho07
1546,tynA,2902996,2902996,2902698,298,0,utRho07
1547,typA,8116460,8116814,8116460,354,10878,utRho07
1548,tyrB,8534164,8534228,8534164,64,2618,utRho07
1549,tyrP,3979004,3979362,3979004,358,0,utRho07
1550,tyrR,2773384,2773440,2773384,56,20,utRho07
1551,tyrS,3434566,3434566,3434444,122,30,utRho07
1552,tyrT,2575330,2575330,2575244,86,64,utRho07
1553,uacT,6062378,6062734,6062378,356,0,utRho07
1554,ubiC,8504886,8505012,8504886,126,0,utRho07
1555,ubiD,8049618,8049976,8049618,358,726,utRho07
1556,ubiE,8037494,8037710,8037494,216,114,utRho07
1557,ubiG,4679078,4679134,4679078,56,0,utRho07
1558,ucpA,5089342,5089342,5089246,96,0,utRho07
1559,udp,8032782,8032862,8032782,80,12,utRho07
1560,ugd,4199470,4199470,4199226,244,0,utRho07
1561,ugpB,7184852,7184852,7184650,202,114,utRho07
1562,ugpQ,7176600,7176600,7176226,374,0,utRho07
1563,uhpT,7694396,7694396,7694334,62,0,utRho07
1564,uidA,3392304,3392304,3392142,162,108,utRho07
1565,uidC,3386012,3386012,3385702,310,0,utRho07
1566,uidR,3394150,3394150,3394104,46,162,utRho07
1567,ulaA,8839854,8839960,8839854,106,0,utRho07
1568,ulaG,8839350,8839350,8839250,100,0,utRho07
1569,ulaR,8837124,8837124,8836906,218,0,utRho07
1570,umpG,5741372,5741372,5740548,824,84,utRho07
1571,umpH,1400704,1400704,1400652,52,40,utRho07
1572,umuD,2461476,2461534,2461476,58,0,utRho07
1573,ung,5433476,5433508,5433476,32,0,utRho07
1574,uof,2843316,2843316,2842900,416,7380,utRho07
1575,upp,5241818,5241818,5241744,74,498,utRho07
1576,usg,4873780,4873780,4873298,482,170,utRho07
1577,ushA,1009772,1009828,1009772,56,0,utRho07
1578,uspA,7279966,7280222,7279966,256,202,utRho07
1579,uspB,7279696,7279696,7279440,256,42,utRho07
1580,uspC,3959172,3959506,3959172,334,0,utRho07
1581,uspE,2797318,2797318,2797244,74,24,utRho07
1582,uspF,2871282,2871282,2871238,44,0,utRho07
1583,uspG,1283806,1283806,1283734,72,254,utRho07
1584,uvrA,8547872,8547872,8547742,130,86,utRho07
1585,uvrB,1626304,1627052,1626304,748,432,utRho07
1586,uvrC,3989758,3989758,3989412,346,86,utRho07
1587,uvrD,7995814,7995966,7995814,152,38,utRho07
1588,uvrY,3990812,3990812,3990718,94,0,utRho07
1589,uxaB,3221474,3221474,3221360,114,26,utRho07
1590,uxaC,6489714,6489714,6489482,232,16,utRho07
1591,uxuA,9103036,9103272,9103036,236,468,utRho07
1592,uxuR,9108916,9109152,9108916,236,32,utRho07
1593,valS,8967854,8967854,8967674,180,602,utRho07
1594,valU,5041848,5041862,5041848,14,2,utRho07
1595,valV,3492830,3492870,3492830,40,44,utRho07
1596,ves,3649968,3649968,3649874,94,0,utRho07
1597,waaA,7616512,7617080,7616512,568,148,utRho07
1598,waaH,7580298,7580298,7580162,136,0,utRho07
1599,waaQ,7616476,7616476,7616196,280,102,utRho07
1600,waaU,7598996,7598996,7598624,372,116,utRho07
1601,waaY,7602272,7602272,7601930,342,6830,utRho07
1602,wbbH,4214888,4214888,4214452,436,3864,utRho07
1603,wbbK,4209212,4209212,4209018,194,204,utRho07
1604,wcaM,4231868,4231868,4231792,76,0,utRho07
1605,wrbA,2135516,2135516,2135416,100,0,utRho07
1606,wza,4275166,4275166,4274486,680,0,utRho07
1607,wzxC,4240674,4240674,4240316,358,0,utRho07
1608,wzzB,4196950,4196950,4196602,348,108,utRho07
1609,xanP,7657642,7657890,7657642,248,0,utRho07
1610,xanQ,6048520,6048702,6048520,182,0,utRho07
1611,xapA,5049820,5049820,5049756,64,0,utRho07
1612,xapR,10090252,10090252,10089908,344,0,utRho07
1613,xdhA,6000514,6000690,6000514,176,0,utRho07
1614,xerD,6079702,6079702,6079486,216,0,utRho07
1615,xseA,5268394,5268464,5268394,70,134,utRho07
1616,xseB,882746,882746,882686,60,334,utRho07
1617,xthA,3664798,3664856,3664798,58,0,utRho07
1618,xylA,7461614,7461614,7461530,84,256,utRho07
1619,xylE,8484540,8484540,8484508,32,0,utRho07
1620,xylF,7462138,7462262,7462138,124,0,utRho07
1621,xylR,7469812,7469958,7469812,146,0,utRho07
1622,yaaA,13230,13230,12918,312,0,utRho07
1623,yaaI,23876,23876,23572,304,0,utRho07
1624,yaaJ,16034,16034,15918,116,0,utRho07
1625,yaaU,91184,91614,91184,430,0,utRho07
1626,yaaW,23084,23084,22712,372,52,utRho07
1627,yaaX,10060,10468,10060,408,18,utRho07
1628,yabI,142542,142702,142542,160,20,utRho07
1629,yacC,273880,273880,273834,46,152,utRho07
1630,yacH,262932,262932,262520,412,0,utRho07
1631,yacL,268678,268776,268678,98,16,utRho07
1632,yadD,293796,293936,293796,140,0,utRho07
1633,yadE,289930,290162,289930,232,274,utRho07
1634,yadN,314110,314110,313766,344,0,utRho07
1635,yadS,355572,355572,355248,324,252,utRho07
1636,yadV,312470,312470,312402,68,26,utRho07
1637,yaeF,434270,434270,434006,264,40,utRho07
1638,yaeP,428374,428374,428250,124,0,utRho07
1639,yaeQ,428176,428582,428176,406,0,utRho07
1640,yaeR,423716,423754,423716,38,24,utRho07
1641,yafC,462166,462166,461762,404,22,utRho07
1642,yafD,462128,462244,462128,116,34,utRho07
1643,yafK,491986,491986,491610,376,1006,utRho07
1644,yafL,493282,493424,493282,142,0,utRho07
1645,yafN,503938,504010,503938,72,0,utRho07
1646,yafS,469568,469632,469568,64,108,utRho07
1647,yafT,474470,474670,474470,200,0,utRho07
1648,yafV,480432,480432,480378,54,0,utRho07
1649,yafZ,536052,536052,536010,42,0,utRho07
1650,yagE,564446,564556,564446,110,40,utRho07
1651,yagG,570414,570790,570414,376,4,utRho07
1652,yagI,578384,578384,578324,60,0,utRho07
1653,yagK,586236,586236,585896,340,2,utRho07
1654,yagL,588062,588062,587836,226,0,utRho07
1655,yagN,591342,591342,591158,184,372,utRho07
1656,yahA,663746,664742,663746,996,152,utRho07
1657,yahC,670136,670136,670044,92,2,utRho07
1658,yahE,671478,671850,671478,372,0,utRho07
1659,yahM,690504,690808,690504,304,0,utRho07
1660,yahN,692872,692872,692674,198,0,utRho07
1661,yahO,692864,692968,692864,104,0,utRho07
1662,yaiE,816296,816354,816296,58,66,utRho07
1663,yaiI,811396,811528,811396,132,0,utRho07
1664,yaiO,761946,761946,761684,262,0,utRho07
1665,yaiP,767970,767970,767870,100,0,utRho07
1666,yaiS,769660,769660,769232,428,0,utRho07
1667,yaiV,788922,788922,788922,0,0,utRho07
1668,yaiY,799094,799094,798666,428,2,utRho07
1669,yaiZ,798888,799186,798888,298,0,utRho07
1670,yajC,854410,854574,854410,164,1578,utRho07
1671,yajD,860938,861210,860938,272,290,utRho07
1672,yajI,866068,866068,865702,366,316,utRho07
1673,yajL,887496,887496,887282,214,462,utRho07
1674,yajQ,889316,889366,889316,50,0,utRho07
1675,yajR,893374,893374,893332,42,60,utRho07
1676,ybaB,987418,988152,987418,734,3426,utRho07
1677,ybaL,1006590,1006590,1006476,114,36,utRho07
1678,ybaM,980648,980648,980542,106,154,utRho07
1679,ybaN,981436,981764,981436,328,266,utRho07
1680,ybaO,936704,936766,936704,62,0,utRho07
1681,ybaP,1016568,1016568,1016160,408,326,utRho07
1682,ybaQ,1016348,1016436,1016348,88,0,utRho07
1683,ybaS,1023146,1023282,1023146,136,0,utRho07
1684,ybaV,927504,927874,927504,370,130,utRho07
1685,ybaY,950490,950758,950490,268,22,utRho07
1686,ybbB,1062724,1062724,1062452,272,0,utRho07
1687,ybbJ,1030154,1030154,1029718,436,404,utRho07
1688,ybbL,1031784,1031838,1031784,54,0,utRho07
1689,ybbN,1037136,1037136,1036558,578,1676,utRho07
1690,ybbO,1038658,1038658,1038298,360,774,utRho07
1691,ybbY,1080718,1081130,1080718,412,0,utRho07
1692,ybcH,1176140,1176140,1175962,178,0,utRho07
1693,ybcI,1113264,1113264,1113106,158,174,utRho07
1694,ybcJ,1114050,1114050,1113746,304,202,utRho07
1695,ybcK,1137502,1137804,1137502,302,0,utRho07
1696,ybcL,1141690,1141786,1141690,96,0,utRho07
1697,ybcN,1144628,1144932,1144628,304,0,utRho07
1698,ybcQ,1147548,1147912,1147548,364,4,utRho07
1699,ybcW,1159610,1159760,1159610,150,0,utRho07
1700,ybdD,1263982,1264364,1263982,382,0,utRho07
1701,ybdF,1212106,1212106,1211772,334,22,utRho07
1702,ybdH,1267048,1267048,1266954,94,0,utRho07
1703,ybdJ,1212822,1212822,1212398,424,0,utRho07
1704,ybdK,1215122,1215122,1214766,356,4,utRho07
1705,ybdL,1267114,1267172,1267114,58,0,utRho07
1706,ybdM,1271110,1271110,1270752,358,48,utRho07
1707,ybdN,1273372,1273372,1273138,234,0,utRho07
1708,ybdR,1283844,1284176,1283844,332,380,utRho07
1709,ybeD,1325412,1325412,1325284,128,158,utRho07
1710,ybeF,1323090,1323090,1322756,334,86,utRho07
1711,ybeL,1349986,1350036,1349986,50,44,utRho07
1712,ybeQ,1353412,1353412,1353094,318,0,utRho07
1713,ybeR,1353120,1353422,1353120,302,0,utRho07
1714,ybeT,1358832,1358832,1358812,20,0,utRho07
1715,ybeU,1358924,1359016,1358924,92,0,utRho07
1716,ybeZ,1386938,1386938,1386834,104,5148,utRho07
1717,ybfA,1458074,1458268,1458074,194,28,utRho07
1718,ybfE,1423878,1423878,1423796,82,196,utRho07
1719,ybfF,1425692,1425692,1425604,88,166,utRho07
1720,ybfH,1433282,1433282,1433194,88,0,utRho07
1721,ybgA,1477840,1478002,1477840,162,4,utRho07
1722,ybgC,1549288,1549504,1549288,216,32,utRho07
1723,ybgD,1505916,1505916,1505590,326,108,utRho07
1724,ybgI,1485238,1485654,1485238,416,0,utRho07
1725,ybgO,1498370,1498370,1497964,406,0,utRho07
1726,ybgS,1570992,1570992,1570634,358,4,utRho07
1727,ybhA,1597184,1597184,1596862,322,0,utRho07
1728,ybhB,1616070,1616070,1615818,252,130,utRho07
1729,ybhC,1614642,1614642,1614562,80,1854,utRho07
1730,ybhD,1601418,1601418,1601276,142,0,utRho07
1731,ybhH,1601104,1601518,1601104,414,0,utRho07
1732,ybhK,1633384,1633384,1633294,90,24,utRho07
1733,ybhM,1641556,1641586,1641556,30,0,utRho07
1734,ybhN,1645296,1645296,1644996,300,0,utRho07
1735,ybhQ,1649202,1649260,1649202,58,0,utRho07
1736,ybiA,1665920,1665920,1665900,20,0,utRho07
1737,ybiI,1676968,1676968,1676912,56,0,utRho07
1738,ybiO,1691328,1691328,1690960,368,94,utRho07
1739,ybiP,1705252,1705252,1705194,58,222,utRho07
1740,ybiS,1711572,1711572,1711488,84,842,utRho07
1741,ybiT,1711894,1711926,1711894,32,0,utRho07
1742,ybiU,1718212,1718212,1718122,90,0,utRho07
1743,ybiV,1720176,1720176,1720056,120,0,utRho07
1744,ybiW,1725566,1725566,1725212,354,108,utRho07
1745,ybiX,1678548,1678548,1678414,134,192,utRho07
1746,ybjC,1781784,1781826,1781784,42,0,utRho07
1747,ybjE,1830154,1830154,1829714,440,128,utRho07
1748,ybjG,1767016,1767016,1766776,240,706,utRho07
1749,ybjL,1779882,1779882,1779638,244,76,utRho07
1750,ybjM,1779770,1780178,1779770,408,38,utRho07
1751,ybjO,1795704,1795978,1795704,274,0,utRho07
1752,ybjP,1809046,1809046,1808934,112,0,utRho07
1753,ybjQ,1809034,1809186,1809034,152,0,utRho07
1754,ybjS,1813796,1813796,1813506,290,24,utRho07
1755,ybjX,1838206,1838206,1838168,38,0,utRho07
1756,ycaD,1891438,1891742,1891438,304,0,utRho07
1757,ycaI,1928210,1928640,1928210,430,152,utRho07
1758,ycaK,1899094,1899336,1899094,242,0,utRho07
1759,ycaL,1920264,1920528,1920264,264,0,utRho07
1760,ycaM,1894240,1894458,1894240,218,22,utRho07
1761,ycaR,1941284,1941346,1941284,62,744,utRho07
1762,ycbB,1961862,1962094,1961862,232,0,utRho07
1763,ycbJ,1943344,1943504,1943344,160,0,utRho07
1764,ycbK,1966046,1966150,1966046,104,188,utRho07
1765,ycbZ,2036920,2036920,2036598,322,0,utRho07
1766,yccA,2062886,2062886,2062836,50,22,utRho07
1767,yccF,2048730,2048730,2048696,34,0,utRho07
1768,yccS,2047988,2047988,2047766,222,48,utRho07
1769,yccT,2055674,2055674,2055546,128,0,utRho07
1770,yccX,2059960,2060128,2059960,168,32,utRho07
1771,ycdT,2185682,2185752,2185682,70,0,utRho07
1772,ycdU,2191266,2191686,2191266,420,0,utRho07
1773,ycdZ,2200504,2200592,2200504,88,58,utRho07
1774,yceA,2233544,2233614,2233544,70,254,utRho07
1775,yceD,2293298,2293588,2293298,290,9416,utRho07
1776,yceF,2293522,2293522,2293190,332,5364,utRho07
1777,yceH,2252154,2252314,2252154,160,1874,utRho07
1778,yceI,2237282,2237282,2236952,330,304,utRho07
1779,yceJ,2238142,2238142,2238092,50,0,utRho07
1780,yceM,2253208,2253612,2253208,404,76,utRho07
1781,yceO,2239264,2239264,2238894,370,104,utRho07
1782,yceQ,2288760,2289004,2288760,244,8028,utRho07
1783,ycfD,2376540,2376540,2376480,60,308,utRho07
1784,ycfJ,2334814,2335198,2334814,384,8,utRho07
1785,ycfS,2340834,2340834,2340748,86,0,utRho07
1786,ycfT,2350658,2350658,2350330,328,4,utRho07
1787,ycfZ,2362760,2362760,2362534,226,246,utRho07
1788,ycgB,2474570,2474570,2474482,88,0,utRho07
1789,ycgG,2434614,2434656,2434614,42,56,utRho07
1790,ycgJ,2452956,2453200,2452956,244,0,utRho07
1791,ycgL,2455218,2455362,2455218,144,0,utRho07
1792,ycgN,2457366,2457660,2457366,294,0,utRho07
1793,ycgR,2489112,2489112,2489054,58,0,utRho07
1794,ycgV,2512222,2512222,2511904,318,102,utRho07
1795,ycgX,2426568,2426568,2426214,354,4450,utRho07
1796,ycgY,2490166,2490320,2490166,154,0,utRho07
1797,ycgZ,2431504,2431578,2431504,74,0,utRho07
1798,ychE,2596904,2597196,2596904,292,0,utRho07
1799,ychF,2515764,2515764,2515624,140,0,utRho07
1800,ychH,2517476,2517582,2517476,106,26,utRho07
1801,ychJ,2578354,2578354,2578264,90,0,utRho07
1802,ychN,2547310,2547310,2547198,112,0,utRho07
1803,ychO,2547520,2547850,2547520,330,106,utRho07
1804,ychQ,2533798,2533848,2533798,50,0,utRho07
1805,yciA,2624828,2624828,2624492,336,250,utRho07
1806,yciB,2626110,2626110,2625780,330,3068,utRho07
1807,yciC,2627396,2627396,2627326,70,0,utRho07
1808,yciE,2630794,2630794,2630448,346,0,utRho07
1809,yciG,5264368,5264368,5264140,228,0,utRho07
1810,yciI,2621784,2621784,2621730,54,6,utRho07
1811,yciN,2661606,2661606,2661336,270,36,utRho07
1812,yciS,2680270,2680486,2680270,216,0,utRho07
1813,yciT,2689088,2689088,2688692,396,390,utRho07
1814,yciU,2614718,2614718,2614300,418,622,utRho07
1815,yciV,2646376,2646440,2646376,64,0,utRho07
1816,yciW,2700472,2700472,2700214,258,206,utRho07
1817,yciZ,2689276,2689276,2689218,58,126,utRho07
1818,ycjD,2703792,2703792,2703520,272,0,utRho07
1819,ycjG,2777748,2777860,2777748,112,86,utRho07
1820,ycjM,2740006,2740432,2740006,426,62,utRho07
1821,ycjW,2767982,2767982,2767922,60,20,utRho07
1822,ycjX,2768138,2768234,2768138,96,0,utRho07
1823,ycjY,5568288,5568288,5567460,828,0,utRho07
1824,ydaE,2836438,2836438,2836016,422,0,utRho07
1825,ydaN,2816048,2816100,2816048,52,0,utRho07
1826,ydaS,2840340,2840730,2840340,390,44,utRho07
1827,ydbC,2948376,2948442,2948376,66,0,utRho07
1828,ydbD,2950132,2950288,2950132,156,0,utRho07
1829,ydbH,2885800,2886102,2885800,302,0,utRho07
1830,ydbJ,2881712,2882116,2881712,404,0,utRho07
1831,ydbK,2881692,2881692,2881568,124,16,utRho07
1832,ydcA,2983294,2983354,2983294,60,0,utRho07
1833,ydcF,2974404,2974470,2974404,66,56,utRho07
1834,ydcI,2990268,2990268,2990142,126,0,utRho07
1835,ydcJ,2990266,2990576,2990266,310,0,utRho07
1836,ydcK,3001280,3001280,3000898,382,0,utRho07
1837,ydcL,3004646,3004914,3004646,268,16,utRho07
1838,ydcN,3012308,3012344,3012308,36,32,utRho07
1839,ydcP,3013508,3013562,3013508,54,84,utRho07
1840,ydcR,3019956,3020006,3019956,50,36,utRho07
1841,ydcS,3022906,3023308,3022906,402,0,utRho07
1842,ydcX,3034442,3034778,3034442,336,8,utRho07
1843,ydcY,3035220,3035296,3035220,76,0,utRho07
1844,ydcZ,3036750,3036750,3036662,88,4,utRho07
1845,yddB,3155332,3155332,3155238,94,0,utRho07
1846,yddE,3071738,3071738,3071716,22,0,utRho07
1847,yddG,3094410,3094410,3094338,72,0,utRho07
1848,yddJ,3089732,3089732,3089438,294,0,utRho07
1849,yddW,3137704,3137704,3137646,58,0,utRho07
1850,ydeA,3233910,3234056,3233910,146,112,utRho07
1851,ydeE,3242528,3242664,3242528,136,0,utRho07
1852,ydeI,3249118,3249118,3248994,124,0,utRho07
1853,ydeJ,3249376,3249546,3249376,170,0,utRho07
1854,ydeN,3165458,3165458,3165048,410,0,utRho07
1855,ydeP,3173328,3173328,3172972,356,0,utRho07
1856,ydeR,3176596,3176596,3176592,4,0,utRho07
1857,ydfA,3296872,3297016,3296872,144,8,utRho07
1858,ydfG,3254982,3255034,3254982,52,0,utRho07
1859,ydfH,3256652,3256704,3256652,52,56,utRho07
1860,ydfK,3265446,3266144,3265446,698,300,utRho07
1861,ydgA,3379588,3379704,3379588,116,20,utRho07
1862,ydgC,3364124,3364124,3364060,64,0,utRho07
1863,ydgD,3343906,3343920,3343906,14,2,utRho07
1864,ydgH,3356754,3356854,3356754,100,0,utRho07
1865,ydgJ,3408798,3408798,3408616,182,98,utRho07
1866,ydgK,3410414,3410500,3410414,86,204,utRho07
1867,ydhB,3479618,3479618,3479596,22,0,utRho07
1868,ydhC,3479698,3479822,3479698,124,0,utRho07
1869,ydhF,3451310,3451310,3451264,46,0,utRho07
1870,ydhI,3441996,3442050,3441996,54,0,utRho07
1871,ydhL,3451864,3451864,3451840,24,0,utRho07
1872,ydhQ,3492404,3492404,3492254,150,0,utRho07
1873,ydhS,3494136,3494262,3494136,126,0,utRho07
1874,ydhT,3499138,3499138,3499118,20,2,utRho07
1875,ydhY,3509284,3509284,3508954,330,0,utRho07
1876,ydhZ,3510418,3510418,3510282,136,0,utRho07
1877,ydiE,3579206,3579226,3579206,20,0,utRho07
1878,ydiH,3530582,3530582,3530406,176,0,utRho07
1879,ydiM,3541852,3542142,3541852,290,0,utRho07
1880,ydiN,3544818,3545024,3544818,206,0,utRho07
1881,ydiP,3558656,3558656,3558602,54,2,utRho07
1882,ydiU,3582508,3582508,3582488,20,2,utRho07
1883,ydiV,3584174,3584174,3584040,134,56,utRho07
1884,ydiY,3612500,3612500,3612166,334,0,utRho07
1885,ydjA,3697400,3697400,3697352,48,100,utRho07
1886,ydjE,3708082,3708082,3707958,124,0,utRho07
1887,ydjF,3709848,3709848,3709708,140,0,utRho07
1888,ydjM,3620340,3620422,3620340,82,0,utRho07
1889,ydjO,3626696,3626696,3626288,408,20,utRho07
1890,ydjX,3666434,3666802,3666434,368,456,utRho07
1891,yeaE,3731448,3731448,3731272,176,42,utRho07
1892,yeaG,3733530,3733816,3733530,286,0,utRho07
1893,yeaI,3740486,3740770,3740486,284,0,utRho07
1894,yeaJ,3743874,3744082,3743874,208,24,utRho07
1895,yeaL,3748646,3748704,3748646,58,96,utRho07
1896,yeaM,3751296,3751296,3751152,144,0,utRho07
1897,yeaN,3750926,3751346,3750926,420,24,utRho07
1898,yeaO,3753554,3753818,3753554,264,0,utRho07
1899,yeaP,3755314,3755430,3755314,116,494,utRho07
1900,yeaQ,3758780,3758780,3758510,270,6,utRho07
1901,yeaR,3759988,3759988,3759896,92,0,utRho07
1902,yeaY,3781122,3781122,3781064,58,0,utRho07
1903,yebB,3892220,3892502,3892220,282,46,utRho07
1904,yebC,3896370,3896370,3896302,68,72,utRho07
1905,yebE,3859464,3859464,3859414,50,16,utRho07
1906,yebG,3861530,3861530,3861494,36,0,utRho07
1907,yebK,3873180,3873304,3873180,124,86,utRho07
1908,yebQ,3820314,3820552,3820314,238,22,utRho07
1909,yebS,3832238,3832516,3832238,278,0,utRho07
1910,yebV,3843430,3843560,3843430,130,0,utRho07
1911,yebW,3843914,3844242,3843914,328,562,utRho07
1912,yecC,3995646,3995646,3995628,18,0,utRho07
1913,yecD,3901272,3901664,3901272,392,32,utRho07
1914,yecF,3991434,3991636,3991434,202,0,utRho07
1915,yecH,3979304,3979304,3978980,324,32,utRho07
1916,yecJ,3975604,3975604,3975516,88,0,utRho07
1917,yecM,3919968,3919968,3919692,276,0,utRho07
1918,yecR,3976400,3976444,3976400,44,0,utRho07
1919,yecT,3923862,3923944,3923862,82,38,utRho07
1920,yedD,4016522,4016522,4016180,342,56,utRho07
1921,yedE,4016310,4016554,4016310,244,84,utRho07
1922,yedI,4058922,4058922,4058732,190,0,utRho07
1923,yedJ,4066446,4066446,4066158,288,2,utRho07
1924,yedV,4076404,4076404,4076304,100,48,utRho07
1925,yedX,4077680,4077912,4077680,232,0,utRho07
1926,yedY,4078572,4078956,4078572,384,0,utRho07
1927,yeeA,4161322,4161322,4161182,140,0,utRho07
1928,yeeE,4171104,4171104,4171050,54,0,utRho07
1929,yeeJ,4089526,4089822,4089526,296,0,utRho07
1930,yeeN,4113508,4113716,4113508,208,40,utRho07
1931,yeeO,4119444,4119444,4119692,248,0,utRho07
1932,yeeX,4158834,4158834,4158722,112,122,utRho07
1933,yeeZ,4178422,4178422,4178256,166,16,utRho07
1934,yefM,4179466,4179466,4179426,40,0,utRho07
1935,yegD,4295288,4295348,4295288,60,0,utRho07
1936,yegH,4275726,4275804,4275726,78,0,utRho07
1937,yegI,4302154,4302154,4301970,184,0,utRho07
1938,yegJ,4302032,4302370,4302032,338,0,utRho07
1939,yegQ,4331182,4331336,4331182,154,0,utRho07
1940,yegR,4336698,4336698,4336612,86,0,utRho07
1941,yegS,4337086,4337424,4337086,338,0,utRho07
1942,yegT,4357562,4357642,4357562,80,0,utRho07
1943,yegX,4367640,4367640,4367302,338,0,utRho07
1944,yehA,4376944,4376944,4376828,116,2,utRho07
1945,yehE,4385818,4385818,4385592,226,0,utRho07
1946,yehK,4407568,4407944,4407568,376,0,utRho07
1947,yehL,4408804,4409192,4408804,388,0,utRho07
1948,yeiB,4486146,4486146,4485934,212,150,utRho07
1949,yeiE,4499422,4499422,4499236,186,0,utRho07
1950,yeiG,4487776,4487820,4487776,44,406,utRho07
1951,yeiH,4499332,4499434,4499332,102,14,utRho07
1952,yeiI,4503306,4503400,4503306,94,192,utRho07
1953,yeiL,4510580,4510710,4510580,130,0,utRho07
1954,yeiP,4530834,4530900,4530834,66,504,utRho07
1955,yeiQ,4532328,4532490,4532328,162,48,utRho07
1956,yeiR,4535484,4535658,4535484,174,110,utRho07
1957,yeiW,4530840,4530840,4530590,250,674,utRho07
1958,yejA,4544624,4544728,4544624,104,0,utRho07
1959,yejG,4556892,4556892,4556474,418,386,utRho07
1960,yejH,4561244,4561264,4561244,20,0,utRho07
1961,yejK,4568218,4568218,4567894,324,132,utRho07
1962,yejO,4578352,4578352,4577800,552,66,utRho07
1963,yfaD,4713380,4713808,4713380,428,30,utRho07
1964,yfaE,4696676,4697028,4696676,352,502,utRho07
1965,yfaL,4688568,4688568,4688338,230,0,utRho07
1966,yfaP,4656398,4656398,4656286,112,0,utRho07
1967,yfaU,4717892,4717892,4717690,202,0,utRho07
1968,yfaY,4727310,4727310,4727266,44,0,utRho07
1969,yfaZ,4728744,4728744,4728550,194,2,utRho07
1970,yfbK,4771810,4771810,4771444,366,0,utRho07
1971,yfbL,4771500,4771720,4771500,220,0,utRho07
1972,yfbN,4777174,4777174,4776852,322,0,utRho07
1973,yfbO,4776916,4777162,4776916,246,0,utRho07
1974,yfbP,4777990,4778232,4777990,242,10,utRho07
1975,yfbR,4817662,4817724,4817662,62,0,utRho07
1976,yfcI,4847424,4847424,4847078,346,0,utRho07
1977,yfcJ,4880482,4880482,4880240,242,92,utRho07
1978,yfcL,4888502,4888502,4888338,164,58,utRho07
1979,yfcV,4911642,4911642,4911292,350,2,utRho07
1980,yfcZ,4921958,4921958,4921868,90,16,utRho07
1981,yfdF,4925604,4926024,4925604,420,278,utRho07
1982,yfdG,4935474,4935710,4935474,236,0,utRho07
1983,yfdP,4946844,4947040,4946844,196,0,utRho07
1984,yfdX,4988866,4988866,4988804,62,0,utRho07
1985,yfdY,4990672,4990672,4990584,88,0,utRho07
1986,yfeA,5035784,5035784,5035664,120,2640,utRho07
1987,yfeC,5036668,5036934,5036668,266,142,utRho07
1988,yfeH,5053818,5053892,5053818,74,0,utRho07
1989,yfeK,5074630,5074684,5074630,54,0,utRho07
1990,yfeO,5018906,5019260,5018906,354,150,utRho07
1991,yfeR,5054078,5054078,5053712,366,12,utRho07
1992,yfeX,5101356,5101356,5101090,266,0,utRho07
1993,yfeY,5102486,5102486,5102432,54,0,utRho07
1994,yfeZ,5103842,5103842,5103452,390,0,utRho07
1995,yffO,5123804,5124222,5123804,418,0,utRho07
1996,yffQ,5126778,5127154,5126778,376,0,utRho07
1997,yffS,5128800,5128986,5128800,186,110,utRho07
1998,yfgC,5232052,5232188,5232052,136,0,utRho07
1999,yfgF,5258062,5258062,5257876,186,0,utRho07
2000,yfgG,5258170,5258580,5258170,410,0,utRho07
2001,yfgH,5259344,5259584,5259344,240,0,utRho07
2002,yfgM,5278866,5278866,5278566,300,572,utRho07
2003,yfhH,5397414,5397518,5397414,104,0,utRho07
2004,yfhM,5304648,5304648,5304574,74,0,utRho07
2005,yfhR,5328408,5328726,5328408,318,570,utRho07
2006,yfiC,5425610,5425610,5425528,82,0,utRho07
2007,yfiE,5430688,5430688,5430640,48,0,utRho07
2008,yfiL,5482630,5482720,5482630,90,0,utRho07
2009,yfiM,5448066,5448358,5448066,292,4834,utRho07
2010,yfiR,5483354,5483750,5483354,396,76,utRho07
2011,yfjH,5517326,5517326,5517200,126,14,utRho07
2012,yfjI,5517710,5517970,5517710,260,0,utRho07
2013,yfjJ,5521014,5521094,5521014,80,28,utRho07
2014,yfjM,5531970,5531970,5531552,418,238,utRho07
2015,yfjP,5535080,5535420,5535080,340,88,utRho07
2016,yfjW,5546570,5546636,5546570,66,40,utRho07
2017,yfjX,5551776,5551838,5551776,62,0,utRho07
2018,ygaC,5601180,5601180,5599988,1192,8,utRho07
2019,ygaM,5600242,5600292,5600242,50,2,utRho07
2020,ygaU,5593628,5593628,5593572,56,0,utRho07
2021,ygaZ,5619190,5619234,5619190,44,126,utRho07
2022,ygbA,5713656,5713656,5713612,44,0,utRho07
2023,ygbE,5746784,5746784,5746674,110,0,utRho07
2024,ygbI,5722882,5722882,5722528,354,0,utRho07
2025,ygbK,5724394,5724670,5724394,276,0,utRho07
2026,ygbL,5727074,5727186,5727074,112,10,utRho07
2027,ygbN,5729814,5730202,5729814,388,80,utRho07
2028,ygcG,5811210,5811422,5811210,212,0,utRho07
2029,ygcN,5785144,5785314,5785144,170,0,utRho07
2030,ygcU,5799214,5799214,5798836,378,0,utRho07
2031,ygcW,5800942,5800942,5800546,396,0,utRho07
2032,ygdD,5883442,5883442,5883262,180,4,utRho07
2033,ygdG,5861746,5861930,5861746,184,340,utRho07
2034,ygdI,5886526,5886526,5886290,236,0,utRho07
2035,ygdQ,5940784,5940840,5940784,56,0,utRho07
2036,ygdR,5942494,5942542,5942494,48,0,utRho07
2037,ygeA,5961606,5961606,5961270,336,0,utRho07
2038,ygeH,5983758,5984188,5983758,430,0,utRho07
2039,ygeI,5987162,5987276,5987162,114,0,utRho07
2040,ygeR,6000078,6000078,5999782,296,104,utRho07
2041,ygeV,6011694,6011694,6011572,122,24,utRho07
2042,ygeW,6012234,6012524,6012234,290,0,utRho07
2043,ygfB,6110946,6110946,6110888,58,2,utRho07
2044,ygfK,6031984,6032120,6031984,136,0,utRho07
2045,ygfS,6058328,6058328,6058024,304,0,utRho07
2046,ygfZ,6082564,6082626,6082564,62,30,utRho07
2047,yggC,6149512,6149512,6149378,134,146,utRho07
2048,yggE,6136370,6136370,6136160,210,0,utRho07
2049,yggI,6179176,6179510,6179176,334,58,utRho07
2050,yggL,6204508,6204508,6204266,242,164,utRho07
2051,yggM,6199514,6199514,6199130,384,120,utRho07
2052,yggN,6203596,6203596,6203246,350,10,utRho07
2053,yggX,18623958,18624558,18623958,600,378,utRho07
2054,yghA,6298966,6299324,6298966,358,52,utRho07
2055,yghB,6307058,6307126,6307058,68,10,utRho07
2056,yghD,6222614,6222614,6222252,362,0,utRho07
2057,yghF,6225798,6225798,6225840,42,0,utRho07
2058,yghJ,6238640,6238640,6238224,416,0,utRho07
2059,yghQ,6265186,6265186,6264816,370,0,utRho07
2060,yghT,6267830,6268262,6267830,432,0,utRho07
2061,yghU,6277400,6277454,6277400,54,16,utRho07
2062,yghW,6293506,6293506,6293474,32,0,utRho07
2063,yghZ,6295562,6295794,6295562,232,0,utRho07
2064,ygiD,6365122,6365122,6364868,254,158,utRho07
2065,ygiH,6409066,6409388,6409066,322,0,utRho07
2066,ygiL,6370622,6370828,6370622,206,4,utRho07
2067,ygiM,6402084,6402414,6402084,330,28,utRho07
2068,ygiN,6346156,6346284,6346156,128,1058,utRho07
2069,ygiQ,6322620,6322620,6322292,328,224,utRho07
2070,ygiS,6335462,6335462,6335436,26,0,utRho07
2071,ygiV,6338582,6338582,6338462,120,10,utRho07
2072,ygiW,6339774,6339774,6339352,422,0,utRho07
2073,ygiZ,6344506,6344506,6344422,84,0,utRho07
2074,ygjH,6442528,6442528,6442494,34,0,utRho07
2075,ygjI,6452140,6452468,6452140,328,0,utRho07
2076,ygjQ,6472730,6473080,6472730,350,56,utRho07
2077,ygjR,6474564,6474586,6474564,22,0,utRho07
2078,ygjV,6483638,6483638,6483488,150,0,utRho07
2079,yhaB,6535632,6535708,6535632,76,0,utRho07
2080,yhaH,6504498,6504608,6504498,110,38,utRho07
2081,yhaI,6505400,6505822,6505400,422,0,utRho07
2082,yhaJ,6508560,6508560,6508428,132,40,utRho07
2083,yhaK,6508538,6508638,6508538,100,0,utRho07
2084,yhbQ,6599878,6599932,6599878,54,80,utRho07
2085,yhbT,6602736,6602736,6602552,184,0,utRho07
2086,yhbU,6602558,6602970,6602558,412,0,utRho07
2087,yhbX,6643302,6643302,6643226,76,0,utRho07
2088,yhbY,6655518,6655580,6655518,62,1120,utRho07
2089,yhcA,6723956,6724224,6723956,268,0,utRho07
2090,yhcB,6760364,6760382,6760364,18,74,utRho07
2091,yhcC,6708470,6708470,6708100,370,44,utRho07
2092,yhcF,6733440,6733852,6733440,412,20,utRho07
2093,yhcH,6739124,6739124,6738956,168,12,utRho07
2094,yhcM,6760312,6760312,6759994,318,24,utRho07
2095,yhcN,6770812,6771076,6770812,264,168,utRho07
2096,yhcO,6772606,6772606,6772258,348,0,utRho07
2097,yhdH,6806560,6806968,6806560,408,104,utRho07
2098,yhdJ,6823234,6823306,6823234,72,0,utRho07
2099,yhdN,6879092,6879092,6879018,74,1774,utRho07
2100,yhdT,6814702,6814750,6814702,48,362,utRho07
2101,yhdU,6824994,6825242,6824994,248,60,utRho07
2102,yhdV,6836392,6836780,6836392,388,0,utRho07
2103,yhdW,6837944,6838298,6837944,354,2,utRho07
2104,yheO,6953082,6953082,6952880,202,666,utRho07
2105,yheV,6957970,6957970,6957584,386,138,utRho07
2106,yhfA,6971902,6971902,6971636,266,126,utRho07
2107,yhfG,6983294,6983294,6983240,54,122,utRho07
2108,yhfL,6998622,6998896,6998622,274,0,utRho07
2109,yhfY,7023244,7023244,7022844,400,84,utRho07
2110,yhgA,7086294,7086334,7086294,40,0,utRho07
2111,yhgE,7065176,7065176,7064878,298,20,utRho07
2112,yhgF,7074352,7074770,7074352,418,1560,utRho07
2113,yhhA,7173458,7173886,7173458,428,0,utRho07
2114,yhhI,7248346,7248756,7248346,410,0,utRho07
2115,yhhJ,7253696,7253696,7253606,90,0,utRho07
2116,yhhM,7211588,7211588,7211220,368,44,utRho07
2117,yhhN,7211150,7211502,7211150,352,44,utRho07
2118,yhhQ,7218238,7218434,7218238,196,338,utRho07
2119,yhhT,7223682,7223730,7223682,48,0,utRho07
2120,yhhX,7162032,7162032,7161610,422,28,utRho07
2121,yhhY,7162222,7162276,7162222,54,28,utRho07
2122,yhhZ,7163516,7163726,7163516,210,0,utRho07
2123,yhiD,7312220,7312220,7311804,416,1792,utRho07
2124,yhiJ,7265190,7265190,7265180,10,0,utRho07
2125,yhiM,7269270,7269682,7269270,412,0,utRho07
2126,yhiN,7275000,7275000,7274820,180,82,utRho07
2127,yhjA,7338522,7338522,7338376,146,0,utRho07
2128,yhjB,7344090,7344090,7343788,302,0,utRho07
2129,yhjC,7344272,7344684,7344272,412,0,utRho07
2130,yhjD,7346660,7346724,7346660,64,42,utRho07
2131,yhjE,7349274,7349572,7349274,298,16,utRho07
2132,yhjG,7356824,7356824,7356730,94,40,utRho07
2133,yhjH,7358458,7358458,7358374,84,80,utRho07
2134,yhjJ,7364032,7364032,7363880,152,50,utRho07
2135,yhjK,7371296,7371296,7371158,138,0,utRho07
2136,yhjR,7392750,7392750,7392370,380,94,utRho07
2137,yhjV,7400796,7401126,7400796,330,514,utRho07
2138,yhjX,7424194,7424194,7424014,180,24,utRho07
2139,yhjY,7425966,7425966,7425868,98,28,utRho07
2140,yiaB,7455654,7455654,7455496,158,0,utRho07
2141,yiaD,7432712,7433094,7432712,382,128,utRho07
2142,yiaF,7438194,7438194,7438088,106,0,utRho07
2143,yiaG,7438862,7438956,7438862,94,0,utRho07
2144,yiaJ,7485236,7485236,7485064,172,0,utRho07
2145,yiaK,7485348,7485466,7485348,118,2,utRho07
2146,yiaT,7503924,7503924,7503736,188,0,utRho07
2147,yiaU,7503792,7503984,7503792,192,0,utRho07
2148,yiaY,7515856,7515856,7515654,202,0,utRho07
2149,yibF,7523950,7523950,7523910,40,0,utRho07
2150,yibG,7536128,7536354,7536128,226,0,utRho07
2151,yibL,7553194,7553330,7553194,136,22,utRho07
2152,yibN,7570112,7570112,7570030,82,700,utRho07
2153,yibT,7552848,7552848,7552760,88,22,utRho07
2154,yicC,7633290,7633352,7633290,62,60,utRho07
2155,yicH,7660862,7660914,7660862,52,0,utRho07
2156,yicJ,7673328,7673328,7671858,1470,196,utRho07
2157,yicN,7685018,7685018,7684804,214,0,utRho07
2158,yicO,7687914,7687914,7687578,336,0,utRho07
2159,yicR,15250308,15250308,15250236,72,0,utRho07
2160,yidB,7755230,7755230,7754930,300,0,utRho07
2161,yidE,7732780,7732780,7732546,234,0,utRho07
2162,yidF,7711580,7711580,7711222,358,0,utRho07
2163,yidQ,7735088,7735456,7735088,368,856,utRho07
2164,yidR,7738824,7738824,7738618,206,0,utRho07
2165,yieE,7787658,7787738,7787658,80,2,utRho07
2166,yieH,7793314,7793548,7793314,234,0,utRho07
2167,yieK,7798928,7798928,7798786,142,0,utRho07
2168,yifB,7900350,7900350,7899998,352,0,utRho07
2169,yifL,7988984,7989044,7988984,60,6,utRho07
2170,yigF,8005750,8005750,8005598,152,98,utRho07
2171,yigI,8009448,8009448,8009394,54,2,utRho07
2172,yigM,8022100,8022152,8022100,52,132,utRho07
2173,yihA,8101970,8101970,8101458,512,218,utRho07
2174,yihD,8084098,8084138,8084098,40,0,utRho07
2175,yihF,8088110,8088398,8088110,288,0,utRho07
2176,yihG,8093304,8093304,8093204,100,0,utRho07
2177,yihI,8102616,8102694,8102616,78,0,utRho07
2178,yihL,8120506,8120894,8120506,388,32,utRho07
2179,yihN,8124332,8124494,8124332,162,0,utRho07
2180,yihO,8131942,8131942,8131532,410,0,utRho07
2181,yihQ,8138892,8138892,8138552,340,0,utRho07
2182,yihV,8147064,8147478,8147064,414,0,utRho07
2183,yihX,8151096,8151106,8151096,10,0,utRho07
2184,yiiE,8158192,8158582,8158192,390,0,utRho07
2185,yiiF,8159124,8159502,8159124,378,0,utRho07
2186,yiiG,8173762,8174004,8173762,242,0,utRho07
2187,yiiM,8205506,8205644,8205506,138,2,utRho07
2188,yiiQ,8224624,8224624,8224428,196,28,utRho07
2189,yiiS,8225738,8225934,8225738,196,24,utRho07
2190,yijE,8272178,8272216,8272178,38,50,utRho07
2191,yijF,8275728,8275728,8275314,414,0,utRho07
2192,yijO,8296858,8296858,8296634,224,166,utRho07
2193,yjaA,8426240,8426468,8426240,228,117772,utRho07
2194,yjaB,8428312,8428312,8428246,66,0,utRho07
2195,yjaG,8398746,8399008,8398746,262,1032,utRho07
2196,yjaH,8401022,8401132,8401022,110,302,utRho07
2197,yjaZ,8379506,8379572,8379506,66,0,utRho07
2198,yjbB,8455204,8455462,8455204,258,0,utRho07
2199,yjbE,16943432,16943624,16943432,192,0,utRho07
2200,yjbL,8520318,8520642,8520318,324,0,utRho07
2201,yjbQ,8540428,8540476,8540428,48,0,utRho07
2202,yjcB,8550328,8550328,8550082,246,126,utRho07
2203,yjcC,8550836,8550942,8550836,106,0,utRho07
2204,yjcD,8556628,8556958,8556628,330,88,utRho07
2205,yjcE,8559658,8559960,8559658,302,0,utRho07
2206,yjcF,8566212,8566212,8566150,62,0,utRho07
2207,yjcO,8594660,8594660,8594250,410,0,utRho07
2208,yjdA,8654128,8654270,8654128,142,0,utRho07
2209,yjdC,8726660,8726660,8726616,44,0,utRho07
2210,yjdK,8704780,8705168,8704780,388,0,utRho07
2211,yjdL,8713034,8713034,8712822,212,0,utRho07
2212,yjdM,8653672,8653672,8653468,204,160,utRho07
2213,yjeF,8787354,8788132,8787354,778,2590,utRho07
2214,yjeI,8745522,8745618,8745522,96,24,utRho07
2215,yjeJ,8748806,8748806,8748468,338,4,utRho07
2216,yjeV,8785472,8785784,8785472,312,88,utRho07
2217,yjfP,8833512,8833904,8833512,392,2,utRho07
2218,yjfY,8849656,8849656,8849582,74,0,utRho07
2219,yjfZ,8855052,8855052,8854844,208,0,utRho07
2220,yjgA,8916162,8916162,8915730,432,84,utRho07
2221,yjgL,8950802,8950874,8950802,72,0,utRho07
2222,yjgM,8959342,8959342,8959074,268,0,utRho07
2223,yjgN,8959132,8959460,8959132,328,0,utRho07
2224,yjgR,8980170,8980170,8980126,44,66,utRho07
2225,yjgZ,9002116,9002520,9002116,404,98,utRho07
2226,yjhB,9007764,9008116,9007764,352,0,utRho07
2227,yjhG,9048452,9048452,9048188,264,90,utRho07
2228,yjhU,9041080,9041080,9040648,432,106,utRho07
2229,yjiA,9178096,9178096,9177730,366,390,utRho07
2230,yjiJ,9125364,9125364,9125350,14,0,utRho07
2231,yjiK,9127270,9127270,9127422,152,22,utRho07
2232,yjiL,9129604,9129604,9129378,226,0,utRho07
2233,yjiS,9143410,9143502,9143410,92,0,utRho07
2234,yjiY,9182734,9182734,9182558,176,384,utRho07
2235,yjjA,9200674,9200674,9200378,296,44,utRho07
2236,yjjB,18408708,18408708,18407800,908,184,utRho07
2237,yjjJ,9243314,9243538,9243314,224,0,utRho07
2238,yjjK,9261132,9261132,9261044,88,0,utRho07
2239,yjjL,9189764,9189764,9189444,320,60,utRho07
2240,yjjM,9191894,9191894,9191702,192,0,utRho07
2241,yjjP,9206068,9206068,9205716,352,10,utRho07
2242,yjjQ,9206638,9206954,9206638,316,2,utRho07
2243,yjjX,9267798,9267798,9267490,308,1014,utRho07
2244,yjjY,9280716,9280804,9280716,88,434,utRho07
2245,yjjZ,9211554,9211608,9211554,54,112,utRho07
2246,yjtD,9281676,9281884,9281676,208,16,utRho07
2247,ykfB,532454,532454,532174,280,114,utRho07
2248,ykfI,527636,527636,527338,298,0,utRho07
2249,ykgB,637050,637050,636638,412,0,utRho07
2250,ykgC,640430,640430,640002,428,0,utRho07
2251,ykgD,640232,640454,640232,222,0,utRho07
2252,ykgE,642962,643216,642962,254,0,utRho07
2253,ykgJ,608524,608524,608364,160,0,utRho07
2254,ykgL,623878,624224,623878,346,0,utRho07
2255,ykgM,625610,625610,625554,56,0,utRho07
2256,ykgR,626570,626570,626484,86,0,utRho07
2257,ylaC,958576,958576,958502,74,574,utRho07
2258,yliE,1745938,1745958,1745938,20,0,utRho07
2259,ymcE,2103660,2103694,2103660,34,0,utRho07
2260,ymdA,2210450,2210828,2210450,378,134,utRho07
2261,ymdB,2211428,2211640,2211428,212,34,utRho07
2262,ymfD,2395322,2395322,2395064,258,186,utRho07
2263,ymfI,2402880,2402994,2402880,114,0,utRho07
2264,ymfJ,2404518,2404518,2404168,350,170,utRho07
2265,ymfK,2406176,2406176,2405866,310,0,utRho07
2266,ymfT,2405766,2406048,2405766,282,0,utRho07
2267,ymgE,2489110,2489456,2489110,346,0,utRho07
2268,ymgF,2437628,2437966,2437628,338,0,utRho07
2269,ymiA,2670112,2670320,2670112,208,80,utRho07
2270,ymjA,2715620,2715620,2715336,284,406,utRho07
2271,ynaI,2791946,2791946,2791844,102,0,utRho07
2272,ynaK,2850438,2850754,2850438,316,0,utRho07
2273,ynbA,2954924,2955242,2954924,318,0,utRho07
2274,yncD,3046552,3046552,3046130,422,74,utRho07
2275,yncE,3046454,3046614,3046454,160,0,utRho07
2276,yncG,3052456,3052494,3052456,38,46,utRho07
2277,yncL,3034492,3034492,3034388,104,22,utRho07
2278,yneE,3218364,3218364,3218044,320,0,utRho07
2279,yneF,3223748,3223748,3223708,40,0,utRho07
2280,yneJ,3229560,3229608,3229560,48,38,utRho07
2281,yneK,3231100,3231526,3231100,426,0,utRho07
2282,yneM,3245176,3245292,3245176,116,0,utRho07
2283,ynfA,3311398,3311398,3311346,52,0,utRho07
2284,ynfB,3311418,3311616,3311418,198,246,utRho07
2285,ynfC,3315094,3315094,3314914,180,0,utRho07
2286,ynfD,3314828,3315130,3314828,302,0,utRho07
2287,ynfE,3316006,3316138,3316006,132,0,utRho07
2288,ynfK,3334670,3334670,3334438,232,210,utRho07
2289,ynfL,3339304,3339304,3339184,120,0,utRho07
2290,ynfM,3339260,3339398,3339260,138,0,utRho07
2291,ynfN,3276598,3276598,3276218,380,10,utRho07
2292,ynfO,3273454,3273512,3273454,58,0,utRho07
2293,ynhG,3517890,3517890,3517450,440,88,utRho07
2294,yniA,3615158,3615592,3615158,434,68,utRho07
2295,yniB,3618526,3618526,3618466,60,0,utRho07
2296,yniC,3618652,3618760,3618652,108,20,utRho07
2297,yniD,3610202,3610330,3610202,128,0,utRho07
2298,ynjE,3678880,3678934,3678880,54,0,utRho07
2299,ynjF,3683222,3683222,3682806,416,56,utRho07
2300,ynjH,3684376,3684376,3684270,106,16,utRho07
2301,ynjI,3690022,3690022,3689742,280,2,utRho07
2302,yoaB,3786642,3786734,3786642,92,28,utRho07
2303,yoaC,3787932,3788146,3787932,214,58,utRho07
2304,yoaE,3803544,3803544,3803170,374,76,utRho07
2305,yoaF,3755444,3755444,3755064,380,518,utRho07
2306,yoaH,3789866,3789866,3789462,404,306,utRho07
2307,yobB,3850418,3850880,3850418,462,330,utRho07
2308,yobF,3815586,3815586,3815182,404,72,utRho07
2309,yobH,3817800,3817850,3817800,50,0,utRho07
2310,yodB,4084352,4084736,4084352,384,0,utRho07
2311,yodC,4057008,4057008,4056740,268,4,utRho07
2312,yohC,4451358,4451358,4451262,96,0,utRho07
2313,yohD,4451526,4451602,4451526,76,0,utRho07
2314,yohJ,4460986,4461248,4460986,262,62,utRho07
2315,yohO,4431172,4431314,4431172,142,80,utRho07
2316,yojI,4617282,4617282,4617230,52,0,utRho07
2317,ypdI,4988988,4989396,4988988,408,0,utRho07
2318,ypfG,5165786,5165786,5165554,232,2,utRho07
2319,ypfM,5182140,5182140,5181732,408,350,utRho07
2320,yphB,5349590,5349590,5349376,214,4,utRho07
2321,ypjA,5565644,5565644,5565452,192,0,utRho07
2322,ypjB,5569636,5569636,5568858,778,0,utRho07
2323,ypjD,5495860,5495774,5495860,86,0,utRho07
2324,yqaE,5594170,5594170,5594056,114,0,utRho07
2325,yqcA,5846100,5846100,5845968,132,62,utRho07
2326,yqcE,5800944,5801184,5800944,240,0,utRho07
2327,yqeC,6030468,6030468,6030114,354,0,utRho07
2328,yqeF,5971618,5971618,5971184,434,102,utRho07
2329,yqeG,5971438,5971694,5971438,256,66,utRho07
2330,yqeH,5975016,5975072,5975016,56,4,utRho07
2331,yqeI,5976688,5977004,5976688,316,0,utRho07
2332,yqeK,5981140,5981140,5980720,420,0,utRho07
2333,yqfA,6086728,6086728,6086296,432,274,utRho07
2334,yqgA,6219042,6219106,6219042,64,0,utRho07
2335,yqgB,6172500,6172500,6172102,398,3984,utRho07
2336,yqgE,6185768,6185874,6185768,106,240,utRho07
2337,yqhA,6299150,6299150,6298942,208,52,utRho07
2338,yqhC,6310768,6310768,6310436,332,20,utRho07
2339,yqhD,6310604,6310710,6310604,106,20,utRho07
2340,yqhH,6316842,6317254,6316842,412,56,utRho07
2341,yqiC,6369662,6369680,6369662,18,70,utRho07
2342,yqiJ,6384108,6384416,6384108,308,0,utRho07
2343,yqjA,6495096,6495546,6495096,450,740,utRho07
2344,yqjF,6500932,6501124,6500932,192,20,utRho07
2345,yqjG,6501948,6502048,6501948,100,0,utRho07
2346,yqjH,6433078,6433078,6432982,96,0,utRho07
2347,yqjI,6433506,6433558,6433506,52,0,utRho07
2348,yraH,6574552,6574852,6574552,300,0,utRho07
2349,yraP,6592144,6592818,6592144,674,416,utRho07
2350,yraQ,6596414,6596414,6596276,138,0,utRho07
2351,yraR,6598024,6598024,6597692,332,0,utRho07
2352,yrbG,13360844,13361100,13360844,256,0,utRho07
2353,yrbL,6696842,6696904,6696842,62,74,utRho07
2354,yrbN,6616172,6616172,6615866,306,4364,utRho07
2355,yrdB,6860176,6860176,6860046,130,98,utRho07
2356,yrfF,7052548,7052938,7052548,390,304,utRho07
2357,yrhB,7169440,7169518,7169440,78,0,utRho07
2358,ysaB,7451804,7451804,7451424,380,0,utRho07
2359,ysgA,8032686,8032686,8032338,348,26,utRho07
2360,ytfB,8857638,8857638,8857434,204,20,utRho07
2361,ytfE,8864018,8864018,8863966,52,0,utRho07
2362,ytfF,8866296,8866296,8866130,166,8,utRho07
2363,ytfH,8868164,8868226,8868164,62,0,utRho07
2364,ytfI,8875234,8875414,8875234,180,0,utRho07
2365,ytfJ,8878572,8878572,8878524,48,90,utRho07
2366,ytfK,8879022,8879174,8879022,152,206,utRho07
2367,ytfL,8882642,8882642,8882430,212,74,utRho07
2368,ytfQ,8899634,8899924,8899634,290,26,utRho07
2369,ytjB,9249598,9249598,9249578,20,0,utRho07
2370,yzfA,8896588,8896588,8896490,98,0,utRho07
2371,zapA,6111102,6111224,6111102,122,1722,utRho07
2372,zapB,8236772,8237030,8236772,258,256,utRho07
2373,zapC,2011700,2011904,2011700,204,0,utRho07
2374,zinT,4082692,4082750,4082692,58,0,utRho07
2375,zipA,5062814,5062814,5062466,348,0,utRho07
2376,zitB,1569716,1569716,1569646,70,0,utRho07
2377,zntA,7212844,7212902,7212844,58,0,utRho07
2378,zntR,6878336,6878336,6878260,76,44,utRho07
2379,znuA,3885322,3885322,3885166,156,0,utRho07
2380,znuC,3885268,3885324,3885268,56,0,utRho07
2381,zraP,8403424,8403424,8403376,48,0,utRho07
2382,zraS,8403810,8403852,8403810,42,0,utRho07
2383,zupT,6364866,6365100,6364866,234,158,utRho07
2384,zur,8520282,8520282,8520006,276,354,utRho07
2385,zwf,3872752,3872752,3872628,124,0,utRho07
0,C0343,2818676,2818728,2818676,52,0,utRho08
1,aaeB,6776526,6776526,6776376,150,0,utRho08
2,aaeR,6778762,6779040,6778762,278,84,utRho08
3,aaeX,6778860,6778860,6778674,186,84,utRho08
4,aat,1854920,1854920,1854864,56,0,utRho08
5,accA,416822,417242,416822,420,1972,utRho08
6,accB,6810280,6810872,6810280,592,9640,utRho08
7,accD,4868030,4868030,4867852,178,662,utRho08
8,aceB,8430804,8430956,8430804,152,0,utRho08
9,aceE,245938,246034,245938,96,520,utRho08
10,ackA,4826918,4826940,4826918,22,1802,utRho08
11,acnA,2670848,2671662,2670848,814,1306,utRho08
12,acnB,263038,263230,263038,192,548,utRho08
13,acpP,2303148,2303230,2303148,82,610,utRho08
14,acpS,5402324,5402324,5401996,328,74,utRho08
15,acrA,971396,971396,971238,158,278,utRho08
16,acrB,969370,969370,968806,564,2252,utRho08
17,acrD,5174950,5175190,5174950,240,0,utRho08
18,acrE,6827404,6827728,6827404,324,0,utRho08
19,acrR,971398,971522,971398,124,62,utRho08
20,acrZ,1589502,1589546,1589502,44,0,utRho08
21,acs,8575190,8575190,8574742,448,0,utRho08
22,actP,8569870,8569870,8569804,66,0,utRho08
23,ada,4620854,4620854,4620810,44,0,utRho08
24,add,3404404,3404466,3404404,62,162,utRho08
25,ade,7687802,7687928,7687802,126,0,utRho08
26,adhE,2596826,2596826,2596242,584,0,utRho08
27,adhP,3107988,3107988,3107676,312,1542,utRho08
28,adiA,8681112,8681112,8681042,70,58,utRho08
29,adiC,8674404,8674404,8674062,342,0,utRho08
30,adiY,8676084,8676084,8675858,226,0,utRho08
31,adk,994278,994350,994278,72,34,utRho08
32,adrA,807374,807406,807374,32,0,utRho08
33,aer,6438240,6438240,6438152,88,234,utRho08
34,aes,1000102,1000102,999946,156,0,utRho08
35,agaR,6557406,6557406,6557330,76,0,utRho08
36,agaS,6563778,6563952,6563778,174,0,utRho08
37,agp,2131118,2131170,2131118,52,70,utRho08
38,agrA,7296126,7296126,7296126,0,0,utRho08
39,agrB,7296588,7296588,7296588,0,0,utRho08
40,ahpC,1277386,1277890,1277386,504,366,utRho08
41,ahpF,1278004,1279506,1278004,1502,65844,utRho08
42,ahr,8992698,8992698,8992418,280,0,utRho08
43,aidB,8828494,8828550,8828494,56,0,utRho08
44,ais,4731512,4731512,4731240,272,0,utRho08
45,alaA,4814816,4815122,4814816,306,0,utRho08
46,alaC,4996798,4996798,4996590,208,0,utRho08
47,alaE,5598140,5598328,5598140,188,0,utRho08
48,alaS,5644180,5644180,5644022,158,1528,utRho08
49,alaW,5036612,5036612,5036462,150,8,utRho08
50,aldA,2976380,2976464,2976380,84,262,utRho08
51,aldB,7513070,7513070,7513022,48,0,utRho08
52,alkA,4295118,4295118,4295080,38,102,utRho08
53,alkB,4618890,4618890,4618682,208,2,utRho08
54,allA,1064780,1064902,1064780,122,0,utRho08
55,allD,1092822,1092822,1092726,96,0,utRho08
56,allE,1088112,1088112,1088092,20,0,utRho08
57,allS,1064600,1064600,1064442,158,0,utRho08
58,alr,8531178,8531564,8531178,386,1814,utRho08
59,alsE,8617334,8617334,8616956,378,0,utRho08
60,alsK,8615990,8615990,8615598,392,0,utRho08
61,alx,6476740,6477160,6476740,420,0,utRho08
62,amiA,5104482,5104704,5104482,222,0,utRho08
63,amiC,5898378,5898378,5898020,358,56,utRho08
64,amn,4110062,4110122,4110062,60,0,utRho08
65,ampC,8758006,8758006,8757888,118,0,utRho08
66,ampD,237362,237466,237362,104,114,utRho08
67,ampG,907372,907372,907090,282,668,utRho08
68,ampH,792726,792726,792574,152,76,utRho08
69,amyA,4012230,4012312,4012230,82,146,utRho08
70,anmK,3439346,3439346,3439204,142,0,utRho08
71,ansB,6201580,6201580,6201456,124,0,utRho08
72,ansP,3052040,3052040,3051960,80,254,utRho08
73,apaG,104068,104068,103212,856,4864,utRho08
74,apaH,102586,102586,102444,142,5266,utRho08
75,apbE,4623188,4623188,4623068,120,0,utRho08
76,appA,2081198,2081234,2081198,36,0,utRho08
77,appC,2075420,2075480,2075420,60,0,utRho08
78,appY,1167134,1167362,1167134,228,0,utRho08
79,apt,982620,982824,982620,204,964,utRho08
80,aqpZ,1832424,1832424,1832094,330,0,utRho08
81,araB,140150,140150,140096,54,0,utRho08
82,araC,140482,140774,140482,292,0,utRho08
83,araE,5964416,5964416,5964364,52,0,utRho08
84,araF,3972476,3972476,3972256,220,0,utRho08
85,araH,3967120,3967120,3967086,34,0,utRho08
86,araJ,825058,825058,824962,96,0,utRho08
87,arcA,9281602,9281602,9280612,990,5664,utRho08
88,arcB,6706098,6706098,6706050,48,0,utRho08
89,arcZ,6701154,6701154,6701154,0,0,utRho08
90,arfA,6877346,6877346,6877298,48,0,utRho08
91,argA,5898312,5898484,5898312,172,56,utRho08
92,argC,8309770,8310002,8309770,232,144,utRho08
93,argD,6980442,6980442,6980360,82,0,utRho08
94,argE,8310156,8310156,8309694,462,288,utRho08
95,argF,580680,580680,580610,70,0,utRho08
96,argG,6637124,6637274,6637124,150,0,utRho08
97,argI,8956688,8956688,8956622,66,22,utRho08
98,argO,6137672,6137672,6137616,56,66,utRho08
99,argP,6119460,6119506,6119460,46,2,utRho08
100,argR,6769204,6769406,6769204,202,0,utRho08
101,argS,3920002,3920124,3920002,122,0,utRho08
102,argT,4855698,4855698,4855582,116,0,utRho08
103,argU,1129406,1129446,1129406,40,0,utRho08
104,argW,4932616,4932618,4932616,2,0,utRho08
105,argX,7964728,7964750,7964728,22,46,utRho08
106,aroF,5482402,5482402,5482300,102,0,utRho08
107,aroG,1571182,1571266,1571182,84,124,utRho08
108,aroH,3576636,3576870,3576636,234,444,utRho08
109,aroK,7038760,7038760,7038128,632,1904,utRho08
110,aroL,812560,812810,812560,250,10,utRho08
111,aroP,243342,243342,243102,240,0,utRho08
112,arpA,8445382,8445382,8444974,408,0,utRho08
113,arrS,7316108,7316108,7316108,0,0,utRho08
114,arsR,7297024,7297056,7297024,32,0,utRho08
115,artJ,1801252,1801252,1801150,102,0,utRho08
116,artP,1807686,1807686,1807468,218,14,utRho08
117,ascF,5678858,5679048,5678858,190,0,utRho08
118,ascG,5678574,5678574,5678528,46,0,utRho08
119,aslB,7965562,7965916,7965562,354,1132,utRho08
120,asnA,7854258,7854310,7854258,52,0,utRho08
121,asnB,1398444,1398444,1398354,90,0,utRho08
122,asnC,23562186,23562186,23562018,168,0,utRho08
123,asnS,1978088,1978088,1977970,118,9496,utRho08
124,asnT,4089082,4089098,4089082,16,222,utRho08
125,asnU,4119690,4119702,4119690,12,0,utRho08
126,asnV,4124504,4124520,4124504,16,0,utRho08
127,aspA,17473728,17473728,17473308,420,0,utRho08
128,aspC,1971486,1971486,1971418,68,576,utRho08
129,aspS,3901402,3901402,3901044,358,414,utRho08
130,aspT,7893560,7893744,7893560,184,198184,utRho08
131,aspV,473826,473862,473826,36,96,utRho08
132,asr,3342654,3342752,3342654,98,0,utRho08
133,astC,3664088,3664088,3663964,124,0,utRho08
134,astE,3654138,3654138,3653846,292,0,utRho08
135,atoD,4646824,4646894,4646824,70,0,utRho08
136,atpB,7844540,7844540,7844102,438,1042,utRho08
137,atpC,7832118,7832118,7831944,174,2218,utRho08
138,atpI,7845050,7845050,7844880,170,300,utRho08
139,avtA,7479348,7479410,7479348,62,176,utRho08
140,azoR,2965982,2965982,2965720,262,148,utRho08
141,azuC,3976002,3976002,3975918,84,0,utRho08
142,bacA,6408350,6408350,6408262,88,0,utRho08
143,bamA,394052,395856,394052,1804,1082,utRho08
144,bamB,5277950,5277950,5277304,646,1634,utRho08
145,bamC,5198028,5198028,5197730,298,1184,utRho08
146,bamD,5471922,5472292,5471922,370,8382,utRho08
147,bamE,5506972,5507210,5506972,238,390,utRho08
148,basS,8666954,8666954,8666544,410,72,utRho08
149,bax,7474468,7474468,7474354,114,54,utRho08
150,bcp,5200874,5200956,5200874,82,3296,utRho08
151,bcsB,7385346,7385346,7385214,132,0,utRho08
152,bcsE,7392644,7392916,7392644,272,0,utRho08
153,bdcA,8948128,8948128,8948106,22,72,utRho08
154,bdcR,8948192,8948248,8948192,56,0,utRho08
155,bdm,3112680,3112680,3112560,120,0,utRho08
156,betA,654522,654522,654494,28,486,utRho08
157,betI,658722,658722,658668,54,0,utRho08
158,betT,658842,658926,658842,84,0,utRho08
159,bfr,6933498,6933498,6933450,48,40,utRho08
160,bglG,23440182,23440182,23439402,780,0,utRho08
161,bglX,4444240,4444240,4443978,262,0,utRho08
162,bhsA,2337962,2338146,2337962,184,0,utRho08
163,bioA,1618584,1618584,1618514,70,0,utRho08
164,bioB,1618604,1618688,1618604,84,0,utRho08
165,bioH,7089716,7089716,7089688,28,0,utRho08
166,bisC,7433026,7433026,7432788,238,204,utRho08
167,blc,8755490,8755490,8755444,46,0,utRho08
168,blr,3409024,3409102,3409024,78,54,utRho08
169,bluF,2431226,2431226,2430950,276,752,utRho08
170,bluR,2428226,2428226,2428118,108,0,utRho08
171,bolA,908698,908944,908698,246,0,utRho08
172,borD,1157842,1157842,1157786,56,0,utRho08
173,brnQ,838976,839182,838976,206,1196,utRho08
174,bssR,1756492,1756496,1756492,4,0,utRho08
175,bssS,2242116,2242116,2241910,206,0,utRho08
176,btuB,8326798,8327278,8326798,480,3922,utRho08
177,cadB,8720212,8720212,8720062,150,0,utRho08
178,cadC,8723926,8723926,8723868,58,0,utRho08
179,caiE,70998,70998,70742,256,0,utRho08
180,caiF,68436,68600,68436,164,0,utRho08
181,caiT,84074,84074,83862,212,0,utRho08
182,can,285406,285406,285340,66,106,utRho08
183,carA,59102,59302,59102,200,4,utRho08
184,carB,61550,61634,61550,84,140,utRho08
185,cas2,5757830,5757830,5757706,124,0,utRho08
186,casA,5768638,5768638,5768276,362,0,utRho08
187,cbl,4121882,4121882,4121828,54,0,utRho08
188,cbpA,2128074,2128074,2127550,524,144,utRho08
189,cbrA,7738628,7738754,7738628,126,0,utRho08
190,cbrB,7794958,7795012,7794958,54,12,utRho08
191,ccmH,4585242,4585242,4584820,422,0,utRho08
192,cdaR,364894,364926,364894,32,0,utRho08
193,cdd,4463638,4463688,4463638,50,0,utRho08
194,cdh,8219814,8219860,8219814,46,0,utRho08
195,cdsA,391110,391354,391110,244,704,utRho08
196,cedA,3627484,3627484,3627326,158,0,utRho08
197,cfa,3482402,3482826,3482402,424,14,utRho08
198,chaC,2544844,2544972,2544844,128,0,utRho08
199,chbB,3643452,3643452,3643238,214,0,utRho08
200,chbG,3634624,3634624,3634270,354,0,utRho08
201,cheW,3946924,3946924,3946678,246,1632,utRho08
202,chiA,6939792,6939792,6939706,86,0,utRho08
203,chiP,1416472,1416668,1416472,196,0,utRho08
204,cho,3646984,3647030,3646984,46,0,utRho08
205,chpS,8896804,8896894,8896804,90,0,utRho08
206,cirA,4493884,4493884,4493538,346,0,utRho08
207,citC,1304078,1304078,1303712,366,0,utRho08
208,citT,1293264,1293264,1293160,104,0,utRho08
209,clcA,350104,350214,350104,110,0,utRho08
210,clpA,1846160,1846528,1846160,368,0,utRho08
211,clpB,5468410,5468410,5468346,64,0,utRho08
212,clpP,913154,913354,913154,200,776,utRho08
213,clpS,1845500,1845826,1845500,326,0,utRho08
214,clpX,914404,914852,914404,448,1730,utRho08
215,clsA,2617346,2617346,2617290,56,0,utRho08
216,clsC,2212584,2212710,2212584,126,420,utRho08
217,cmk,1922330,1922402,1922330,72,140,utRho08
218,cnu,3409522,3409898,3409522,376,618,utRho08
219,coaA,8350214,8350214,8350052,162,572,utRho08
220,cobC,1340092,1340092,1339814,278,416,utRho08
221,cobT,4129202,4129202,4128934,268,0,utRho08
222,cobU,4131944,4131944,4131528,416,56,utRho08
223,codB,709768,709844,709768,76,0,utRho08
224,comR,2337726,2337726,2337664,62,0,utRho08
225,copA,1022822,1022822,1022758,64,0,utRho08
226,corA,8002388,8002852,8002388,464,8464,utRho08
227,cpdB,8873258,8873258,8873130,128,214,utRho08
228,cptB,6082198,6082198,6082140,58,94,utRho08
229,cpxA,8210202,8210202,8209950,252,768,utRho08
230,cpxP,8211570,8211640,8211570,70,72,utRho08
231,cpxR,8211372,8211372,8211340,32,72,utRho08
232,cra,175894,176056,175894,162,0,utRho08
233,crcB,1316016,1316016,1315876,140,108,utRho08
234,creA,9270486,9271042,9270486,556,170,utRho08
235,creD,9276320,9276356,9276320,36,0,utRho08
236,crl,515620,515658,515620,38,958,utRho08
237,crp,6971906,6972240,6971906,334,4518,utRho08
238,crr,5070960,5071668,5070960,708,4486,utRho08
239,csdA,5886414,5886674,5886414,260,0,utRho08
240,csgB,2207718,2207902,2207718,184,0,utRho08
241,csgD,2206688,2206688,2206392,296,0,utRho08
242,csgG,2203510,2203510,2203368,142,0,utRho08
243,csiD,5577854,5577970,5577854,116,80,utRho08
244,csiE,5330802,5330870,5330802,68,0,utRho08
245,csiR,5590942,5591348,5590942,406,0,utRho08
246,cspA,7439778,7440098,7439778,320,40584,utRho08
247,cspB,3283430,3283430,3283108,322,4,utRho08
248,cspC,3815018,3815018,3814870,148,116,utRho08
249,cspD,1845352,1845352,1845180,172,1614,utRho08
250,cspE,1314294,1314584,1314294,290,34,utRho08
251,cspF,3283380,3283710,3283380,330,44,utRho08
252,cspG,2102610,2102922,2102610,312,870,utRho08
253,cspH,2102746,2102746,2102350,396,274,utRho08
254,cspI,3277624,3277624,3277334,290,0,utRho08
255,csrA,5638746,5638746,5638292,454,994,utRho08
256,csrB,5849048,5849048,5849048,0,0,utRho08
257,csrC,8102072,8102072,8102072,0,0,utRho08
258,csrD,6806850,6806850,6806664,186,0,utRho08
259,cstA,1259710,1259788,1259710,78,0,utRho08
260,cueO,274090,274166,274090,76,0,utRho08
261,cueR,1027948,1027986,1027948,38,0,utRho08
262,curA,3037784,3038054,3037784,270,0,utRho08
263,cusC,1191146,1191200,1191146,54,0,utRho08
264,cusR,1190924,1190924,1190886,38,0,utRho08
265,cutA,8730784,8730784,8730712,72,64,utRho08
266,cutC,3918534,3918534,3917920,614,66,utRho08
267,cvpA,4861600,4861600,4861526,74,18,utRho08
268,cvrA,2484328,2484328,2484142,186,28,utRho08
269,cyaA,7981548,7982306,7981548,758,440,utRho08
270,cyaR,4334228,4334224,4334228,4,0,utRho08
271,cyaY,7988166,7988166,7988118,48,0,utRho08
272,cybB,2981522,2981804,2981522,282,0,utRho08
273,cycA,8859560,8859728,8859560,168,8,utRho08
274,cydA,1542340,1542916,1542340,576,0,utRho08
275,cydC,1858800,1858800,1858390,410,332,utRho08
276,cydD,1862062,1862062,1861924,138,80,utRho08
277,cydX,1548300,1548392,1548300,92,184,utRho08
278,cynR,717418,717418,717380,38,0,utRho08
279,cynT,1435092,1435196,1435092,104,0,utRho08
280,cyoA,903306,903306,903220,86,3332,utRho08
281,cyoE,895540,895540,895410,130,614,utRho08
282,cysB,2667576,2667710,2667576,134,146,utRho08
283,cysC,5748056,5748056,5747984,72,0,utRho08
284,cysD,5752736,5752736,5752658,78,0,utRho08
285,cysE,7565362,7565362,7565124,238,442,utRho08
286,cysG,6995508,6995656,6995508,148,0,utRho08
287,cysJ,5783928,5783928,5783796,132,1356,utRho08
288,cysK,5064688,5064818,5064688,130,36,utRho08
289,cysP,5087114,5087114,5087056,58,0,utRho08
290,cysS,1109154,1109222,1109154,68,500,utRho08
291,cysT,3984100,3984100,3983974,126,8,utRho08
292,cysZ,5062766,5062926,5062766,160,0,utRho08
293,cytR,8249018,8249018,8248912,106,108,utRho08
294,dacA,1328002,1328002,1327926,76,122,utRho08
295,dacB,6657714,6657926,6657714,212,120,utRho08
296,dacC,1761306,1761454,1761306,148,0,utRho08
297,dadA,2475018,2475142,2475018,124,0,utRho08
298,dam,7032504,7032504,7031826,678,1778,utRho08
299,damX,7035200,7035200,7034612,588,262,utRho08
300,dapA,5199568,5199568,5199520,48,0,utRho08
301,dapB,56576,56748,56576,172,288,utRho08
302,dapD,371954,371954,371894,60,428,utRho08
303,dapE,5183120,5183214,5183120,94,274,utRho08
304,dcp,3254844,3254844,3254760,84,46,utRho08
305,dcrB,7219534,7219910,7219534,376,8,utRho08
306,dctA,7366996,7366996,7366894,102,252,utRho08
307,dcuA,8733686,8733686,8733546,140,0,utRho08
308,dcuB,8698182,8698182,8697488,694,0,utRho08
309,dcuC,1312166,1312166,1311936,230,0,utRho08
310,dcuD,6749166,6749738,6749166,572,0,utRho08
311,dcuR,8701130,8701130,8700068,1062,376,utRho08
312,dcuS,8703370,8703370,8703324,46,0,utRho08
313,dcyD,3999016,3999016,3998960,56,0,utRho08
314,ddpX,3126498,3126498,3126152,346,0,utRho08
315,deaD,6615818,6615818,6615720,98,2130,utRho08
316,dedA,4869880,4869880,4869482,398,9102,utRho08
317,dedD,4863750,4863750,4863368,382,0,utRho08
318,def,6867300,6867380,6867300,80,0,utRho08
319,degP,361690,361768,361690,78,0,utRho08
320,degQ,6761308,6761486,6761308,178,724,utRho08
321,deoB,9239134,9239206,9239134,72,0,utRho08
322,deoC,9233358,9234646,9233358,1288,128,utRho08
323,dfp,7625406,7625462,7625406,56,0,utRho08
324,dgcZ,3247758,3247758,3247700,58,0,utRho08
325,dgkA,8512914,8513274,8512914,360,224,utRho08
326,dgt,358392,358474,358392,82,0,utRho08
327,dhaK,2501888,2501888,2501676,212,996,utRho08
328,dhaR,2502006,2502132,2502006,126,0,utRho08
329,dicB,3299194,3299218,3299194,24,0,utRho08
330,dicC,3295752,3295752,3295700,52,0,utRho08
331,dinB,501760,501796,501760,36,0,utRho08
332,dinD,7635398,7635520,7635398,122,4,utRho08
333,dinG,1666146,1666140,1666146,6,64,utRho08
334,dinI,2243018,2243018,2242974,44,0,utRho08
335,dinJ,493230,493230,493004,226,0,utRho08
336,dinQ,7295964,7295964,7295576,388,908,utRho08
337,djlA,114536,114728,114536,192,0,utRho08
338,dkgA,6313142,6313246,6313142,104,0,utRho08
339,dkgB,458196,458334,458196,138,46,utRho08
340,dksA,321502,321502,321208,294,1436,utRho08
341,dld,4444164,4444370,4444164,206,0,utRho08
342,dmlA,3763424,3763824,3763424,400,0,utRho08
343,dmlR,3763710,3763710,3763618,92,0,utRho08
344,dmsA,1881646,1881918,1881646,272,0,utRho08
345,dnaA,7767922,7767922,7767458,464,736,utRho08
346,dnaB,8528566,8528628,8528566,62,66,utRho08
347,dnaK,24096,24326,24096,230,408,utRho08
348,dnaN,7765466,7765466,7764642,824,1304,utRho08
349,dnaQ,471868,472134,471868,266,1068,utRho08
350,dnaT,18406460,18406460,18406068,392,0,utRho08
351,dnaX,984112,984184,984112,72,214,utRho08
352,dosP,3131486,3131486,3131466,20,0,utRho08
353,dpiB,1303968,1304470,1303968,502,0,utRho08
354,dppA,7415740,7415740,7415410,330,2278,utRho08
355,dps,1697900,1697900,1697822,78,0,utRho08
356,dsbA,8086754,8086836,8086754,82,2464,utRho08
357,dsbB,2466294,2466294,2466060,234,0,utRho08
358,dsbC,6079266,6079266,6077644,1622,1078,utRho08
359,dsbG,1277600,1277600,1277146,454,650,utRho08
360,dsdA,4958242,4958404,4958242,162,84,utRho08
361,dsdC,4955492,4955492,4955258,234,0,utRho08
362,dsdX,4955642,4955694,4955642,52,0,utRho08
363,dsrA,4050626,4050626,4050626,0,0,utRho08
364,dsrB,4049686,4049686,4049646,40,0,utRho08
365,dtpD,1485340,1485340,1485112,228,0,utRho08
366,dusA,8523200,8523338,8523200,138,1776,utRho08
367,dusB,6820492,6820560,6820492,68,278,utRho08
368,dusC,4460790,4460790,4460770,20,0,utRho08
369,dut,7627704,7627864,7627704,160,2006,utRho08
370,dxr,386670,387042,386670,372,1366,utRho08
371,ebgA,6445102,6445266,6445102,164,48,utRho08
372,ebgR,6442874,6442932,6442874,58,0,utRho08
373,ecnB,8753018,8753106,8753018,88,160,utRho08
374,eco,4607594,4607810,4607594,216,0,utRho08
375,ecpA,621594,621594,621342,252,0,utRho08
376,ecpB,620238,620238,620052,186,0,utRho08
377,ecpR,622964,622964,622672,292,0,utRho08
378,eda,3866218,3866218,3865512,706,176,utRho08
379,edd,3869426,3869426,3869208,218,216,utRho08
380,efeO,2164308,2164486,2164308,178,40,utRho08
381,efeU_1,2162614,2162712,2162614,98,0,utRho08
382,efp,8751134,8751398,8751134,264,4284,utRho08
383,elaA,4763372,4763372,4763086,286,32,utRho08
384,elaD,4765308,4765426,4765308,118,36,utRho08
385,elfA,1995530,1995736,1995530,206,0,utRho08
386,elfD,1996642,1996980,1996642,338,0,utRho08
387,emrD,7707690,7707844,7707690,154,0,utRho08
388,emrK,4966896,4966896,4966678,218,0,utRho08
389,emrY,4964668,4964668,4964352,316,0,utRho08
390,emtA,2486250,2486360,2486250,110,0,utRho08
391,endA,12361100,12361388,12361100,288,0,utRho08
392,eno,5817692,5817692,5815882,1810,4252,utRho08
393,entC,1249662,1249770,1249662,108,0,utRho08
394,entD,1220508,1220508,1220158,350,0,utRho08
395,entH,1258584,1258600,1258584,16,0,utRho08
396,entS,1244506,1244600,1244506,94,0,utRho08
397,envR,6827266,6827266,6826930,336,0,utRho08
398,epd,12295292,12295292,12294764,528,0,utRho08
399,epmA,8765236,8765286,8765236,50,0,utRho08
400,epmB,8751406,8751406,8751314,92,2588,utRho08
401,eptB,7421162,7421162,7420950,212,96,utRho08
402,eptC,8300622,8300622,8300530,92,54,utRho08
403,erfK,4126708,4126708,4126646,62,142,utRho08
404,erpA,353122,353220,353122,98,54,utRho08
405,esrE,8039956,8039956,8039956,0,0,utRho08
406,essD,1153746,1154796,1153746,1050,104,utRho08
407,etk,2088606,2088606,2088420,186,0,utRho08
408,evgA,4967262,4967510,4967262,248,0,utRho08
409,exbB,6304028,6304028,6303968,60,0,utRho08
410,exbD,6302780,6302780,6302486,294,0,utRho08
411,exuR,6493016,6493304,6493016,288,102,utRho08
412,exuT,6490004,6490208,6490004,204,0,utRho08
413,fabA,2032996,2032996,2032940,56,90,utRho08
414,fabB,4883282,4883282,4883210,72,0,utRho08
415,fabH,2297032,2297518,2297032,486,2252,utRho08
416,fabI,2702236,2702236,2702078,158,74,utRho08
417,fadB,8062026,8062026,8061942,84,0,utRho08
418,fadD,3779614,3779614,3779492,122,70,utRho08
419,fadE,486812,486812,486606,206,0,utRho08
420,fadH,6463248,6463330,6463248,82,0,utRho08
421,fadI,4921022,4921022,4920938,84,80,utRho08
422,fadL,4922410,4922600,4922410,190,0,utRho08
423,fadM,928720,928804,928720,84,0,utRho08
424,fadR,2469810,2469876,2469810,66,0,utRho08
425,fbaB,4357334,4357334,4357128,206,0,utRho08
426,fdhE,8162722,8162722,8162456,266,1578,utRho08
427,fdhF,8598814,8598814,8598732,82,0,utRho08
428,fdnG,3094744,3094802,3094744,58,0,utRho08
429,fdrA,1093012,1093360,1093012,348,0,utRho08
430,feaB,2894994,2895038,2894994,44,0,utRho08
431,feaR,2894734,2894734,2894566,168,0,utRho08
432,fecA,9033454,9033454,9033354,100,0,utRho08
433,fecE,9023288,9023288,9022914,374,4848,utRho08
434,fecI,9036564,9036564,9036470,94,0,utRho08
435,feoA,7080114,7080326,7080114,212,94,utRho08
436,fepA,1225334,1225334,1224988,346,0,utRho08
437,fepB,1249454,1249454,1249020,434,0,utRho08
438,fepD,1244468,1244468,1244378,90,0,utRho08
439,fes,1225374,1225630,1225374,256,30,utRho08
440,ffh,5495706,5495706,5495590,116,1608,utRho08
441,ffs,952576,952848,952576,272,0,utRho08
442,fhuA,334884,334968,334884,84,0,utRho08
443,fhuE,2323294,2323294,2323102,192,0,utRho08
444,fhuF,9211504,9211504,9211326,178,186,utRho08
445,fic,6983296,6983296,6982926,370,706,utRho08
446,fieF,8212864,8212938,8212864,74,0,utRho08
447,fimA,9085388,9086230,9085388,842,256,utRho08
448,fimB,9081334,9081914,9081334,580,840,utRho08
449,fimE,9083742,9084074,9083742,332,0,utRho08
450,fimZ,1129214,1129214,1128960,254,0,utRho08
451,fiu,1683296,1683296,1683062,234,0,utRho08
452,fixA,84650,84806,84650,156,0,utRho08
453,fkpA,6955050,6955050,6954838,212,10348,utRho08
454,fldA,2846084,2846084,2845860,224,2868,utRho08
455,fldB,6079644,6079710,6079644,66,0,utRho08
456,flgA,2261770,2261770,2261726,44,0,utRho08
457,flgB,2261986,2262036,2261986,50,0,utRho08
458,flgK,2276702,2276756,2276702,54,446,utRho08
459,flgM,2260330,2260330,2260256,74,412,utRho08
460,flgN,2259828,2259828,2259660,168,152,utRho08
461,flhB,3932432,3932432,3932382,50,698,utRho08
462,flhC,3955864,3955864,3955688,176,0,utRho08
463,flhD,3957154,3957154,3956394,760,120,utRho08
464,fliA,4003638,4003638,4003578,60,76,utRho08
465,fliC,4007352,4007352,4007212,140,1224,utRho08
466,fliD,4007634,4007744,4007634,110,138,utRho08
467,fliE,4026186,4026186,4026028,158,0,utRho08
468,fliF,4026292,4026458,4026292,166,158,utRho08
469,fliL,4039168,4039236,4039168,68,40,utRho08
470,flk,4875824,4875900,4875824,76,0,utRho08
471,flu,4142634,4143078,4142634,444,28,utRho08
472,flxA,3292776,3292810,3292776,34,100,utRho08
473,fnr,2799104,2799104,2799052,52,58,utRho08
474,fnrS,2818258,2818258,2818258,0,0,utRho08
475,focA,1909628,1909628,1908932,696,724,utRho08
476,folA,99598,99646,99598,48,0,utRho08
477,folB,6409296,6409296,6409178,118,28,utRho08
478,folD,1115562,1115562,1115482,80,102,utRho08
479,folE,4487696,4487696,4487304,392,3146,utRho08
480,fpr,8228998,8228998,8228944,54,0,utRho08
481,frc,4986878,4986878,4986508,370,0,utRho08
482,frdA,8764824,8764824,8764636,188,52,utRho08
483,frdD,8758948,8758948,8758732,216,1182,utRho08
484,fre,8052886,8053054,8052886,168,1870,utRho08
485,frlA,6999518,6999820,6999518,302,0,utRho08
486,frr,385624,385744,385624,120,1338,utRho08
487,frsA,513004,513054,513004,50,54,utRho08
488,fruB,4527194,4527194,4526990,204,0,utRho08
489,frvR,8179804,8179804,8179710,94,0,utRho08
490,fryA,5008986,5008986,5008970,16,0,utRho08
491,fsaA,1727060,1727284,1727060,224,0,utRho08
492,fsr,1009710,1009710,1009392,318,52,utRho08
493,ftnA,3977364,3977432,3977364,68,0,utRho08
494,ftnB,3973550,3973850,3973550,300,0,utRho08
495,ftsA,207122,207964,207122,842,850,utRho08
496,ftsB,5745802,5745802,5745640,162,142,utRho08
497,ftsH,6654204,6654204,6653870,334,676,utRho08
498,ftsK,1865858,1866448,1865858,590,2070,utRho08
499,ftsL,181376,182064,181376,688,2162,utRho08
500,ftsP,6325732,6325732,6325338,394,0,utRho08
501,ftsQ,205484,206310,205484,826,286,utRho08
502,ftsX,7204512,7204512,7204172,340,362,utRho08
503,ftsZ,209272,210610,209272,1338,124,utRho08
504,fucA,5867708,5867708,5867376,332,0,utRho08
505,fucP,5868238,5868470,5868238,232,0,utRho08
506,fumA,6753760,6753760,6753508,252,4112,utRho08
507,fumB,8694696,8694696,8694652,44,0,utRho08
508,fumC,3373418,3373418,3373176,242,20,utRho08
509,fur,2842892,2842892,2842584,308,7564,utRho08
510,fusA,6947370,6947370,6947028,342,27930,utRho08
511,fxsA,8737206,8737328,8737206,122,80,utRho08
512,gabD,5581824,5582546,5581824,722,1180,utRho08
513,gadA,7335214,7335214,7335160,54,0,utRho08
514,gadB,3144144,3144144,3144090,54,0,utRho08
515,gadC,3141168,3141168,3140978,190,0,utRho08
516,gadE,7315600,7316732,7315600,1132,0,utRho08
517,gadW,7329562,7329562,7329236,326,0,utRho08
518,gadX,14663356,14663356,14663240,116,0,utRho08
519,gadY,7329728,7329728,7329728,0,0,utRho08
520,galE,1584354,1584354,1584110,244,0,utRho08
521,galF,4228702,4228702,4228654,48,0,utRho08
522,galM,1577796,1577796,1577674,122,180,utRho08
523,galP,6176510,6176568,6176510,58,0,utRho08
524,galR,5953138,5953198,5953138,60,52,utRho08
525,galS,4483420,4483420,4483336,84,0,utRho08
526,galU,2582810,2582914,2582810,104,570,utRho08
527,gapA,3724480,3725542,3724480,1062,5134,utRho08
528,garP,6549868,6549868,6549814,54,60,utRho08
529,gatY,4354468,4354468,4354408,60,0,utRho08
530,gatZ,4352864,4352864,4352642,222,15474,utRho08
531,gcd,282558,282558,282450,108,0,utRho08
532,gcl,1067814,1067832,1067814,18,0,utRho08
533,gcvA,5885278,5885278,5885134,144,0,utRho08
534,gcvB,5885392,5885392,5885392,0,0,utRho08
535,gcvR,5199758,5199812,5199758,54,290,utRho08
536,gcvT,6101544,6101544,6101334,210,1768,utRho08
537,gdhA,3684616,3684742,3684616,126,0,utRho08
538,gfcA,2099668,2099668,2099488,180,0,utRho08
539,gfcD,2096236,2096236,2095890,346,0,utRho08
540,ghrA,2195648,2195772,2195648,124,0,utRho08
541,ghrB,7434378,7434620,7434378,242,656,utRho08
542,glcA,6242728,6242728,6242558,170,2,utRho08
543,glcC,6256412,6256544,6256412,132,0,utRho08
544,glcD,6256152,6256152,6256042,110,0,utRho08
545,gldA,8278092,8278092,8278070,22,0,utRho08
546,glgA,7136784,7136784,7136066,718,586,utRho08
547,glgB,7147314,7147314,7147004,310,0,utRho08
548,glgC,7139142,7139142,7138656,486,126,utRho08
549,glgP,7133546,7133546,7133162,384,460,utRho08
550,glgS,6384024,6384024,6383878,146,0,utRho08
551,glgX,7142838,7142838,7142638,200,0,utRho08
552,glk,5018922,5018922,5018852,70,50,utRho08
553,glmS,7827622,7827622,7827336,286,7516,utRho08
554,glmU,7830652,7830652,7830400,252,204,utRho08
555,glmY,10765360,10765360,10765360,0,0,utRho08
556,glmZ,7972864,7972864,7972864,0,0,utRho08
557,glnA,16232888,16232888,16232136,752,820,utRho08
558,glnB,5375052,5375052,5374816,236,196,utRho08
559,glnD,377310,377310,377300,10,16,utRho08
560,glnE,6399602,6399602,6399282,320,0,utRho08
561,glnH,1696396,1696396,1696008,388,0,utRho08
562,glnK,945112,945196,945112,84,0,utRho08
563,glnL,8112742,8112742,8112678,64,0,utRho08
564,glnQ,1693262,1693262,1692926,336,360,utRho08
565,glnS,1411998,1412186,1411998,188,1114,utRho08
566,gloA,3455602,3455674,3455602,72,16,utRho08
567,gloB,469852,469852,469564,288,314,utRho08
568,glpA,4705166,4705294,4705166,128,0,utRho08
569,glpD,7123942,7124026,7123942,84,0,utRho08
570,glpE,7123698,7123698,7123646,52,0,utRho08
571,glpF,8236322,8236322,8236180,142,208,utRho08
572,glpG,7122960,7122960,7122904,56,244,utRho08
573,glpR,7121782,7121782,7121210,572,182,utRho08
574,glpT,4704902,4704902,4704748,154,298,utRho08
575,glpX,8231212,8231212,8231158,54,4100,utRho08
576,glrK,5382246,5382246,5382196,50,132,utRho08
577,gltA,1509534,1509534,1508936,598,10724,utRho08
578,gltB,6709018,6709264,6709018,246,48,utRho08
579,gltI,1375792,1375792,1375494,298,2216,utRho08
580,gltP,8588536,8588962,8588536,426,1046,utRho08
581,gltS,7657382,7657382,7657330,52,468,utRho08
582,gltX,5041568,5041568,5041344,224,4,utRho08
583,gluQ,320286,320286,320224,62,334,utRho08
584,glyA,5371148,5371148,5371014,134,200,utRho08
585,glyQ,7450708,7450708,7450636,72,138,utRho08
586,glyS,7448990,7448990,7448794,196,4392,utRho08
587,glyU,5998128,5998128,5998114,14,0,utRho08
588,glyV,8784626,8784720,8784626,94,86,utRho08
589,glyW,3984360,3984360,3984234,126,0,utRho08
590,gmhB,445612,445666,445612,54,0,utRho08
591,gmk,7642776,7642856,7642776,80,112,utRho08
592,gmr,2693686,2693686,2693484,202,0,utRho08
593,gnd,4202648,4202648,4202536,112,964,utRho08
594,gnsB,3275692,3275692,3275564,128,0,utRho08
595,gntK,14310580,14310580,14310368,212,0,utRho08
596,gntP,9102668,9102668,9102592,76,0,utRho08
597,gntR,7157760,7157760,7157452,308,452,utRho08
598,gntT,7092810,7093118,7092810,308,0,utRho08
599,gntU,7154170,7154170,7154122,48,0,utRho08
600,gntX,7089334,7089764,7089334,430,0,utRho08
601,gor,7292224,7292598,7292224,374,1078,utRho08
602,gpmA,1575340,1575340,1575190,150,0,utRho08
603,gpmM,7570374,7570520,7570374,146,0,utRho08
604,gpsA,7567620,7567620,7567322,298,11234,utRho08
605,gpt,511828,511954,511828,126,1030,utRho08
606,grcA,5433046,5433046,5432898,148,0,utRho08
607,greA,6657728,6657728,6657430,298,2658,utRho08
608,greB,7073488,7073624,7073488,136,0,utRho08
609,groL,8741566,8742050,8741566,484,1424,utRho08
610,groS,8741232,8741376,8741232,144,1280,utRho08
611,grpE,5501494,5501494,5501416,78,292,utRho08
612,grxA,1781552,1781552,1781506,46,0,utRho08
613,grxB,2248206,2248206,2248108,98,0,utRho08
614,grxC,7569152,7569152,7568884,268,8510,utRho08
615,grxD,3468324,3468324,3468202,122,21890,utRho08
616,gspA,6911268,6911268,6910796,472,0,utRho08
617,gspC,6910964,6911156,6910964,192,0,utRho08
618,gss,6277220,6277220,6277044,176,170,utRho08
619,gstA,3428654,3428754,3428654,100,0,utRho08
620,gstB,1761038,1761038,1760960,78,0,utRho08
621,guaB,5268214,5268214,5268140,74,224,utRho08
622,gudD,5839026,5839026,5838770,256,0,utRho08
623,gyrA,4678914,4678914,4678840,74,0,utRho08
624,gyrB,7760300,7760300,7760238,62,4,utRho08
625,hcaE,5337964,5338064,5337964,100,0,utRho08
626,hcaR,5337928,5337928,5337792,136,44,utRho08
627,hcaT,5336106,5336106,5335692,414,204,utRho08
628,hchA,4071260,4071670,4071260,410,0,utRho08
629,hcp,1828258,1828258,1827628,630,32,utRho08
630,hcr,1824400,1824400,1824300,100,0,utRho08
631,hdeA,7313582,7313582,7313480,102,0,utRho08
632,hdeD,7313920,7313990,7313920,70,0,utRho08
633,hdfR,7896320,7896320,7895934,386,64,utRho08
634,hdhA,3396244,3396244,3396080,164,0,utRho08
635,helD,2048876,2048942,2048876,66,0,utRho08
636,hemA,2527166,2527428,2527166,262,56,utRho08
637,hemB,779722,779722,779454,268,62,utRho08
638,hemF,5106410,5106450,5106410,40,0,utRho08
639,hemH,996062,996110,996062,48,0,utRho08
640,hemL,349882,349882,349764,118,10,utRho08
641,hemN,8103886,8104090,8103886,204,0,utRho08
642,hepA,127176,127176,126528,648,1628,utRho08
643,hflD,2385372,2385372,2385262,110,482,utRho08
644,hfq,8799602,8800576,8799602,974,2538,utRho08
645,hha,961006,961006,960616,390,0,utRho08
646,hicA,3018442,3018572,3018442,130,0,utRho08
647,higA,6468682,6468682,6468288,394,0,utRho08
648,higB,6468960,6468960,6468910,50,0,utRho08
649,hinT,2323642,2323770,2323642,128,0,utRho08
650,hipB,3184964,3184964,3184884,80,0,utRho08
651,hisB,4186720,4186936,4186720,216,474,utRho08
652,hisJ,4853674,4853674,4853576,98,2,utRho08
653,hisL,8359856,8359984,8359856,128,256,utRho08
654,hisS,5281284,5281284,5281150,134,48,utRho08
655,hlpA,400910,400964,400910,54,138,utRho08
656,hlyE,2460932,2460932,2460788,144,0,utRho08
657,hmp,5371594,5371670,5371594,76,0,utRho08
658,hns,2585916,2585916,2585844,72,2108,utRho08
659,hofM,7045856,7045856,7045502,354,0,utRho08
660,hokA,7441620,7441620,7441200,420,96,utRho08
661,hokC,33902,33902,33806,96,302,utRho08
662,hokE,1215462,1215672,1215462,210,0,utRho08
663,holC,8968546,8968546,8968560,14,690,utRho08
664,holD,9215562,9215606,9215562,44,0,utRho08
665,holE,3850040,3850216,3850040,176,304,utRho08
666,hpt,282720,282862,282720,142,0,utRho08
667,hrpB,324150,324210,324150,60,0,utRho08
668,hscB,5319048,5319048,5318934,114,516,utRho08
669,hscC,1367188,1367188,1366786,402,294,utRho08
670,hsdS,9163004,9163004,9162924,80,0,utRho08
671,hslJ,2883560,2883560,2883486,74,240,utRho08
672,hslO,7059344,7059548,7059344,204,7694,utRho08
673,hslR,7058220,7058696,7058220,476,1190,utRho08
674,hslV,8244708,8244708,8244574,134,116,utRho08
675,hsrA,7881412,7881412,7881224,188,0,utRho08
676,htgA,21286,21660,21286,374,70,utRho08
677,htpG,989634,990240,989634,606,4624,utRho08
678,htpX,3825236,3825236,3825152,84,0,utRho08
679,htrE,311036,311036,310852,184,0,utRho08
680,htrL,7587668,7587668,7587366,302,0,utRho08
681,hupA,8400352,8400562,8400352,210,262,utRho08
682,hupB,1845220,1845804,1845220,584,560,utRho08
683,hyaA,2063968,2064278,2063968,310,0,utRho08
684,hybO,6292726,6292726,6292522,204,524,utRho08
685,hycA,5700922,5700922,5700870,52,0,utRho08
686,hycI,5686204,5686204,5686086,118,0,utRho08
687,hydN,5676264,5676264,5676210,54,0,utRho08
688,hyfA,5202342,5202402,5202342,60,0,utRho08
689,hypA,11402508,11402588,11402508,80,0,utRho08
690,hypB,11403356,11404004,11403356,648,180,utRho08
691,hypF,5676210,5676210,5674850,1360,400,utRho08
692,hypT,9116634,9116634,9116578,56,120,utRho08
693,hyuA,6019660,6020056,6019660,396,0,utRho08
694,iaaA,1733074,1733136,1733074,62,0,utRho08
695,iadA,9119074,9119074,9119052,22,0,utRho08
696,iap,5753072,5753162,5753072,90,0,utRho08
697,ibaG,6673966,6673966,6673606,360,334,utRho08
698,ibpA,7735036,7735036,7734844,192,4,utRho08
699,ibpB,7733962,7733962,7733794,168,284,utRho08
700,icd,2389922,2390246,2389922,324,416,utRho08
701,iclR,8447304,8447304,8447256,48,16,utRho08
702,idi,6065876,6066130,6065876,254,0,utRho08
703,idnD,8988870,8988870,8988812,58,0,utRho08
704,idnK,8989194,8989246,8989194,52,0,utRho08
705,ihfA,3591442,3591442,3591104,338,584,utRho08
706,ihfB,1927498,1927656,1927498,158,1246,utRho08
707,ileS,43666,44782,43666,1116,5116,utRho08
708,ileX,6431194,6431196,6431194,2,0,utRho08
709,ilvA,15820940,15821324,15820940,384,0,utRho08
710,ilvC,7915824,7915940,7915824,116,0,utRho08
711,ilvE,15809552,15809936,15809552,384,784,utRho08
712,ilvI,170840,171260,170840,420,36,utRho08
713,ilvL,23701308,23701932,23701308,624,0,utRho08
714,ilvY,7915734,7915734,7915640,94,0,utRho08
715,inaA,4698998,4698998,4698944,54,48,utRho08
716,infA,1853370,1853370,1852886,484,3718,utRho08
717,infC,3602692,3602692,3601276,1416,4952,utRho08
718,insA-5,3958452,3958452,3958430,22,0,utRho08
719,insA-7,9036758,9037054,9036758,296,0,utRho08
720,insC-5,6372080,6372284,6372080,204,22,utRho08
721,insEF-2,785238,785238,785820,582,210,utRho08
722,insEF-4,2190310,2190310,2190892,582,172,utRho08
723,insG,9007098,9007098,9006862,236,0,utRho08
724,insH-1,550596,550596,550234,362,18,utRho08
725,insH-11,7306538,7306538,7306396,142,12,utRho08
726,insH-2,1151548,1151548,1151506,42,24,utRho08
727,insH-3,1378444,1378444,1378026,418,24,utRho08
728,insH-4,2791942,2792152,2791942,210,34,utRho08
729,insH-5,2857852,2857852,2857452,400,30,utRho08
730,insH-6,4135022,4135022,4134642,380,6,utRho08
731,insH-7,4206186,4206186,4205822,364,5338,utRho08
732,insH-9,6260050,6260356,6260050,306,16,utRho08
733,insI-3,9017372,9017372,9017234,138,0,utRho08
734,insJ,7441188,7441360,7441188,172,48,utRho08
735,insK,7442130,7442308,7442130,178,0,utRho08
736,insL-1,30760,30890,30760,130,394,utRho08
737,insL-2,1216112,1216130,1216112,18,24,utRho08
738,insL-3,5028644,5028662,5028644,18,168,utRho08
739,insN-1,540452,540484,540452,32,0,utRho08
740,intD,1132202,1132202,1131956,246,0,utRho08
741,intR,2826520,2826520,2826470,50,0,utRho08
742,intS,4933026,4933090,4933026,64,2,utRho08
743,intZ,5117386,5117542,5117386,156,64,utRho08
744,iraD,9113152,9113986,9113152,834,0,utRho08
745,iraM,2424246,2424246,2424006,240,0,utRho08
746,iraP,802638,802772,802638,134,0,utRho08
747,iscA,5319924,5319924,5319772,152,1996,utRho08
748,iscR,5324398,5324398,5324262,136,19142,utRho08
749,iscX,5313834,5313834,5313472,362,3058,utRho08
750,ispF,5743968,5743968,5743560,408,880,utRho08
751,ispG,5283908,5283908,5283608,300,1204,utRho08
752,ispU,389568,389806,389568,238,96,utRho08
753,isrA,2811502,2811502,2811618,116,0,utRho08
754,istr-1,7706384,7706384,7706384,0,0,utRho08
755,istr-2,7706514,7706514,7706514,0,0,utRho08
756,ivbL,15412092,15412092,15411952,140,368,utRho08
757,ivy,480638,480686,480638,48,0,utRho08
758,katE,3627628,3627734,3627628,106,0,utRho08
759,katG,8267624,8267670,8267624,46,0,utRho08
760,kbaZ,6557732,6557828,6557732,96,0,utRho08
761,kbl,7585154,7585154,7585102,52,490,utRho08
762,kch,2621046,2621046,2620538,508,100,utRho08
763,kdgR,3820506,3820506,3820198,308,0,utRho08
764,kdpE,1443788,1443788,1443466,322,0,utRho08
765,kdpF,1457698,1457698,1457642,56,0,utRho08
766,kdsA,2535708,2536330,2535708,622,1834,utRho08
767,kdsC,6683438,6684546,6683438,1108,1742,utRho08
768,kduI,5968388,5968388,5968248,140,718,utRho08
769,kefF,94160,94492,94160,332,0,utRho08
770,kgtP,5451624,5451624,5451492,132,78,utRho08
771,kup,7862206,7862632,7862206,426,176,utRho08
772,lacI,735076,735076,735020,56,0,utRho08
773,lacZ,1465508,1465508,1465220,288,160,utRho08
774,ldcA,2486394,2486394,2486160,234,0,utRho08
775,ldhA,2885830,2885830,2885686,144,0,utRho08
776,ldrA,2538954,2538954,2538550,404,318,utRho08
777,ldrB,2540024,2540024,2539620,404,92,utRho08
778,ldrC,2541092,2541092,2540690,402,208,utRho08
779,ldrD,7400544,7400544,7400174,370,62,utRho08
780,lepA,5414392,5414392,5414248,144,56,utRho08
781,lepB,5410928,5410928,5410618,310,1168,utRho08
782,leuD,159188,159188,158906,282,110,utRho08
783,leuE,3761600,3761600,3761518,82,0,utRho08
784,leuL,168048,168048,167416,632,0,utRho08
785,leuO,168308,168736,168308,428,276,utRho08
786,leuQ,9212864,9212864,9212802,62,0,utRho08
787,leuU,6644556,6644556,6644316,240,1864,utRho08
788,leuV,9212546,9212546,9212330,216,1432,utRho08
789,leuX,8992772,8992810,8992772,38,0,utRho08
790,lexA,8514174,8514230,8514174,56,26,utRho08
791,lhr,3456706,3458174,3456706,1468,2730,utRho08
792,ligA,5060402,5060402,5060352,50,0,utRho08
793,ligB,7642576,7642576,7642340,236,0,utRho08
794,lipA,1320602,1320602,1320432,170,100,utRho08
795,lipB,1324802,1324802,1324556,246,1612,utRho08
796,lit,2397032,2397390,2397032,358,256,utRho08
797,livJ,7199524,7199524,7199316,208,62,utRho08
798,livK,7195510,7195510,7195120,390,0,utRho08
799,lldP,7554578,7554798,7554578,220,4314,utRho08
800,lnt,1381968,1381968,1381762,206,336,utRho08
801,loiP,6163784,6163826,6163784,42,0,utRho08
802,lolA,1874656,1874738,1874656,82,82,utRho08
803,lolB,2527112,2527112,2527000,112,56,utRho08
804,lolC,2350748,2350854,2350748,106,0,utRho08
805,lon,917630,917776,917630,146,572,utRho08
806,lpcA,486936,487086,486936,150,0,utRho08
807,lpd,255434,255824,255434,390,2350,utRho08
808,lplA,9248476,9248476,9248234,242,1178,utRho08
809,lplT,5947878,5947878,5947724,154,0,utRho08
810,lpoA,6586422,6586800,6586422,378,454,utRho08
811,lpp,3514592,3514842,3514592,250,0,utRho08
812,lptA,6686598,6686760,6686598,162,892,utRho08
813,lptB,6686792,6687888,6686792,1096,1344,utRho08
814,lptD,114672,114672,114218,454,2816,utRho08
815,lptF,8972244,8972436,8972244,192,0,utRho08
816,lpxC,213016,213114,213016,98,11250,utRho08
817,lpxD,401920,401942,401920,22,4,utRho08
818,lpxL,2233418,2233418,2233164,254,0,utRho08
819,lpxM,3880456,3880456,3880386,70,158,utRho08
820,lpxP,4991156,4991290,4991156,134,130,utRho08
821,lrhA,4813312,4813312,4813282,30,0,utRho08
822,lrp,1864656,1865190,1864656,534,772,utRho08
823,lspA,50028,50414,50028,386,870,utRho08
824,lsrA,3202920,3202980,3202920,60,0,utRho08
825,lsrR,3202514,3202514,3202482,32,0,utRho08
826,ltaE,1818640,1818640,1818588,52,0,utRho08
827,luxS,5630130,5630130,5629466,664,1154,utRho08
828,lysA,5957902,5957902,5957798,104,0,utRho08
829,lysC,8467232,8467232,8466466,766,242,utRho08
830,lysP,4497120,4497120,4497064,56,0,utRho08
831,lysR,5957900,5958042,5957900,142,0,utRho08
832,lysT,1561028,1561108,1561028,80,230,utRho08
833,lysU,8709610,8709610,8709434,176,0,utRho08
834,macB,1840188,1840694,1840188,506,212,utRho08
835,maeA,3111484,3111484,3111338,146,4792,utRho08
836,mak,820236,820288,820236,52,66,utRho08
837,malE,8492928,8492928,8492838,90,0,utRho08
838,malI,3398456,3398456,3398360,96,0,utRho08
839,malK,8493472,8493568,8493472,96,0,utRho08
840,malP,7105020,7105020,7104946,74,294,utRho08
841,malQ,7100798,7100798,7100140,658,0,utRho08
842,malS,14949880,14949988,14949880,108,0,utRho08
843,malT,7106048,7106170,7106048,122,304,utRho08
844,malX,3398626,3398710,3398626,84,0,utRho08
845,malZ,1689980,1690072,1689980,92,968,utRho08
846,manA,3377102,3377152,3377102,50,0,utRho08
847,manX,3803866,3804096,3803866,230,0,utRho08
848,marC,3237882,3237882,3237816,66,0,utRho08
849,marR,3238186,3238240,3238186,54,122,utRho08
850,matP,2036918,2036970,2036918,52,102,utRho08
851,mazE,5822736,5822736,5822678,58,56,utRho08
852,mazG,5821720,5821720,5821370,350,2798,utRho08
853,mcbA,1684306,1684306,1684112,194,0,utRho08
854,mcbR,3040192,3040524,3040192,332,0,utRho08
855,mcrA,2420278,2420692,2420278,414,0,utRho08
856,mcrC,9156124,9156124,9155916,208,160,utRho08
857,mdaB,6344814,6345060,6344814,246,0,utRho08
858,mdfA,1767138,1767346,1767138,208,0,utRho08
859,mdh,6768940,6768940,6768536,404,0,utRho08
860,mdoB,9198988,9198988,9198882,106,1454,utRho08
861,mdoD,2993290,2993712,2993290,422,0,utRho08
862,mdoG,2218514,2218670,2218514,156,0,utRho08
863,mdtA,4307958,4308032,4307958,74,0,utRho08
864,mdtE,7318168,7318464,7318168,296,0,utRho08
865,mdtK,3486538,3486914,3486538,376,318,utRho08
866,mdtP,8602472,8602472,8602060,412,0,utRho08
867,melA,8683774,8683822,8683774,48,0,utRho08
868,melR,8683300,8683300,8683256,44,38,utRho08
869,menA,8240812,8240812,8240698,114,20,utRho08
870,menB,4753774,4753774,4753638,136,226,utRho08
871,mepH,3468714,3468870,3468714,156,0,utRho08
872,mepM,3883666,3883666,3883270,396,326,utRho08
873,mepS,4539840,4539958,4539840,118,322,utRho08
874,metA,8428318,8428560,8428318,242,0,utRho08
875,metB,8257272,8257344,8257272,72,1360,utRho08
876,metC,6304150,6304472,6304150,322,0,utRho08
877,metE,8025768,8026106,8025768,338,302,utRho08
878,metF,8265092,8265232,8265092,140,0,utRho08
879,metG,4388538,4388600,4388538,62,0,utRho08
880,metH,8447010,8447656,8447010,646,2090,utRho08
881,metJ,8257116,8257116,8256790,326,0,utRho08
882,metK,6173154,6173412,6173154,258,0,utRho08
883,metN,445428,445428,445290,138,8,utRho08
884,metR,8025710,8025710,8025632,78,0,utRho08
885,metT,1394326,1394326,1394266,60,116,utRho08
886,metY,19910250,19910250,19909734,516,498,utRho08
887,metZ,11789528,11789548,11789528,20,0,utRho08
888,mfd,2348056,2348056,2347928,128,160,utRho08
889,mglA,4478782,4478782,4478578,204,158,utRho08
890,mglB,4481132,4481132,4480696,436,9404,utRho08
891,mglC,4475918,4475918,4475506,412,72,utRho08
892,mgrB,3817584,3817584,3817532,52,0,utRho08
893,mgrR,3245828,3245828,3245828,0,0,utRho08
894,mgsA,2054082,2054082,2054030,52,2,utRho08
895,mgtL,8934560,8934862,8934560,302,0,utRho08
896,mhpA,737038,737222,737038,184,0,utRho08
897,mhpR,737072,737072,736840,232,0,utRho08
898,mhpT,750772,750918,750772,146,0,utRho08
899,miaA,8797964,8798504,8797964,540,386,utRho08
900,micA,5629604,5629604,5629604,0,0,utRho08
901,micC,2874242,2874238,2874242,4,0,utRho08
902,micF,4626168,4626168,4626168,0,0,utRho08
903,micM,1014408,1014408,1014408,0,0,utRho08
904,minE,2449422,2449422,2449090,332,1138,utRho08
905,mioC,7852950,7852950,7852910,40,0,utRho08
906,mipA,3733012,3733012,3732944,68,4092,utRho08
907,mlaA,4930270,4930270,4930014,256,0,utRho08
908,mlc,3337206,3337206,3337128,78,0,utRho08
909,mlrA,4429498,4429732,4429498,234,0,utRho08
910,mltA,5894546,5894546,5894356,190,0,utRho08
911,mltD,468050,468050,467910,140,0,utRho08
912,mltF,5391534,5391602,5391534,68,0,utRho08
913,mmuP,550238,550650,550238,412,18,utRho08
914,mngA,1531622,1531968,1531622,346,0,utRho08
915,mngR,1531852,1531852,1531750,102,0,utRho08
916,mnmG,7851348,7851348,7851266,82,1824,utRho08
917,mntH,5025470,5025470,5025412,58,0,utRho08
918,mntP,3810918,3811376,3810918,458,392,utRho08
919,mntR,1706160,1706366,1706160,206,0,utRho08
920,mntS,1706128,1706128,1705994,134,0,utRho08
921,moaA,1633654,1634088,1633654,434,296,utRho08
922,moaB,1635954,1636110,1635954,156,1520,utRho08
923,mobA,8084242,8084242,8083998,244,32,utRho08
924,mocA,6030112,6030320,6030112,208,0,utRho08
925,modA,1589990,1590178,1589990,188,84,utRho08
926,moeA,1732788,1732788,1732728,60,144,utRho08
927,mokB,2984610,2984610,2984258,352,252,utRho08
928,molR_1,4392888,4392948,4392888,60,0,utRho08
929,motA,3954604,3954604,3954278,326,52,utRho08
930,mpaA,2781278,2781278,2781196,82,14,utRho08
931,mpl,8911456,8911570,8911456,114,0,utRho08
932,mppA,2786108,2786454,2786108,346,0,utRho08
933,mprA,5621494,5621540,5621494,46,516,utRho08
934,mqo,4613848,4613848,4613508,340,68,utRho08
935,mqsA,6336742,6336742,6336492,250,304,utRho08
936,mqsR,6337306,6337306,6337088,218,226,utRho08
937,mraZ,179192,179268,179192,76,0,utRho08
938,mrcA,7045652,7045742,7045652,90,0,utRho08
939,mrcB,329442,329460,329442,18,0,utRho08
940,mreB,13605424,13605424,13604348,1076,2308,utRho08
941,mreD,6798166,6798166,6797750,416,274,utRho08
942,mrp,4388360,4388360,4388336,24,60,utRho08
943,mscK,972984,973072,972984,88,16,utRho08
944,mscL,6876002,6876048,6876002,46,116,utRho08
945,mscS,6139742,6139742,6139614,128,0,utRho08
946,msrA,8884522,8884522,8884352,170,132,utRho08
947,msrB,3725168,3725168,3724858,310,0,utRho08
948,msyB,2228426,2228426,2228362,64,276,utRho08
949,mtfA,4087236,4087302,4087236,66,2624,utRho08
950,mtgA,6699662,6699662,6699618,44,114,utRho08
951,mtlA,30177504,30178248,30177504,744,832,utRho08
952,mtn,358366,358366,358306,60,0,utRho08
953,mtr,6611864,6611864,6611634,230,36,utRho08
954,mug,6430992,6430992,6430946,46,0,utRho08
955,murQ,5091466,5091546,5091466,80,100,utRho08
956,murR,5091586,5091586,5091218,368,100,utRho08
957,mutH,5939164,5939324,5939164,160,166,utRho08
958,mutL,8794092,8794824,8794092,732,392,utRho08
959,mutM,7622554,7622554,7622304,250,1264,utRho08
960,mutS,5714038,5714186,5714038,148,812,utRho08
961,mutY,18617466,18618078,18617466,612,426,utRho08
962,nac,4123956,4123956,4123866,90,0,utRho08
963,nadA,1564122,1564170,1564122,48,0,utRho08
964,nadB,5420714,5420840,5420714,126,0,utRho08
965,nadC,237326,237326,237290,36,0,utRho08
966,nadE,3644604,3644916,3644604,312,0,utRho08
967,nadK,5501526,5501662,5501526,136,306,utRho08
968,nagA,1406350,1406350,1405502,848,3038,utRho08
969,nagB,1407416,1407416,1407222,194,2,utRho08
970,nagC,1404016,1404016,1403188,828,220,utRho08
971,nagE,1407680,1407888,1407680,208,0,utRho08
972,nagK,2357080,2357186,2357080,106,0,utRho08
973,nanA,6747240,6747240,6747152,88,0,utRho08
974,nanC,9079856,9079856,9079002,854,0,utRho08
975,nanR,6749406,6749406,6748978,428,78,utRho08
976,nanS,9075406,9075406,9075188,218,0,utRho08
977,napF,4607390,4607390,4606994,396,4,utRho08
978,narG,2559614,2559728,2559614,114,62,utRho08
979,narK,2555642,2555914,2555642,272,0,utRho08
980,narP,4580844,4581000,4580844,156,0,utRho08
981,narQ,5171154,5171462,5171154,308,0,utRho08
982,narU,3088326,3088326,3088120,206,0,utRho08
983,narW,3077374,3077374,3074618,2756,0,utRho08
984,narX,2555554,2555554,2555236,318,0,utRho08
985,narZ,3085380,3085380,3085180,200,0,utRho08
986,ndh,2331984,2332170,2331984,186,2,utRho08
987,ndk,5289920,5289920,5289728,192,70,utRho08
988,nemR,6904084,6904092,6904084,8,0,utRho08
989,nepI,7683542,7683542,7683478,64,22,utRho08
990,nfo,4501612,4501680,4501612,68,0,utRho08
991,nfsB,1210906,1210906,1210848,58,24,utRho08
992,nfuA,7090916,7091248,7090916,332,558,utRho08
993,nhaA,34634,34978,34634,344,0,utRho08
994,nhaB,2469534,2469534,2469434,100,0,utRho08
995,nhoA,3067926,3068048,3067926,122,0,utRho08
996,nikA,7226878,7227334,7226878,456,1874,utRho08
997,nikR,7237074,7237176,7237074,102,152,utRho08
998,nirB,6987974,6988022,6987974,48,0,utRho08
999,nlpA,7680034,7680034,7679986,48,0,utRho08
1000,nlpC,3585654,3585654,3585462,192,0,utRho08
1001,nlpD,5737658,5737658,5737506,152,64,utRho08
1002,nlpI,6618080,6618080,6617848,232,154,utRho08
1003,nmpC,1153740,1153740,1153650,90,0,utRho08
1004,nohA,3273206,3273206,3272734,472,0,utRho08
1005,norR,5664614,5664614,5664578,36,0,utRho08
1006,norV,5664878,5664952,5664878,74,0,utRho08
1007,nrdA,4689510,4689730,4689510,220,16514,utRho08
1008,nrdD,8925676,8925676,8925320,356,1174,utRho08
1009,nrdH,5601312,5601446,5601312,134,32,utRho08
1010,nrdR,865954,866004,865954,50,0,utRho08
1011,nrfA,8575342,8575528,8575342,186,0,utRho08
1012,nsrR,8812088,8812380,8812088,292,1880,utRho08
1013,nudB,3897348,3897348,3897264,84,0,utRho08
1014,nudC,8393428,8393806,8393428,378,28,utRho08
1015,nudE,7052658,7052658,7052298,360,1150,utRho08
1016,nudG,3682876,3682980,3682876,104,0,utRho08
1017,nudI,4729050,4729108,4729050,58,0,utRho08
1018,nudJ,2388874,2388874,2388576,298,1380,utRho08
1019,nuoA,4810670,4810670,4810144,526,7002,utRho08
1020,nuoN,4783434,4783434,4783010,424,824,utRho08
1021,nupC,5026018,5026084,5026018,66,0,utRho08
1022,nupG,6211302,6211428,6211302,126,0,utRho08
1023,ogrK,4335096,4335096,4335040,56,0,utRho08
1024,ogt,2800568,2800568,2800472,96,60,utRho08
1025,ohsC,5401036,5401040,5401036,4,0,utRho08
1026,ompA,2040382,2040382,2040106,276,29492,utRho08
1027,ompC,4625774,4625774,4625498,276,0,utRho08
1028,ompF,1974184,1974184,1973964,220,630,utRho08
1029,ompL,8128958,8128958,8128590,368,0,utRho08
1030,ompN,2874158,2874158,2873786,372,24,utRho08
1031,ompR,7073510,7073510,7073168,342,0,utRho08
1032,ompT,1171330,1171330,1171266,64,0,utRho08
1033,ompW,2627982,2628040,2627982,58,0,utRho08
1034,ompX,1700418,1700900,1700418,482,1188,utRho08
1035,omrA,5952378,5952378,5952378,0,0,utRho08
1036,omrB,5952770,5952770,5952770,0,0,utRho08
1037,oppA,2602170,2602364,2602170,194,13012,utRho08
1038,orn,8783168,8783208,8783168,40,0,utRho08
1039,osmB,2686952,2686952,2686656,296,98,utRho08
1040,osmC,3113192,3113250,3113192,58,0,utRho08
1041,osmE,3644566,3644566,3644512,54,0,utRho08
1042,osmF,4439046,4439046,4438962,84,1292,utRho08
1043,osmY,9222306,9222792,9222306,486,0,utRho08
1044,otsA,3963302,3963302,3963224,78,0,utRho08
1045,otsB,3964930,3964930,3964774,156,0,utRho08
1046,oxc,4984288,4984288,4983900,388,0,utRho08
1047,oxyR,8316914,8316980,8316914,66,156,utRho08
1048,oxyS,8316788,8316788,8316788,0,0,utRho08
1049,paaA,2907730,2907854,2907730,124,0,utRho08
1050,paaX,2927018,2927078,2927018,60,0,utRho08
1051,paaZ,2907340,2907340,2907284,56,0,utRho08
1052,pabA,6981702,6981702,6981658,44,0,utRho08
1053,pabB,3789256,3789610,3789256,354,72,utRho08
1054,pabC,2306186,2306600,2306186,414,160,utRho08
1055,pagP,1313052,1313114,1313052,62,0,utRho08
1056,panB,299260,299260,299202,58,0,utRho08
1057,panC,297840,297840,297590,250,304,utRho08
1058,panD,293490,293490,293388,102,158,utRho08
1059,panZ,7195656,7195968,7195656,312,102,utRho08
1060,parC,6332060,6332060,6331946,114,34,utRho08
1061,patA,6438916,6438988,6438916,72,0,utRho08
1062,patD,3030830,3031156,3030830,326,0,utRho08
1063,pbpC,5294986,5294986,5294650,336,0,utRho08
1064,pbpG,4450132,4450132,4449740,392,172,utRho08
1065,pck,7065358,7065636,7065358,278,5622,utRho08
1066,pcnB,318782,318782,318252,530,928,utRho08
1067,pdhR,244068,244184,244068,116,0,utRho08
1068,pdxB,4875768,4875768,4875702,66,0,utRho08
1069,pdxH,3436068,3436068,3436014,54,630,utRho08
1070,pdxJ,5403626,5403626,5403458,168,396,utRho08
1071,pdxK,5074638,5074638,5074474,164,0,utRho08
1072,pepA,8972278,8972278,8971902,376,264,utRho08
1073,pepD,511618,511618,511432,186,4990,utRho08
1074,pepN,1981182,1981244,1981182,62,94,utRho08
1075,pepQ,8062294,8062322,8062294,28,24,utRho08
1076,pepT,2371646,2371688,2371646,42,0,utRho08
1077,pfkA,8214948,8215104,8214948,156,376,utRho08
1078,pfkB,3612646,3612740,3612646,94,0,utRho08
1079,pflA,1902456,1902456,1902160,296,102,utRho08
1080,pflB,1907850,1907850,1907108,742,536,utRho08
1081,pflD,8287716,8287990,8287716,274,66,utRho08
1082,pgaA,2185046,2185046,2184578,468,0,utRho08
1083,pgi,8467444,8467516,8467444,72,0,utRho08
1084,pgk,12291428,12291428,12290488,940,2892,utRho08
1085,pgl,1597078,1597172,1597078,94,80,utRho08
1086,pgpB,2678324,2678660,2678324,336,0,utRho08
1087,pgpC,5397276,5397276,5397100,176,0,utRho08
1088,pgrR,2783744,2783982,2783744,238,0,utRho08
1089,pheL,5475158,5475198,5475158,40,0,utRho08
1090,pheM,7197204,7197204,7197080,124,96,utRho08
1091,pheP,1203858,1203918,1203858,60,0,utRho08
1092,pheU,8725254,8725254,8725252,2,0,utRho08
1093,pheV,6220730,6220732,6220730,2,0,utRho08
1094,phnC,8650412,8650412,8650330,82,0,utRho08
1095,phoA,803414,803494,803414,80,0,utRho08
1096,phoB,834202,834284,834202,82,0,utRho08
1097,phoE,520316,520316,520200,116,0,utRho08
1098,phoH,2169730,2169984,2169730,254,0,utRho08
1099,phoP,2381016,2381016,2380894,122,1332,utRho08
1100,phoQ,2379880,2379880,2379552,328,1052,utRho08
1101,phoU,7815330,7815330,7815156,174,334,utRho08
1102,phr,1478842,1479014,1478842,172,4,utRho08
1103,pinE,2419054,2419370,2419054,316,0,utRho08
1104,pinQ,3267168,3267244,3267168,76,0,utRho08
1105,pinR,2867424,2867424,2867348,76,0,utRho08
1106,pitA,7275224,7275284,7275224,60,0,utRho08
1107,pitB,6272806,6272806,6272742,64,0,utRho08
1108,pka,5439862,5439906,5439862,44,0,utRho08
1109,plaP,4174476,4174476,4174124,352,1958,utRho08
1110,pldA,8009628,8009724,8009628,96,58,utRho08
1111,pldB,8018028,8018340,8018028,312,100,utRho08
1112,plsB,8513196,8513196,8512932,264,108,utRho08
1113,pmbA,8915890,8915918,8915890,28,0,utRho08
1114,pmrD,4747148,4747148,4747076,72,0,utRho08
1115,pncB,1980828,1980828,1980712,116,0,utRho08
1116,pncC,5648788,5648788,5648692,96,0,utRho08
1117,pnp,6622652,6622652,6622336,316,76,utRho08
1118,pntA,3355950,3355950,3355806,144,0,utRho08
1119,pntB,3353096,3353096,3352720,376,0,utRho08
1120,polA,8093880,8093932,8093880,52,212,utRho08
1121,polB,131606,131606,131560,46,0,utRho08
1122,potD,2365700,2365700,2365658,42,0,utRho08
1123,potE,1436688,1436688,1436530,158,0,utRho08
1124,potF,1787268,1787568,1787268,300,0,utRho08
1125,poxB,1822152,1822152,1822098,54,0,utRho08
1126,ppa,8899372,8899372,8899304,68,376,utRho08
1127,ppc,8306380,8306380,8306196,184,138,utRho08
1128,ppdA,5928440,5928440,5928354,86,104,utRho08
1129,ppdD,235410,235410,235098,312,0,utRho08
1130,pphA,3846770,3846770,3845938,832,2214,utRho08
1131,pphB,5719474,5719520,5719474,46,0,utRho08
1132,ppiA,6984898,6984898,6984594,304,0,utRho08
1133,ppiC,7919682,7919682,7919626,56,24,utRho08
1134,ppiD,923638,923830,923638,192,1440,utRho08
1135,ppk,5245748,5246088,5245748,340,588,utRho08
1136,pppA,6228958,6228958,6228704,254,0,utRho08
1137,ppsA,3574322,3574322,3574224,98,0,utRho08
1138,ppsR,3574678,3574890,3574678,212,0,utRho08
1139,pptA,3065716,3066104,3065716,388,0,utRho08
1140,pqiA,2023318,2024002,2023318,684,36,utRho08
1141,prc,3830054,3830054,3829632,422,35896,utRho08
1142,preT,4467978,4468066,4467978,88,0,utRho08
1143,prfC,9218688,9218828,9218688,140,904,utRho08
1144,prkB,6968622,6968980,6968622,358,1052,utRho08
1145,prlC,7290476,7290476,7290364,112,200,utRho08
1146,prlF,6553944,6554004,6553944,60,0,utRho08
1147,proB,520432,520776,520432,344,0,utRho08
1148,proC,811372,811372,811288,84,0,utRho08
1149,proK,7417388,7417388,7417384,4,0,utRho08
1150,proL,4572414,4572422,4572414,8,64,utRho08
1151,proP,8660640,8661004,8660640,364,102,utRho08
1152,proS,437674,437674,437550,124,682,utRho08
1153,proV,5609126,5609630,5609126,504,198,utRho08
1154,prpB,697292,697364,697292,72,0,utRho08
1155,prpR,696942,696942,696886,56,0,utRho08
1156,prs,2524354,2524354,2523750,604,76456,utRho08
1157,psd,8781276,8781276,8780720,556,2414,utRho08
1158,psiE,8480600,8480650,8480600,50,0,utRho08
1159,pspA,2736076,2736158,2736076,82,0,utRho08
1160,pspF,2736080,2736080,2735824,256,0,utRho08
1161,pspG,8525632,8525680,8525632,48,0,utRho08
1162,pssA,5445156,5445454,5445156,298,2228,utRho08
1163,pstB,7817112,7817112,7816732,380,50,utRho08
1164,pstC,7821084,7821084,7820796,288,0,utRho08
1165,pstS,23469408,23469408,23469150,258,0,utRho08
1166,psuG,4517114,4517114,4516734,380,396,utRho08
1167,psuT,4514992,4514992,4514670,322,32,utRho08
1168,pth,2517084,2517084,2517026,58,62,utRho08
1169,ptrA,5918022,5918022,5917768,254,0,utRho08
1170,ptrB,3857730,3857730,3857678,52,912,utRho08
1171,ptsG,2315252,2315738,2315252,486,2158,utRho08
1172,ptsH,5066996,5067528,5066996,532,4650,utRho08
1173,purA,8809328,8809374,8809328,46,0,utRho08
1174,purC,5195562,5195562,5195236,326,0,utRho08
1175,purD,8411972,8411972,8411862,110,52,utRho08
1176,purE,1106284,1106284,1106200,84,1038,utRho08
1177,purH,8415254,8415254,8415064,190,16,utRho08
1178,purL,5391178,5391178,5391086,92,576,utRho08
1179,purM,5242306,5242394,5242306,88,0,utRho08
1180,purR,3475378,3475688,3475378,310,198,utRho08
1181,purT,3861438,3861762,3861438,324,0,utRho08
1182,purU,2577512,2577512,2577248,264,440,utRho08
1183,putA,2157850,2157850,2157764,86,0,utRho08
1184,putP,2158336,2158610,2158336,274,570,utRho08
1185,puuA,2721936,2721936,2721816,120,0,utRho08
1186,puuC,2725456,2725486,2725456,30,0,utRho08
1187,puuD,2722104,2722240,2722104,136,0,utRho08
1188,puuP,2718746,2718746,2718374,372,114,utRho08
1189,pykA,3874988,3875298,3874988,310,376,utRho08
1190,pykF,3510934,3511396,3510934,462,382,utRho08
1191,pyrC,2245286,2245286,2245214,72,72,utRho08
1192,pyrD,2009464,2009536,2009464,72,0,utRho08
1193,pyrE,7631970,7631970,7631536,434,0,utRho08
1194,pyrF,2683740,2683842,2683740,102,470,utRho08
1195,pyrG,5819594,5819594,5819332,262,866,utRho08
1196,pyrH,383624,383710,383624,86,2084,utRho08
1197,pyrL,8945490,8945490,8945066,424,96,utRho08
1198,qmcA,1031646,1031646,1031546,100,0,utRho08
1199,qor,8528608,8528608,8528462,146,194,utRho08
1200,qseB,6339502,6339656,6339502,154,0,utRho08
1201,queA,849970,850022,849970,52,418,utRho08
1202,queE,5811212,5811212,5810836,376,0,utRho08
1203,queF,5850642,5850696,5850642,54,0,utRho08
1204,queG,8788184,8788184,8788134,50,1152,utRho08
1205,racC,2835630,2835630,2835526,104,0,utRho08
1206,racR,2840898,2840898,2840482,416,0,utRho08
1207,raiA,5474208,5474308,5474208,100,0,utRho08
1208,rarD,8008594,8008594,8008356,238,144,utRho08
1209,ravA,7862256,7862256,7862186,70,62,utRho08
1210,rayT,495088,495274,495088,186,0,utRho08
1211,rbn,4763162,4763216,4763162,54,0,utRho08
1212,rbsD,7866644,7866702,7866644,58,0,utRho08
1213,rcnA,4371654,4371834,4371654,180,0,utRho08
1214,rcnB,4373768,4373920,4373768,152,0,utRho08
1215,rcnR,4371806,4371806,4371592,214,0,utRho08
1216,rcsA,4047672,4047936,4047672,264,122,utRho08
1217,rcsB,4631390,4632354,4631390,964,2264,utRho08
1218,rcsC,4640162,4640162,4639656,506,158,utRho08
1219,rcsD,4626904,4626976,4626904,72,0,utRho08
1220,rdgB,6193240,6193362,6193240,122,834,utRho08
1221,rdlA,2538646,2538646,2538646,0,0,utRho08
1222,rdlB,2539712,2539716,2539712,4,0,utRho08
1223,rdlC,2540782,2540786,2540782,4,0,utRho08
1224,rdlD,7400272,7400272,7400272,0,0,utRho08
1225,rdoA,8084782,8084830,8084782,48,0,utRho08
1226,recA,11295276,11295276,11295076,200,424,utRho08
1227,recC,5925014,5925014,5924856,158,66,utRho08
1228,recF,7763722,7763722,7762442,1280,8652,utRho08
1229,recN,5503518,5503590,5503518,72,0,utRho08
1230,recQ,8011666,8011728,8011666,62,0,utRho08
1231,relA,5828554,5828554,5827302,1252,470,utRho08
1232,relB,3291806,3291806,3291744,62,0,utRho08
1233,rem,3289950,3289950,3289804,146,0,utRho08
1234,rep,7921294,7921354,7921294,60,12,utRho08
1235,rfaD,7587730,7587974,7587730,244,0,utRho08
1236,rfaE,6393852,6393852,6393506,346,0,utRho08
1237,rfaH,8049930,8049930,8049642,288,400,utRho08
1238,rfbX,4219436,4219436,4219168,268,2014,utRho08
1239,rfe,7935600,7935832,7935600,232,116,utRho08
1240,rhaB,8194944,8194944,8194896,48,0,utRho08
1241,rhaD,8188770,8188770,8188544,226,0,utRho08
1242,rhaS,8195422,8195472,8195422,50,0,utRho08
1243,rhaT,8201132,8201132,8201050,82,0,utRho08
1244,rhlE,1661566,1661744,1661566,178,304,utRho08
1245,rhoL,47593944,47594772,47593944,828,81276,utRho08
1246,rhsB,7238006,7238384,7238006,378,0,utRho08
1247,rhsC,1458758,1459166,1458758,408,0,utRho08
1248,rhsD,1046132,1046522,1046132,390,0,utRho08
1249,rhtA,1700608,1700608,1700194,414,0,utRho08
1250,rhtC,8015478,8015514,8015478,36,1128,utRho08
1251,ribA,2678468,2678468,2678320,148,0,utRho08
1252,ribC,3486916,3486916,3486484,432,318,utRho08
1253,ribE,869008,869294,869008,286,8230,utRho08
1254,ribF,42766,42814,42766,48,0,utRho08
1255,ridA,8941892,8941892,8941826,66,0,utRho08
1256,rihA,1369204,1369204,1368824,380,84,utRho08
1257,rihB,4510504,4510504,4510372,132,70,utRho08
1258,rimJ,2251044,2251124,2251044,80,0,utRho08
1259,rimK,1783752,1783934,1783752,182,312,utRho08
1260,rimL,2997486,2997876,2997486,390,224,utRho08
1261,rimO,1756140,1756140,1756070,70,14,utRho08
1262,rimP,6636350,6636350,6636012,338,808,utRho08
1263,rlmA,3814172,3814172,3814120,52,102,utRho08
1264,rlmD,5830086,5830086,5830000,86,0,utRho08
1265,rlmE,6655520,6655520,6655328,192,2086,utRho08
1266,rlmF,1684384,1684664,1684384,280,0,utRho08
1267,rlmG,6471784,6471784,6471750,34,0,utRho08
1268,rlmI,2060002,2060002,2059938,64,4,utRho08
1269,rlmJ,7290700,7290770,7290700,70,180,utRho08
1270,rlmL,2015344,2015688,2015344,344,536,utRho08
1271,rlpA,1330444,1330444,1330380,64,82,utRho08
1272,rluA,120900,120900,120692,208,718,utRho08
1273,rluF,8460324,8460708,8460324,384,0,utRho08
1274,rmf,2031006,2031430,2031006,424,310,utRho08
1275,rna,1290068,1290068,1290006,62,0,utRho08
1276,rnb,2698258,2698258,2697824,434,1360,utRho08
1277,rnc,10816892,10816892,10816252,640,7256,utRho08
1278,rnd,3776122,3776122,3775982,140,34,utRho08
1279,rne,2289746,2289746,2288734,1012,9480,utRho08
1280,rnhA,472082,472082,472004,78,478,utRho08
1281,rnk,1288360,1288360,1287934,426,56,utRho08
1282,rnlA,5531788,5531836,5531788,48,0,utRho08
1283,rnlB,5533414,5533968,5533414,554,502,utRho08
1284,rnpB,19623552,19623552,19623552,0,0,utRho08
1285,rob,9270706,9270706,9270620,86,56,utRho08
1286,rodZ,5285868,5285868,5285688,180,26,utRho08
1287,rpe,7030306,7030306,7030118,188,246,utRho08
1288,rph,15266320,15266320,15266196,124,0,utRho08
1289,rpiA,6118706,6118706,6118650,56,46,utRho08
1290,rpiB,8626514,8626700,8626514,186,0,utRho08
1291,rpiR,8626274,8626274,8625982,292,0,utRho08
1292,rplJ,8359246,8359992,8359246,746,13504,utRho08
1293,rplK,8356708,8356894,8356708,186,968,utRho08
1294,rplM,6757344,6757344,6757302,42,15816,utRho08
1295,rplN,6896444,6896444,6896298,146,12016,utRho08
1296,rplS,5489284,5489284,5489060,224,30446,utRho08
1297,rplT,7199052,7199052,7198996,56,1000,utRho08
1298,rplU,6667036,6667036,6666902,134,116,utRho08
1299,rplY,4564866,4565034,4564866,168,298,utRho08
1300,rpmA,6666450,6666450,6666238,212,1210,utRho08
1301,rpmB,15247980,15247980,15246696,1284,241696,utRho08
1302,rpmE,8253816,8254026,8253816,210,1026,utRho08
1303,rpmF,2294676,2294734,2294676,58,80744,utRho08
1304,rpmH,7768130,7768672,7768130,542,8466,utRho08
1305,rpmI,3600854,3600854,3599998,856,14622,utRho08
1306,rpoB,8362126,8362490,8362126,364,750,utRho08
1307,rpoD,6424946,6426094,6424946,1148,18072,utRho08
1308,rpoE,5420372,5420372,5420024,348,0,utRho08
1309,rpoH,7202006,7202006,7201566,440,3222,utRho08
1310,rpoN,6689324,6689434,6689324,110,0,utRho08
1311,rpoS,5736236,5736236,5735102,1134,2664,utRho08
1312,rpoZ,7644154,7644212,7644154,58,1134,utRho08
1313,rppH,5937986,5937986,5937954,32,0,utRho08
1314,rprA,3540744,3540744,3540744,0,0,utRho08
1315,rpsA,1923434,1923990,1923434,556,238240,utRho08
1316,rpsF,8850050,8850236,8850050,186,61468,utRho08
1317,rpsI,6756580,6756580,6756414,166,12538,utRho08
1318,rpsJ,6906884,6906884,6906540,344,11818,utRho08
1319,rpsL,6949242,6949242,6949104,138,818,utRho08
1320,rpsM,6885130,6885130,6884942,188,2716,utRho08
1321,rpsO,13247144,13247144,13246736,408,2212,utRho08
1322,rpsP,5492508,5492508,5492370,138,234,utRho08
1323,rpsT,42420,42420,42156,264,550,utRho08
1324,rpsU,12842584,12843124,12842584,540,4200,utRho08
1325,rraA,8238716,8238716,8238660,56,372,utRho08
1326,rraB,8956768,8956946,8956768,178,28,utRho08
1327,rrsA,8070478,8071062,8070478,584,11514,utRho08
1328,rrsB,16665468,16666636,16665468,1168,23504,utRho08
1329,rrsC,7883032,7883616,7883032,584,13068,utRho08
1330,rrsD,6858094,6858094,6857524,570,562,utRho08
1331,rrsE,8415726,8416294,8415726,568,2042,utRho08
1332,rrsG,5462896,5462896,5462314,582,10050,utRho08
1333,rrsH,446970,447542,446970,572,2022,utRho08
1334,rsd,8393908,8393908,8393616,292,56,utRho08
1335,rseA,5419264,5419264,5418808,456,204,utRho08
1336,rseP,392940,393092,392940,152,0,utRho08
1337,rseX,4067298,4067298,4067298,0,0,utRho08
1338,rsfS,1338144,1338144,1338072,72,600,utRho08
1339,rsgA,8783132,8783132,8783018,114,138,utRho08
1340,rsmA,105176,105176,104860,316,2322,utRho08
1341,rsmB,6869982,6870414,6869982,432,204,utRho08
1342,rsmC,9215736,9215736,9215400,336,436,utRho08
1343,rsmD,7208594,7208786,7208594,192,0,utRho08
1344,rsmE,6182036,6182268,6182036,232,254,utRho08
1345,rsmG,7847512,7847512,7847360,152,526,utRho08
1346,rsmH,180020,180188,180020,168,604,utRho08
1347,rsmI,6587106,6587106,6586670,436,1206,utRho08
1348,rssA,2578212,2578412,2578212,200,330,utRho08
1349,rssB,2580440,2580484,2580440,44,136,utRho08
1350,rstA,3364276,3364300,3364276,24,0,utRho08
1351,rsuA,4561096,4561096,4560966,130,194,utRho08
1352,rsxA,3411510,3411534,3411510,24,0,utRho08
1353,rtcA,7114004,7114004,7113698,306,0,utRho08
1354,rtcB,7116214,7116214,7116158,56,0,utRho08
1355,rtn,4541356,4541452,4541356,96,60,utRho08
1356,rutA,2148052,2148052,2148022,30,0,utRho08
1357,rutG,2140090,2140090,2139678,412,0,utRho08
1358,rutR,2148226,2148484,2148226,258,0,utRho08
1359,ruvA,7784096,7784096,7783904,192,0,utRho08
1360,ruvB,7782176,7782176,7781424,752,732,utRho08
1361,ruvC,3894878,3894878,3894752,126,0,utRho08
1362,rybB,1776114,1776114,1776114,0,0,utRho08
1363,rydB,3529860,3529860,3529322,538,80,utRho08
1364,rydC,2983012,2983012,2983012,0,0,utRho08
1365,ryfA,5307398,5307710,5307398,312,0,utRho08
1366,ryfD,5468590,5468590,5468590,0,0,utRho08
1367,ryhB,7162032,7162032,7162032,0,0,utRho08
1368,ryjA,8556132,8556132,8556132,0,0,utRho08
1369,ryjB,9055954,9055954,9055954,0,0,utRho08
1370,sad,3229598,3229598,3229406,192,0,utRho08
1371,safA,3168056,3168056,3167918,138,0,utRho08
1372,sanA,4465368,4465756,4465368,388,0,utRho08
1373,sapF,2705314,2705314,2705268,46,62,utRho08
1374,sbcB,4165456,4165512,4165456,56,0,utRho08
1375,sbcC,831694,831694,831506,188,184,utRho08
1376,sbcD,833954,833954,833904,50,86,utRho08
1377,sbmA,793106,793278,793106,172,0,utRho08
1378,sbmC,4162650,4162650,4162524,126,0,utRho08
1379,sdaA,3793618,3793864,3793618,246,16,utRho08
1380,sdaC,5856070,5856458,5856070,388,2342,utRho08
1381,sdhC,1509916,1510354,1509916,438,58956,utRho08
1382,sdhD,1510808,1511120,1510808,312,11938,utRho08
1383,sdiA,3993834,3993834,3993664,170,292,utRho08
1384,secE,8354354,8354716,8354354,362,0,utRho08
1385,secG,6645180,6645180,6645010,170,916,utRho08
1386,selA,7522594,7522594,7522498,96,754,utRho08
1387,selB,7519850,7519850,7519722,128,324,utRho08
1388,selC,7672396,7672444,7672396,48,0,utRho08
1389,selD,3696058,3696058,3696016,42,2564,utRho08
1390,seqA,1425884,1425974,1425884,90,794,utRho08
1391,serA,6117098,6117098,6116820,278,0,utRho08
1392,serB,9249712,9249790,9249712,78,134,utRho08
1393,serC,3830380,3830612,3830380,232,0,utRho08
1394,serS,1878730,1878856,1878730,126,1392,utRho08
1395,serT,2063438,2063438,2063424,14,0,utRho08
1396,serU,4087124,4087124,4087114,10,202,utRho08
1397,serV,5637394,5637394,5637290,104,0,utRho08
1398,serW,1852014,1852014,1851942,72,188,utRho08
1399,serX,2195352,2195352,2195304,48,20,utRho08
1400,setB,4527426,4527726,4527426,300,0,utRho08
1401,setC,7673488,7673906,7673488,418,2,utRho08
1402,sfmA,1116124,1116424,1116124,300,0,utRho08
1403,sfmC,1117606,1117948,1117606,342,0,utRho08
1404,sfsA,323030,323030,322972,58,298,utRho08
1405,sfsB,6669592,6669818,6669592,226,182,utRho08
1406,sgrR,154676,154676,154598,78,0,utRho08
1407,sgrS,154734,154734,154734,0,0,utRho08
1408,shiA,4107068,4107286,4107068,218,0,utRho08
1409,sibA,4306622,4306622,4306622,0,0,utRho08
1410,sibB,4307292,4307292,4307292,0,0,utRho08
1411,sibC,6113702,6113702,6113702,0,0,utRho08
1412,sibD,6389730,6389730,6389730,0,0,utRho08
1413,sibE,6390480,6390480,6390480,0,0,utRho08
1414,sixA,4913998,4913998,4913624,374,0,utRho08
1415,slp,7307872,7307922,7307872,50,0,utRho08
1416,slt,9261400,9261466,9261400,66,0,utRho08
1417,slyA,3442028,3442028,3441648,380,0,utRho08
1418,slyB,3439496,3439752,3439496,256,0,utRho08
1419,slyD,6957398,6957398,6956994,404,204,utRho08
1420,slyX,6954862,6955280,6954862,418,10878,utRho08
1421,smf,6867372,6867372,6867120,252,0,utRho08
1422,smpB,5509534,5509792,5509534,258,922,utRho08
1423,smrA,2811872,2811958,2811872,86,0,utRho08
1424,smrB,4896872,4897212,4896872,340,22,utRho08
1425,smtA,1946808,1947074,1946808,266,0,utRho08
1426,sodA,8201518,8201620,8201518,102,15780,utRho08
1427,sodB,3470646,3470756,3470646,110,104,utRho08
1428,sodC,3449358,3449358,3449310,48,0,utRho08
1429,sohB,2658568,2658664,2658568,96,0,utRho08
1430,sokB,2984232,2984238,2984232,6,54,utRho08
1431,solA,2241218,2241218,2241172,46,66,utRho08
1432,soxR,8554894,8554938,8554894,44,0,utRho08
1433,soxS,8554846,8554846,8554766,80,0,utRho08
1434,speA,6172096,6172096,6171822,274,546,utRho08
1435,speB,6167892,6167892,6167594,298,132,utRho08
1436,speC,6218350,6218350,6218310,40,0,utRho08
1437,spf,8099798,8099798,8099798,0,0,utRho08
1438,sppA,3697422,3697674,3697422,252,0,utRho08
1439,spy,3651376,3651376,3651250,126,0,utRho08
1440,sra,3112092,3112092,3111926,166,0,utRho08
1441,sraB,2293178,2293178,2293178,0,0,utRho08
1442,sraC,3846132,3846132,3846132,0,0,utRho08
1443,srlA,5651582,5651664,5651582,82,92,utRho08
1444,srlR,5657720,5658094,5657720,374,852,utRho08
1445,srmB,5425752,5425792,5425752,40,0,utRho08
1446,sroA,151216,151216,151216,0,0,utRho08
1447,sroG,6369436,6369436,6369436,0,0,utRho08
1448,sroH,8380974,8380974,8380974,0,0,utRho08
1449,ssb,8548022,8548250,8548022,228,12,utRho08
1450,sseA,5304782,5304988,5304782,206,13134,utRho08
1451,sspA,6755138,6755138,6754840,298,1432,utRho08
1452,ssrA,5511014,5511186,5511014,172,2,utRho08
1453,ssrS,12223036,12223932,12223036,896,796,utRho08
1454,sstT,6479726,6479888,6479726,162,0,utRho08
1455,ssuB,1988282,1988282,1988088,194,0,utRho08
1456,ssuE,1995126,1995126,1995024,102,0,utRho08
1457,sthA,8321604,8321604,8321580,24,974,utRho08
1458,stpA,5597156,5597156,5596990,166,0,utRho08
1459,sucA,3034344,3034824,3034344,480,2952,utRho08
1460,sufA,3528836,3528836,3528772,64,0,utRho08
1461,sufE,3518962,3518962,3518580,382,106,utRho08
1462,sugE,8753588,8753750,8753588,162,110,utRho08
1463,sulA,2041894,2041894,2041838,56,174,utRho08
1464,syd,5850738,5850738,5850560,178,42,utRho08
1465,symE,9159834,9159834,9159680,154,0,utRho08
1466,symR,9159670,9159670,9159670,0,0,utRho08
1467,tabA,8949566,8949724,8949566,158,0,utRho08
1468,talA,5157140,5157332,5157140,192,0,utRho08
1469,talB,16382,16476,16382,94,14040,utRho08
1470,tam,3214442,3214692,3214442,250,60,utRho08
1471,tamA,8884540,8884764,8884540,224,22,utRho08
1472,tar,3945432,3945432,3945382,50,62,utRho08
1473,tas,5943138,5943194,5943138,56,172,utRho08
1474,tatA,16087636,16087780,16087636,144,188,utRho08
1475,tatE,1317742,1317894,1317742,152,0,utRho08
1476,tauA,770410,770464,770410,54,0,utRho08
1477,tdcA,6534186,6534186,6534130,56,0,utRho08
1478,tdcG,6519652,6519652,6519298,354,84,utRho08
1479,tdcR,6534380,6534760,6534380,380,0,utRho08
1480,tdk,2586986,2587054,2586986,68,0,utRho08
1481,tehA,3001072,3001146,3001072,74,0,utRho08
1482,tesA,1039898,1039898,1039530,368,300,utRho08
1483,tesB,950402,950402,950322,80,0,utRho08
1484,tfaE,2418532,2418532,2418238,294,0,utRho08
1485,tfaQ,3269912,3269912,3269770,142,0,utRho08
1486,tff,379424,379256,379424,168,0,utRho08
1487,tgt,852110,852274,852110,164,0,utRho08
1488,thiD,4369346,4369346,4369032,314,0,utRho08
1489,thiI,882936,883098,882936,162,770,utRho08
1490,thiM,4370902,4370902,4370602,300,308,utRho08
1491,thiQ,146170,146170,145854,316,186,utRho08
1492,thrL,592,760,592,168,168,utRho08
1493,thrS,7210932,7210932,7210280,652,1316,utRho08
1494,thrU,8350762,8350776,8350762,14,0,utRho08
1495,thrV,6847414,6847414,6847310,104,324938,utRho08
1496,thrW,525682,525742,525682,60,0,utRho08
1497,thyA,5930696,5930696,5930310,386,2920,utRho08
1498,tig,909986,910266,909986,280,1806,utRho08
1499,tisB,7706674,7707106,7706674,432,72,utRho08
1500,tktA,6163414,6163414,6163270,144,512,utRho08
1501,tktB,5158616,5159272,5158616,656,360,utRho08
1502,tldD,6784368,6784368,6784056,312,0,utRho08
1503,tmcA,5191876,5191876,5191718,158,0,utRho08
1504,tnaC,15553644,15553740,15553644,96,792,utRho08
1505,tolB,1555074,1555480,1555074,406,176,utRho08
1506,tolC,6356008,6356230,6356008,222,940,utRho08
1507,tomB,961588,961588,961416,172,706,utRho08
1508,tonB,2622108,2622178,2622108,70,0,utRho08
1509,topA,2661578,2662096,2661578,518,736,utRho08
1510,torC,2116112,2116168,2116112,56,108,utRho08
1511,torR,2115968,2115968,2115908,60,372,utRho08
1512,torS,2112364,2112364,2112356,8,0,utRho08
1513,torT,2112414,2112522,2112414,108,0,utRho08
1514,tpiA,8223138,8223138,8223014,124,186,utRho08
1515,tppB,3425342,3425538,3425342,196,11270,utRho08
1516,tpr,2574376,2574376,2574376,0,0,utRho08
1517,tpx,2777688,2777688,2777622,66,684,utRho08
1518,tqsA,3347780,3347826,3347780,46,0,utRho08
1519,treA,2494850,2494850,2494752,98,0,utRho08
1520,treB,8932420,8932420,8932360,60,0,utRho08
1521,treF,7339102,7339184,7339102,82,0,utRho08
1522,treR,8934694,8934694,8934492,202,0,utRho08
1523,trg,2984878,2984940,2984878,62,0,utRho08
1524,trkG,2847342,2847564,2847342,222,16,utRho08
1525,trmA,8326590,8326590,8326540,50,100,utRho08
1526,trpA,2634678,2634678,2634444,234,1138,utRho08
1527,trpC,2639888,2639888,2639570,318,84,utRho08
1528,trpL,5292432,5292432,5292328,104,0,utRho08
1529,trpR,9265408,9265520,9265408,112,88,utRho08
1530,trpS,7027394,7027394,7027276,118,2092,utRho08
1531,trpT,7893560,7893914,7893560,354,198908,utRho08
1532,trxA,7931294,7931522,7931294,228,418,utRho08
1533,trxB,1864156,1864156,1864100,56,0,utRho08
1534,trxC,5437350,5437470,5437350,120,236,utRho08
1535,tsaD,6421256,6421256,6421086,170,0,utRho08
1536,tsgA,6985038,6985136,6985038,98,0,utRho08
1537,tsr,9182824,9183314,9182824,490,200,utRho08
1538,tsx,864490,864490,864026,464,328,utRho08
1539,ttcA,2823970,2823970,2823896,74,5430,utRho08
1540,ttdA,6412848,6412926,6412848,78,0,utRho08
1541,ttdR,6412760,6412760,6412512,248,0,utRho08
1542,tufA,6943448,6943448,6942658,790,167656,utRho08
1543,tus,3368346,3368518,3368346,172,0,utRho08
1544,tusA,7218040,7218040,7217992,48,0,utRho08
1545,tusB,6950218,6950218,6949930,288,1348,utRho08
1546,tynA,2902996,2902996,2902698,298,0,utRho08
1547,typA,8116460,8116814,8116460,354,12384,utRho08
1548,tyrB,8534164,8534228,8534164,64,3466,utRho08
1549,tyrP,3979004,3979362,3979004,358,0,utRho08
1550,tyrR,2773384,2773440,2773384,56,70,utRho08
1551,tyrS,3434566,3434566,3434444,122,0,utRho08
1552,tyrT,2575330,2575330,2575244,86,218,utRho08
1553,uacT,6062378,6062734,6062378,356,0,utRho08
1554,ubiC,8504886,8505012,8504886,126,0,utRho08
1555,ubiD,8049618,8049976,8049618,358,466,utRho08
1556,ubiE,8037494,8037710,8037494,216,84,utRho08
1557,ubiG,4679078,4679134,4679078,56,0,utRho08
1558,ucpA,5089342,5089342,5089246,96,84,utRho08
1559,udp,8032782,8032862,8032782,80,48,utRho08
1560,ugd,4199470,4199470,4199226,244,0,utRho08
1561,ugpB,7184852,7184852,7184650,202,56,utRho08
1562,ugpQ,7176600,7176600,7176226,374,2,utRho08
1563,uhpT,7694396,7694396,7694334,62,0,utRho08
1564,uidA,3392304,3392304,3392142,162,0,utRho08
1565,uidC,3386012,3386012,3385702,310,0,utRho08
1566,uidR,3394150,3394150,3394104,46,174,utRho08
1567,ulaA,8839854,8839960,8839854,106,134,utRho08
1568,ulaG,8839350,8839350,8839250,100,0,utRho08
1569,ulaR,8837124,8837124,8836906,218,0,utRho08
1570,umpG,5741372,5741372,5740548,824,0,utRho08
1571,umpH,1400704,1400704,1400652,52,0,utRho08
1572,umuD,2461476,2461534,2461476,58,0,utRho08
1573,ung,5433476,5433508,5433476,32,0,utRho08
1574,uof,2843316,2843316,2842900,416,8000,utRho08
1575,upp,5241818,5241818,5241744,74,654,utRho08
1576,usg,4873780,4873780,4873298,482,122,utRho08
1577,ushA,1009772,1009828,1009772,56,0,utRho08
1578,uspA,7279966,7280222,7279966,256,266,utRho08
1579,uspB,7279696,7279696,7279440,256,76,utRho08
1580,uspC,3959172,3959506,3959172,334,0,utRho08
1581,uspE,2797318,2797318,2797244,74,58,utRho08
1582,uspF,2871282,2871282,2871238,44,74,utRho08
1583,uspG,1283806,1283806,1283734,72,218,utRho08
1584,uvrA,8547872,8547872,8547742,130,126,utRho08
1585,uvrB,1626304,1627052,1626304,748,168,utRho08
1586,uvrC,3989758,3989758,3989412,346,226,utRho08
1587,uvrD,7995814,7995966,7995814,152,112,utRho08
1588,uvrY,3990812,3990812,3990718,94,0,utRho08
1589,uxaB,3221474,3221474,3221360,114,0,utRho08
1590,uxaC,6489714,6489714,6489482,232,0,utRho08
1591,uxuA,9103036,9103272,9103036,236,124,utRho08
1592,uxuR,9108916,9109152,9108916,236,112,utRho08
1593,valS,8967854,8967854,8967674,180,548,utRho08
1594,valU,5041848,5041862,5041848,14,84,utRho08
1595,valV,3492830,3492870,3492830,40,0,utRho08
1596,ves,3649968,3649968,3649874,94,0,utRho08
1597,waaA,7616512,7617080,7616512,568,84,utRho08
1598,waaH,7580298,7580298,7580162,136,0,utRho08
1599,waaQ,7616476,7616476,7616196,280,144,utRho08
1600,waaU,7598996,7598996,7598624,372,134,utRho08
1601,waaY,7602272,7602272,7601930,342,6810,utRho08
1602,wbbH,4214888,4214888,4214452,436,2966,utRho08
1603,wbbK,4209212,4209212,4209018,194,162,utRho08
1604,wcaM,4231868,4231868,4231792,76,0,utRho08
1605,wrbA,2135516,2135516,2135416,100,0,utRho08
1606,wza,4275166,4275166,4274486,680,0,utRho08
1607,wzxC,4240674,4240674,4240316,358,0,utRho08
1608,wzzB,4196950,4196950,4196602,348,76,utRho08
1609,xanP,7657642,7657890,7657642,248,0,utRho08
1610,xanQ,6048520,6048702,6048520,182,0,utRho08
1611,xapA,5049820,5049820,5049756,64,0,utRho08
1612,xapR,10090252,10090252,10089908,344,0,utRho08
1613,xdhA,6000514,6000690,6000514,176,0,utRho08
1614,xerD,6079702,6079702,6079486,216,0,utRho08
1615,xseA,5268394,5268464,5268394,70,306,utRho08
1616,xseB,882746,882746,882686,60,54,utRho08
1617,xthA,3664798,3664856,3664798,58,0,utRho08
1618,xylA,7461614,7461614,7461530,84,300,utRho08
1619,xylE,8484540,8484540,8484508,32,0,utRho08
1620,xylF,7462138,7462262,7462138,124,0,utRho08
1621,xylR,7469812,7469958,7469812,146,96,utRho08
1622,yaaA,13230,13230,12918,312,0,utRho08
1623,yaaI,23876,23876,23572,304,0,utRho08
1624,yaaJ,16034,16034,15918,116,0,utRho08
1625,yaaU,91184,91614,91184,430,108,utRho08
1626,yaaW,23084,23084,22712,372,0,utRho08
1627,yaaX,10060,10468,10060,408,0,utRho08
1628,yabI,142542,142702,142542,160,0,utRho08
1629,yacC,273880,273880,273834,46,158,utRho08
1630,yacH,262932,262932,262520,412,0,utRho08
1631,yacL,268678,268776,268678,98,0,utRho08
1632,yadD,293796,293936,293796,140,0,utRho08
1633,yadE,289930,290162,289930,232,140,utRho08
1634,yadN,314110,314110,313766,344,0,utRho08
1635,yadS,355572,355572,355248,324,4,utRho08
1636,yadV,312470,312470,312402,68,66,utRho08
1637,yaeF,434270,434270,434006,264,0,utRho08
1638,yaeP,428374,428374,428250,124,0,utRho08
1639,yaeQ,428176,428582,428176,406,52,utRho08
1640,yaeR,423716,423754,423716,38,0,utRho08
1641,yafC,462166,462166,461762,404,64,utRho08
1642,yafD,462128,462244,462128,116,76,utRho08
1643,yafK,491986,491986,491610,376,578,utRho08
1644,yafL,493282,493424,493282,142,0,utRho08
1645,yafN,503938,504010,503938,72,0,utRho08
1646,yafS,469568,469632,469568,64,170,utRho08
1647,yafT,474470,474670,474470,200,0,utRho08
1648,yafV,480432,480432,480378,54,0,utRho08
1649,yafZ,536052,536052,536010,42,12,utRho08
1650,yagE,564446,564556,564446,110,108,utRho08
1651,yagG,570414,570790,570414,376,0,utRho08
1652,yagI,578384,578384,578324,60,0,utRho08
1653,yagK,586236,586236,585896,340,52,utRho08
1654,yagL,588062,588062,587836,226,0,utRho08
1655,yagN,591342,591342,591158,184,498,utRho08
1656,yahA,663746,664742,663746,996,404,utRho08
1657,yahC,670136,670136,670044,92,0,utRho08
1658,yahE,671478,671850,671478,372,0,utRho08
1659,yahM,690504,690808,690504,304,0,utRho08
1660,yahN,692872,692872,692674,198,0,utRho08
1661,yahO,692864,692968,692864,104,0,utRho08
1662,yaiE,816296,816354,816296,58,16,utRho08
1663,yaiI,811396,811528,811396,132,0,utRho08
1664,yaiO,761946,761946,761684,262,0,utRho08
1665,yaiP,767970,767970,767870,100,0,utRho08
1666,yaiS,769660,769660,769232,428,0,utRho08
1667,yaiV,788922,788922,788922,0,0,utRho08
1668,yaiY,799094,799094,798666,428,0,utRho08
1669,yaiZ,798888,799186,798888,298,54,utRho08
1670,yajC,854410,854574,854410,164,1432,utRho08
1671,yajD,860938,861210,860938,272,436,utRho08
1672,yajI,866068,866068,865702,366,284,utRho08
1673,yajL,887496,887496,887282,214,604,utRho08
1674,yajQ,889316,889366,889316,50,0,utRho08
1675,yajR,893374,893374,893332,42,56,utRho08
1676,ybaB,987418,988152,987418,734,3256,utRho08
1677,ybaL,1006590,1006590,1006476,114,12,utRho08
1678,ybaM,980648,980648,980542,106,52,utRho08
1679,ybaN,981436,981764,981436,328,464,utRho08
1680,ybaO,936704,936766,936704,62,0,utRho08
1681,ybaP,1016568,1016568,1016160,408,328,utRho08
1682,ybaQ,1016348,1016436,1016348,88,0,utRho08
1683,ybaS,1023146,1023282,1023146,136,56,utRho08
1684,ybaV,927504,927874,927504,370,50,utRho08
1685,ybaY,950490,950758,950490,268,0,utRho08
1686,ybbB,1062724,1062724,1062452,272,0,utRho08
1687,ybbJ,1030154,1030154,1029718,436,204,utRho08
1688,ybbL,1031784,1031838,1031784,54,0,utRho08
1689,ybbN,1037136,1037136,1036558,578,1740,utRho08
1690,ybbO,1038658,1038658,1038298,360,1304,utRho08
1691,ybbY,1080718,1081130,1080718,412,0,utRho08
1692,ybcH,1176140,1176140,1175962,178,0,utRho08
1693,ybcI,1113264,1113264,1113106,158,654,utRho08
1694,ybcJ,1114050,1114050,1113746,304,144,utRho08
1695,ybcK,1137502,1137804,1137502,302,0,utRho08
1696,ybcL,1141690,1141786,1141690,96,0,utRho08
1697,ybcN,1144628,1144932,1144628,304,0,utRho08
1698,ybcQ,1147548,1147912,1147548,364,0,utRho08
1699,ybcW,1159610,1159760,1159610,150,0,utRho08
1700,ybdD,1263982,1264364,1263982,382,144,utRho08
1701,ybdF,1212106,1212106,1211772,334,96,utRho08
1702,ybdH,1267048,1267048,1266954,94,0,utRho08
1703,ybdJ,1212822,1212822,1212398,424,0,utRho08
1704,ybdK,1215122,1215122,1214766,356,0,utRho08
1705,ybdL,1267114,1267172,1267114,58,0,utRho08
1706,ybdM,1271110,1271110,1270752,358,42,utRho08
1707,ybdN,1273372,1273372,1273138,234,0,utRho08
1708,ybdR,1283844,1284176,1283844,332,202,utRho08
1709,ybeD,1325412,1325412,1325284,128,464,utRho08
1710,ybeF,1323090,1323090,1322756,334,68,utRho08
1711,ybeL,1349986,1350036,1349986,50,106,utRho08
1712,ybeQ,1353412,1353412,1353094,318,0,utRho08
1713,ybeR,1353120,1353422,1353120,302,0,utRho08
1714,ybeT,1358832,1358832,1358812,20,0,utRho08
1715,ybeU,1358924,1359016,1358924,92,0,utRho08
1716,ybeZ,1386938,1386938,1386834,104,5498,utRho08
1717,ybfA,1458074,1458268,1458074,194,0,utRho08
1718,ybfE,1423878,1423878,1423796,82,284,utRho08
1719,ybfF,1425692,1425692,1425604,88,428,utRho08
1720,ybfH,1433282,1433282,1433194,88,0,utRho08
1721,ybgA,1477840,1478002,1477840,162,0,utRho08
1722,ybgC,1549288,1549504,1549288,216,0,utRho08
1723,ybgD,1505916,1505916,1505590,326,0,utRho08
1724,ybgI,1485238,1485654,1485238,416,0,utRho08
1725,ybgO,1498370,1498370,1497964,406,0,utRho08
1726,ybgS,1570992,1570992,1570634,358,0,utRho08
1727,ybhA,1597184,1597184,1596862,322,80,utRho08
1728,ybhB,1616070,1616070,1615818,252,376,utRho08
1729,ybhC,1614642,1614642,1614562,80,1972,utRho08
1730,ybhD,1601418,1601418,1601276,142,0,utRho08
1731,ybhH,1601104,1601518,1601104,414,0,utRho08
1732,ybhK,1633384,1633384,1633294,90,92,utRho08
1733,ybhM,1641556,1641586,1641556,30,0,utRho08
1734,ybhN,1645296,1645296,1644996,300,0,utRho08
1735,ybhQ,1649202,1649260,1649202,58,4,utRho08
1736,ybiA,1665920,1665920,1665900,20,0,utRho08
1737,ybiI,1676968,1676968,1676912,56,120,utRho08
1738,ybiO,1691328,1691328,1690960,368,0,utRho08
1739,ybiP,1705252,1705252,1705194,58,6,utRho08
1740,ybiS,1711572,1711572,1711488,84,636,utRho08
1741,ybiT,1711894,1711926,1711894,32,0,utRho08
1742,ybiU,1718212,1718212,1718122,90,0,utRho08
1743,ybiV,1720176,1720176,1720056,120,0,utRho08
1744,ybiW,1725566,1725566,1725212,354,172,utRho08
1745,ybiX,1678548,1678548,1678414,134,464,utRho08
1746,ybjC,1781784,1781826,1781784,42,0,utRho08
1747,ybjE,1830154,1830154,1829714,440,72,utRho08
1748,ybjG,1767016,1767016,1766776,240,1112,utRho08
1749,ybjL,1779882,1779882,1779638,244,100,utRho08
1750,ybjM,1779770,1780178,1779770,408,62,utRho08
1751,ybjO,1795704,1795978,1795704,274,0,utRho08
1752,ybjP,1809046,1809046,1808934,112,72,utRho08
1753,ybjQ,1809034,1809186,1809034,152,148,utRho08
1754,ybjS,1813796,1813796,1813506,290,344,utRho08
1755,ybjX,1838206,1838206,1838168,38,0,utRho08
1756,ycaD,1891438,1891742,1891438,304,0,utRho08
1757,ycaI,1928210,1928640,1928210,430,0,utRho08
1758,ycaK,1899094,1899336,1899094,242,0,utRho08
1759,ycaL,1920264,1920528,1920264,264,0,utRho08
1760,ycaM,1894240,1894458,1894240,218,0,utRho08
1761,ycaR,1941284,1941346,1941284,62,404,utRho08
1762,ycbB,1961862,1962094,1961862,232,0,utRho08
1763,ycbJ,1943344,1943504,1943344,160,0,utRho08
1764,ycbK,1966046,1966150,1966046,104,320,utRho08
1765,ycbZ,2036920,2036920,2036598,322,70,utRho08
1766,yccA,2062886,2062886,2062836,50,0,utRho08
1767,yccF,2048730,2048730,2048696,34,0,utRho08
1768,yccS,2047988,2047988,2047766,222,0,utRho08
1769,yccT,2055674,2055674,2055546,128,0,utRho08
1770,yccX,2059960,2060128,2059960,168,2,utRho08
1771,ycdT,2185682,2185752,2185682,70,0,utRho08
1772,ycdU,2191266,2191686,2191266,420,0,utRho08
1773,ycdZ,2200504,2200592,2200504,88,364,utRho08
1774,yceA,2233544,2233614,2233544,70,164,utRho08
1775,yceD,2293298,2293588,2293298,290,11748,utRho08
1776,yceF,2293522,2293522,2293190,332,7240,utRho08
1777,yceH,2252154,2252314,2252154,160,1778,utRho08
1778,yceI,2237282,2237282,2236952,330,324,utRho08
1779,yceJ,2238142,2238142,2238092,50,0,utRho08
1780,yceM,2253208,2253612,2253208,404,16,utRho08
1781,yceO,2239264,2239264,2238894,370,220,utRho08
1782,yceQ,2288760,2289004,2288760,244,6714,utRho08
1783,ycfD,2376540,2376540,2376480,60,96,utRho08
1784,ycfJ,2334814,2335198,2334814,384,276,utRho08
1785,ycfS,2340834,2340834,2340748,86,0,utRho08
1786,ycfT,2350658,2350658,2350330,328,0,utRho08
1787,ycfZ,2362760,2362760,2362534,226,362,utRho08
1788,ycgB,2474570,2474570,2474482,88,0,utRho08
1789,ycgG,2434614,2434656,2434614,42,0,utRho08
1790,ycgJ,2452956,2453200,2452956,244,0,utRho08
1791,ycgL,2455218,2455362,2455218,144,0,utRho08
1792,ycgN,2457366,2457660,2457366,294,116,utRho08
1793,ycgR,2489112,2489112,2489054,58,0,utRho08
1794,ycgV,2512222,2512222,2511904,318,86,utRho08
1795,ycgX,2426568,2426568,2426214,354,5418,utRho08
1796,ycgY,2490166,2490320,2490166,154,0,utRho08
1797,ycgZ,2431504,2431578,2431504,74,0,utRho08
1798,ychE,2596904,2597196,2596904,292,148,utRho08
1799,ychF,2515764,2515764,2515624,140,0,utRho08
1800,ychH,2517476,2517582,2517476,106,60,utRho08
1801,ychJ,2578354,2578354,2578264,90,0,utRho08
1802,ychN,2547310,2547310,2547198,112,0,utRho08
1803,ychO,2547520,2547850,2547520,330,152,utRho08
1804,ychQ,2533798,2533848,2533798,50,160,utRho08
1805,yciA,2624828,2624828,2624492,336,220,utRho08
1806,yciB,2626110,2626110,2625780,330,5382,utRho08
1807,yciC,2627396,2627396,2627326,70,0,utRho08
1808,yciE,2630794,2630794,2630448,346,0,utRho08
1809,yciG,5264368,5264368,5264140,228,0,utRho08
1810,yciI,2621784,2621784,2621730,54,0,utRho08
1811,yciN,2661606,2661606,2661336,270,0,utRho08
1812,yciS,2680270,2680486,2680270,216,0,utRho08
1813,yciT,2689088,2689088,2688692,396,180,utRho08
1814,yciU,2614718,2614718,2614300,418,1296,utRho08
1815,yciV,2646376,2646440,2646376,64,0,utRho08
1816,yciW,2700472,2700472,2700214,258,0,utRho08
1817,yciZ,2689276,2689276,2689218,58,122,utRho08
1818,ycjD,2703792,2703792,2703520,272,0,utRho08
1819,ycjG,2777748,2777860,2777748,112,22,utRho08
1820,ycjM,2740006,2740432,2740006,426,44,utRho08
1821,ycjW,2767982,2767982,2767922,60,0,utRho08
1822,ycjX,2768138,2768234,2768138,96,0,utRho08
1823,ycjY,5568288,5568288,5567460,828,0,utRho08
1824,ydaE,2836438,2836438,2836016,422,0,utRho08
1825,ydaN,2816048,2816100,2816048,52,0,utRho08
1826,ydaS,2840340,2840730,2840340,390,0,utRho08
1827,ydbC,2948376,2948442,2948376,66,0,utRho08
1828,ydbD,2950132,2950288,2950132,156,0,utRho08
1829,ydbH,2885800,2886102,2885800,302,4,utRho08
1830,ydbJ,2881712,2882116,2881712,404,0,utRho08
1831,ydbK,2881692,2881692,2881568,124,54,utRho08
1832,ydcA,2983294,2983354,2983294,60,0,utRho08
1833,ydcF,2974404,2974470,2974404,66,0,utRho08
1834,ydcI,2990268,2990268,2990142,126,0,utRho08
1835,ydcJ,2990266,2990576,2990266,310,0,utRho08
1836,ydcK,3001280,3001280,3000898,382,0,utRho08
1837,ydcL,3004646,3004914,3004646,268,0,utRho08
1838,ydcN,3012308,3012344,3012308,36,0,utRho08
1839,ydcP,3013508,3013562,3013508,54,190,utRho08
1840,ydcR,3019956,3020006,3019956,50,0,utRho08
1841,ydcS,3022906,3023308,3022906,402,0,utRho08
1842,ydcX,3034442,3034778,3034442,336,60,utRho08
1843,ydcY,3035220,3035296,3035220,76,0,utRho08
1844,ydcZ,3036750,3036750,3036662,88,0,utRho08
1845,yddB,3155332,3155332,3155238,94,0,utRho08
1846,yddE,3071738,3071738,3071716,22,0,utRho08
1847,yddG,3094410,3094410,3094338,72,0,utRho08
1848,yddJ,3089732,3089732,3089438,294,0,utRho08
1849,yddW,3137704,3137704,3137646,58,46,utRho08
1850,ydeA,3233910,3234056,3233910,146,46,utRho08
1851,ydeE,3242528,3242664,3242528,136,0,utRho08
1852,ydeI,3249118,3249118,3248994,124,0,utRho08
1853,ydeJ,3249376,3249546,3249376,170,0,utRho08
1854,ydeN,3165458,3165458,3165048,410,0,utRho08
1855,ydeP,3173328,3173328,3172972,356,0,utRho08
1856,ydeR,3176596,3176596,3176592,4,0,utRho08
1857,ydfA,3296872,3297016,3296872,144,0,utRho08
1858,ydfG,3254982,3255034,3254982,52,32,utRho08
1859,ydfH,3256652,3256704,3256652,52,0,utRho08
1860,ydfK,3265446,3266144,3265446,698,700,utRho08
1861,ydgA,3379588,3379704,3379588,116,0,utRho08
1862,ydgC,3364124,3364124,3364060,64,0,utRho08
1863,ydgD,3343906,3343920,3343906,14,0,utRho08
1864,ydgH,3356754,3356854,3356754,100,0,utRho08
1865,ydgJ,3408798,3408798,3408616,182,0,utRho08
1866,ydgK,3410414,3410500,3410414,86,302,utRho08
1867,ydhB,3479618,3479618,3479596,22,0,utRho08
1868,ydhC,3479698,3479822,3479698,124,0,utRho08
1869,ydhF,3451310,3451310,3451264,46,0,utRho08
1870,ydhI,3441996,3442050,3441996,54,0,utRho08
1871,ydhL,3451864,3451864,3451840,24,0,utRho08
1872,ydhQ,3492404,3492404,3492254,150,0,utRho08
1873,ydhS,3494136,3494262,3494136,126,0,utRho08
1874,ydhT,3499138,3499138,3499118,20,0,utRho08
1875,ydhY,3509284,3509284,3508954,330,0,utRho08
1876,ydhZ,3510418,3510418,3510282,136,0,utRho08
1877,ydiE,3579206,3579226,3579206,20,0,utRho08
1878,ydiH,3530582,3530582,3530406,176,0,utRho08
1879,ydiM,3541852,3542142,3541852,290,0,utRho08
1880,ydiN,3544818,3545024,3544818,206,0,utRho08
1881,ydiP,3558656,3558656,3558602,54,0,utRho08
1882,ydiU,3582508,3582508,3582488,20,42,utRho08
1883,ydiV,3584174,3584174,3584040,134,44,utRho08
1884,ydiY,3612500,3612500,3612166,334,0,utRho08
1885,ydjA,3697400,3697400,3697352,48,88,utRho08
1886,ydjE,3708082,3708082,3707958,124,0,utRho08
1887,ydjF,3709848,3709848,3709708,140,0,utRho08
1888,ydjM,3620340,3620422,3620340,82,0,utRho08
1889,ydjO,3626696,3626696,3626288,408,0,utRho08
1890,ydjX,3666434,3666802,3666434,368,780,utRho08
1891,yeaE,3731448,3731448,3731272,176,264,utRho08
1892,yeaG,3733530,3733816,3733530,286,0,utRho08
1893,yeaI,3740486,3740770,3740486,284,0,utRho08
1894,yeaJ,3743874,3744082,3743874,208,74,utRho08
1895,yeaL,3748646,3748704,3748646,58,316,utRho08
1896,yeaM,3751296,3751296,3751152,144,0,utRho08
1897,yeaN,3750926,3751346,3750926,420,0,utRho08
1898,yeaO,3753554,3753818,3753554,264,0,utRho08
1899,yeaP,3755314,3755430,3755314,116,644,utRho08
1900,yeaQ,3758780,3758780,3758510,270,0,utRho08
1901,yeaR,3759988,3759988,3759896,92,0,utRho08
1902,yeaY,3781122,3781122,3781064,58,12,utRho08
1903,yebB,3892220,3892502,3892220,282,0,utRho08
1904,yebC,3896370,3896370,3896302,68,0,utRho08
1905,yebE,3859464,3859464,3859414,50,0,utRho08
1906,yebG,3861530,3861530,3861494,36,0,utRho08
1907,yebK,3873180,3873304,3873180,124,0,utRho08
1908,yebQ,3820314,3820552,3820314,238,0,utRho08
1909,yebS,3832238,3832516,3832238,278,0,utRho08
1910,yebV,3843430,3843560,3843430,130,0,utRho08
1911,yebW,3843914,3844242,3843914,328,828,utRho08
1912,yecC,3995646,3995646,3995628,18,0,utRho08
1913,yecD,3901272,3901664,3901272,392,192,utRho08
1914,yecF,3991434,3991636,3991434,202,0,utRho08
1915,yecH,3979304,3979304,3978980,324,0,utRho08
1916,yecJ,3975604,3975604,3975516,88,0,utRho08
1917,yecM,3919968,3919968,3919692,276,0,utRho08
1918,yecR,3976400,3976444,3976400,44,0,utRho08
1919,yecT,3923862,3923944,3923862,82,98,utRho08
1920,yedD,4016522,4016522,4016180,342,6,utRho08
1921,yedE,4016310,4016554,4016310,244,12,utRho08
1922,yedI,4058922,4058922,4058732,190,0,utRho08
1923,yedJ,4066446,4066446,4066158,288,40,utRho08
1924,yedV,4076404,4076404,4076304,100,0,utRho08
1925,yedX,4077680,4077912,4077680,232,0,utRho08
1926,yedY,4078572,4078956,4078572,384,0,utRho08
1927,yeeA,4161322,4161322,4161182,140,152,utRho08
1928,yeeE,4171104,4171104,4171050,54,0,utRho08
1929,yeeJ,4089526,4089822,4089526,296,52,utRho08
1930,yeeN,4113508,4113716,4113508,208,144,utRho08
1931,yeeO,4119444,4119444,4119692,248,0,utRho08
1932,yeeX,4158834,4158834,4158722,112,12,utRho08
1933,yeeZ,4178422,4178422,4178256,166,0,utRho08
1934,yefM,4179466,4179466,4179426,40,0,utRho08
1935,yegD,4295288,4295348,4295288,60,100,utRho08
1936,yegH,4275726,4275804,4275726,78,0,utRho08
1937,yegI,4302154,4302154,4301970,184,0,utRho08
1938,yegJ,4302032,4302370,4302032,338,0,utRho08
1939,yegQ,4331182,4331336,4331182,154,32,utRho08
1940,yegR,4336698,4336698,4336612,86,0,utRho08
1941,yegS,4337086,4337424,4337086,338,0,utRho08
1942,yegT,4357562,4357642,4357562,80,0,utRho08
1943,yegX,4367640,4367640,4367302,338,148,utRho08
1944,yehA,4376944,4376944,4376828,116,0,utRho08
1945,yehE,4385818,4385818,4385592,226,0,utRho08
1946,yehK,4407568,4407944,4407568,376,0,utRho08
1947,yehL,4408804,4409192,4408804,388,0,utRho08
1948,yeiB,4486146,4486146,4485934,212,92,utRho08
1949,yeiE,4499422,4499422,4499236,186,0,utRho08
1950,yeiG,4487776,4487820,4487776,44,252,utRho08
1951,yeiH,4499332,4499434,4499332,102,0,utRho08
1952,yeiI,4503306,4503400,4503306,94,96,utRho08
1953,yeiL,4510580,4510710,4510580,130,0,utRho08
1954,yeiP,4530834,4530900,4530834,66,652,utRho08
1955,yeiQ,4532328,4532490,4532328,162,0,utRho08
1956,yeiR,4535484,4535658,4535484,174,146,utRho08
1957,yeiW,4530840,4530840,4530590,250,788,utRho08
1958,yejA,4544624,4544728,4544624,104,0,utRho08
1959,yejG,4556892,4556892,4556474,418,462,utRho08
1960,yejH,4561244,4561264,4561244,20,2,utRho08
1961,yejK,4568218,4568218,4567894,324,360,utRho08
1962,yejO,4578352,4578352,4577800,552,30,utRho08
1963,yfaD,4713380,4713808,4713380,428,316,utRho08
1964,yfaE,4696676,4697028,4696676,352,926,utRho08
1965,yfaL,4688568,4688568,4688338,230,0,utRho08
1966,yfaP,4656398,4656398,4656286,112,0,utRho08
1967,yfaU,4717892,4717892,4717690,202,0,utRho08
1968,yfaY,4727310,4727310,4727266,44,0,utRho08
1969,yfaZ,4728744,4728744,4728550,194,0,utRho08
1970,yfbK,4771810,4771810,4771444,366,0,utRho08
1971,yfbL,4771500,4771720,4771500,220,0,utRho08
1972,yfbN,4777174,4777174,4776852,322,0,utRho08
1973,yfbO,4776916,4777162,4776916,246,0,utRho08
1974,yfbP,4777990,4778232,4777990,242,146,utRho08
1975,yfbR,4817662,4817724,4817662,62,112,utRho08
1976,yfcI,4847424,4847424,4847078,346,0,utRho08
1977,yfcJ,4880482,4880482,4880240,242,0,utRho08
1978,yfcL,4888502,4888502,4888338,164,0,utRho08
1979,yfcV,4911642,4911642,4911292,350,0,utRho08
1980,yfcZ,4921958,4921958,4921868,90,0,utRho08
1981,yfdF,4925604,4926024,4925604,420,296,utRho08
1982,yfdG,4935474,4935710,4935474,236,0,utRho08
1983,yfdP,4946844,4947040,4946844,196,0,utRho08
1984,yfdX,4988866,4988866,4988804,62,0,utRho08
1985,yfdY,4990672,4990672,4990584,88,0,utRho08
1986,yfeA,5035784,5035784,5035664,120,6226,utRho08
1987,yfeC,5036668,5036934,5036668,266,232,utRho08
1988,yfeH,5053818,5053892,5053818,74,0,utRho08
1989,yfeK,5074630,5074684,5074630,54,0,utRho08
1990,yfeO,5018906,5019260,5018906,354,162,utRho08
1991,yfeR,5054078,5054078,5053712,366,56,utRho08
1992,yfeX,5101356,5101356,5101090,266,0,utRho08
1993,yfeY,5102486,5102486,5102432,54,0,utRho08
1994,yfeZ,5103842,5103842,5103452,390,68,utRho08
1995,yffO,5123804,5124222,5123804,418,0,utRho08
1996,yffQ,5126778,5127154,5126778,376,20,utRho08
1997,yffS,5128800,5128986,5128800,186,178,utRho08
1998,yfgC,5232052,5232188,5232052,136,0,utRho08
1999,yfgF,5258062,5258062,5257876,186,0,utRho08
2000,yfgG,5258170,5258580,5258170,410,0,utRho08
2001,yfgH,5259344,5259584,5259344,240,0,utRho08
2002,yfgM,5278866,5278866,5278566,300,28,utRho08
2003,yfhH,5397414,5397518,5397414,104,0,utRho08
2004,yfhM,5304648,5304648,5304574,74,0,utRho08
2005,yfhR,5328408,5328726,5328408,318,404,utRho08
2006,yfiC,5425610,5425610,5425528,82,0,utRho08
2007,yfiE,5430688,5430688,5430640,48,0,utRho08
2008,yfiL,5482630,5482720,5482630,90,0,utRho08
2009,yfiM,5448066,5448358,5448066,292,7476,utRho08
2010,yfiR,5483354,5483750,5483354,396,0,utRho08
2011,yfjH,5517326,5517326,5517200,126,0,utRho08
2012,yfjI,5517710,5517970,5517710,260,0,utRho08
2013,yfjJ,5521014,5521094,5521014,80,0,utRho08
2014,yfjM,5531970,5531970,5531552,418,272,utRho08
2015,yfjP,5535080,5535420,5535080,340,64,utRho08
2016,yfjW,5546570,5546636,5546570,66,0,utRho08
2017,yfjX,5551776,5551838,5551776,62,0,utRho08
2018,ygaC,5601180,5601180,5599988,1192,0,utRho08
2019,ygaM,5600242,5600292,5600242,50,0,utRho08
2020,ygaU,5593628,5593628,5593572,56,0,utRho08
2021,ygaZ,5619190,5619234,5619190,44,26,utRho08
2022,ygbA,5713656,5713656,5713612,44,0,utRho08
2023,ygbE,5746784,5746784,5746674,110,72,utRho08
2024,ygbI,5722882,5722882,5722528,354,0,utRho08
2025,ygbK,5724394,5724670,5724394,276,20,utRho08
2026,ygbL,5727074,5727186,5727074,112,0,utRho08
2027,ygbN,5729814,5730202,5729814,388,92,utRho08
2028,ygcG,5811210,5811422,5811210,212,48,utRho08
2029,ygcN,5785144,5785314,5785144,170,0,utRho08
2030,ygcU,5799214,5799214,5798836,378,0,utRho08
2031,ygcW,5800942,5800942,5800546,396,0,utRho08
2032,ygdD,5883442,5883442,5883262,180,218,utRho08
2033,ygdG,5861746,5861930,5861746,184,116,utRho08
2034,ygdI,5886526,5886526,5886290,236,0,utRho08
2035,ygdQ,5940784,5940840,5940784,56,0,utRho08
2036,ygdR,5942494,5942542,5942494,48,0,utRho08
2037,ygeA,5961606,5961606,5961270,336,0,utRho08
2038,ygeH,5983758,5984188,5983758,430,0,utRho08
2039,ygeI,5987162,5987276,5987162,114,0,utRho08
2040,ygeR,6000078,6000078,5999782,296,58,utRho08
2041,ygeV,6011694,6011694,6011572,122,0,utRho08
2042,ygeW,6012234,6012524,6012234,290,0,utRho08
2043,ygfB,6110946,6110946,6110888,58,34,utRho08
2044,ygfK,6031984,6032120,6031984,136,0,utRho08
2045,ygfS,6058328,6058328,6058024,304,0,utRho08
2046,ygfZ,6082564,6082626,6082564,62,74,utRho08
2047,yggC,6149512,6149512,6149378,134,134,utRho08
2048,yggE,6136370,6136370,6136160,210,70,utRho08
2049,yggI,6179176,6179510,6179176,334,8,utRho08
2050,yggL,6204508,6204508,6204266,242,322,utRho08
2051,yggM,6199514,6199514,6199130,384,4,utRho08
2052,yggN,6203596,6203596,6203246,350,128,utRho08
2053,yggX,18623958,18624558,18623958,600,1182,utRho08
2054,yghA,6298966,6299324,6298966,358,0,utRho08
2055,yghB,6307058,6307126,6307058,68,0,utRho08
2056,yghD,6222614,6222614,6222252,362,100,utRho08
2057,yghF,6225798,6225798,6225840,42,0,utRho08
2058,yghJ,6238640,6238640,6238224,416,0,utRho08
2059,yghQ,6265186,6265186,6264816,370,0,utRho08
2060,yghT,6267830,6268262,6267830,432,0,utRho08
2061,yghU,6277400,6277454,6277400,54,0,utRho08
2062,yghW,6293506,6293506,6293474,32,0,utRho08
2063,yghZ,6295562,6295794,6295562,232,0,utRho08
2064,ygiD,6365122,6365122,6364868,254,126,utRho08
2065,ygiH,6409066,6409388,6409066,322,56,utRho08
2066,ygiL,6370622,6370828,6370622,206,0,utRho08
2067,ygiM,6402084,6402414,6402084,330,132,utRho08
2068,ygiN,6346156,6346284,6346156,128,1072,utRho08
2069,ygiQ,6322620,6322620,6322292,328,374,utRho08
2070,ygiS,6335462,6335462,6335436,26,0,utRho08
2071,ygiV,6338582,6338582,6338462,120,42,utRho08
2072,ygiW,6339774,6339774,6339352,422,0,utRho08
2073,ygiZ,6344506,6344506,6344422,84,0,utRho08
2074,ygjH,6442528,6442528,6442494,34,0,utRho08
2075,ygjI,6452140,6452468,6452140,328,0,utRho08
2076,ygjQ,6472730,6473080,6472730,350,248,utRho08
2077,ygjR,6474564,6474586,6474564,22,0,utRho08
2078,ygjV,6483638,6483638,6483488,150,0,utRho08
2079,yhaB,6535632,6535708,6535632,76,0,utRho08
2080,yhaH,6504498,6504608,6504498,110,4,utRho08
2081,yhaI,6505400,6505822,6505400,422,0,utRho08
2082,yhaJ,6508560,6508560,6508428,132,46,utRho08
2083,yhaK,6508538,6508638,6508538,100,0,utRho08
2084,yhbQ,6599878,6599932,6599878,54,0,utRho08
2085,yhbT,6602736,6602736,6602552,184,82,utRho08
2086,yhbU,6602558,6602970,6602558,412,82,utRho08
2087,yhbX,6643302,6643302,6643226,76,0,utRho08
2088,yhbY,6655518,6655580,6655518,62,1440,utRho08
2089,yhcA,6723956,6724224,6723956,268,0,utRho08
2090,yhcB,6760364,6760382,6760364,18,400,utRho08
2091,yhcC,6708470,6708470,6708100,370,0,utRho08
2092,yhcF,6733440,6733852,6733440,412,24,utRho08
2093,yhcH,6739124,6739124,6738956,168,128,utRho08
2094,yhcM,6760312,6760312,6759994,318,66,utRho08
2095,yhcN,6770812,6771076,6770812,264,116,utRho08
2096,yhcO,6772606,6772606,6772258,348,0,utRho08
2097,yhdH,6806560,6806968,6806560,408,132,utRho08
2098,yhdJ,6823234,6823306,6823234,72,0,utRho08
2099,yhdN,6879092,6879092,6879018,74,1560,utRho08
2100,yhdT,6814702,6814750,6814702,48,252,utRho08
2101,yhdU,6824994,6825242,6824994,248,0,utRho08
2102,yhdV,6836392,6836780,6836392,388,20,utRho08
2103,yhdW,6837944,6838298,6837944,354,0,utRho08
2104,yheO,6953082,6953082,6952880,202,652,utRho08
2105,yheV,6957970,6957970,6957584,386,18,utRho08
2106,yhfA,6971902,6971902,6971636,266,0,utRho08
2107,yhfG,6983294,6983294,6983240,54,300,utRho08
2108,yhfL,6998622,6998896,6998622,274,0,utRho08
2109,yhfY,7023244,7023244,7022844,400,132,utRho08
2110,yhgA,7086294,7086334,7086294,40,0,utRho08
2111,yhgE,7065176,7065176,7064878,298,128,utRho08
2112,yhgF,7074352,7074770,7074352,418,992,utRho08
2113,yhhA,7173458,7173886,7173458,428,0,utRho08
2114,yhhI,7248346,7248756,7248346,410,0,utRho08
2115,yhhJ,7253696,7253696,7253606,90,0,utRho08
2116,yhhM,7211588,7211588,7211220,368,84,utRho08
2117,yhhN,7211150,7211502,7211150,352,86,utRho08
2118,yhhQ,7218238,7218434,7218238,196,246,utRho08
2119,yhhT,7223682,7223730,7223682,48,104,utRho08
2120,yhhX,7162032,7162032,7161610,422,0,utRho08
2121,yhhY,7162222,7162276,7162222,54,0,utRho08
2122,yhhZ,7163516,7163726,7163516,210,0,utRho08
2123,yhiD,7312220,7312220,7311804,416,1914,utRho08
2124,yhiJ,7265190,7265190,7265180,10,0,utRho08
2125,yhiM,7269270,7269682,7269270,412,0,utRho08
2126,yhiN,7275000,7275000,7274820,180,36,utRho08
2127,yhjA,7338522,7338522,7338376,146,0,utRho08
2128,yhjB,7344090,7344090,7343788,302,60,utRho08
2129,yhjC,7344272,7344684,7344272,412,0,utRho08
2130,yhjD,7346660,7346724,7346660,64,0,utRho08
2131,yhjE,7349274,7349572,7349274,298,0,utRho08
2132,yhjG,7356824,7356824,7356730,94,54,utRho08
2133,yhjH,7358458,7358458,7358374,84,200,utRho08
2134,yhjJ,7364032,7364032,7363880,152,82,utRho08
2135,yhjK,7371296,7371296,7371158,138,44,utRho08
2136,yhjR,7392750,7392750,7392370,380,114,utRho08
2137,yhjV,7400796,7401126,7400796,330,130,utRho08
2138,yhjX,7424194,7424194,7424014,180,0,utRho08
2139,yhjY,7425966,7425966,7425868,98,0,utRho08
2140,yiaB,7455654,7455654,7455496,158,0,utRho08
2141,yiaD,7432712,7433094,7432712,382,204,utRho08
2142,yiaF,7438194,7438194,7438088,106,0,utRho08
2143,yiaG,7438862,7438956,7438862,94,0,utRho08
2144,yiaJ,7485236,7485236,7485064,172,0,utRho08
2145,yiaK,7485348,7485466,7485348,118,32,utRho08
2146,yiaT,7503924,7503924,7503736,188,0,utRho08
2147,yiaU,7503792,7503984,7503792,192,0,utRho08
2148,yiaY,7515856,7515856,7515654,202,0,utRho08
2149,yibF,7523950,7523950,7523910,40,0,utRho08
2150,yibG,7536128,7536354,7536128,226,0,utRho08
2151,yibL,7553194,7553330,7553194,136,44,utRho08
2152,yibN,7570112,7570112,7570030,82,386,utRho08
2153,yibT,7552848,7552848,7552760,88,0,utRho08
2154,yicC,7633290,7633352,7633290,62,40,utRho08
2155,yicH,7660862,7660914,7660862,52,0,utRho08
2156,yicJ,7673328,7673328,7671858,1470,454,utRho08
2157,yicN,7685018,7685018,7684804,214,0,utRho08
2158,yicO,7687914,7687914,7687578,336,0,utRho08
2159,yicR,15250308,15250308,15250236,72,0,utRho08
2160,yidB,7755230,7755230,7754930,300,0,utRho08
2161,yidE,7732780,7732780,7732546,234,0,utRho08
2162,yidF,7711580,7711580,7711222,358,132,utRho08
2163,yidQ,7735088,7735456,7735088,368,854,utRho08
2164,yidR,7738824,7738824,7738618,206,0,utRho08
2165,yieE,7787658,7787738,7787658,80,4,utRho08
2166,yieH,7793314,7793548,7793314,234,0,utRho08
2167,yieK,7798928,7798928,7798786,142,0,utRho08
2168,yifB,7900350,7900350,7899998,352,0,utRho08
2169,yifL,7988984,7989044,7988984,60,4,utRho08
2170,yigF,8005750,8005750,8005598,152,188,utRho08
2171,yigI,8009448,8009448,8009394,54,0,utRho08
2172,yigM,8022100,8022152,8022100,52,0,utRho08
2173,yihA,8101970,8101970,8101458,512,222,utRho08
2174,yihD,8084098,8084138,8084098,40,0,utRho08
2175,yihF,8088110,8088398,8088110,288,0,utRho08
2176,yihG,8093304,8093304,8093204,100,0,utRho08
2177,yihI,8102616,8102694,8102616,78,0,utRho08
2178,yihL,8120506,8120894,8120506,388,332,utRho08
2179,yihN,8124332,8124494,8124332,162,0,utRho08
2180,yihO,8131942,8131942,8131532,410,0,utRho08
2181,yihQ,8138892,8138892,8138552,340,0,utRho08
2182,yihV,8147064,8147478,8147064,414,0,utRho08
2183,yihX,8151096,8151106,8151096,10,34,utRho08
2184,yiiE,8158192,8158582,8158192,390,0,utRho08
2185,yiiF,8159124,8159502,8159124,378,0,utRho08
2186,yiiG,8173762,8174004,8173762,242,0,utRho08
2187,yiiM,8205506,8205644,8205506,138,118,utRho08
2188,yiiQ,8224624,8224624,8224428,196,0,utRho08
2189,yiiS,8225738,8225934,8225738,196,0,utRho08
2190,yijE,8272178,8272216,8272178,38,20,utRho08
2191,yijF,8275728,8275728,8275314,414,0,utRho08
2192,yijO,8296858,8296858,8296634,224,32,utRho08
2193,yjaA,8426240,8426468,8426240,228,190776,utRho08
2194,yjaB,8428312,8428312,8428246,66,0,utRho08
2195,yjaG,8398746,8399008,8398746,262,1074,utRho08
2196,yjaH,8401022,8401132,8401022,110,258,utRho08
2197,yjaZ,8379506,8379572,8379506,66,0,utRho08
2198,yjbB,8455204,8455462,8455204,258,0,utRho08
2199,yjbE,16943432,16943624,16943432,192,0,utRho08
2200,yjbL,8520318,8520642,8520318,324,0,utRho08
2201,yjbQ,8540428,8540476,8540428,48,0,utRho08
2202,yjcB,8550328,8550328,8550082,246,98,utRho08
2203,yjcC,8550836,8550942,8550836,106,0,utRho08
2204,yjcD,8556628,8556958,8556628,330,160,utRho08
2205,yjcE,8559658,8559960,8559658,302,0,utRho08
2206,yjcF,8566212,8566212,8566150,62,0,utRho08
2207,yjcO,8594660,8594660,8594250,410,22,utRho08
2208,yjdA,8654128,8654270,8654128,142,0,utRho08
2209,yjdC,8726660,8726660,8726616,44,0,utRho08
2210,yjdK,8704780,8705168,8704780,388,298,utRho08
2211,yjdL,8713034,8713034,8712822,212,0,utRho08
2212,yjdM,8653672,8653672,8653468,204,68,utRho08
2213,yjeF,8787354,8788132,8787354,778,4374,utRho08
2214,yjeI,8745522,8745618,8745522,96,0,utRho08
2215,yjeJ,8748806,8748806,8748468,338,0,utRho08
2216,yjeV,8785472,8785784,8785472,312,142,utRho08
2217,yjfP,8833512,8833904,8833512,392,0,utRho08
2218,yjfY,8849656,8849656,8849582,74,0,utRho08
2219,yjfZ,8855052,8855052,8854844,208,10,utRho08
2220,yjgA,8916162,8916162,8915730,432,18,utRho08
2221,yjgL,8950802,8950874,8950802,72,0,utRho08
2222,yjgM,8959342,8959342,8959074,268,0,utRho08
2223,yjgN,8959132,8959460,8959132,328,0,utRho08
2224,yjgR,8980170,8980170,8980126,44,0,utRho08
2225,yjgZ,9002116,9002520,9002116,404,272,utRho08
2226,yjhB,9007764,9008116,9007764,352,0,utRho08
2227,yjhG,9048452,9048452,9048188,264,274,utRho08
2228,yjhU,9041080,9041080,9040648,432,104,utRho08
2229,yjiA,9178096,9178096,9177730,366,260,utRho08
2230,yjiJ,9125364,9125364,9125350,14,0,utRho08
2231,yjiK,9127270,9127270,9127422,152,0,utRho08
2232,yjiL,9129604,9129604,9129378,226,0,utRho08
2233,yjiS,9143410,9143502,9143410,92,0,utRho08
2234,yjiY,9182734,9182734,9182558,176,182,utRho08
2235,yjjA,9200674,9200674,9200378,296,162,utRho08
2236,yjjB,18408708,18408708,18407800,908,0,utRho08
2237,yjjJ,9243314,9243538,9243314,224,0,utRho08
2238,yjjK,9261132,9261132,9261044,88,2,utRho08
2239,yjjL,9189764,9189764,9189444,320,0,utRho08
2240,yjjM,9191894,9191894,9191702,192,0,utRho08
2241,yjjP,9206068,9206068,9205716,352,8,utRho08
2242,yjjQ,9206638,9206954,9206638,316,0,utRho08
2243,yjjX,9267798,9267798,9267490,308,738,utRho08
2244,yjjY,9280716,9280804,9280716,88,706,utRho08
2245,yjjZ,9211554,9211608,9211554,54,172,utRho08
2246,yjtD,9281676,9281884,9281676,208,64,utRho08
2247,ykfB,532454,532454,532174,280,30,utRho08
2248,ykfI,527636,527636,527338,298,0,utRho08
2249,ykgB,637050,637050,636638,412,0,utRho08
2250,ykgC,640430,640430,640002,428,0,utRho08
2251,ykgD,640232,640454,640232,222,0,utRho08
2252,ykgE,642962,643216,642962,254,0,utRho08
2253,ykgJ,608524,608524,608364,160,0,utRho08
2254,ykgL,623878,624224,623878,346,0,utRho08
2255,ykgM,625610,625610,625554,56,4,utRho08
2256,ykgR,626570,626570,626484,86,0,utRho08
2257,ylaC,958576,958576,958502,74,662,utRho08
2258,yliE,1745938,1745958,1745938,20,0,utRho08
2259,ymcE,2103660,2103694,2103660,34,2,utRho08
2260,ymdA,2210450,2210828,2210450,378,108,utRho08
2261,ymdB,2211428,2211640,2211428,212,0,utRho08
2262,ymfD,2395322,2395322,2395064,258,676,utRho08
2263,ymfI,2402880,2402994,2402880,114,0,utRho08
2264,ymfJ,2404518,2404518,2404168,350,138,utRho08
2265,ymfK,2406176,2406176,2405866,310,0,utRho08
2266,ymfT,2405766,2406048,2405766,282,0,utRho08
2267,ymgE,2489110,2489456,2489110,346,180,utRho08
2268,ymgF,2437628,2437966,2437628,338,0,utRho08
2269,ymiA,2670112,2670320,2670112,208,48,utRho08
2270,ymjA,2715620,2715620,2715336,284,722,utRho08
2271,ynaI,2791946,2791946,2791844,102,0,utRho08
2272,ynaK,2850438,2850754,2850438,316,0,utRho08
2273,ynbA,2954924,2955242,2954924,318,0,utRho08
2274,yncD,3046552,3046552,3046130,422,170,utRho08
2275,yncE,3046454,3046614,3046454,160,0,utRho08
2276,yncG,3052456,3052494,3052456,38,128,utRho08
2277,yncL,3034492,3034492,3034388,104,60,utRho08
2278,yneE,3218364,3218364,3218044,320,0,utRho08
2279,yneF,3223748,3223748,3223708,40,10,utRho08
2280,yneJ,3229560,3229608,3229560,48,0,utRho08
2281,yneK,3231100,3231526,3231100,426,0,utRho08
2282,yneM,3245176,3245292,3245176,116,160,utRho08
2283,ynfA,3311398,3311398,3311346,52,0,utRho08
2284,ynfB,3311418,3311616,3311418,198,230,utRho08
2285,ynfC,3315094,3315094,3314914,180,0,utRho08
2286,ynfD,3314828,3315130,3314828,302,0,utRho08
2287,ynfE,3316006,3316138,3316006,132,0,utRho08
2288,ynfK,3334670,3334670,3334438,232,40,utRho08
2289,ynfL,3339304,3339304,3339184,120,0,utRho08
2290,ynfM,3339260,3339398,3339260,138,0,utRho08
2291,ynfN,3276598,3276598,3276218,380,0,utRho08
2292,ynfO,3273454,3273512,3273454,58,0,utRho08
2293,ynhG,3517890,3517890,3517450,440,432,utRho08
2294,yniA,3615158,3615592,3615158,434,4,utRho08
2295,yniB,3618526,3618526,3618466,60,0,utRho08
2296,yniC,3618652,3618760,3618652,108,0,utRho08
2297,yniD,3610202,3610330,3610202,128,0,utRho08
2298,ynjE,3678880,3678934,3678880,54,0,utRho08
2299,ynjF,3683222,3683222,3682806,416,0,utRho08
2300,ynjH,3684376,3684376,3684270,106,34,utRho08
2301,ynjI,3690022,3690022,3689742,280,150,utRho08
2302,yoaB,3786642,3786734,3786642,92,80,utRho08
2303,yoaC,3787932,3788146,3787932,214,270,utRho08
2304,yoaE,3803544,3803544,3803170,374,2,utRho08
2305,yoaF,3755444,3755444,3755064,380,666,utRho08
2306,yoaH,3789866,3789866,3789462,404,188,utRho08
2307,yobB,3850418,3850880,3850418,462,392,utRho08
2308,yobF,3815586,3815586,3815182,404,0,utRho08
2309,yobH,3817800,3817850,3817800,50,0,utRho08
2310,yodB,4084352,4084736,4084352,384,0,utRho08
2311,yodC,4057008,4057008,4056740,268,0,utRho08
2312,yohC,4451358,4451358,4451262,96,0,utRho08
2313,yohD,4451526,4451602,4451526,76,0,utRho08
2314,yohJ,4460986,4461248,4460986,262,0,utRho08
2315,yohO,4431172,4431314,4431172,142,0,utRho08
2316,yojI,4617282,4617282,4617230,52,0,utRho08
2317,ypdI,4988988,4989396,4988988,408,0,utRho08
2318,ypfG,5165786,5165786,5165554,232,2,utRho08
2319,ypfM,5182140,5182140,5181732,408,320,utRho08
2320,yphB,5349590,5349590,5349376,214,0,utRho08
2321,ypjA,5565644,5565644,5565452,192,0,utRho08
2322,ypjB,5569636,5569636,5568858,778,0,utRho08
2323,ypjD,5495860,5495774,5495860,86,0,utRho08
2324,yqaE,5594170,5594170,5594056,114,0,utRho08
2325,yqcA,5846100,5846100,5845968,132,0,utRho08
2326,yqcE,5800944,5801184,5800944,240,0,utRho08
2327,yqeC,6030468,6030468,6030114,354,0,utRho08
2328,yqeF,5971618,5971618,5971184,434,0,utRho08
2329,yqeG,5971438,5971694,5971438,256,0,utRho08
2330,yqeH,5975016,5975072,5975016,56,0,utRho08
2331,yqeI,5976688,5977004,5976688,316,0,utRho08
2332,yqeK,5981140,5981140,5980720,420,0,utRho08
2333,yqfA,6086728,6086728,6086296,432,498,utRho08
2334,yqgA,6219042,6219106,6219042,64,0,utRho08
2335,yqgB,6172500,6172500,6172102,398,3694,utRho08
2336,yqgE,6185768,6185874,6185768,106,552,utRho08
2337,yqhA,6299150,6299150,6298942,208,0,utRho08
2338,yqhC,6310768,6310768,6310436,332,118,utRho08
2339,yqhD,6310604,6310710,6310604,106,96,utRho08
2340,yqhH,6316842,6317254,6316842,412,208,utRho08
2341,yqiC,6369662,6369680,6369662,18,38,utRho08
2342,yqiJ,6384108,6384416,6384108,308,0,utRho08
2343,yqjA,6495096,6495546,6495096,450,830,utRho08
2344,yqjF,6500932,6501124,6500932,192,0,utRho08
2345,yqjG,6501948,6502048,6501948,100,0,utRho08
2346,yqjH,6433078,6433078,6432982,96,0,utRho08
2347,yqjI,6433506,6433558,6433506,52,0,utRho08
2348,yraH,6574552,6574852,6574552,300,0,utRho08
2349,yraP,6592144,6592818,6592144,674,42,utRho08
2350,yraQ,6596414,6596414,6596276,138,0,utRho08
2351,yraR,6598024,6598024,6597692,332,0,utRho08
2352,yrbG,13360844,13361100,13360844,256,152,utRho08
2353,yrbL,6696842,6696904,6696842,62,0,utRho08
2354,yrbN,6616172,6616172,6615866,306,4956,utRho08
2355,yrdB,6860176,6860176,6860046,130,0,utRho08
2356,yrfF,7052548,7052938,7052548,390,258,utRho08
2357,yrhB,7169440,7169518,7169440,78,0,utRho08
2358,ysaB,7451804,7451804,7451424,380,0,utRho08
2359,ysgA,8032686,8032686,8032338,348,106,utRho08
2360,ytfB,8857638,8857638,8857434,204,176,utRho08
2361,ytfE,8864018,8864018,8863966,52,0,utRho08
2362,ytfF,8866296,8866296,8866130,166,0,utRho08
2363,ytfH,8868164,8868226,8868164,62,0,utRho08
2364,ytfI,8875234,8875414,8875234,180,0,utRho08
2365,ytfJ,8878572,8878572,8878524,48,244,utRho08
2366,ytfK,8879022,8879174,8879022,152,132,utRho08
2367,ytfL,8882642,8882642,8882430,212,0,utRho08
2368,ytfQ,8899634,8899924,8899634,290,82,utRho08
2369,ytjB,9249598,9249598,9249578,20,0,utRho08
2370,yzfA,8896588,8896588,8896490,98,0,utRho08
2371,zapA,6111102,6111224,6111102,122,2814,utRho08
2372,zapB,8236772,8237030,8236772,258,0,utRho08
2373,zapC,2011700,2011904,2011700,204,12,utRho08
2374,zinT,4082692,4082750,4082692,58,0,utRho08
2375,zipA,5062814,5062814,5062466,348,68,utRho08
2376,zitB,1569716,1569716,1569646,70,0,utRho08
2377,zntA,7212844,7212902,7212844,58,0,utRho08
2378,zntR,6878336,6878336,6878260,76,6,utRho08
2379,znuA,3885322,3885322,3885166,156,144,utRho08
2380,znuC,3885268,3885324,3885268,56,72,utRho08
2381,zraP,8403424,8403424,8403376,48,0,utRho08
2382,zraS,8403810,8403852,8403810,42,0,utRho08
2383,zupT,6364866,6365100,6364866,234,126,utRho08
2384,zur,8520282,8520282,8520006,276,686,utRho08
2385,zwf,3872752,3872752,3872628,124,86,utRho08
0,C0343,2818676,2818728,2818676,52,0,utRho09
1,aaeB,6776526,6776526,6776376,150,0,utRho09
2,aaeR,6778762,6779040,6778762,278,44,utRho09
3,aaeX,6778860,6778860,6778674,186,82,utRho09
4,aat,1854920,1854920,1854864,56,64,utRho09
5,accA,416822,417242,416822,420,2118,utRho09
6,accB,6810280,6810872,6810280,592,8024,utRho09
7,accD,4868030,4868030,4867852,178,1046,utRho09
8,aceB,8430804,8430956,8430804,152,4,utRho09
9,aceE,245938,246034,245938,96,166,utRho09
10,ackA,4826918,4826940,4826918,22,2822,utRho09
11,acnA,2670848,2671662,2670848,814,836,utRho09
12,acnB,263038,263230,263038,192,752,utRho09
13,acpP,2303148,2303230,2303148,82,722,utRho09
14,acpS,5402324,5402324,5401996,328,446,utRho09
15,acrA,971396,971396,971238,158,426,utRho09
16,acrB,969370,969370,968806,564,2812,utRho09
17,acrD,5174950,5175190,5174950,240,6,utRho09
18,acrE,6827404,6827728,6827404,324,0,utRho09
19,acrR,971398,971522,971398,124,180,utRho09
20,acrZ,1589502,1589546,1589502,44,34,utRho09
21,acs,8575190,8575190,8574742,448,16,utRho09
22,actP,8569870,8569870,8569804,66,0,utRho09
23,ada,4620854,4620854,4620810,44,0,utRho09
24,add,3404404,3404466,3404404,62,82,utRho09
25,ade,7687802,7687928,7687802,126,52,utRho09
26,adhE,2596826,2596826,2596242,584,172,utRho09
27,adhP,3107988,3107988,3107676,312,970,utRho09
28,adiA,8681112,8681112,8681042,70,50,utRho09
29,adiC,8674404,8674404,8674062,342,2,utRho09
30,adiY,8676084,8676084,8675858,226,0,utRho09
31,adk,994278,994350,994278,72,30,utRho09
32,adrA,807374,807406,807374,32,0,utRho09
33,aer,6438240,6438240,6438152,88,72,utRho09
34,aes,1000102,1000102,999946,156,58,utRho09
35,agaR,6557406,6557406,6557330,76,0,utRho09
36,agaS,6563778,6563952,6563778,174,0,utRho09
37,agp,2131118,2131170,2131118,52,0,utRho09
38,agrA,7296126,7296126,7296126,0,0,utRho09
39,agrB,7296588,7296588,7296588,0,0,utRho09
40,ahpC,1277386,1277890,1277386,504,758,utRho09
41,ahpF,1278004,1279506,1278004,1502,79074,utRho09
42,ahr,8992698,8992698,8992418,280,0,utRho09
43,aidB,8828494,8828550,8828494,56,0,utRho09
44,ais,4731512,4731512,4731240,272,2,utRho09
45,alaA,4814816,4815122,4814816,306,114,utRho09
46,alaC,4996798,4996798,4996590,208,0,utRho09
47,alaE,5598140,5598328,5598140,188,34,utRho09
48,alaS,5644180,5644180,5644022,158,2848,utRho09
49,alaW,5036612,5036612,5036462,150,0,utRho09
50,aldA,2976380,2976464,2976380,84,384,utRho09
51,aldB,7513070,7513070,7513022,48,0,utRho09
52,alkA,4295118,4295118,4295080,38,44,utRho09
53,alkB,4618890,4618890,4618682,208,0,utRho09
54,allA,1064780,1064902,1064780,122,0,utRho09
55,allD,1092822,1092822,1092726,96,0,utRho09
56,allE,1088112,1088112,1088092,20,72,utRho09
57,allS,1064600,1064600,1064442,158,2,utRho09
58,alr,8531178,8531564,8531178,386,2290,utRho09
59,alsE,8617334,8617334,8616956,378,132,utRho09
60,alsK,8615990,8615990,8615598,392,0,utRho09
61,alx,6476740,6477160,6476740,420,4,utRho09
62,amiA,5104482,5104704,5104482,222,4,utRho09
63,amiC,5898378,5898378,5898020,358,2,utRho09
64,amn,4110062,4110122,4110062,60,0,utRho09
65,ampC,8758006,8758006,8757888,118,0,utRho09
66,ampD,237362,237466,237362,104,98,utRho09
67,ampG,907372,907372,907090,282,548,utRho09
68,ampH,792726,792726,792574,152,56,utRho09
69,amyA,4012230,4012312,4012230,82,0,utRho09
70,anmK,3439346,3439346,3439204,142,0,utRho09
71,ansB,6201580,6201580,6201456,124,8,utRho09
72,ansP,3052040,3052040,3051960,80,16,utRho09
73,apaG,104068,104068,103212,856,6018,utRho09
74,apaH,102586,102586,102444,142,5282,utRho09
75,apbE,4623188,4623188,4623068,120,0,utRho09
76,appA,2081198,2081234,2081198,36,32,utRho09
77,appC,2075420,2075480,2075420,60,0,utRho09
78,appY,1167134,1167362,1167134,228,0,utRho09
79,apt,982620,982824,982620,204,274,utRho09
80,aqpZ,1832424,1832424,1832094,330,6,utRho09
81,araB,140150,140150,140096,54,0,utRho09
82,araC,140482,140774,140482,292,2,utRho09
83,araE,5964416,5964416,5964364,52,0,utRho09
84,araF,3972476,3972476,3972256,220,54,utRho09
85,araH,3967120,3967120,3967086,34,0,utRho09
86,araJ,825058,825058,824962,96,12,utRho09
87,arcA,9281602,9281602,9280612,990,4828,utRho09
88,arcB,6706098,6706098,6706050,48,2,utRho09
89,arcZ,6701154,6701154,6701154,0,0,utRho09
90,arfA,6877346,6877346,6877298,48,2,utRho09
91,argA,5898312,5898484,5898312,172,0,utRho09
92,argC,8309770,8310002,8309770,232,22,utRho09
93,argD,6980442,6980442,6980360,82,2,utRho09
94,argE,8310156,8310156,8309694,462,76,utRho09
95,argF,580680,580680,580610,70,0,utRho09
96,argG,6637124,6637274,6637124,150,0,utRho09
97,argI,8956688,8956688,8956622,66,0,utRho09
98,argO,6137672,6137672,6137616,56,26,utRho09
99,argP,6119460,6119506,6119460,46,0,utRho09
100,argR,6769204,6769406,6769204,202,58,utRho09
101,argS,3920002,3920124,3920002,122,0,utRho09
102,argT,4855698,4855698,4855582,116,0,utRho09
103,argU,1129406,1129446,1129406,40,0,utRho09
104,argW,4932616,4932618,4932616,2,0,utRho09
105,argX,7964728,7964750,7964728,22,4,utRho09
106,aroF,5482402,5482402,5482300,102,0,utRho09
107,aroG,1571182,1571266,1571182,84,78,utRho09
108,aroH,3576636,3576870,3576636,234,570,utRho09
109,aroK,7038760,7038760,7038128,632,1906,utRho09
110,aroL,812560,812810,812560,250,48,utRho09
111,aroP,243342,243342,243102,240,0,utRho09
112,arpA,8445382,8445382,8444974,408,44,utRho09
113,arrS,7316108,7316108,7316108,0,0,utRho09
114,arsR,7297024,7297056,7297024,32,0,utRho09
115,artJ,1801252,1801252,1801150,102,0,utRho09
116,artP,1807686,1807686,1807468,218,8,utRho09
117,ascF,5678858,5679048,5678858,190,0,utRho09
118,ascG,5678574,5678574,5678528,46,0,utRho09
119,aslB,7965562,7965916,7965562,354,1480,utRho09
120,asnA,7854258,7854310,7854258,52,0,utRho09
121,asnB,1398444,1398444,1398354,90,40,utRho09
122,asnC,23562186,23562186,23562018,168,6,utRho09
123,asnS,1978088,1978088,1977970,118,10814,utRho09
124,asnT,4089082,4089098,4089082,16,218,utRho09
125,asnU,4119690,4119702,4119690,12,0,utRho09
126,asnV,4124504,4124520,4124504,16,0,utRho09
127,aspA,17473728,17473728,17473308,420,56,utRho09
128,aspC,1971486,1971486,1971418,68,508,utRho09
129,aspS,3901402,3901402,3901044,358,32,utRho09
130,aspT,7893560,7893744,7893560,184,132274,utRho09
131,aspV,473826,473862,473826,36,42,utRho09
132,asr,3342654,3342752,3342654,98,0,utRho09
133,astC,3664088,3664088,3663964,124,0,utRho09
134,astE,3654138,3654138,3653846,292,2,utRho09
135,atoD,4646824,4646894,4646824,70,16,utRho09
136,atpB,7844540,7844540,7844102,438,616,utRho09
137,atpC,7832118,7832118,7831944,174,2826,utRho09
138,atpI,7845050,7845050,7844880,170,42,utRho09
139,avtA,7479348,7479410,7479348,62,52,utRho09
140,azoR,2965982,2965982,2965720,262,58,utRho09
141,azuC,3976002,3976002,3975918,84,0,utRho09
142,bacA,6408350,6408350,6408262,88,76,utRho09
143,bamA,394052,395856,394052,1804,1360,utRho09
144,bamB,5277950,5277950,5277304,646,1444,utRho09
145,bamC,5198028,5198028,5197730,298,1364,utRho09
146,bamD,5471922,5472292,5471922,370,8354,utRho09
147,bamE,5506972,5507210,5506972,238,288,utRho09
148,basS,8666954,8666954,8666544,410,230,utRho09
149,bax,7474468,7474468,7474354,114,2,utRho09
150,bcp,5200874,5200956,5200874,82,2828,utRho09
151,bcsB,7385346,7385346,7385214,132,0,utRho09
152,bcsE,7392644,7392916,7392644,272,0,utRho09
153,bdcA,8948128,8948128,8948106,22,10,utRho09
154,bdcR,8948192,8948248,8948192,56,0,utRho09
155,bdm,3112680,3112680,3112560,120,0,utRho09
156,betA,654522,654522,654494,28,612,utRho09
157,betI,658722,658722,658668,54,0,utRho09
158,betT,658842,658926,658842,84,0,utRho09
159,bfr,6933498,6933498,6933450,48,0,utRho09
160,bglG,23440182,23440182,23439402,780,0,utRho09
161,bglX,4444240,4444240,4443978,262,0,utRho09
162,bhsA,2337962,2338146,2337962,184,0,utRho09
163,bioA,1618584,1618584,1618514,70,10,utRho09
164,bioB,1618604,1618688,1618604,84,0,utRho09
165,bioH,7089716,7089716,7089688,28,0,utRho09
166,bisC,7433026,7433026,7432788,238,2,utRho09
167,blc,8755490,8755490,8755444,46,0,utRho09
168,blr,3409024,3409102,3409024,78,28,utRho09
169,bluF,2431226,2431226,2430950,276,602,utRho09
170,bluR,2428226,2428226,2428118,108,34,utRho09
171,bolA,908698,908944,908698,246,0,utRho09
172,borD,1157842,1157842,1157786,56,0,utRho09
173,brnQ,838976,839182,838976,206,938,utRho09
174,bssR,1756492,1756496,1756492,4,0,utRho09
175,bssS,2242116,2242116,2241910,206,104,utRho09
176,btuB,8326798,8327278,8326798,480,4456,utRho09
177,cadB,8720212,8720212,8720062,150,0,utRho09
178,cadC,8723926,8723926,8723868,58,0,utRho09
179,caiE,70998,70998,70742,256,0,utRho09
180,caiF,68436,68600,68436,164,10,utRho09
181,caiT,84074,84074,83862,212,0,utRho09
182,can,285406,285406,285340,66,34,utRho09
183,carA,59102,59302,59102,200,2,utRho09
184,carB,61550,61634,61550,84,262,utRho09
185,cas2,5757830,5757830,5757706,124,4,utRho09
186,casA,5768638,5768638,5768276,362,2,utRho09
187,cbl,4121882,4121882,4121828,54,2,utRho09
188,cbpA,2128074,2128074,2127550,524,22,utRho09
189,cbrA,7738628,7738754,7738628,126,0,utRho09
190,cbrB,7794958,7795012,7794958,54,48,utRho09
191,ccmH,4585242,4585242,4584820,422,0,utRho09
192,cdaR,364894,364926,364894,32,0,utRho09
193,cdd,4463638,4463688,4463638,50,108,utRho09
194,cdh,8219814,8219860,8219814,46,4,utRho09
195,cdsA,391110,391354,391110,244,1838,utRho09
196,cedA,3627484,3627484,3627326,158,22,utRho09
197,cfa,3482402,3482826,3482402,424,132,utRho09
198,chaC,2544844,2544972,2544844,128,38,utRho09
199,chbB,3643452,3643452,3643238,214,0,utRho09
200,chbG,3634624,3634624,3634270,354,0,utRho09
201,cheW,3946924,3946924,3946678,246,2286,utRho09
202,chiA,6939792,6939792,6939706,86,4,utRho09
203,chiP,1416472,1416668,1416472,196,0,utRho09
204,cho,3646984,3647030,3646984,46,0,utRho09
205,chpS,8896804,8896894,8896804,90,0,utRho09
206,cirA,4493884,4493884,4493538,346,62,utRho09
207,citC,1304078,1304078,1303712,366,0,utRho09
208,citT,1293264,1293264,1293160,104,4,utRho09
209,clcA,350104,350214,350104,110,36,utRho09
210,clpA,1846160,1846528,1846160,368,4,utRho09
211,clpB,5468410,5468410,5468346,64,30,utRho09
212,clpP,913154,913354,913154,200,592,utRho09
213,clpS,1845500,1845826,1845500,326,2,utRho09
214,clpX,914404,914852,914404,448,1860,utRho09
215,clsA,2617346,2617346,2617290,56,2,utRho09
216,clsC,2212584,2212710,2212584,126,780,utRho09
217,cmk,1922330,1922402,1922330,72,46,utRho09
218,cnu,3409522,3409898,3409522,376,664,utRho09
219,coaA,8350214,8350214,8350052,162,496,utRho09
220,cobC,1340092,1340092,1339814,278,302,utRho09
221,cobT,4129202,4129202,4128934,268,70,utRho09
222,cobU,4131944,4131944,4131528,416,204,utRho09
223,codB,709768,709844,709768,76,42,utRho09
224,comR,2337726,2337726,2337664,62,0,utRho09
225,copA,1022822,1022822,1022758,64,0,utRho09
226,corA,8002388,8002852,8002388,464,8572,utRho09
227,cpdB,8873258,8873258,8873130,128,126,utRho09
228,cptB,6082198,6082198,6082140,58,32,utRho09
229,cpxA,8210202,8210202,8209950,252,188,utRho09
230,cpxP,8211570,8211640,8211570,70,80,utRho09
231,cpxR,8211372,8211372,8211340,32,0,utRho09
232,cra,175894,176056,175894,162,4,utRho09
233,crcB,1316016,1316016,1315876,140,0,utRho09
234,creA,9270486,9271042,9270486,556,278,utRho09
235,creD,9276320,9276356,9276320,36,64,utRho09
236,crl,515620,515658,515620,38,614,utRho09
237,crp,6971906,6972240,6971906,334,4180,utRho09
238,crr,5070960,5071668,5070960,708,4924,utRho09
239,csdA,5886414,5886674,5886414,260,0,utRho09
240,csgB,2207718,2207902,2207718,184,0,utRho09
241,csgD,2206688,2206688,2206392,296,4,utRho09
242,csgG,2203510,2203510,2203368,142,64,utRho09
243,csiD,5577854,5577970,5577854,116,0,utRho09
244,csiE,5330802,5330870,5330802,68,0,utRho09
245,csiR,5590942,5591348,5590942,406,0,utRho09
246,cspA,7439778,7440098,7439778,320,53992,utRho09
247,cspB,3283430,3283430,3283108,322,22,utRho09
248,cspC,3815018,3815018,3814870,148,426,utRho09
249,cspD,1845352,1845352,1845180,172,1774,utRho09
250,cspE,1314294,1314584,1314294,290,36,utRho09
251,cspF,3283380,3283710,3283380,330,60,utRho09
252,cspG,2102610,2102922,2102610,312,1266,utRho09
253,cspH,2102746,2102746,2102350,396,42,utRho09
254,cspI,3277624,3277624,3277334,290,40,utRho09
255,csrA,5638746,5638746,5638292,454,886,utRho09
256,csrB,5849048,5849048,5849048,0,0,utRho09
257,csrC,8102072,8102072,8102072,0,0,utRho09
258,csrD,6806850,6806850,6806664,186,66,utRho09
259,cstA,1259710,1259788,1259710,78,30,utRho09
260,cueO,274090,274166,274090,76,38,utRho09
261,cueR,1027948,1027986,1027948,38,0,utRho09
262,curA,3037784,3038054,3037784,270,0,utRho09
263,cusC,1191146,1191200,1191146,54,0,utRho09
264,cusR,1190924,1190924,1190886,38,0,utRho09
265,cutA,8730784,8730784,8730712,72,88,utRho09
266,cutC,3918534,3918534,3917920,614,308,utRho09
267,cvpA,4861600,4861600,4861526,74,32,utRho09
268,cvrA,2484328,2484328,2484142,186,84,utRho09
269,cyaA,7981548,7982306,7981548,758,444,utRho09
270,cyaR,4334228,4334224,4334228,4,42,utRho09
271,cyaY,7988166,7988166,7988118,48,20,utRho09
272,cybB,2981522,2981804,2981522,282,148,utRho09
273,cycA,8859560,8859728,8859560,168,240,utRho09
274,cydA,1542340,1542916,1542340,576,134,utRho09
275,cydC,1858800,1858800,1858390,410,0,utRho09
276,cydD,1862062,1862062,1861924,138,102,utRho09
277,cydX,1548300,1548392,1548300,92,292,utRho09
278,cynR,717418,717418,717380,38,0,utRho09
279,cynT,1435092,1435196,1435092,104,0,utRho09
280,cyoA,903306,903306,903220,86,3112,utRho09
281,cyoE,895540,895540,895410,130,1086,utRho09
282,cysB,2667576,2667710,2667576,134,326,utRho09
283,cysC,5748056,5748056,5747984,72,0,utRho09
284,cysD,5752736,5752736,5752658,78,0,utRho09
285,cysE,7565362,7565362,7565124,238,700,utRho09
286,cysG,6995508,6995656,6995508,148,36,utRho09
287,cysJ,5783928,5783928,5783796,132,736,utRho09
288,cysK,5064688,5064818,5064688,130,0,utRho09
289,cysP,5087114,5087114,5087056,58,2,utRho09
290,cysS,1109154,1109222,1109154,68,170,utRho09
291,cysT,3984100,3984100,3983974,126,114,utRho09
292,cysZ,5062766,5062926,5062766,160,70,utRho09
293,cytR,8249018,8249018,8248912,106,8,utRho09
294,dacA,1328002,1328002,1327926,76,34,utRho09
295,dacB,6657714,6657926,6657714,212,0,utRho09
296,dacC,1761306,1761454,1761306,148,2,utRho09
297,dadA,2475018,2475142,2475018,124,22,utRho09
298,dam,7032504,7032504,7031826,678,1824,utRho09
299,damX,7035200,7035200,7034612,588,280,utRho09
300,dapA,5199568,5199568,5199520,48,0,utRho09
301,dapB,56576,56748,56576,172,148,utRho09
302,dapD,371954,371954,371894,60,186,utRho09
303,dapE,5183120,5183214,5183120,94,490,utRho09
304,dcp,3254844,3254844,3254760,84,48,utRho09
305,dcrB,7219534,7219910,7219534,376,6,utRho09
306,dctA,7366996,7366996,7366894,102,570,utRho09
307,dcuA,8733686,8733686,8733546,140,6,utRho09
308,dcuB,8698182,8698182,8697488,694,216,utRho09
309,dcuC,1312166,1312166,1311936,230,0,utRho09
310,dcuD,6749166,6749738,6749166,572,48,utRho09
311,dcuR,8701130,8701130,8700068,1062,590,utRho09
312,dcuS,8703370,8703370,8703324,46,0,utRho09
313,dcyD,3999016,3999016,3998960,56,0,utRho09
314,ddpX,3126498,3126498,3126152,346,0,utRho09
315,deaD,6615818,6615818,6615720,98,1940,utRho09
316,dedA,4869880,4869880,4869482,398,13714,utRho09
317,dedD,4863750,4863750,4863368,382,124,utRho09
318,def,6867300,6867380,6867300,80,0,utRho09
319,degP,361690,361768,361690,78,0,utRho09
320,degQ,6761308,6761486,6761308,178,816,utRho09
321,deoB,9239134,9239206,9239134,72,0,utRho09
322,deoC,9233358,9234646,9233358,1288,70,utRho09
323,dfp,7625406,7625462,7625406,56,62,utRho09
324,dgcZ,3247758,3247758,3247700,58,2,utRho09
325,dgkA,8512914,8513274,8512914,360,366,utRho09
326,dgt,358392,358474,358392,82,22,utRho09
327,dhaK,2501888,2501888,2501676,212,596,utRho09
328,dhaR,2502006,2502132,2502006,126,54,utRho09
329,dicB,3299194,3299218,3299194,24,0,utRho09
330,dicC,3295752,3295752,3295700,52,0,utRho09
331,dinB,501760,501796,501760,36,0,utRho09
332,dinD,7635398,7635520,7635398,122,152,utRho09
333,dinG,1666146,1666140,1666146,6,12,utRho09
334,dinI,2243018,2243018,2242974,44,50,utRho09
335,dinJ,493230,493230,493004,226,22,utRho09
336,dinQ,7295964,7295964,7295576,388,996,utRho09
337,djlA,114536,114728,114536,192,2,utRho09
338,dkgA,6313142,6313246,6313142,104,10,utRho09
339,dkgB,458196,458334,458196,138,2,utRho09
340,dksA,321502,321502,321208,294,1042,utRho09
341,dld,4444164,4444370,4444164,206,0,utRho09
342,dmlA,3763424,3763824,3763424,400,64,utRho09
343,dmlR,3763710,3763710,3763618,92,28,utRho09
344,dmsA,1881646,1881918,1881646,272,0,utRho09
345,dnaA,7767922,7767922,7767458,464,1000,utRho09
346,dnaB,8528566,8528628,8528566,62,112,utRho09
347,dnaK,24096,24326,24096,230,398,utRho09
348,dnaN,7765466,7765466,7764642,824,910,utRho09
349,dnaQ,471868,472134,471868,266,368,utRho09
350,dnaT,18406460,18406460,18406068,392,48,utRho09
351,dnaX,984112,984184,984112,72,160,utRho09
352,dosP,3131486,3131486,3131466,20,0,utRho09
353,dpiB,1303968,1304470,1303968,502,4,utRho09
354,dppA,7415740,7415740,7415410,330,2076,utRho09
355,dps,1697900,1697900,1697822,78,0,utRho09
356,dsbA,8086754,8086836,8086754,82,2180,utRho09
357,dsbB,2466294,2466294,2466060,234,0,utRho09
358,dsbC,6079266,6079266,6077644,1622,938,utRho09
359,dsbG,1277600,1277600,1277146,454,424,utRho09
360,dsdA,4958242,4958404,4958242,162,40,utRho09
361,dsdC,4955492,4955492,4955258,234,0,utRho09
362,dsdX,4955642,4955694,4955642,52,2,utRho09
363,dsrA,4050626,4050626,4050626,0,0,utRho09
364,dsrB,4049686,4049686,4049646,40,0,utRho09
365,dtpD,1485340,1485340,1485112,228,30,utRho09
366,dusA,8523200,8523338,8523200,138,1420,utRho09
367,dusB,6820492,6820560,6820492,68,186,utRho09
368,dusC,4460790,4460790,4460770,20,0,utRho09
369,dut,7627704,7627864,7627704,160,2000,utRho09
370,dxr,386670,387042,386670,372,1114,utRho09
371,ebgA,6445102,6445266,6445102,164,92,utRho09
372,ebgR,6442874,6442932,6442874,58,116,utRho09
373,ecnB,8753018,8753106,8753018,88,142,utRho09
374,eco,4607594,4607810,4607594,216,12,utRho09
375,ecpA,621594,621594,621342,252,0,utRho09
376,ecpB,620238,620238,620052,186,18,utRho09
377,ecpR,622964,622964,622672,292,0,utRho09
378,eda,3866218,3866218,3865512,706,20,utRho09
379,edd,3869426,3869426,3869208,218,0,utRho09
380,efeO,2164308,2164486,2164308,178,0,utRho09
381,efeU_1,2162614,2162712,2162614,98,2,utRho09
382,efp,8751134,8751398,8751134,264,2604,utRho09
383,elaA,4763372,4763372,4763086,286,108,utRho09
384,elaD,4765308,4765426,4765308,118,0,utRho09
385,elfA,1995530,1995736,1995530,206,0,utRho09
386,elfD,1996642,1996980,1996642,338,44,utRho09
387,emrD,7707690,7707844,7707690,154,20,utRho09
388,emrK,4966896,4966896,4966678,218,0,utRho09
389,emrY,4964668,4964668,4964352,316,48,utRho09
390,emtA,2486250,2486360,2486250,110,0,utRho09
391,endA,12361100,12361388,12361100,288,4,utRho09
392,eno,5817692,5817692,5815882,1810,4744,utRho09
393,entC,1249662,1249770,1249662,108,0,utRho09
394,entD,1220508,1220508,1220158,350,4,utRho09
395,entH,1258584,1258600,1258584,16,22,utRho09
396,entS,1244506,1244600,1244506,94,0,utRho09
397,envR,6827266,6827266,6826930,336,0,utRho09
398,epd,12295292,12295292,12294764,528,0,utRho09
399,epmA,8765236,8765286,8765236,50,0,utRho09
400,epmB,8751406,8751406,8751314,92,1386,utRho09
401,eptB,7421162,7421162,7420950,212,120,utRho09
402,eptC,8300622,8300622,8300530,92,196,utRho09
403,erfK,4126708,4126708,4126646,62,82,utRho09
404,erpA,353122,353220,353122,98,60,utRho09
405,esrE,8039956,8039956,8039956,0,0,utRho09
406,essD,1153746,1154796,1153746,1050,34,utRho09
407,etk,2088606,2088606,2088420,186,0,utRho09
408,evgA,4967262,4967510,4967262,248,106,utRho09
409,exbB,6304028,6304028,6303968,60,2,utRho09
410,exbD,6302780,6302780,6302486,294,40,utRho09
411,exuR,6493016,6493304,6493016,288,142,utRho09
412,exuT,6490004,6490208,6490004,204,0,utRho09
413,fabA,2032996,2032996,2032940,56,240,utRho09
414,fabB,4883282,4883282,4883210,72,30,utRho09
415,fabH,2297032,2297518,2297032,486,2368,utRho09
416,fabI,2702236,2702236,2702078,158,190,utRho09
417,fadB,8062026,8062026,8061942,84,0,utRho09
418,fadD,3779614,3779614,3779492,122,44,utRho09
419,fadE,486812,486812,486606,206,0,utRho09
420,fadH,6463248,6463330,6463248,82,0,utRho09
421,fadI,4921022,4921022,4920938,84,6,utRho09
422,fadL,4922410,4922600,4922410,190,124,utRho09
423,fadM,928720,928804,928720,84,0,utRho09
424,fadR,2469810,2469876,2469810,66,0,utRho09
425,fbaB,4357334,4357334,4357128,206,0,utRho09
426,fdhE,8162722,8162722,8162456,266,1756,utRho09
427,fdhF,8598814,8598814,8598732,82,0,utRho09
428,fdnG,3094744,3094802,3094744,58,0,utRho09
429,fdrA,1093012,1093360,1093012,348,0,utRho09
430,feaB,2894994,2895038,2894994,44,0,utRho09
431,feaR,2894734,2894734,2894566,168,0,utRho09
432,fecA,9033454,9033454,9033354,100,8,utRho09
433,fecE,9023288,9023288,9022914,374,4550,utRho09
434,fecI,9036564,9036564,9036470,94,2,utRho09
435,feoA,7080114,7080326,7080114,212,6,utRho09
436,fepA,1225334,1225334,1224988,346,0,utRho09
437,fepB,1249454,1249454,1249020,434,0,utRho09
438,fepD,1244468,1244468,1244378,90,0,utRho09
439,fes,1225374,1225630,1225374,256,42,utRho09
440,ffh,5495706,5495706,5495590,116,938,utRho09
441,ffs,952576,952848,952576,272,8,utRho09
442,fhuA,334884,334968,334884,84,40,utRho09
443,fhuE,2323294,2323294,2323102,192,4,utRho09
444,fhuF,9211504,9211504,9211326,178,212,utRho09
445,fic,6983296,6983296,6982926,370,656,utRho09
446,fieF,8212864,8212938,8212864,74,2,utRho09
447,fimA,9085388,9086230,9085388,842,168,utRho09
448,fimB,9081334,9081914,9081334,580,470,utRho09
449,fimE,9083742,9084074,9083742,332,6,utRho09
450,fimZ,1129214,1129214,1128960,254,2,utRho09
451,fiu,1683296,1683296,1683062,234,2,utRho09
452,fixA,84650,84806,84650,156,0,utRho09
453,fkpA,6955050,6955050,6954838,212,12500,utRho09
454,fldA,2846084,2846084,2845860,224,3592,utRho09
455,fldB,6079644,6079710,6079644,66,116,utRho09
456,flgA,2261770,2261770,2261726,44,2,utRho09
457,flgB,2261986,2262036,2261986,50,30,utRho09
458,flgK,2276702,2276756,2276702,54,870,utRho09
459,flgM,2260330,2260330,2260256,74,480,utRho09
460,flgN,2259828,2259828,2259660,168,78,utRho09
461,flhB,3932432,3932432,3932382,50,538,utRho09
462,flhC,3955864,3955864,3955688,176,66,utRho09
463,flhD,3957154,3957154,3956394,760,144,utRho09
464,fliA,4003638,4003638,4003578,60,122,utRho09
465,fliC,4007352,4007352,4007212,140,1508,utRho09
466,fliD,4007634,4007744,4007634,110,352,utRho09
467,fliE,4026186,4026186,4026028,158,0,utRho09
468,fliF,4026292,4026458,4026292,166,372,utRho09
469,fliL,4039168,4039236,4039168,68,160,utRho09
470,flk,4875824,4875900,4875824,76,0,utRho09
471,flu,4142634,4143078,4142634,444,2,utRho09
472,flxA,3292776,3292810,3292776,34,58,utRho09
473,fnr,2799104,2799104,2799052,52,68,utRho09
474,fnrS,2818258,2818258,2818258,0,0,utRho09
475,focA,1909628,1909628,1908932,696,442,utRho09
476,folA,99598,99646,99598,48,0,utRho09
477,folB,6409296,6409296,6409178,118,12,utRho09
478,folD,1115562,1115562,1115482,80,242,utRho09
479,folE,4487696,4487696,4487304,392,3262,utRho09
480,fpr,8228998,8228998,8228944,54,4,utRho09
481,frc,4986878,4986878,4986508,370,4,utRho09
482,frdA,8764824,8764824,8764636,188,180,utRho09
483,frdD,8758948,8758948,8758732,216,818,utRho09
484,fre,8052886,8053054,8052886,168,1564,utRho09
485,frlA,6999518,6999820,6999518,302,4,utRho09
486,frr,385624,385744,385624,120,1570,utRho09
487,frsA,513004,513054,513004,50,98,utRho09
488,fruB,4527194,4527194,4526990,204,4,utRho09
489,frvR,8179804,8179804,8179710,94,0,utRho09
490,fryA,5008986,5008986,5008970,16,2,utRho09
491,fsaA,1727060,1727284,1727060,224,2,utRho09
492,fsr,1009710,1009710,1009392,318,32,utRho09
493,ftnA,3977364,3977432,3977364,68,14,utRho09
494,ftnB,3973550,3973850,3973550,300,124,utRho09
495,ftsA,207122,207964,207122,842,1188,utRho09
496,ftsB,5745802,5745802,5745640,162,48,utRho09
497,ftsH,6654204,6654204,6653870,334,588,utRho09
498,ftsK,1865858,1866448,1865858,590,2338,utRho09
499,ftsL,181376,182064,181376,688,2340,utRho09
500,ftsP,6325732,6325732,6325338,394,414,utRho09
501,ftsQ,205484,206310,205484,826,524,utRho09
502,ftsX,7204512,7204512,7204172,340,342,utRho09
503,ftsZ,209272,210610,209272,1338,98,utRho09
504,fucA,5867708,5867708,5867376,332,24,utRho09
505,fucP,5868238,5868470,5868238,232,4,utRho09
506,fumA,6753760,6753760,6753508,252,4720,utRho09
507,fumB,8694696,8694696,8694652,44,0,utRho09
508,fumC,3373418,3373418,3373176,242,0,utRho09
509,fur,2842892,2842892,2842584,308,7876,utRho09
510,fusA,6947370,6947370,6947028,342,40118,utRho09
511,fxsA,8737206,8737328,8737206,122,42,utRho09
512,gabD,5581824,5582546,5581824,722,820,utRho09
513,gadA,7335214,7335214,7335160,54,0,utRho09
514,gadB,3144144,3144144,3144090,54,0,utRho09
515,gadC,3141168,3141168,3140978,190,4,utRho09
516,gadE,7315600,7316732,7315600,1132,2,utRho09
517,gadW,7329562,7329562,7329236,326,2,utRho09
518,gadX,14663356,14663356,14663240,116,0,utRho09
519,gadY,7329728,7329728,7329728,0,0,utRho09
520,galE,1584354,1584354,1584110,244,2,utRho09
521,galF,4228702,4228702,4228654,48,2,utRho09
522,galM,1577796,1577796,1577674,122,614,utRho09
523,galP,6176510,6176568,6176510,58,4,utRho09
524,galR,5953138,5953198,5953138,60,108,utRho09
525,galS,4483420,4483420,4483336,84,0,utRho09
526,galU,2582810,2582914,2582810,104,444,utRho09
527,gapA,3724480,3725542,3724480,1062,6048,utRho09
528,garP,6549868,6549868,6549814,54,82,utRho09
529,gatY,4354468,4354468,4354408,60,38,utRho09
530,gatZ,4352864,4352864,4352642,222,16972,utRho09
531,gcd,282558,282558,282450,108,0,utRho09
532,gcl,1067814,1067832,1067814,18,0,utRho09
533,gcvA,5885278,5885278,5885134,144,0,utRho09
534,gcvB,5885392,5885392,5885392,0,0,utRho09
535,gcvR,5199758,5199812,5199758,54,36,utRho09
536,gcvT,6101544,6101544,6101334,210,1488,utRho09
537,gdhA,3684616,3684742,3684616,126,0,utRho09
538,gfcA,2099668,2099668,2099488,180,20,utRho09
539,gfcD,2096236,2096236,2095890,346,34,utRho09
540,ghrA,2195648,2195772,2195648,124,2,utRho09
541,ghrB,7434378,7434620,7434378,242,456,utRho09
542,glcA,6242728,6242728,6242558,170,118,utRho09
543,glcC,6256412,6256544,6256412,132,2,utRho09
544,glcD,6256152,6256152,6256042,110,0,utRho09
545,gldA,8278092,8278092,8278070,22,10,utRho09
546,glgA,7136784,7136784,7136066,718,302,utRho09
547,glgB,7147314,7147314,7147004,310,112,utRho09
548,glgC,7139142,7139142,7138656,486,706,utRho09
549,glgP,7133546,7133546,7133162,384,6,utRho09
550,glgS,6384024,6384024,6383878,146,4,utRho09
551,glgX,7142838,7142838,7142638,200,0,utRho09
552,glk,5018922,5018922,5018852,70,18,utRho09
553,glmS,7827622,7827622,7827336,286,6924,utRho09
554,glmU,7830652,7830652,7830400,252,106,utRho09
555,glmY,10765360,10765360,10765360,0,0,utRho09
556,glmZ,7972864,7972864,7972864,0,0,utRho09
557,glnA,16232888,16232888,16232136,752,1156,utRho09
558,glnB,5375052,5375052,5374816,236,246,utRho09
559,glnD,377310,377310,377300,10,2,utRho09
560,glnE,6399602,6399602,6399282,320,60,utRho09
561,glnH,1696396,1696396,1696008,388,14,utRho09
562,glnK,945112,945196,945112,84,4,utRho09
563,glnL,8112742,8112742,8112678,64,0,utRho09
564,glnQ,1693262,1693262,1692926,336,558,utRho09
565,glnS,1411998,1412186,1411998,188,1022,utRho09
566,gloA,3455602,3455674,3455602,72,72,utRho09
567,gloB,469852,469852,469564,288,514,utRho09
568,glpA,4705166,4705294,4705166,128,0,utRho09
569,glpD,7123942,7124026,7123942,84,32,utRho09
570,glpE,7123698,7123698,7123646,52,40,utRho09
571,glpF,8236322,8236322,8236180,142,254,utRho09
572,glpG,7122960,7122960,7122904,56,344,utRho09
573,glpR,7121782,7121782,7121210,572,196,utRho09
574,glpT,4704902,4704902,4704748,154,164,utRho09
575,glpX,8231212,8231212,8231158,54,3776,utRho09
576,glrK,5382246,5382246,5382196,50,132,utRho09
577,gltA,1509534,1509534,1508936,598,12986,utRho09
578,gltB,6709018,6709264,6709018,246,48,utRho09
579,gltI,1375792,1375792,1375494,298,2042,utRho09
580,gltP,8588536,8588962,8588536,426,808,utRho09
581,gltS,7657382,7657382,7657330,52,418,utRho09
582,gltX,5041568,5041568,5041344,224,114,utRho09
583,gluQ,320286,320286,320224,62,100,utRho09
584,glyA,5371148,5371148,5371014,134,192,utRho09
585,glyQ,7450708,7450708,7450636,72,200,utRho09
586,glyS,7448990,7448990,7448794,196,5264,utRho09
587,glyU,5998128,5998128,5998114,14,38,utRho09
588,glyV,8784626,8784720,8784626,94,44,utRho09
589,glyW,3984360,3984360,3984234,126,0,utRho09
590,gmhB,445612,445666,445612,54,0,utRho09
591,gmk,7642776,7642856,7642776,80,36,utRho09
592,gmr,2693686,2693686,2693484,202,52,utRho09
593,gnd,4202648,4202648,4202536,112,856,utRho09
594,gnsB,3275692,3275692,3275564,128,0,utRho09
595,gntK,14310580,14310580,14310368,212,148,utRho09
596,gntP,9102668,9102668,9102592,76,4,utRho09
597,gntR,7157760,7157760,7157452,308,540,utRho09
598,gntT,7092810,7093118,7092810,308,106,utRho09
599,gntU,7154170,7154170,7154122,48,2,utRho09
600,gntX,7089334,7089764,7089334,430,0,utRho09
601,gor,7292224,7292598,7292224,374,1308,utRho09
602,gpmA,1575340,1575340,1575190,150,0,utRho09
603,gpmM,7570374,7570520,7570374,146,0,utRho09
604,gpsA,7567620,7567620,7567322,298,17134,utRho09
605,gpt,511828,511954,511828,126,1496,utRho09
606,grcA,5433046,5433046,5432898,148,2,utRho09
607,greA,6657728,6657728,6657430,298,2314,utRho09
608,greB,7073488,7073624,7073488,136,0,utRho09
609,groL,8741566,8742050,8741566,484,1758,utRho09
610,groS,8741232,8741376,8741232,144,1594,utRho09
611,grpE,5501494,5501494,5501416,78,128,utRho09
612,grxA,1781552,1781552,1781506,46,0,utRho09
613,grxB,2248206,2248206,2248108,98,80,utRho09
614,grxC,7569152,7569152,7568884,268,10296,utRho09
615,grxD,3468324,3468324,3468202,122,17370,utRho09
616,gspA,6911268,6911268,6910796,472,2,utRho09
617,gspC,6910964,6911156,6910964,192,0,utRho09
618,gss,6277220,6277220,6277044,176,104,utRho09
619,gstA,3428654,3428754,3428654,100,0,utRho09
620,gstB,1761038,1761038,1760960,78,0,utRho09
621,guaB,5268214,5268214,5268140,74,348,utRho09
622,gudD,5839026,5839026,5838770,256,2,utRho09
623,gyrA,4678914,4678914,4678840,74,60,utRho09
624,gyrB,7760300,7760300,7760238,62,236,utRho09
625,hcaE,5337964,5338064,5337964,100,8,utRho09
626,hcaR,5337928,5337928,5337792,136,2,utRho09
627,hcaT,5336106,5336106,5335692,414,36,utRho09
628,hchA,4071260,4071670,4071260,410,0,utRho09
629,hcp,1828258,1828258,1827628,630,64,utRho09
630,hcr,1824400,1824400,1824300,100,0,utRho09
631,hdeA,7313582,7313582,7313480,102,0,utRho09
632,hdeD,7313920,7313990,7313920,70,12,utRho09
633,hdfR,7896320,7896320,7895934,386,2,utRho09
634,hdhA,3396244,3396244,3396080,164,14,utRho09
635,helD,2048876,2048942,2048876,66,0,utRho09
636,hemA,2527166,2527428,2527166,262,64,utRho09
637,hemB,779722,779722,779454,268,6,utRho09
638,hemF,5106410,5106450,5106410,40,22,utRho09
639,hemH,996062,996110,996062,48,2,utRho09
640,hemL,349882,349882,349764,118,84,utRho09
641,hemN,8103886,8104090,8103886,204,2,utRho09
642,hepA,127176,127176,126528,648,1380,utRho09
643,hflD,2385372,2385372,2385262,110,568,utRho09
644,hfq,8799602,8800576,8799602,974,2926,utRho09
645,hha,961006,961006,960616,390,144,utRho09
646,hicA,3018442,3018572,3018442,130,0,utRho09
647,higA,6468682,6468682,6468288,394,106,utRho09
648,higB,6468960,6468960,6468910,50,4,utRho09
649,hinT,2323642,2323770,2323642,128,0,utRho09
650,hipB,3184964,3184964,3184884,80,0,utRho09
651,hisB,4186720,4186936,4186720,216,854,utRho09
652,hisJ,4853674,4853674,4853576,98,14,utRho09
653,hisL,8359856,8359984,8359856,128,220,utRho09
654,hisS,5281284,5281284,5281150,134,430,utRho09
655,hlpA,400910,400964,400910,54,28,utRho09
656,hlyE,2460932,2460932,2460788,144,2,utRho09
657,hmp,5371594,5371670,5371594,76,0,utRho09
658,hns,2585916,2585916,2585844,72,2274,utRho09
659,hofM,7045856,7045856,7045502,354,6,utRho09
660,hokA,7441620,7441620,7441200,420,248,utRho09
661,hokC,33902,33902,33806,96,302,utRho09
662,hokE,1215462,1215672,1215462,210,0,utRho09
663,holC,8968546,8968546,8968560,14,816,utRho09
664,holD,9215562,9215606,9215562,44,2,utRho09
665,holE,3850040,3850216,3850040,176,280,utRho09
666,hpt,282720,282862,282720,142,120,utRho09
667,hrpB,324150,324210,324150,60,20,utRho09
668,hscB,5319048,5319048,5318934,114,1428,utRho09
669,hscC,1367188,1367188,1366786,402,516,utRho09
670,hsdS,9163004,9163004,9162924,80,16,utRho09
671,hslJ,2883560,2883560,2883486,74,124,utRho09
672,hslO,7059344,7059548,7059344,204,9224,utRho09
673,hslR,7058220,7058696,7058220,476,834,utRho09
674,hslV,8244708,8244708,8244574,134,42,utRho09
675,hsrA,7881412,7881412,7881224,188,24,utRho09
676,htgA,21286,21660,21286,374,82,utRho09
677,htpG,989634,990240,989634,606,5454,utRho09
678,htpX,3825236,3825236,3825152,84,0,utRho09
679,htrE,311036,311036,310852,184,4,utRho09
680,htrL,7587668,7587668,7587366,302,26,utRho09
681,hupA,8400352,8400562,8400352,210,42,utRho09
682,hupB,1845220,1845804,1845220,584,540,utRho09
683,hyaA,2063968,2064278,2063968,310,0,utRho09
684,hybO,6292726,6292726,6292522,204,526,utRho09
685,hycA,5700922,5700922,5700870,52,0,utRho09
686,hycI,5686204,5686204,5686086,118,14,utRho09
687,hydN,5676264,5676264,5676210,54,2,utRho09
688,hyfA,5202342,5202402,5202342,60,0,utRho09
689,hypA,11402508,11402588,11402508,80,8,utRho09
690,hypB,11403356,11404004,11403356,648,228,utRho09
691,hypF,5676210,5676210,5674850,1360,540,utRho09
692,hypT,9116634,9116634,9116578,56,0,utRho09
693,hyuA,6019660,6020056,6019660,396,0,utRho09
694,iaaA,1733074,1733136,1733074,62,0,utRho09
695,iadA,9119074,9119074,9119052,22,48,utRho09
696,iap,5753072,5753162,5753072,90,0,utRho09
697,ibaG,6673966,6673966,6673606,360,194,utRho09
698,ibpA,7735036,7735036,7734844,192,52,utRho09
699,ibpB,7733962,7733962,7733794,168,830,utRho09
700,icd,2389922,2390246,2389922,324,438,utRho09
701,iclR,8447304,8447304,8447256,48,0,utRho09
702,idi,6065876,6066130,6065876,254,0,utRho09
703,idnD,8988870,8988870,8988812,58,0,utRho09
704,idnK,8989194,8989246,8989194,52,2,utRho09
705,ihfA,3591442,3591442,3591104,338,864,utRho09
706,ihfB,1927498,1927656,1927498,158,1226,utRho09
707,ileS,43666,44782,43666,1116,5710,utRho09
708,ileX,6431194,6431196,6431194,2,0,utRho09
709,ilvA,15820940,15821324,15820940,384,228,utRho09
710,ilvC,7915824,7915940,7915824,116,0,utRho09
711,ilvE,15809552,15809936,15809552,384,152,utRho09
712,ilvI,170840,171260,170840,420,0,utRho09
713,ilvL,23701308,23701932,23701308,624,6,utRho09
714,ilvY,7915734,7915734,7915640,94,0,utRho09
715,inaA,4698998,4698998,4698944,54,0,utRho09
716,infA,1853370,1853370,1852886,484,2374,utRho09
717,infC,3602692,3602692,3601276,1416,6976,utRho09
718,insA-5,3958452,3958452,3958430,22,10,utRho09
719,insA-7,9036758,9037054,9036758,296,158,utRho09
720,insC-5,6372080,6372284,6372080,204,180,utRho09
721,insEF-2,785238,785238,785820,582,140,utRho09
722,insEF-4,2190310,2190310,2190892,582,132,utRho09
723,insG,9007098,9007098,9006862,236,22,utRho09
724,insH-1,550596,550596,550234,362,54,utRho09
725,insH-11,7306538,7306538,7306396,142,26,utRho09
726,insH-2,1151548,1151548,1151506,42,28,utRho09
727,insH-3,1378444,1378444,1378026,418,58,utRho09
728,insH-4,2791942,2792152,2791942,210,54,utRho09
729,insH-5,2857852,2857852,2857452,400,0,utRho09
730,insH-6,4135022,4135022,4134642,380,4,utRho09
731,insH-7,4206186,4206186,4205822,364,7450,utRho09
732,insH-9,6260050,6260356,6260050,306,46,utRho09
733,insI-3,9017372,9017372,9017234,138,6,utRho09
734,insJ,7441188,7441360,7441188,172,82,utRho09
735,insK,7442130,7442308,7442130,178,0,utRho09
736,insL-1,30760,30890,30760,130,504,utRho09
737,insL-2,1216112,1216130,1216112,18,28,utRho09
738,insL-3,5028644,5028662,5028644,18,32,utRho09
739,insN-1,540452,540484,540452,32,0,utRho09
740,intD,1132202,1132202,1131956,246,20,utRho09
741,intR,2826520,2826520,2826470,50,0,utRho09
742,intS,4933026,4933090,4933026,64,18,utRho09
743,intZ,5117386,5117542,5117386,156,8,utRho09
744,iraD,9113152,9113986,9113152,834,0,utRho09
745,iraM,2424246,2424246,2424006,240,0,utRho09
746,iraP,802638,802772,802638,134,0,utRho09
747,iscA,5319924,5319924,5319772,152,2680,utRho09
748,iscR,5324398,5324398,5324262,136,14748,utRho09
749,iscX,5313834,5313834,5313472,362,3892,utRho09
750,ispF,5743968,5743968,5743560,408,1532,utRho09
751,ispG,5283908,5283908,5283608,300,1228,utRho09
752,ispU,389568,389806,389568,238,228,utRho09
753,isrA,2811502,2811502,2811618,116,54,utRho09
754,istr-1,7706384,7706384,7706384,0,0,utRho09
755,istr-2,7706514,7706514,7706514,0,0,utRho09
756,ivbL,15412092,15412092,15411952,140,888,utRho09
757,ivy,480638,480686,480638,48,0,utRho09
758,katE,3627628,3627734,3627628,106,20,utRho09
759,katG,8267624,8267670,8267624,46,2,utRho09
760,kbaZ,6557732,6557828,6557732,96,0,utRho09
761,kbl,7585154,7585154,7585102,52,606,utRho09
762,kch,2621046,2621046,2620538,508,0,utRho09
763,kdgR,3820506,3820506,3820198,308,0,utRho09
764,kdpE,1443788,1443788,1443466,322,26,utRho09
765,kdpF,1457698,1457698,1457642,56,0,utRho09
766,kdsA,2535708,2536330,2535708,622,2570,utRho09
767,kdsC,6683438,6684546,6683438,1108,3076,utRho09
768,kduI,5968388,5968388,5968248,140,388,utRho09
769,kefF,94160,94492,94160,332,6,utRho09
770,kgtP,5451624,5451624,5451492,132,10,utRho09
771,kup,7862206,7862632,7862206,426,76,utRho09
772,lacI,735076,735076,735020,56,2,utRho09
773,lacZ,1465508,1465508,1465220,288,236,utRho09
774,ldcA,2486394,2486394,2486160,234,0,utRho09
775,ldhA,2885830,2885830,2885686,144,6,utRho09
776,ldrA,2538954,2538954,2538550,404,450,utRho09
777,ldrB,2540024,2540024,2539620,404,70,utRho09
778,ldrC,2541092,2541092,2540690,402,440,utRho09
779,ldrD,7400544,7400544,7400174,370,80,utRho09
780,lepA,5414392,5414392,5414248,144,242,utRho09
781,lepB,5410928,5410928,5410618,310,822,utRho09
782,leuD,159188,159188,158906,282,100,utRho09
783,leuE,3761600,3761600,3761518,82,2,utRho09
784,leuL,168048,168048,167416,632,4,utRho09
785,leuO,168308,168736,168308,428,8,utRho09
786,leuQ,9212864,9212864,9212802,62,2,utRho09
787,leuU,6644556,6644556,6644316,240,2524,utRho09
788,leuV,9212546,9212546,9212330,216,1180,utRho09
789,leuX,8992772,8992810,8992772,38,2,utRho09
790,lexA,8514174,8514230,8514174,56,36,utRho09
791,lhr,3456706,3458174,3456706,1468,2120,utRho09
792,ligA,5060402,5060402,5060352,50,0,utRho09
793,ligB,7642576,7642576,7642340,236,2,utRho09
794,lipA,1320602,1320602,1320432,170,74,utRho09
795,lipB,1324802,1324802,1324556,246,1378,utRho09
796,lit,2397032,2397390,2397032,358,66,utRho09
797,livJ,7199524,7199524,7199316,208,20,utRho09
798,livK,7195510,7195510,7195120,390,8,utRho09
799,lldP,7554578,7554798,7554578,220,4494,utRho09
800,lnt,1381968,1381968,1381762,206,484,utRho09
801,loiP,6163784,6163826,6163784,42,0,utRho09
802,lolA,1874656,1874738,1874656,82,334,utRho09
803,lolB,2527112,2527112,2527000,112,50,utRho09
804,lolC,2350748,2350854,2350748,106,0,utRho09
805,lon,917630,917776,917630,146,764,utRho09
806,lpcA,486936,487086,486936,150,0,utRho09
807,lpd,255434,255824,255434,390,2644,utRho09
808,lplA,9248476,9248476,9248234,242,1512,utRho09
809,lplT,5947878,5947878,5947724,154,0,utRho09
810,lpoA,6586422,6586800,6586422,378,320,utRho09
811,lpp,3514592,3514842,3514592,250,132,utRho09
812,lptA,6686598,6686760,6686598,162,986,utRho09
813,lptB,6686792,6687888,6686792,1096,1868,utRho09
814,lptD,114672,114672,114218,454,4542,utRho09
815,lptF,8972244,8972436,8972244,192,80,utRho09
816,lpxC,213016,213114,213016,98,11142,utRho09
817,lpxD,401920,401942,401920,22,38,utRho09
818,lpxL,2233418,2233418,2233164,254,118,utRho09
819,lpxM,3880456,3880456,3880386,70,46,utRho09
820,lpxP,4991156,4991290,4991156,134,146,utRho09
821,lrhA,4813312,4813312,4813282,30,20,utRho09
822,lrp,1864656,1865190,1864656,534,1000,utRho09
823,lspA,50028,50414,50028,386,932,utRho09
824,lsrA,3202920,3202980,3202920,60,0,utRho09
825,lsrR,3202514,3202514,3202482,32,0,utRho09
826,ltaE,1818640,1818640,1818588,52,12,utRho09
827,luxS,5630130,5630130,5629466,664,1828,utRho09
828,lysA,5957902,5957902,5957798,104,2,utRho09
829,lysC,8467232,8467232,8466466,766,208,utRho09
830,lysP,4497120,4497120,4497064,56,20,utRho09
831,lysR,5957900,5958042,5957900,142,0,utRho09
832,lysT,1561028,1561108,1561028,80,272,utRho09
833,lysU,8709610,8709610,8709434,176,0,utRho09
834,macB,1840188,1840694,1840188,506,224,utRho09
835,maeA,3111484,3111484,3111338,146,3874,utRho09
836,mak,820236,820288,820236,52,10,utRho09
837,malE,8492928,8492928,8492838,90,0,utRho09
838,malI,3398456,3398456,3398360,96,0,utRho09
839,malK,8493472,8493568,8493472,96,0,utRho09
840,malP,7105020,7105020,7104946,74,264,utRho09
841,malQ,7100798,7100798,7100140,658,144,utRho09
842,malS,14949880,14949988,14949880,108,0,utRho09
843,malT,7106048,7106170,7106048,122,108,utRho09
844,malX,3398626,3398710,3398626,84,0,utRho09
845,malZ,1689980,1690072,1689980,92,704,utRho09
846,manA,3377102,3377152,3377102,50,0,utRho09
847,manX,3803866,3804096,3803866,230,72,utRho09
848,marC,3237882,3237882,3237816,66,44,utRho09
849,marR,3238186,3238240,3238186,54,0,utRho09
850,matP,2036918,2036970,2036918,52,2,utRho09
851,mazE,5822736,5822736,5822678,58,6,utRho09
852,mazG,5821720,5821720,5821370,350,2708,utRho09
853,mcbA,1684306,1684306,1684112,194,0,utRho09
854,mcbR,3040192,3040524,3040192,332,0,utRho09
855,mcrA,2420278,2420692,2420278,414,28,utRho09
856,mcrC,9156124,9156124,9155916,208,62,utRho09
857,mdaB,6344814,6345060,6344814,246,0,utRho09
858,mdfA,1767138,1767346,1767138,208,0,utRho09
859,mdh,6768940,6768940,6768536,404,180,utRho09
860,mdoB,9198988,9198988,9198882,106,746,utRho09
861,mdoD,2993290,2993712,2993290,422,4,utRho09
862,mdoG,2218514,2218670,2218514,156,112,utRho09
863,mdtA,4307958,4308032,4307958,74,0,utRho09
864,mdtE,7318168,7318464,7318168,296,22,utRho09
865,mdtK,3486538,3486914,3486538,376,140,utRho09
866,mdtP,8602472,8602472,8602060,412,42,utRho09
867,melA,8683774,8683822,8683774,48,0,utRho09
868,melR,8683300,8683300,8683256,44,8,utRho09
869,menA,8240812,8240812,8240698,114,0,utRho09
870,menB,4753774,4753774,4753638,136,400,utRho09
871,mepH,3468714,3468870,3468714,156,4,utRho09
872,mepM,3883666,3883666,3883270,396,486,utRho09
873,mepS,4539840,4539958,4539840,118,202,utRho09
874,metA,8428318,8428560,8428318,242,0,utRho09
875,metB,8257272,8257344,8257272,72,916,utRho09
876,metC,6304150,6304472,6304150,322,84,utRho09
877,metE,8025768,8026106,8025768,338,176,utRho09
878,metF,8265092,8265232,8265092,140,0,utRho09
879,metG,4388538,4388600,4388538,62,148,utRho09
880,metH,8447010,8447656,8447010,646,2096,utRho09
881,metJ,8257116,8257116,8256790,326,38,utRho09
882,metK,6173154,6173412,6173154,258,188,utRho09
883,metN,445428,445428,445290,138,40,utRho09
884,metR,8025710,8025710,8025632,78,0,utRho09
885,metT,1394326,1394326,1394266,60,226,utRho09
886,metY,19910250,19910250,19909734,516,1494,utRho09
887,metZ,11789528,11789548,11789528,20,12,utRho09
888,mfd,2348056,2348056,2347928,128,108,utRho09
889,mglA,4478782,4478782,4478578,204,70,utRho09
890,mglB,4481132,4481132,4480696,436,11164,utRho09
891,mglC,4475918,4475918,4475506,412,144,utRho09
892,mgrB,3817584,3817584,3817532,52,0,utRho09
893,mgrR,3245828,3245828,3245828,0,0,utRho09
894,mgsA,2054082,2054082,2054030,52,98,utRho09
895,mgtL,8934560,8934862,8934560,302,74,utRho09
896,mhpA,737038,737222,737038,184,0,utRho09
897,mhpR,737072,737072,736840,232,0,utRho09
898,mhpT,750772,750918,750772,146,0,utRho09
899,miaA,8797964,8798504,8797964,540,442,utRho09
900,micA,5629604,5629604,5629604,0,0,utRho09
901,micC,2874242,2874238,2874242,4,0,utRho09
902,micF,4626168,4626168,4626168,0,0,utRho09
903,micM,1014408,1014408,1014408,0,0,utRho09
904,minE,2449422,2449422,2449090,332,1924,utRho09
905,mioC,7852950,7852950,7852910,40,0,utRho09
906,mipA,3733012,3733012,3732944,68,3716,utRho09
907,mlaA,4930270,4930270,4930014,256,2,utRho09
908,mlc,3337206,3337206,3337128,78,2,utRho09
909,mlrA,4429498,4429732,4429498,234,2,utRho09
910,mltA,5894546,5894546,5894356,190,6,utRho09
911,mltD,468050,468050,467910,140,60,utRho09
912,mltF,5391534,5391602,5391534,68,0,utRho09
913,mmuP,550238,550650,550238,412,58,utRho09
914,mngA,1531622,1531968,1531622,346,68,utRho09
915,mngR,1531852,1531852,1531750,102,0,utRho09
916,mnmG,7851348,7851348,7851266,82,2576,utRho09
917,mntH,5025470,5025470,5025412,58,0,utRho09
918,mntP,3810918,3811376,3810918,458,322,utRho09
919,mntR,1706160,1706366,1706160,206,0,utRho09
920,mntS,1706128,1706128,1705994,134,38,utRho09
921,moaA,1633654,1634088,1633654,434,408,utRho09
922,moaB,1635954,1636110,1635954,156,1110,utRho09
923,mobA,8084242,8084242,8083998,244,30,utRho09
924,mocA,6030112,6030320,6030112,208,20,utRho09
925,modA,1589990,1590178,1589990,188,0,utRho09
926,moeA,1732788,1732788,1732728,60,168,utRho09
927,mokB,2984610,2984610,2984258,352,224,utRho09
928,molR_1,4392888,4392948,4392888,60,22,utRho09
929,motA,3954604,3954604,3954278,326,142,utRho09
930,mpaA,2781278,2781278,2781196,82,26,utRho09
931,mpl,8911456,8911570,8911456,114,0,utRho09
932,mppA,2786108,2786454,2786108,346,0,utRho09
933,mprA,5621494,5621540,5621494,46,636,utRho09
934,mqo,4613848,4613848,4613508,340,150,utRho09
935,mqsA,6336742,6336742,6336492,250,124,utRho09
936,mqsR,6337306,6337306,6337088,218,60,utRho09
937,mraZ,179192,179268,179192,76,2,utRho09
938,mrcA,7045652,7045742,7045652,90,2,utRho09
939,mrcB,329442,329460,329442,18,0,utRho09
940,mreB,13605424,13605424,13604348,1076,3164,utRho09
941,mreD,6798166,6798166,6797750,416,402,utRho09
942,mrp,4388360,4388360,4388336,24,2,utRho09
943,mscK,972984,973072,972984,88,2,utRho09
944,mscL,6876002,6876048,6876002,46,50,utRho09
945,mscS,6139742,6139742,6139614,128,108,utRho09
946,msrA,8884522,8884522,8884352,170,224,utRho09
947,msrB,3725168,3725168,3724858,310,0,utRho09
948,msyB,2228426,2228426,2228362,64,80,utRho09
949,mtfA,4087236,4087302,4087236,66,2386,utRho09
950,mtgA,6699662,6699662,6699618,44,64,utRho09
951,mtlA,30177504,30178248,30177504,744,256,utRho09
952,mtn,358366,358366,358306,60,44,utRho09
953,mtr,6611864,6611864,6611634,230,42,utRho09
954,mug,6430992,6430992,6430946,46,4,utRho09
955,murQ,5091466,5091546,5091466,80,62,utRho09
956,murR,5091586,5091586,5091218,368,128,utRho09
957,mutH,5939164,5939324,5939164,160,64,utRho09
958,mutL,8794092,8794824,8794092,732,750,utRho09
959,mutM,7622554,7622554,7622304,250,1258,utRho09
960,mutS,5714038,5714186,5714038,148,1116,utRho09
961,mutY,18617466,18618078,18617466,612,6,utRho09
962,nac,4123956,4123956,4123866,90,2,utRho09
963,nadA,1564122,1564170,1564122,48,0,utRho09
964,nadB,5420714,5420840,5420714,126,0,utRho09
965,nadC,237326,237326,237290,36,0,utRho09
966,nadE,3644604,3644916,3644604,312,38,utRho09
967,nadK,5501526,5501662,5501526,136,116,utRho09
968,nagA,1406350,1406350,1405502,848,4436,utRho09
969,nagB,1407416,1407416,1407222,194,36,utRho09
970,nagC,1404016,1404016,1403188,828,34,utRho09
971,nagE,1407680,1407888,1407680,208,6,utRho09
972,nagK,2357080,2357186,2357080,106,52,utRho09
973,nanA,6747240,6747240,6747152,88,72,utRho09
974,nanC,9079856,9079856,9079002,854,4,utRho09
975,nanR,6749406,6749406,6748978,428,166,utRho09
976,nanS,9075406,9075406,9075188,218,2,utRho09
977,napF,4607390,4607390,4606994,396,0,utRho09
978,narG,2559614,2559728,2559614,114,0,utRho09
979,narK,2555642,2555914,2555642,272,4,utRho09
980,narP,4580844,4581000,4580844,156,0,utRho09
981,narQ,5171154,5171462,5171154,308,30,utRho09
982,narU,3088326,3088326,3088120,206,0,utRho09
983,narW,3077374,3077374,3074618,2756,28,utRho09
984,narX,2555554,2555554,2555236,318,0,utRho09
985,narZ,3085380,3085380,3085180,200,0,utRho09
986,ndh,2331984,2332170,2331984,186,12,utRho09
987,ndk,5289920,5289920,5289728,192,74,utRho09
988,nemR,6904084,6904092,6904084,8,0,utRho09
989,nepI,7683542,7683542,7683478,64,84,utRho09
990,nfo,4501612,4501680,4501612,68,0,utRho09
991,nfsB,1210906,1210906,1210848,58,32,utRho09
992,nfuA,7090916,7091248,7090916,332,600,utRho09
993,nhaA,34634,34978,34634,344,32,utRho09
994,nhaB,2469534,2469534,2469434,100,8,utRho09
995,nhoA,3067926,3068048,3067926,122,2,utRho09
996,nikA,7226878,7227334,7226878,456,1924,utRho09
997,nikR,7237074,7237176,7237074,102,124,utRho09
998,nirB,6987974,6988022,6987974,48,36,utRho09
999,nlpA,7680034,7680034,7679986,48,0,utRho09
1000,nlpC,3585654,3585654,3585462,192,38,utRho09
1001,nlpD,5737658,5737658,5737506,152,18,utRho09
1002,nlpI,6618080,6618080,6617848,232,108,utRho09
1003,nmpC,1153740,1153740,1153650,90,0,utRho09
1004,nohA,3273206,3273206,3272734,472,38,utRho09
1005,norR,5664614,5664614,5664578,36,0,utRho09
1006,norV,5664878,5664952,5664878,74,0,utRho09
1007,nrdA,4689510,4689730,4689510,220,14846,utRho09
1008,nrdD,8925676,8925676,8925320,356,1162,utRho09
1009,nrdH,5601312,5601446,5601312,134,92,utRho09
1010,nrdR,865954,866004,865954,50,110,utRho09
1011,nrfA,8575342,8575528,8575342,186,0,utRho09
1012,nsrR,8812088,8812380,8812088,292,1656,utRho09
1013,nudB,3897348,3897348,3897264,84,34,utRho09
1014,nudC,8393428,8393806,8393428,378,0,utRho09
1015,nudE,7052658,7052658,7052298,360,734,utRho09
1016,nudG,3682876,3682980,3682876,104,2,utRho09
1017,nudI,4729050,4729108,4729050,58,0,utRho09
1018,nudJ,2388874,2388874,2388576,298,544,utRho09
1019,nuoA,4810670,4810670,4810144,526,7956,utRho09
1020,nuoN,4783434,4783434,4783010,424,1214,utRho09
1021,nupC,5026018,5026084,5026018,66,0,utRho09
1022,nupG,6211302,6211428,6211302,126,0,utRho09
1023,ogrK,4335096,4335096,4335040,56,0,utRho09
1024,ogt,2800568,2800568,2800472,96,2,utRho09
1025,ohsC,5401036,5401040,5401036,4,0,utRho09
1026,ompA,2040382,2040382,2040106,276,29974,utRho09
1027,ompC,4625774,4625774,4625498,276,16,utRho09
1028,ompF,1974184,1974184,1973964,220,586,utRho09
1029,ompL,8128958,8128958,8128590,368,10,utRho09
1030,ompN,2874158,2874158,2873786,372,16,utRho09
1031,ompR,7073510,7073510,7073168,342,128,utRho09
1032,ompT,1171330,1171330,1171266,64,0,utRho09
1033,ompW,2627982,2628040,2627982,58,2,utRho09
1034,ompX,1700418,1700900,1700418,482,1214,utRho09
1035,omrA,5952378,5952378,5952378,0,0,utRho09
1036,omrB,5952770,5952770,5952770,0,0,utRho09
1037,oppA,2602170,2602364,2602170,194,15344,utRho09
1038,orn,8783168,8783208,8783168,40,0,utRho09
1039,osmB,2686952,2686952,2686656,296,184,utRho09
1040,osmC,3113192,3113250,3113192,58,116,utRho09
1041,osmE,3644566,3644566,3644512,54,0,utRho09
1042,osmF,4439046,4439046,4438962,84,812,utRho09
1043,osmY,9222306,9222792,9222306,486,36,utRho09
1044,otsA,3963302,3963302,3963224,78,0,utRho09
1045,otsB,3964930,3964930,3964774,156,2,utRho09
1046,oxc,4984288,4984288,4983900,388,44,utRho09
1047,oxyR,8316914,8316980,8316914,66,4,utRho09
1048,oxyS,8316788,8316788,8316788,0,0,utRho09
1049,paaA,2907730,2907854,2907730,124,0,utRho09
1050,paaX,2927018,2927078,2927018,60,0,utRho09
1051,paaZ,2907340,2907340,2907284,56,0,utRho09
1052,pabA,6981702,6981702,6981658,44,0,utRho09
1053,pabB,3789256,3789610,3789256,354,34,utRho09
1054,pabC,2306186,2306600,2306186,414,320,utRho09
1055,pagP,1313052,1313114,1313052,62,0,utRho09
1056,panB,299260,299260,299202,58,130,utRho09
1057,panC,297840,297840,297590,250,386,utRho09
1058,panD,293490,293490,293388,102,2,utRho09
1059,panZ,7195656,7195968,7195656,312,58,utRho09
1060,parC,6332060,6332060,6331946,114,170,utRho09
1061,patA,6438916,6438988,6438916,72,0,utRho09
1062,patD,3030830,3031156,3030830,326,0,utRho09
1063,pbpC,5294986,5294986,5294650,336,2,utRho09
1064,pbpG,4450132,4450132,4449740,392,130,utRho09
1065,pck,7065358,7065636,7065358,278,4838,utRho09
1066,pcnB,318782,318782,318252,530,360,utRho09
1067,pdhR,244068,244184,244068,116,22,utRho09
1068,pdxB,4875768,4875768,4875702,66,14,utRho09
1069,pdxH,3436068,3436068,3436014,54,684,utRho09
1070,pdxJ,5403626,5403626,5403458,168,82,utRho09
1071,pdxK,5074638,5074638,5074474,164,0,utRho09
1072,pepA,8972278,8972278,8971902,376,292,utRho09
1073,pepD,511618,511618,511432,186,6138,utRho09
1074,pepN,1981182,1981244,1981182,62,74,utRho09
1075,pepQ,8062294,8062322,8062294,28,0,utRho09
1076,pepT,2371646,2371688,2371646,42,6,utRho09
1077,pfkA,8214948,8215104,8214948,156,328,utRho09
1078,pfkB,3612646,3612740,3612646,94,0,utRho09
1079,pflA,1902456,1902456,1902160,296,0,utRho09
1080,pflB,1907850,1907850,1907108,742,658,utRho09
1081,pflD,8287716,8287990,8287716,274,0,utRho09
1082,pgaA,2185046,2185046,2184578,468,6,utRho09
1083,pgi,8467444,8467516,8467444,72,2,utRho09
1084,pgk,12291428,12291428,12290488,940,5264,utRho09
1085,pgl,1597078,1597172,1597078,94,26,utRho09
1086,pgpB,2678324,2678660,2678324,336,26,utRho09
1087,pgpC,5397276,5397276,5397100,176,0,utRho09
1088,pgrR,2783744,2783982,2783744,238,0,utRho09
1089,pheL,5475158,5475198,5475158,40,2,utRho09
1090,pheM,7197204,7197204,7197080,124,4,utRho09
1091,pheP,1203858,1203918,1203858,60,0,utRho09
1092,pheU,8725254,8725254,8725252,2,0,utRho09
1093,pheV,6220730,6220732,6220730,2,0,utRho09
1094,phnC,8650412,8650412,8650330,82,2,utRho09
1095,phoA,803414,803494,803414,80,0,utRho09
1096,phoB,834202,834284,834202,82,0,utRho09
1097,phoE,520316,520316,520200,116,0,utRho09
1098,phoH,2169730,2169984,2169730,254,2,utRho09
1099,phoP,2381016,2381016,2380894,122,1260,utRho09
1100,phoQ,2379880,2379880,2379552,328,980,utRho09
1101,phoU,7815330,7815330,7815156,174,266,utRho09
1102,phr,1478842,1479014,1478842,172,0,utRho09
1103,pinE,2419054,2419370,2419054,316,0,utRho09
1104,pinQ,3267168,3267244,3267168,76,2,utRho09
1105,pinR,2867424,2867424,2867348,76,8,utRho09
1106,pitA,7275224,7275284,7275224,60,0,utRho09
1107,pitB,6272806,6272806,6272742,64,2,utRho09
1108,pka,5439862,5439906,5439862,44,2,utRho09
1109,plaP,4174476,4174476,4174124,352,2314,utRho09
1110,pldA,8009628,8009724,8009628,96,2,utRho09
1111,pldB,8018028,8018340,8018028,312,74,utRho09
1112,plsB,8513196,8513196,8512932,264,270,utRho09
1113,pmbA,8915890,8915918,8915890,28,4,utRho09
1114,pmrD,4747148,4747148,4747076,72,0,utRho09
1115,pncB,1980828,1980828,1980712,116,22,utRho09
1116,pncC,5648788,5648788,5648692,96,0,utRho09
1117,pnp,6622652,6622652,6622336,316,200,utRho09
1118,pntA,3355950,3355950,3355806,144,0,utRho09
1119,pntB,3353096,3353096,3352720,376,0,utRho09
1120,polA,8093880,8093932,8093880,52,52,utRho09
1121,polB,131606,131606,131560,46,0,utRho09
1122,potD,2365700,2365700,2365658,42,4,utRho09
1123,potE,1436688,1436688,1436530,158,0,utRho09
1124,potF,1787268,1787568,1787268,300,54,utRho09
1125,poxB,1822152,1822152,1822098,54,0,utRho09
1126,ppa,8899372,8899372,8899304,68,62,utRho09
1127,ppc,8306380,8306380,8306196,184,190,utRho09
1128,ppdA,5928440,5928440,5928354,86,174,utRho09
1129,ppdD,235410,235410,235098,312,28,utRho09
1130,pphA,3846770,3846770,3845938,832,3340,utRho09
1131,pphB,5719474,5719520,5719474,46,0,utRho09
1132,ppiA,6984898,6984898,6984594,304,84,utRho09
1133,ppiC,7919682,7919682,7919626,56,0,utRho09
1134,ppiD,923638,923830,923638,192,1348,utRho09
1135,ppk,5245748,5246088,5245748,340,300,utRho09
1136,pppA,6228958,6228958,6228704,254,0,utRho09
1137,ppsA,3574322,3574322,3574224,98,0,utRho09
1138,ppsR,3574678,3574890,3574678,212,0,utRho09
1139,pptA,3065716,3066104,3065716,388,42,utRho09
1140,pqiA,2023318,2024002,2023318,684,168,utRho09
1141,prc,3830054,3830054,3829632,422,34124,utRho09
1142,preT,4467978,4468066,4467978,88,24,utRho09
1143,prfC,9218688,9218828,9218688,140,534,utRho09
1144,prkB,6968622,6968980,6968622,358,898,utRho09
1145,prlC,7290476,7290476,7290364,112,54,utRho09
1146,prlF,6553944,6554004,6553944,60,30,utRho09
1147,proB,520432,520776,520432,344,22,utRho09
1148,proC,811372,811372,811288,84,0,utRho09
1149,proK,7417388,7417388,7417384,4,0,utRho09
1150,proL,4572414,4572422,4572414,8,22,utRho09
1151,proP,8660640,8661004,8660640,364,264,utRho09
1152,proS,437674,437674,437550,124,528,utRho09
1153,proV,5609126,5609630,5609126,504,48,utRho09
1154,prpB,697292,697364,697292,72,0,utRho09
1155,prpR,696942,696942,696886,56,0,utRho09
1156,prs,2524354,2524354,2523750,604,82966,utRho09
1157,psd,8781276,8781276,8780720,556,2574,utRho09
1158,psiE,8480600,8480650,8480600,50,0,utRho09
1159,pspA,2736076,2736158,2736076,82,0,utRho09
1160,pspF,2736080,2736080,2735824,256,0,utRho09
1161,pspG,8525632,8525680,8525632,48,2,utRho09
1162,pssA,5445156,5445454,5445156,298,2464,utRho09
1163,pstB,7817112,7817112,7816732,380,0,utRho09
1164,pstC,7821084,7821084,7820796,288,0,utRho09
1165,pstS,23469408,23469408,23469150,258,6,utRho09
1166,psuG,4517114,4517114,4516734,380,270,utRho09
1167,psuT,4514992,4514992,4514670,322,0,utRho09
1168,pth,2517084,2517084,2517026,58,86,utRho09
1169,ptrA,5918022,5918022,5917768,254,0,utRho09
1170,ptrB,3857730,3857730,3857678,52,448,utRho09
1171,ptsG,2315252,2315738,2315252,486,2756,utRho09
1172,ptsH,5066996,5067528,5066996,532,4906,utRho09
1173,purA,8809328,8809374,8809328,46,96,utRho09
1174,purC,5195562,5195562,5195236,326,14,utRho09
1175,purD,8411972,8411972,8411862,110,0,utRho09
1176,purE,1106284,1106284,1106200,84,808,utRho09
1177,purH,8415254,8415254,8415064,190,16,utRho09
1178,purL,5391178,5391178,5391086,92,418,utRho09
1179,purM,5242306,5242394,5242306,88,34,utRho09
1180,purR,3475378,3475688,3475378,310,854,utRho09
1181,purT,3861438,3861762,3861438,324,4,utRho09
1182,purU,2577512,2577512,2577248,264,774,utRho09
1183,putA,2157850,2157850,2157764,86,0,utRho09
1184,putP,2158336,2158610,2158336,274,342,utRho09
1185,puuA,2721936,2721936,2721816,120,0,utRho09
1186,puuC,2725456,2725486,2725456,30,0,utRho09
1187,puuD,2722104,2722240,2722104,136,0,utRho09
1188,puuP,2718746,2718746,2718374,372,236,utRho09
1189,pykA,3874988,3875298,3874988,310,570,utRho09
1190,pykF,3510934,3511396,3510934,462,758,utRho09
1191,pyrC,2245286,2245286,2245214,72,182,utRho09
1192,pyrD,2009464,2009536,2009464,72,32,utRho09
1193,pyrE,7631970,7631970,7631536,434,84,utRho09
1194,pyrF,2683740,2683842,2683740,102,296,utRho09
1195,pyrG,5819594,5819594,5819332,262,574,utRho09
1196,pyrH,383624,383710,383624,86,2764,utRho09
1197,pyrL,8945490,8945490,8945066,424,92,utRho09
1198,qmcA,1031646,1031646,1031546,100,8,utRho09
1199,qor,8528608,8528608,8528462,146,148,utRho09
1200,qseB,6339502,6339656,6339502,154,6,utRho09
1201,queA,849970,850022,849970,52,186,utRho09
1202,queE,5811212,5811212,5810836,376,78,utRho09
1203,queF,5850642,5850696,5850642,54,0,utRho09
1204,queG,8788184,8788184,8788134,50,848,utRho09
1205,racC,2835630,2835630,2835526,104,0,utRho09
1206,racR,2840898,2840898,2840482,416,0,utRho09
1207,raiA,5474208,5474308,5474208,100,16,utRho09
1208,rarD,8008594,8008594,8008356,238,338,utRho09
1209,ravA,7862256,7862256,7862186,70,34,utRho09
1210,rayT,495088,495274,495088,186,12,utRho09
1211,rbn,4763162,4763216,4763162,54,0,utRho09
1212,rbsD,7866644,7866702,7866644,58,0,utRho09
1213,rcnA,4371654,4371834,4371654,180,22,utRho09
1214,rcnB,4373768,4373920,4373768,152,20,utRho09
1215,rcnR,4371806,4371806,4371592,214,46,utRho09
1216,rcsA,4047672,4047936,4047672,264,8,utRho09
1217,rcsB,4631390,4632354,4631390,964,1208,utRho09
1218,rcsC,4640162,4640162,4639656,506,318,utRho09
1219,rcsD,4626904,4626976,4626904,72,188,utRho09
1220,rdgB,6193240,6193362,6193240,122,832,utRho09
1221,rdlA,2538646,2538646,2538646,0,0,utRho09
1222,rdlB,2539712,2539716,2539712,4,0,utRho09
1223,rdlC,2540782,2540786,2540782,4,0,utRho09
1224,rdlD,7400272,7400272,7400272,0,0,utRho09
1225,rdoA,8084782,8084830,8084782,48,0,utRho09
1226,recA,11295276,11295276,11295076,200,732,utRho09
1227,recC,5925014,5925014,5924856,158,62,utRho09
1228,recF,7763722,7763722,7762442,1280,7538,utRho09
1229,recN,5503518,5503590,5503518,72,0,utRho09
1230,recQ,8011666,8011728,8011666,62,0,utRho09
1231,relA,5828554,5828554,5827302,1252,552,utRho09
1232,relB,3291806,3291806,3291744,62,0,utRho09
1233,rem,3289950,3289950,3289804,146,0,utRho09
1234,rep,7921294,7921354,7921294,60,48,utRho09
1235,rfaD,7587730,7587974,7587730,244,216,utRho09
1236,rfaE,6393852,6393852,6393506,346,56,utRho09
1237,rfaH,8049930,8049930,8049642,288,396,utRho09
1238,rfbX,4219436,4219436,4219168,268,3852,utRho09
1239,rfe,7935600,7935832,7935600,232,78,utRho09
1240,rhaB,8194944,8194944,8194896,48,0,utRho09
1241,rhaD,8188770,8188770,8188544,226,0,utRho09
1242,rhaS,8195422,8195472,8195422,50,0,utRho09
1243,rhaT,8201132,8201132,8201050,82,0,utRho09
1244,rhlE,1661566,1661744,1661566,178,298,utRho09
1245,rhoL,47593944,47594772,47593944,828,70344,utRho09
1246,rhsB,7238006,7238384,7238006,378,32,utRho09
1247,rhsC,1458758,1459166,1458758,408,0,utRho09
1248,rhsD,1046132,1046522,1046132,390,0,utRho09
1249,rhtA,1700608,1700608,1700194,414,18,utRho09
1250,rhtC,8015478,8015514,8015478,36,738,utRho09
1251,ribA,2678468,2678468,2678320,148,26,utRho09
1252,ribC,3486916,3486916,3486484,432,140,utRho09
1253,ribE,869008,869294,869008,286,9460,utRho09
1254,ribF,42766,42814,42766,48,36,utRho09
1255,ridA,8941892,8941892,8941826,66,10,utRho09
1256,rihA,1369204,1369204,1368824,380,254,utRho09
1257,rihB,4510504,4510504,4510372,132,4,utRho09
1258,rimJ,2251044,2251124,2251044,80,0,utRho09
1259,rimK,1783752,1783934,1783752,182,346,utRho09
1260,rimL,2997486,2997876,2997486,390,0,utRho09
1261,rimO,1756140,1756140,1756070,70,34,utRho09
1262,rimP,6636350,6636350,6636012,338,866,utRho09
1263,rlmA,3814172,3814172,3814120,52,572,utRho09
1264,rlmD,5830086,5830086,5830000,86,24,utRho09
1265,rlmE,6655520,6655520,6655328,192,1060,utRho09
1266,rlmF,1684384,1684664,1684384,280,2,utRho09
1267,rlmG,6471784,6471784,6471750,34,0,utRho09
1268,rlmI,2060002,2060002,2059938,64,0,utRho09
1269,rlmJ,7290700,7290770,7290700,70,148,utRho09
1270,rlmL,2015344,2015688,2015344,344,966,utRho09
1271,rlpA,1330444,1330444,1330380,64,86,utRho09
1272,rluA,120900,120900,120692,208,274,utRho09
1273,rluF,8460324,8460708,8460324,384,0,utRho09
1274,rmf,2031006,2031430,2031006,424,150,utRho09
1275,rna,1290068,1290068,1290006,62,0,utRho09
1276,rnb,2698258,2698258,2697824,434,3416,utRho09
1277,rnc,10816892,10816892,10816252,640,8564,utRho09
1278,rnd,3776122,3776122,3775982,140,342,utRho09
1279,rne,2289746,2289746,2288734,1012,9796,utRho09
1280,rnhA,472082,472082,472004,78,80,utRho09
1281,rnk,1288360,1288360,1287934,426,114,utRho09
1282,rnlA,5531788,5531836,5531788,48,14,utRho09
1283,rnlB,5533414,5533968,5533414,554,736,utRho09
1284,rnpB,19623552,19623552,19623552,0,0,utRho09
1285,rob,9270706,9270706,9270620,86,22,utRho09
1286,rodZ,5285868,5285868,5285688,180,126,utRho09
1287,rpe,7030306,7030306,7030118,188,142,utRho09
1288,rph,15266320,15266320,15266196,124,152,utRho09
1289,rpiA,6118706,6118706,6118650,56,8,utRho09
1290,rpiB,8626514,8626700,8626514,186,20,utRho09
1291,rpiR,8626274,8626274,8625982,292,0,utRho09
1292,rplJ,8359246,8359992,8359246,746,13608,utRho09
1293,rplK,8356708,8356894,8356708,186,518,utRho09
1294,rplM,6757344,6757344,6757302,42,12256,utRho09
1295,rplN,6896444,6896444,6896298,146,12568,utRho09
1296,rplS,5489284,5489284,5489060,224,27568,utRho09
1297,rplT,7199052,7199052,7198996,56,2028,utRho09
1298,rplU,6667036,6667036,6666902,134,140,utRho09
1299,rplY,4564866,4565034,4564866,168,258,utRho09
1300,rpmA,6666450,6666450,6666238,212,1410,utRho09
1301,rpmB,15247980,15247980,15246696,1284,228356,utRho09
1302,rpmE,8253816,8254026,8253816,210,954,utRho09
1303,rpmF,2294676,2294734,2294676,58,86940,utRho09
1304,rpmH,7768130,7768672,7768130,542,9972,utRho09
1305,rpmI,3600854,3600854,3599998,856,13788,utRho09
1306,rpoB,8362126,8362490,8362126,364,892,utRho09
1307,rpoD,6424946,6426094,6424946,1148,23720,utRho09
1308,rpoE,5420372,5420372,5420024,348,0,utRho09
1309,rpoH,7202006,7202006,7201566,440,3438,utRho09
1310,rpoN,6689324,6689434,6689324,110,70,utRho09
1311,rpoS,5736236,5736236,5735102,1134,4072,utRho09
1312,rpoZ,7644154,7644212,7644154,58,1234,utRho09
1313,rppH,5937986,5937986,5937954,32,2,utRho09
1314,rprA,3540744,3540744,3540744,0,0,utRho09
1315,rpsA,1923434,1923990,1923434,556,271806,utRho09
1316,rpsF,8850050,8850236,8850050,186,64310,utRho09
1317,rpsI,6756580,6756580,6756414,166,20408,utRho09
1318,rpsJ,6906884,6906884,6906540,344,15140,utRho09
1319,rpsL,6949242,6949242,6949104,138,224,utRho09
1320,rpsM,6885130,6885130,6884942,188,2294,utRho09
1321,rpsO,13247144,13247144,13246736,408,1120,utRho09
1322,rpsP,5492508,5492508,5492370,138,118,utRho09
1323,rpsT,42420,42420,42156,264,862,utRho09
1324,rpsU,12842584,12843124,12842584,540,4904,utRho09
1325,rraA,8238716,8238716,8238660,56,302,utRho09
1326,rraB,8956768,8956946,8956768,178,0,utRho09
1327,rrsA,8070478,8071062,8070478,584,10266,utRho09
1328,rrsB,16665468,16666636,16665468,1168,20920,utRho09
1329,rrsC,7883032,7883616,7883032,584,12060,utRho09
1330,rrsD,6858094,6858094,6857524,570,660,utRho09
1331,rrsE,8415726,8416294,8415726,568,1930,utRho09
1332,rrsG,5462896,5462896,5462314,582,8960,utRho09
1333,rrsH,446970,447542,446970,572,2552,utRho09
1334,rsd,8393908,8393908,8393616,292,0,utRho09
1335,rseA,5419264,5419264,5418808,456,54,utRho09
1336,rseP,392940,393092,392940,152,244,utRho09
1337,rseX,4067298,4067298,4067298,0,0,utRho09
1338,rsfS,1338144,1338144,1338072,72,440,utRho09
1339,rsgA,8783132,8783132,8783018,114,0,utRho09
1340,rsmA,105176,105176,104860,316,2732,utRho09
1341,rsmB,6869982,6870414,6869982,432,450,utRho09
1342,rsmC,9215736,9215736,9215400,336,588,utRho09
1343,rsmD,7208594,7208786,7208594,192,2,utRho09
1344,rsmE,6182036,6182268,6182036,232,104,utRho09
1345,rsmG,7847512,7847512,7847360,152,506,utRho09
1346,rsmH,180020,180188,180020,168,308,utRho09
1347,rsmI,6587106,6587106,6586670,436,1216,utRho09
1348,rssA,2578212,2578412,2578212,200,252,utRho09
1349,rssB,2580440,2580484,2580440,44,54,utRho09
1350,rstA,3364276,3364300,3364276,24,0,utRho09
1351,rsuA,4561096,4561096,4560966,130,132,utRho09
1352,rsxA,3411510,3411534,3411510,24,0,utRho09
1353,rtcA,7114004,7114004,7113698,306,8,utRho09
1354,rtcB,7116214,7116214,7116158,56,0,utRho09
1355,rtn,4541356,4541452,4541356,96,0,utRho09
1356,rutA,2148052,2148052,2148022,30,0,utRho09
1357,rutG,2140090,2140090,2139678,412,0,utRho09
1358,rutR,2148226,2148484,2148226,258,0,utRho09
1359,ruvA,7784096,7784096,7783904,192,88,utRho09
1360,ruvB,7782176,7782176,7781424,752,588,utRho09
1361,ruvC,3894878,3894878,3894752,126,0,utRho09
1362,rybB,1776114,1776114,1776114,0,0,utRho09
1363,rydB,3529860,3529860,3529322,538,80,utRho09
1364,rydC,2983012,2983012,2983012,0,0,utRho09
1365,ryfA,5307398,5307710,5307398,312,0,utRho09
1366,ryfD,5468590,5468590,5468590,0,0,utRho09
1367,ryhB,7162032,7162032,7162032,0,0,utRho09
1368,ryjA,8556132,8556132,8556132,0,0,utRho09
1369,ryjB,9055954,9055954,9055954,0,0,utRho09
1370,sad,3229598,3229598,3229406,192,30,utRho09
1371,safA,3168056,3168056,3167918,138,6,utRho09
1372,sanA,4465368,4465756,4465368,388,26,utRho09
1373,sapF,2705314,2705314,2705268,46,36,utRho09
1374,sbcB,4165456,4165512,4165456,56,0,utRho09
1375,sbcC,831694,831694,831506,188,262,utRho09
1376,sbcD,833954,833954,833904,50,4,utRho09
1377,sbmA,793106,793278,793106,172,10,utRho09
1378,sbmC,4162650,4162650,4162524,126,0,utRho09
1379,sdaA,3793618,3793864,3793618,246,210,utRho09
1380,sdaC,5856070,5856458,5856070,388,2002,utRho09
1381,sdhC,1509916,1510354,1509916,438,63342,utRho09
1382,sdhD,1510808,1511120,1510808,312,13390,utRho09
1383,sdiA,3993834,3993834,3993664,170,108,utRho09
1384,secE,8354354,8354716,8354354,362,4,utRho09
1385,secG,6645180,6645180,6645010,170,868,utRho09
1386,selA,7522594,7522594,7522498,96,284,utRho09
1387,selB,7519850,7519850,7519722,128,344,utRho09
1388,selC,7672396,7672444,7672396,48,22,utRho09
1389,selD,3696058,3696058,3696016,42,3204,utRho09
1390,seqA,1425884,1425974,1425884,90,1216,utRho09
1391,serA,6117098,6117098,6116820,278,112,utRho09
1392,serB,9249712,9249790,9249712,78,0,utRho09
1393,serC,3830380,3830612,3830380,232,0,utRho09
1394,serS,1878730,1878856,1878730,126,1658,utRho09
1395,serT,2063438,2063438,2063424,14,0,utRho09
1396,serU,4087124,4087124,4087114,10,226,utRho09
1397,serV,5637394,5637394,5637290,104,0,utRho09
1398,serW,1852014,1852014,1851942,72,310,utRho09
1399,serX,2195352,2195352,2195304,48,0,utRho09
1400,setB,4527426,4527726,4527426,300,2,utRho09
1401,setC,7673488,7673906,7673488,418,30,utRho09
1402,sfmA,1116124,1116424,1116124,300,0,utRho09
1403,sfmC,1117606,1117948,1117606,342,0,utRho09
1404,sfsA,323030,323030,322972,58,248,utRho09
1405,sfsB,6669592,6669818,6669592,226,26,utRho09
1406,sgrR,154676,154676,154598,78,2,utRho09
1407,sgrS,154734,154734,154734,0,0,utRho09
1408,shiA,4107068,4107286,4107068,218,0,utRho09
1409,sibA,4306622,4306622,4306622,0,0,utRho09
1410,sibB,4307292,4307292,4307292,0,0,utRho09
1411,sibC,6113702,6113702,6113702,0,0,utRho09
1412,sibD,6389730,6389730,6389730,0,0,utRho09
1413,sibE,6390480,6390480,6390480,0,0,utRho09
1414,sixA,4913998,4913998,4913624,374,2,utRho09
1415,slp,7307872,7307922,7307872,50,2,utRho09
1416,slt,9261400,9261466,9261400,66,0,utRho09
1417,slyA,3442028,3442028,3441648,380,0,utRho09
1418,slyB,3439496,3439752,3439496,256,16,utRho09
1419,slyD,6957398,6957398,6956994,404,376,utRho09
1420,slyX,6954862,6955280,6954862,418,12574,utRho09
1421,smf,6867372,6867372,6867120,252,6,utRho09
1422,smpB,5509534,5509792,5509534,258,466,utRho09
1423,smrA,2811872,2811958,2811872,86,66,utRho09
1424,smrB,4896872,4897212,4896872,340,0,utRho09
1425,smtA,1946808,1947074,1946808,266,0,utRho09
1426,sodA,8201518,8201620,8201518,102,17492,utRho09
1427,sodB,3470646,3470756,3470646,110,120,utRho09
1428,sodC,3449358,3449358,3449310,48,48,utRho09
1429,sohB,2658568,2658664,2658568,96,0,utRho09
1430,sokB,2984232,2984238,2984232,6,142,utRho09
1431,solA,2241218,2241218,2241172,46,2,utRho09
1432,soxR,8554894,8554938,8554894,44,6,utRho09
1433,soxS,8554846,8554846,8554766,80,0,utRho09
1434,speA,6172096,6172096,6171822,274,410,utRho09
1435,speB,6167892,6167892,6167594,298,468,utRho09
1436,speC,6218350,6218350,6218310,40,120,utRho09
1437,spf,8099798,8099798,8099798,0,0,utRho09
1438,sppA,3697422,3697674,3697422,252,2,utRho09
1439,spy,3651376,3651376,3651250,126,0,utRho09
1440,sra,3112092,3112092,3111926,166,0,utRho09
1441,sraB,2293178,2293178,2293178,0,0,utRho09
1442,sraC,3846132,3846132,3846132,0,0,utRho09
1443,srlA,5651582,5651664,5651582,82,2,utRho09
1444,srlR,5657720,5658094,5657720,374,924,utRho09
1445,srmB,5425752,5425792,5425752,40,302,utRho09
1446,sroA,151216,151216,151216,0,0,utRho09
1447,sroG,6369436,6369436,6369436,0,0,utRho09
1448,sroH,8380974,8380974,8380974,0,0,utRho09
1449,ssb,8548022,8548250,8548022,228,84,utRho09
1450,sseA,5304782,5304988,5304782,206,11578,utRho09
1451,sspA,6755138,6755138,6754840,298,758,utRho09
1452,ssrA,5511014,5511186,5511014,172,102,utRho09
1453,ssrS,12223036,12223932,12223036,896,696,utRho09
1454,sstT,6479726,6479888,6479726,162,4,utRho09
1455,ssuB,1988282,1988282,1988088,194,4,utRho09
1456,ssuE,1995126,1995126,1995024,102,0,utRho09
1457,sthA,8321604,8321604,8321580,24,1470,utRho09
1458,stpA,5597156,5597156,5596990,166,4,utRho09
1459,sucA,3034344,3034824,3034344,480,3136,utRho09
1460,sufA,3528836,3528836,3528772,64,0,utRho09
1461,sufE,3518962,3518962,3518580,382,246,utRho09
1462,sugE,8753588,8753750,8753588,162,192,utRho09
1463,sulA,2041894,2041894,2041838,56,314,utRho09
1464,syd,5850738,5850738,5850560,178,92,utRho09
1465,symE,9159834,9159834,9159680,154,0,utRho09
1466,symR,9159670,9159670,9159670,0,0,utRho09
1467,tabA,8949566,8949724,8949566,158,0,utRho09
1468,talA,5157140,5157332,5157140,192,0,utRho09
1469,talB,16382,16476,16382,94,10810,utRho09
1470,tam,3214442,3214692,3214442,250,14,utRho09
1471,tamA,8884540,8884764,8884540,224,46,utRho09
1472,tar,3945432,3945432,3945382,50,48,utRho09
1473,tas,5943138,5943194,5943138,56,90,utRho09
1474,tatA,16087636,16087780,16087636,144,212,utRho09
1475,tatE,1317742,1317894,1317742,152,34,utRho09
1476,tauA,770410,770464,770410,54,0,utRho09
1477,tdcA,6534186,6534186,6534130,56,0,utRho09
1478,tdcG,6519652,6519652,6519298,354,2,utRho09
1479,tdcR,6534380,6534760,6534380,380,8,utRho09
1480,tdk,2586986,2587054,2586986,68,0,utRho09
1481,tehA,3001072,3001146,3001072,74,0,utRho09
1482,tesA,1039898,1039898,1039530,368,74,utRho09
1483,tesB,950402,950402,950322,80,0,utRho09
1484,tfaE,2418532,2418532,2418238,294,8,utRho09
1485,tfaQ,3269912,3269912,3269770,142,0,utRho09
1486,tff,379424,379256,379424,168,2,utRho09
1487,tgt,852110,852274,852110,164,12,utRho09
1488,thiD,4369346,4369346,4369032,314,4,utRho09
1489,thiI,882936,883098,882936,162,346,utRho09
1490,thiM,4370902,4370902,4370602,300,210,utRho09
1491,thiQ,146170,146170,145854,316,114,utRho09
1492,thrL,592,760,592,168,68,utRho09
1493,thrS,7210932,7210932,7210280,652,1204,utRho09
1494,thrU,8350762,8350776,8350762,14,8,utRho09
1495,thrV,6847414,6847414,6847310,104,201320,utRho09
1496,thrW,525682,525742,525682,60,130,utRho09
1497,thyA,5930696,5930696,5930310,386,3240,utRho09
1498,tig,909986,910266,909986,280,1522,utRho09
1499,tisB,7706674,7707106,7706674,432,314,utRho09
1500,tktA,6163414,6163414,6163270,144,168,utRho09
1501,tktB,5158616,5159272,5158616,656,242,utRho09
1502,tldD,6784368,6784368,6784056,312,0,utRho09
1503,tmcA,5191876,5191876,5191718,158,6,utRho09
1504,tnaC,15553644,15553740,15553644,96,664,utRho09
1505,tolB,1555074,1555480,1555074,406,230,utRho09
1506,tolC,6356008,6356230,6356008,222,472,utRho09
1507,tomB,961588,961588,961416,172,806,utRho09
1508,tonB,2622108,2622178,2622108,70,2,utRho09
1509,topA,2661578,2662096,2661578,518,674,utRho09
1510,torC,2116112,2116168,2116112,56,92,utRho09
1511,torR,2115968,2115968,2115908,60,200,utRho09
1512,torS,2112364,2112364,2112356,8,0,utRho09
1513,torT,2112414,2112522,2112414,108,0,utRho09
1514,tpiA,8223138,8223138,8223014,124,32,utRho09
1515,tppB,3425342,3425538,3425342,196,8578,utRho09
1516,tpr,2574376,2574376,2574376,0,0,utRho09
1517,tpx,2777688,2777688,2777622,66,462,utRho09
1518,tqsA,3347780,3347826,3347780,46,0,utRho09
1519,treA,2494850,2494850,2494752,98,106,utRho09
1520,treB,8932420,8932420,8932360,60,24,utRho09
1521,treF,7339102,7339184,7339102,82,52,utRho09
1522,treR,8934694,8934694,8934492,202,6,utRho09
1523,trg,2984878,2984940,2984878,62,0,utRho09
1524,trkG,2847342,2847564,2847342,222,2,utRho09
1525,trmA,8326590,8326590,8326540,50,44,utRho09
1526,trpA,2634678,2634678,2634444,234,1340,utRho09
1527,trpC,2639888,2639888,2639570,318,8,utRho09
1528,trpL,5292432,5292432,5292328,104,0,utRho09
1529,trpR,9265408,9265520,9265408,112,0,utRho09
1530,trpS,7027394,7027394,7027276,118,2446,utRho09
1531,trpT,7893560,7893914,7893560,354,132974,utRho09
1532,trxA,7931294,7931522,7931294,228,440,utRho09
1533,trxB,1864156,1864156,1864100,56,64,utRho09
1534,trxC,5437350,5437470,5437350,120,170,utRho09
1535,tsaD,6421256,6421256,6421086,170,12,utRho09
1536,tsgA,6985038,6985136,6985038,98,8,utRho09
1537,tsr,9182824,9183314,9182824,490,126,utRho09
1538,tsx,864490,864490,864026,464,464,utRho09
1539,ttcA,2823970,2823970,2823896,74,4760,utRho09
1540,ttdA,6412848,6412926,6412848,78,0,utRho09
1541,ttdR,6412760,6412760,6412512,248,6,utRho09
1542,tufA,6943448,6943448,6942658,790,202382,utRho09
1543,tus,3368346,3368518,3368346,172,180,utRho09
1544,tusA,7218040,7218040,7217992,48,56,utRho09
1545,tusB,6950218,6950218,6949930,288,1610,utRho09
1546,tynA,2902996,2902996,2902698,298,60,utRho09
1547,typA,8116460,8116814,8116460,354,11628,utRho09
1548,tyrB,8534164,8534228,8534164,64,3296,utRho09
1549,tyrP,3979004,3979362,3979004,358,4,utRho09
1550,tyrR,2773384,2773440,2773384,56,0,utRho09
1551,tyrS,3434566,3434566,3434444,122,22,utRho09
1552,tyrT,2575330,2575330,2575244,86,62,utRho09
1553,uacT,6062378,6062734,6062378,356,0,utRho09
1554,ubiC,8504886,8505012,8504886,126,2,utRho09
1555,ubiD,8049618,8049976,8049618,358,424,utRho09
1556,ubiE,8037494,8037710,8037494,216,54,utRho09
1557,ubiG,4679078,4679134,4679078,56,0,utRho09
1558,ucpA,5089342,5089342,5089246,96,0,utRho09
1559,udp,8032782,8032862,8032782,80,0,utRho09
1560,ugd,4199470,4199470,4199226,244,0,utRho09
1561,ugpB,7184852,7184852,7184650,202,132,utRho09
1562,ugpQ,7176600,7176600,7176226,374,0,utRho09
1563,uhpT,7694396,7694396,7694334,62,2,utRho09
1564,uidA,3392304,3392304,3392142,162,0,utRho09
1565,uidC,3386012,3386012,3385702,310,0,utRho09
1566,uidR,3394150,3394150,3394104,46,104,utRho09
1567,ulaA,8839854,8839960,8839854,106,2,utRho09
1568,ulaG,8839350,8839350,8839250,100,2,utRho09
1569,ulaR,8837124,8837124,8836906,218,0,utRho09
1570,umpG,5741372,5741372,5740548,824,200,utRho09
1571,umpH,1400704,1400704,1400652,52,2,utRho09
1572,umuD,2461476,2461534,2461476,58,0,utRho09
1573,ung,5433476,5433508,5433476,32,2,utRho09
1574,uof,2843316,2843316,2842900,416,7928,utRho09
1575,upp,5241818,5241818,5241744,74,768,utRho09
1576,usg,4873780,4873780,4873298,482,224,utRho09
1577,ushA,1009772,1009828,1009772,56,0,utRho09
1578,uspA,7279966,7280222,7279966,256,274,utRho09
1579,uspB,7279696,7279696,7279440,256,8,utRho09
1580,uspC,3959172,3959506,3959172,334,0,utRho09
1581,uspE,2797318,2797318,2797244,74,0,utRho09
1582,uspF,2871282,2871282,2871238,44,0,utRho09
1583,uspG,1283806,1283806,1283734,72,122,utRho09
1584,uvrA,8547872,8547872,8547742,130,54,utRho09
1585,uvrB,1626304,1627052,1626304,748,578,utRho09
1586,uvrC,3989758,3989758,3989412,346,296,utRho09
1587,uvrD,7995814,7995966,7995814,152,88,utRho09
1588,uvrY,3990812,3990812,3990718,94,20,utRho09
1589,uxaB,3221474,3221474,3221360,114,10,utRho09
1590,uxaC,6489714,6489714,6489482,232,68,utRho09
1591,uxuA,9103036,9103272,9103036,236,488,utRho09
1592,uxuR,9108916,9109152,9108916,236,0,utRho09
1593,valS,8967854,8967854,8967674,180,428,utRho09
1594,valU,5041848,5041862,5041848,14,0,utRho09
1595,valV,3492830,3492870,3492830,40,18,utRho09
1596,ves,3649968,3649968,3649874,94,0,utRho09
1597,waaA,7616512,7617080,7616512,568,80,utRho09
1598,waaH,7580298,7580298,7580162,136,12,utRho09
1599,waaQ,7616476,7616476,7616196,280,170,utRho09
1600,waaU,7598996,7598996,7598624,372,130,utRho09
1601,waaY,7602272,7602272,7601930,342,11426,utRho09
1602,wbbH,4214888,4214888,4214452,436,5086,utRho09
1603,wbbK,4209212,4209212,4209018,194,270,utRho09
1604,wcaM,4231868,4231868,4231792,76,0,utRho09
1605,wrbA,2135516,2135516,2135416,100,0,utRho09
1606,wza,4275166,4275166,4274486,680,4,utRho09
1607,wzxC,4240674,4240674,4240316,358,0,utRho09
1608,wzzB,4196950,4196950,4196602,348,150,utRho09
1609,xanP,7657642,7657890,7657642,248,0,utRho09
1610,xanQ,6048520,6048702,6048520,182,0,utRho09
1611,xapA,5049820,5049820,5049756,64,0,utRho09
1612,xapR,10090252,10090252,10089908,344,0,utRho09
1613,xdhA,6000514,6000690,6000514,176,56,utRho09
1614,xerD,6079702,6079702,6079486,216,188,utRho09
1615,xseA,5268394,5268464,5268394,70,72,utRho09
1616,xseB,882746,882746,882686,60,204,utRho09
1617,xthA,3664798,3664856,3664798,58,0,utRho09
1618,xylA,7461614,7461614,7461530,84,198,utRho09
1619,xylE,8484540,8484540,8484508,32,0,utRho09
1620,xylF,7462138,7462262,7462138,124,0,utRho09
1621,xylR,7469812,7469958,7469812,146,0,utRho09
1622,yaaA,13230,13230,12918,312,106,utRho09
1623,yaaI,23876,23876,23572,304,10,utRho09
1624,yaaJ,16034,16034,15918,116,62,utRho09
1625,yaaU,91184,91614,91184,430,4,utRho09
1626,yaaW,23084,23084,22712,372,122,utRho09
1627,yaaX,10060,10468,10060,408,42,utRho09
1628,yabI,142542,142702,142542,160,0,utRho09
1629,yacC,273880,273880,273834,46,278,utRho09
1630,yacH,262932,262932,262520,412,0,utRho09
1631,yacL,268678,268776,268678,98,72,utRho09
1632,yadD,293796,293936,293796,140,2,utRho09
1633,yadE,289930,290162,289930,232,196,utRho09
1634,yadN,314110,314110,313766,344,0,utRho09
1635,yadS,355572,355572,355248,324,128,utRho09
1636,yadV,312470,312470,312402,68,62,utRho09
1637,yaeF,434270,434270,434006,264,2,utRho09
1638,yaeP,428374,428374,428250,124,4,utRho09
1639,yaeQ,428176,428582,428176,406,54,utRho09
1640,yaeR,423716,423754,423716,38,0,utRho09
1641,yafC,462166,462166,461762,404,24,utRho09
1642,yafD,462128,462244,462128,116,34,utRho09
1643,yafK,491986,491986,491610,376,670,utRho09
1644,yafL,493282,493424,493282,142,0,utRho09
1645,yafN,503938,504010,503938,72,0,utRho09
1646,yafS,469568,469632,469568,64,184,utRho09
1647,yafT,474470,474670,474470,200,0,utRho09
1648,yafV,480432,480432,480378,54,0,utRho09
1649,yafZ,536052,536052,536010,42,0,utRho09
1650,yagE,564446,564556,564446,110,0,utRho09
1651,yagG,570414,570790,570414,376,0,utRho09
1652,yagI,578384,578384,578324,60,0,utRho09
1653,yagK,586236,586236,585896,340,38,utRho09
1654,yagL,588062,588062,587836,226,0,utRho09
1655,yagN,591342,591342,591158,184,726,utRho09
1656,yahA,663746,664742,663746,996,86,utRho09
1657,yahC,670136,670136,670044,92,2,utRho09
1658,yahE,671478,671850,671478,372,0,utRho09
1659,yahM,690504,690808,690504,304,62,utRho09
1660,yahN,692872,692872,692674,198,64,utRho09
1661,yahO,692864,692968,692864,104,32,utRho09
1662,yaiE,816296,816354,816296,58,2,utRho09
1663,yaiI,811396,811528,811396,132,2,utRho09
1664,yaiO,761946,761946,761684,262,2,utRho09
1665,yaiP,767970,767970,767870,100,0,utRho09
1666,yaiS,769660,769660,769232,428,4,utRho09
1667,yaiV,788922,788922,788922,0,0,utRho09
1668,yaiY,799094,799094,798666,428,2,utRho09
1669,yaiZ,798888,799186,798888,298,20,utRho09
1670,yajC,854410,854574,854410,164,1622,utRho09
1671,yajD,860938,861210,860938,272,276,utRho09
1672,yajI,866068,866068,865702,366,558,utRho09
1673,yajL,887496,887496,887282,214,344,utRho09
1674,yajQ,889316,889366,889316,50,2,utRho09
1675,yajR,893374,893374,893332,42,148,utRho09
1676,ybaB,987418,988152,987418,734,3716,utRho09
1677,ybaL,1006590,1006590,1006476,114,32,utRho09
1678,ybaM,980648,980648,980542,106,402,utRho09
1679,ybaN,981436,981764,981436,328,368,utRho09
1680,ybaO,936704,936766,936704,62,0,utRho09
1681,ybaP,1016568,1016568,1016160,408,252,utRho09
1682,ybaQ,1016348,1016436,1016348,88,0,utRho09
1683,ybaS,1023146,1023282,1023146,136,16,utRho09
1684,ybaV,927504,927874,927504,370,112,utRho09
1685,ybaY,950490,950758,950490,268,138,utRho09
1686,ybbB,1062724,1062724,1062452,272,14,utRho09
1687,ybbJ,1030154,1030154,1029718,436,330,utRho09
1688,ybbL,1031784,1031838,1031784,54,0,utRho09
1689,ybbN,1037136,1037136,1036558,578,2232,utRho09
1690,ybbO,1038658,1038658,1038298,360,1506,utRho09
1691,ybbY,1080718,1081130,1080718,412,2,utRho09
1692,ybcH,1176140,1176140,1175962,178,2,utRho09
1693,ybcI,1113264,1113264,1113106,158,314,utRho09
1694,ybcJ,1114050,1114050,1113746,304,380,utRho09
1695,ybcK,1137502,1137804,1137502,302,34,utRho09
1696,ybcL,1141690,1141786,1141690,96,0,utRho09
1697,ybcN,1144628,1144932,1144628,304,2,utRho09
1698,ybcQ,1147548,1147912,1147548,364,0,utRho09
1699,ybcW,1159610,1159760,1159610,150,0,utRho09
1700,ybdD,1263982,1264364,1263982,382,4,utRho09
1701,ybdF,1212106,1212106,1211772,334,76,utRho09
1702,ybdH,1267048,1267048,1266954,94,0,utRho09
1703,ybdJ,1212822,1212822,1212398,424,0,utRho09
1704,ybdK,1215122,1215122,1214766,356,0,utRho09
1705,ybdL,1267114,1267172,1267114,58,2,utRho09
1706,ybdM,1271110,1271110,1270752,358,78,utRho09
1707,ybdN,1273372,1273372,1273138,234,2,utRho09
1708,ybdR,1283844,1284176,1283844,332,128,utRho09
1709,ybeD,1325412,1325412,1325284,128,396,utRho09
1710,ybeF,1323090,1323090,1322756,334,48,utRho09
1711,ybeL,1349986,1350036,1349986,50,16,utRho09
1712,ybeQ,1353412,1353412,1353094,318,2,utRho09
1713,ybeR,1353120,1353422,1353120,302,2,utRho09
1714,ybeT,1358832,1358832,1358812,20,0,utRho09
1715,ybeU,1358924,1359016,1358924,92,0,utRho09
1716,ybeZ,1386938,1386938,1386834,104,6160,utRho09
1717,ybfA,1458074,1458268,1458074,194,12,utRho09
1718,ybfE,1423878,1423878,1423796,82,338,utRho09
1719,ybfF,1425692,1425692,1425604,88,166,utRho09
1720,ybfH,1433282,1433282,1433194,88,2,utRho09
1721,ybgA,1477840,1478002,1477840,162,0,utRho09
1722,ybgC,1549288,1549504,1549288,216,4,utRho09
1723,ybgD,1505916,1505916,1505590,326,202,utRho09
1724,ybgI,1485238,1485654,1485238,416,0,utRho09
1725,ybgO,1498370,1498370,1497964,406,0,utRho09
1726,ybgS,1570992,1570992,1570634,358,0,utRho09
1727,ybhA,1597184,1597184,1596862,322,26,utRho09
1728,ybhB,1616070,1616070,1615818,252,272,utRho09
1729,ybhC,1614642,1614642,1614562,80,1702,utRho09
1730,ybhD,1601418,1601418,1601276,142,0,utRho09
1731,ybhH,1601104,1601518,1601104,414,0,utRho09
1732,ybhK,1633384,1633384,1633294,90,2,utRho09
1733,ybhM,1641556,1641586,1641556,30,2,utRho09
1734,ybhN,1645296,1645296,1644996,300,0,utRho09
1735,ybhQ,1649202,1649260,1649202,58,14,utRho09
1736,ybiA,1665920,1665920,1665900,20,0,utRho09
1737,ybiI,1676968,1676968,1676912,56,36,utRho09
1738,ybiO,1691328,1691328,1690960,368,22,utRho09
1739,ybiP,1705252,1705252,1705194,58,150,utRho09
1740,ybiS,1711572,1711572,1711488,84,784,utRho09
1741,ybiT,1711894,1711926,1711894,32,0,utRho09
1742,ybiU,1718212,1718212,1718122,90,2,utRho09
1743,ybiV,1720176,1720176,1720056,120,0,utRho09
1744,ybiW,1725566,1725566,1725212,354,86,utRho09
1745,ybiX,1678548,1678548,1678414,134,256,utRho09
1746,ybjC,1781784,1781826,1781784,42,0,utRho09
1747,ybjE,1830154,1830154,1829714,440,112,utRho09
1748,ybjG,1767016,1767016,1766776,240,1104,utRho09
1749,ybjL,1779882,1779882,1779638,244,86,utRho09
1750,ybjM,1779770,1780178,1779770,408,74,utRho09
1751,ybjO,1795704,1795978,1795704,274,0,utRho09
1752,ybjP,1809046,1809046,1808934,112,0,utRho09
1753,ybjQ,1809034,1809186,1809034,152,0,utRho09
1754,ybjS,1813796,1813796,1813506,290,192,utRho09
1755,ybjX,1838206,1838206,1838168,38,20,utRho09
1756,ycaD,1891438,1891742,1891438,304,0,utRho09
1757,ycaI,1928210,1928640,1928210,430,174,utRho09
1758,ycaK,1899094,1899336,1899094,242,0,utRho09
1759,ycaL,1920264,1920528,1920264,264,56,utRho09
1760,ycaM,1894240,1894458,1894240,218,4,utRho09
1761,ycaR,1941284,1941346,1941284,62,840,utRho09
1762,ycbB,1961862,1962094,1961862,232,0,utRho09
1763,ycbJ,1943344,1943504,1943344,160,0,utRho09
1764,ycbK,1966046,1966150,1966046,104,200,utRho09
1765,ycbZ,2036920,2036920,2036598,322,0,utRho09
1766,yccA,2062886,2062886,2062836,50,2,utRho09
1767,yccF,2048730,2048730,2048696,34,2,utRho09
1768,yccS,2047988,2047988,2047766,222,34,utRho09
1769,yccT,2055674,2055674,2055546,128,36,utRho09
1770,yccX,2059960,2060128,2059960,168,2,utRho09
1771,ycdT,2185682,2185752,2185682,70,0,utRho09
1772,ycdU,2191266,2191686,2191266,420,2,utRho09
1773,ycdZ,2200504,2200592,2200504,88,82,utRho09
1774,yceA,2233544,2233614,2233544,70,194,utRho09
1775,yceD,2293298,2293588,2293298,290,9036,utRho09
1776,yceF,2293522,2293522,2293190,332,5566,utRho09
1777,yceH,2252154,2252314,2252154,160,1660,utRho09
1778,yceI,2237282,2237282,2236952,330,192,utRho09
1779,yceJ,2238142,2238142,2238092,50,12,utRho09
1780,yceM,2253208,2253612,2253208,404,44,utRho09
1781,yceO,2239264,2239264,2238894,370,88,utRho09
1782,yceQ,2288760,2289004,2288760,244,7912,utRho09
1783,ycfD,2376540,2376540,2376480,60,140,utRho09
1784,ycfJ,2334814,2335198,2334814,384,144,utRho09
1785,ycfS,2340834,2340834,2340748,86,0,utRho09
1786,ycfT,2350658,2350658,2350330,328,0,utRho09
1787,ycfZ,2362760,2362760,2362534,226,142,utRho09
1788,ycgB,2474570,2474570,2474482,88,0,utRho09
1789,ycgG,2434614,2434656,2434614,42,38,utRho09
1790,ycgJ,2452956,2453200,2452956,244,0,utRho09
1791,ycgL,2455218,2455362,2455218,144,0,utRho09
1792,ycgN,2457366,2457660,2457366,294,24,utRho09
1793,ycgR,2489112,2489112,2489054,58,0,utRho09
1794,ycgV,2512222,2512222,2511904,318,286,utRho09
1795,ycgX,2426568,2426568,2426214,354,3580,utRho09
1796,ycgY,2490166,2490320,2490166,154,0,utRho09
1797,ycgZ,2431504,2431578,2431504,74,0,utRho09
1798,ychE,2596904,2597196,2596904,292,12,utRho09
1799,ychF,2515764,2515764,2515624,140,2,utRho09
1800,ychH,2517476,2517582,2517476,106,114,utRho09
1801,ychJ,2578354,2578354,2578264,90,26,utRho09
1802,ychN,2547310,2547310,2547198,112,0,utRho09
1803,ychO,2547520,2547850,2547520,330,56,utRho09
1804,ychQ,2533798,2533848,2533798,50,28,utRho09
1805,yciA,2624828,2624828,2624492,336,216,utRho09
1806,yciB,2626110,2626110,2625780,330,6176,utRho09
1807,yciC,2627396,2627396,2627326,70,2,utRho09
1808,yciE,2630794,2630794,2630448,346,38,utRho09
1809,yciG,5264368,5264368,5264140,228,0,utRho09
1810,yciI,2621784,2621784,2621730,54,0,utRho09
1811,yciN,2661606,2661606,2661336,270,36,utRho09
1812,yciS,2680270,2680486,2680270,216,104,utRho09
1813,yciT,2689088,2689088,2688692,396,480,utRho09
1814,yciU,2614718,2614718,2614300,418,550,utRho09
1815,yciV,2646376,2646440,2646376,64,0,utRho09
1816,yciW,2700472,2700472,2700214,258,98,utRho09
1817,yciZ,2689276,2689276,2689218,58,154,utRho09
1818,ycjD,2703792,2703792,2703520,272,166,utRho09
1819,ycjG,2777748,2777860,2777748,112,90,utRho09
1820,ycjM,2740006,2740432,2740006,426,36,utRho09
1821,ycjW,2767982,2767982,2767922,60,64,utRho09
1822,ycjX,2768138,2768234,2768138,96,40,utRho09
1823,ycjY,5568288,5568288,5567460,828,0,utRho09
1824,ydaE,2836438,2836438,2836016,422,0,utRho09
1825,ydaN,2816048,2816100,2816048,52,0,utRho09
1826,ydaS,2840340,2840730,2840340,390,62,utRho09
1827,ydbC,2948376,2948442,2948376,66,0,utRho09
1828,ydbD,2950132,2950288,2950132,156,0,utRho09
1829,ydbH,2885800,2886102,2885800,302,98,utRho09
1830,ydbJ,2881712,2882116,2881712,404,8,utRho09
1831,ydbK,2881692,2881692,2881568,124,50,utRho09
1832,ydcA,2983294,2983354,2983294,60,16,utRho09
1833,ydcF,2974404,2974470,2974404,66,0,utRho09
1834,ydcI,2990268,2990268,2990142,126,14,utRho09
1835,ydcJ,2990266,2990576,2990266,310,2,utRho09
1836,ydcK,3001280,3001280,3000898,382,4,utRho09
1837,ydcL,3004646,3004914,3004646,268,0,utRho09
1838,ydcN,3012308,3012344,3012308,36,8,utRho09
1839,ydcP,3013508,3013562,3013508,54,44,utRho09
1840,ydcR,3019956,3020006,3019956,50,0,utRho09
1841,ydcS,3022906,3023308,3022906,402,0,utRho09
1842,ydcX,3034442,3034778,3034442,336,10,utRho09
1843,ydcY,3035220,3035296,3035220,76,104,utRho09
1844,ydcZ,3036750,3036750,3036662,88,32,utRho09
1845,yddB,3155332,3155332,3155238,94,0,utRho09
1846,yddE,3071738,3071738,3071716,22,0,utRho09
1847,yddG,3094410,3094410,3094338,72,0,utRho09
1848,yddJ,3089732,3089732,3089438,294,4,utRho09
1849,yddW,3137704,3137704,3137646,58,0,utRho09
1850,ydeA,3233910,3234056,3233910,146,78,utRho09
1851,ydeE,3242528,3242664,3242528,136,2,utRho09
1852,ydeI,3249118,3249118,3248994,124,0,utRho09
1853,ydeJ,3249376,3249546,3249376,170,0,utRho09
1854,ydeN,3165458,3165458,3165048,410,0,utRho09
1855,ydeP,3173328,3173328,3172972,356,0,utRho09
1856,ydeR,3176596,3176596,3176592,4,0,utRho09
1857,ydfA,3296872,3297016,3296872,144,0,utRho09
1858,ydfG,3254982,3255034,3254982,52,0,utRho09
1859,ydfH,3256652,3256704,3256652,52,96,utRho09
1860,ydfK,3265446,3266144,3265446,698,578,utRho09
1861,ydgA,3379588,3379704,3379588,116,36,utRho09
1862,ydgC,3364124,3364124,3364060,64,56,utRho09
1863,ydgD,3343906,3343920,3343906,14,2,utRho09
1864,ydgH,3356754,3356854,3356754,100,114,utRho09
1865,ydgJ,3408798,3408798,3408616,182,26,utRho09
1866,ydgK,3410414,3410500,3410414,86,174,utRho09
1867,ydhB,3479618,3479618,3479596,22,0,utRho09
1868,ydhC,3479698,3479822,3479698,124,0,utRho09
1869,ydhF,3451310,3451310,3451264,46,0,utRho09
1870,ydhI,3441996,3442050,3441996,54,0,utRho09
1871,ydhL,3451864,3451864,3451840,24,4,utRho09
1872,ydhQ,3492404,3492404,3492254,150,0,utRho09
1873,ydhS,3494136,3494262,3494136,126,4,utRho09
1874,ydhT,3499138,3499138,3499118,20,0,utRho09
1875,ydhY,3509284,3509284,3508954,330,0,utRho09
1876,ydhZ,3510418,3510418,3510282,136,4,utRho09
1877,ydiE,3579206,3579226,3579206,20,0,utRho09
1878,ydiH,3530582,3530582,3530406,176,0,utRho09
1879,ydiM,3541852,3542142,3541852,290,0,utRho09
1880,ydiN,3544818,3545024,3544818,206,0,utRho09
1881,ydiP,3558656,3558656,3558602,54,0,utRho09
1882,ydiU,3582508,3582508,3582488,20,4,utRho09
1883,ydiV,3584174,3584174,3584040,134,152,utRho09
1884,ydiY,3612500,3612500,3612166,334,0,utRho09
1885,ydjA,3697400,3697400,3697352,48,2,utRho09
1886,ydjE,3708082,3708082,3707958,124,0,utRho09
1887,ydjF,3709848,3709848,3709708,140,4,utRho09
1888,ydjM,3620340,3620422,3620340,82,0,utRho09
1889,ydjO,3626696,3626696,3626288,408,0,utRho09
1890,ydjX,3666434,3666802,3666434,368,396,utRho09
1891,yeaE,3731448,3731448,3731272,176,142,utRho09
1892,yeaG,3733530,3733816,3733530,286,0,utRho09
1893,yeaI,3740486,3740770,3740486,284,4,utRho09
1894,yeaJ,3743874,3744082,3743874,208,4,utRho09
1895,yeaL,3748646,3748704,3748646,58,98,utRho09
1896,yeaM,3751296,3751296,3751152,144,0,utRho09
1897,yeaN,3750926,3751346,3750926,420,2,utRho09
1898,yeaO,3753554,3753818,3753554,264,42,utRho09
1899,yeaP,3755314,3755430,3755314,116,306,utRho09
1900,yeaQ,3758780,3758780,3758510,270,0,utRho09
1901,yeaR,3759988,3759988,3759896,92,20,utRho09
1902,yeaY,3781122,3781122,3781064,58,166,utRho09
1903,yebB,3892220,3892502,3892220,282,32,utRho09
1904,yebC,3896370,3896370,3896302,68,148,utRho09
1905,yebE,3859464,3859464,3859414,50,6,utRho09
1906,yebG,3861530,3861530,3861494,36,0,utRho09
1907,yebK,3873180,3873304,3873180,124,38,utRho09
1908,yebQ,3820314,3820552,3820314,238,0,utRho09
1909,yebS,3832238,3832516,3832238,278,0,utRho09
1910,yebV,3843430,3843560,3843430,130,0,utRho09
1911,yebW,3843914,3844242,3843914,328,770,utRho09
1912,yecC,3995646,3995646,3995628,18,22,utRho09
1913,yecD,3901272,3901664,3901272,392,18,utRho09
1914,yecF,3991434,3991636,3991434,202,6,utRho09
1915,yecH,3979304,3979304,3978980,324,2,utRho09
1916,yecJ,3975604,3975604,3975516,88,0,utRho09
1917,yecM,3919968,3919968,3919692,276,30,utRho09
1918,yecR,3976400,3976444,3976400,44,0,utRho09
1919,yecT,3923862,3923944,3923862,82,0,utRho09
1920,yedD,4016522,4016522,4016180,342,144,utRho09
1921,yedE,4016310,4016554,4016310,244,156,utRho09
1922,yedI,4058922,4058922,4058732,190,0,utRho09
1923,yedJ,4066446,4066446,4066158,288,6,utRho09
1924,yedV,4076404,4076404,4076304,100,90,utRho09
1925,yedX,4077680,4077912,4077680,232,0,utRho09
1926,yedY,4078572,4078956,4078572,384,2,utRho09
1927,yeeA,4161322,4161322,4161182,140,96,utRho09
1928,yeeE,4171104,4171104,4171050,54,4,utRho09
1929,yeeJ,4089526,4089822,4089526,296,112,utRho09
1930,yeeN,4113508,4113716,4113508,208,60,utRho09
1931,yeeO,4119444,4119444,4119692,248,0,utRho09
1932,yeeX,4158834,4158834,4158722,112,168,utRho09
1933,yeeZ,4178422,4178422,4178256,166,0,utRho09
1934,yefM,4179466,4179466,4179426,40,2,utRho09
1935,yegD,4295288,4295348,4295288,60,44,utRho09
1936,yegH,4275726,4275804,4275726,78,0,utRho09
1937,yegI,4302154,4302154,4301970,184,0,utRho09
1938,yegJ,4302032,4302370,4302032,338,0,utRho09
1939,yegQ,4331182,4331336,4331182,154,88,utRho09
1940,yegR,4336698,4336698,4336612,86,20,utRho09
1941,yegS,4337086,4337424,4337086,338,8,utRho09
1942,yegT,4357562,4357642,4357562,80,0,utRho09
1943,yegX,4367640,4367640,4367302,338,0,utRho09
1944,yehA,4376944,4376944,4376828,116,0,utRho09
1945,yehE,4385818,4385818,4385592,226,0,utRho09
1946,yehK,4407568,4407944,4407568,376,4,utRho09
1947,yehL,4408804,4409192,4408804,388,0,utRho09
1948,yeiB,4486146,4486146,4485934,212,28,utRho09
1949,yeiE,4499422,4499422,4499236,186,2,utRho09
1950,yeiG,4487776,4487820,4487776,44,506,utRho09
1951,yeiH,4499332,4499434,4499332,102,2,utRho09
1952,yeiI,4503306,4503400,4503306,94,56,utRho09
1953,yeiL,4510580,4510710,4510580,130,0,utRho09
1954,yeiP,4530834,4530900,4530834,66,460,utRho09
1955,yeiQ,4532328,4532490,4532328,162,0,utRho09
1956,yeiR,4535484,4535658,4535484,174,170,utRho09
1957,yeiW,4530840,4530840,4530590,250,1122,utRho09
1958,yejA,4544624,4544728,4544624,104,0,utRho09
1959,yejG,4556892,4556892,4556474,418,476,utRho09
1960,yejH,4561244,4561264,4561244,20,0,utRho09
1961,yejK,4568218,4568218,4567894,324,222,utRho09
1962,yejO,4578352,4578352,4577800,552,68,utRho09
1963,yfaD,4713380,4713808,4713380,428,136,utRho09
1964,yfaE,4696676,4697028,4696676,352,514,utRho09
1965,yfaL,4688568,4688568,4688338,230,0,utRho09
1966,yfaP,4656398,4656398,4656286,112,0,utRho09
1967,yfaU,4717892,4717892,4717690,202,0,utRho09
1968,yfaY,4727310,4727310,4727266,44,4,utRho09
1969,yfaZ,4728744,4728744,4728550,194,2,utRho09
1970,yfbK,4771810,4771810,4771444,366,4,utRho09
1971,yfbL,4771500,4771720,4771500,220,2,utRho09
1972,yfbN,4777174,4777174,4776852,322,20,utRho09
1973,yfbO,4776916,4777162,4776916,246,20,utRho09
1974,yfbP,4777990,4778232,4777990,242,72,utRho09
1975,yfbR,4817662,4817724,4817662,62,12,utRho09
1976,yfcI,4847424,4847424,4847078,346,16,utRho09
1977,yfcJ,4880482,4880482,4880240,242,284,utRho09
1978,yfcL,4888502,4888502,4888338,164,8,utRho09
1979,yfcV,4911642,4911642,4911292,350,4,utRho09
1980,yfcZ,4921958,4921958,4921868,90,8,utRho09
1981,yfdF,4925604,4926024,4925604,420,196,utRho09
1982,yfdG,4935474,4935710,4935474,236,0,utRho09
1983,yfdP,4946844,4947040,4946844,196,0,utRho09
1984,yfdX,4988866,4988866,4988804,62,0,utRho09
1985,yfdY,4990672,4990672,4990584,88,4,utRho09
1986,yfeA,5035784,5035784,5035664,120,5038,utRho09
1987,yfeC,5036668,5036934,5036668,266,42,utRho09
1988,yfeH,5053818,5053892,5053818,74,0,utRho09
1989,yfeK,5074630,5074684,5074630,54,0,utRho09
1990,yfeO,5018906,5019260,5018906,354,104,utRho09
1991,yfeR,5054078,5054078,5053712,366,60,utRho09
1992,yfeX,5101356,5101356,5101090,266,0,utRho09
1993,yfeY,5102486,5102486,5102432,54,0,utRho09
1994,yfeZ,5103842,5103842,5103452,390,50,utRho09
1995,yffO,5123804,5124222,5123804,418,0,utRho09
1996,yffQ,5126778,5127154,5126778,376,16,utRho09
1997,yffS,5128800,5128986,5128800,186,26,utRho09
1998,yfgC,5232052,5232188,5232052,136,0,utRho09
1999,yfgF,5258062,5258062,5257876,186,54,utRho09
2000,yfgG,5258170,5258580,5258170,410,148,utRho09
2001,yfgH,5259344,5259584,5259344,240,0,utRho09
2002,yfgM,5278866,5278866,5278566,300,250,utRho09
2003,yfhH,5397414,5397518,5397414,104,0,utRho09
2004,yfhM,5304648,5304648,5304574,74,0,utRho09
2005,yfhR,5328408,5328726,5328408,318,928,utRho09
2006,yfiC,5425610,5425610,5425528,82,0,utRho09
2007,yfiE,5430688,5430688,5430640,48,4,utRho09
2008,yfiL,5482630,5482720,5482630,90,0,utRho09
2009,yfiM,5448066,5448358,5448066,292,6360,utRho09
2010,yfiR,5483354,5483750,5483354,396,74,utRho09
2011,yfjH,5517326,5517326,5517200,126,2,utRho09
2012,yfjI,5517710,5517970,5517710,260,0,utRho09
2013,yfjJ,5521014,5521094,5521014,80,0,utRho09
2014,yfjM,5531970,5531970,5531552,418,238,utRho09
2015,yfjP,5535080,5535420,5535080,340,56,utRho09
2016,yfjW,5546570,5546636,5546570,66,34,utRho09
2017,yfjX,5551776,5551838,5551776,62,0,utRho09
2018,ygaC,5601180,5601180,5599988,1192,116,utRho09
2019,ygaM,5600242,5600292,5600242,50,34,utRho09
2020,ygaU,5593628,5593628,5593572,56,14,utRho09
2021,ygaZ,5619190,5619234,5619190,44,46,utRho09
2022,ygbA,5713656,5713656,5713612,44,0,utRho09
2023,ygbE,5746784,5746784,5746674,110,2,utRho09
2024,ygbI,5722882,5722882,5722528,354,0,utRho09
2025,ygbK,5724394,5724670,5724394,276,6,utRho09
2026,ygbL,5727074,5727186,5727074,112,74,utRho09
2027,ygbN,5729814,5730202,5729814,388,92,utRho09
2028,ygcG,5811210,5811422,5811210,212,44,utRho09
2029,ygcN,5785144,5785314,5785144,170,44,utRho09
2030,ygcU,5799214,5799214,5798836,378,106,utRho09
2031,ygcW,5800942,5800942,5800546,396,0,utRho09
2032,ygdD,5883442,5883442,5883262,180,0,utRho09
2033,ygdG,5861746,5861930,5861746,184,280,utRho09
2034,ygdI,5886526,5886526,5886290,236,0,utRho09
2035,ygdQ,5940784,5940840,5940784,56,0,utRho09
2036,ygdR,5942494,5942542,5942494,48,12,utRho09
2037,ygeA,5961606,5961606,5961270,336,10,utRho09
2038,ygeH,5983758,5984188,5983758,430,0,utRho09
2039,ygeI,5987162,5987276,5987162,114,10,utRho09
2040,ygeR,6000078,6000078,5999782,296,84,utRho09
2041,ygeV,6011694,6011694,6011572,122,52,utRho09
2042,ygeW,6012234,6012524,6012234,290,70,utRho09
2043,ygfB,6110946,6110946,6110888,58,42,utRho09
2044,ygfK,6031984,6032120,6031984,136,0,utRho09
2045,ygfS,6058328,6058328,6058024,304,0,utRho09
2046,ygfZ,6082564,6082626,6082564,62,0,utRho09
2047,yggC,6149512,6149512,6149378,134,58,utRho09
2048,yggE,6136370,6136370,6136160,210,2,utRho09
2049,yggI,6179176,6179510,6179176,334,20,utRho09
2050,yggL,6204508,6204508,6204266,242,278,utRho09
2051,yggM,6199514,6199514,6199130,384,140,utRho09
2052,yggN,6203596,6203596,6203246,350,4,utRho09
2053,yggX,18623958,18624558,18623958,600,624,utRho09
2054,yghA,6298966,6299324,6298966,358,4,utRho09
2055,yghB,6307058,6307126,6307058,68,2,utRho09
2056,yghD,6222614,6222614,6222252,362,0,utRho09
2057,yghF,6225798,6225798,6225840,42,0,utRho09
2058,yghJ,6238640,6238640,6238224,416,0,utRho09
2059,yghQ,6265186,6265186,6264816,370,0,utRho09
2060,yghT,6267830,6268262,6267830,432,14,utRho09
2061,yghU,6277400,6277454,6277400,54,36,utRho09
2062,yghW,6293506,6293506,6293474,32,0,utRho09
2063,yghZ,6295562,6295794,6295562,232,0,utRho09
2064,ygiD,6365122,6365122,6364868,254,182,utRho09
2065,ygiH,6409066,6409388,6409066,322,36,utRho09
2066,ygiL,6370622,6370828,6370622,206,0,utRho09
2067,ygiM,6402084,6402414,6402084,330,136,utRho09
2068,ygiN,6346156,6346284,6346156,128,1378,utRho09
2069,ygiQ,6322620,6322620,6322292,328,322,utRho09
2070,ygiS,6335462,6335462,6335436,26,0,utRho09
2071,ygiV,6338582,6338582,6338462,120,18,utRho09
2072,ygiW,6339774,6339774,6339352,422,8,utRho09
2073,ygiZ,6344506,6344506,6344422,84,0,utRho09
2074,ygjH,6442528,6442528,6442494,34,0,utRho09
2075,ygjI,6452140,6452468,6452140,328,0,utRho09
2076,ygjQ,6472730,6473080,6472730,350,262,utRho09
2077,ygjR,6474564,6474586,6474564,22,4,utRho09
2078,ygjV,6483638,6483638,6483488,150,0,utRho09
2079,yhaB,6535632,6535708,6535632,76,2,utRho09
2080,yhaH,6504498,6504608,6504498,110,16,utRho09
2081,yhaI,6505400,6505822,6505400,422,18,utRho09
2082,yhaJ,6508560,6508560,6508428,132,0,utRho09
2083,yhaK,6508538,6508638,6508538,100,0,utRho09
2084,yhbQ,6599878,6599932,6599878,54,34,utRho09
2085,yhbT,6602736,6602736,6602552,184,46,utRho09
2086,yhbU,6602558,6602970,6602558,412,48,utRho09
2087,yhbX,6643302,6643302,6643226,76,2,utRho09
2088,yhbY,6655518,6655580,6655518,62,660,utRho09
2089,yhcA,6723956,6724224,6723956,268,8,utRho09
2090,yhcB,6760364,6760382,6760364,18,98,utRho09
2091,yhcC,6708470,6708470,6708100,370,70,utRho09
2092,yhcF,6733440,6733852,6733440,412,70,utRho09
2093,yhcH,6739124,6739124,6738956,168,8,utRho09
2094,yhcM,6760312,6760312,6759994,318,72,utRho09
2095,yhcN,6770812,6771076,6770812,264,180,utRho09
2096,yhcO,6772606,6772606,6772258,348,0,utRho09
2097,yhdH,6806560,6806968,6806560,408,120,utRho09
2098,yhdJ,6823234,6823306,6823234,72,0,utRho09
2099,yhdN,6879092,6879092,6879018,74,1466,utRho09
2100,yhdT,6814702,6814750,6814702,48,312,utRho09
2101,yhdU,6824994,6825242,6824994,248,2,utRho09
2102,yhdV,6836392,6836780,6836392,388,12,utRho09
2103,yhdW,6837944,6838298,6837944,354,0,utRho09
2104,yheO,6953082,6953082,6952880,202,916,utRho09
2105,yheV,6957970,6957970,6957584,386,58,utRho09
2106,yhfA,6971902,6971902,6971636,266,154,utRho09
2107,yhfG,6983294,6983294,6983240,54,412,utRho09
2108,yhfL,6998622,6998896,6998622,274,72,utRho09
2109,yhfY,7023244,7023244,7022844,400,36,utRho09
2110,yhgA,7086294,7086334,7086294,40,0,utRho09
2111,yhgE,7065176,7065176,7064878,298,204,utRho09
2112,yhgF,7074352,7074770,7074352,418,986,utRho09
2113,yhhA,7173458,7173886,7173458,428,46,utRho09
2114,yhhI,7248346,7248756,7248346,410,2,utRho09
2115,yhhJ,7253696,7253696,7253606,90,0,utRho09
2116,yhhM,7211588,7211588,7211220,368,2,utRho09
2117,yhhN,7211150,7211502,7211150,352,2,utRho09
2118,yhhQ,7218238,7218434,7218238,196,198,utRho09
2119,yhhT,7223682,7223730,7223682,48,10,utRho09
2120,yhhX,7162032,7162032,7161610,422,24,utRho09
2121,yhhY,7162222,7162276,7162222,54,0,utRho09
2122,yhhZ,7163516,7163726,7163516,210,2,utRho09
2123,yhiD,7312220,7312220,7311804,416,2176,utRho09
2124,yhiJ,7265190,7265190,7265180,10,0,utRho09
2125,yhiM,7269270,7269682,7269270,412,16,utRho09
2126,yhiN,7275000,7275000,7274820,180,8,utRho09
2127,yhjA,7338522,7338522,7338376,146,2,utRho09
2128,yhjB,7344090,7344090,7343788,302,0,utRho09
2129,yhjC,7344272,7344684,7344272,412,0,utRho09
2130,yhjD,7346660,7346724,7346660,64,0,utRho09
2131,yhjE,7349274,7349572,7349274,298,64,utRho09
2132,yhjG,7356824,7356824,7356730,94,2,utRho09
2133,yhjH,7358458,7358458,7358374,84,214,utRho09
2134,yhjJ,7364032,7364032,7363880,152,184,utRho09
2135,yhjK,7371296,7371296,7371158,138,0,utRho09
2136,yhjR,7392750,7392750,7392370,380,0,utRho09
2137,yhjV,7400796,7401126,7400796,330,170,utRho09
2138,yhjX,7424194,7424194,7424014,180,18,utRho09
2139,yhjY,7425966,7425966,7425868,98,0,utRho09
2140,yiaB,7455654,7455654,7455496,158,6,utRho09
2141,yiaD,7432712,7433094,7432712,382,14,utRho09
2142,yiaF,7438194,7438194,7438088,106,0,utRho09
2143,yiaG,7438862,7438956,7438862,94,68,utRho09
2144,yiaJ,7485236,7485236,7485064,172,2,utRho09
2145,yiaK,7485348,7485466,7485348,118,0,utRho09
2146,yiaT,7503924,7503924,7503736,188,0,utRho09
2147,yiaU,7503792,7503984,7503792,192,0,utRho09
2148,yiaY,7515856,7515856,7515654,202,6,utRho09
2149,yibF,7523950,7523950,7523910,40,0,utRho09
2150,yibG,7536128,7536354,7536128,226,12,utRho09
2151,yibL,7553194,7553330,7553194,136,36,utRho09
2152,yibN,7570112,7570112,7570030,82,442,utRho09
2153,yibT,7552848,7552848,7552760,88,152,utRho09
2154,yicC,7633290,7633352,7633290,62,112,utRho09
2155,yicH,7660862,7660914,7660862,52,22,utRho09
2156,yicJ,7673328,7673328,7671858,1470,608,utRho09
2157,yicN,7685018,7685018,7684804,214,20,utRho09
2158,yicO,7687914,7687914,7687578,336,0,utRho09
2159,yicR,15250308,15250308,15250236,72,0,utRho09
2160,yidB,7755230,7755230,7754930,300,8,utRho09
2161,yidE,7732780,7732780,7732546,234,0,utRho09
2162,yidF,7711580,7711580,7711222,358,64,utRho09
2163,yidQ,7735088,7735456,7735088,368,980,utRho09
2164,yidR,7738824,7738824,7738618,206,0,utRho09
2165,yieE,7787658,7787738,7787658,80,30,utRho09
2166,yieH,7793314,7793548,7793314,234,4,utRho09
2167,yieK,7798928,7798928,7798786,142,2,utRho09
2168,yifB,7900350,7900350,7899998,352,36,utRho09
2169,yifL,7988984,7989044,7988984,60,38,utRho09
2170,yigF,8005750,8005750,8005598,152,124,utRho09
2171,yigI,8009448,8009448,8009394,54,30,utRho09
2172,yigM,8022100,8022152,8022100,52,2,utRho09
2173,yihA,8101970,8101970,8101458,512,120,utRho09
2174,yihD,8084098,8084138,8084098,40,0,utRho09
2175,yihF,8088110,8088398,8088110,288,2,utRho09
2176,yihG,8093304,8093304,8093204,100,4,utRho09
2177,yihI,8102616,8102694,8102616,78,32,utRho09
2178,yihL,8120506,8120894,8120506,388,56,utRho09
2179,yihN,8124332,8124494,8124332,162,2,utRho09
2180,yihO,8131942,8131942,8131532,410,2,utRho09
2181,yihQ,8138892,8138892,8138552,340,0,utRho09
2182,yihV,8147064,8147478,8147064,414,0,utRho09
2183,yihX,8151096,8151106,8151096,10,4,utRho09
2184,yiiE,8158192,8158582,8158192,390,8,utRho09
2185,yiiF,8159124,8159502,8159124,378,0,utRho09
2186,yiiG,8173762,8174004,8173762,242,0,utRho09
2187,yiiM,8205506,8205644,8205506,138,20,utRho09
2188,yiiQ,8224624,8224624,8224428,196,0,utRho09
2189,yiiS,8225738,8225934,8225738,196,0,utRho09
2190,yijE,8272178,8272216,8272178,38,0,utRho09
2191,yijF,8275728,8275728,8275314,414,2,utRho09
2192,yijO,8296858,8296858,8296634,224,0,utRho09
2193,yjaA,8426240,8426468,8426240,228,127184,utRho09
2194,yjaB,8428312,8428312,8428246,66,6,utRho09
2195,yjaG,8398746,8399008,8398746,262,1228,utRho09
2196,yjaH,8401022,8401132,8401022,110,430,utRho09
2197,yjaZ,8379506,8379572,8379506,66,40,utRho09
2198,yjbB,8455204,8455462,8455204,258,0,utRho09
2199,yjbE,16943432,16943624,16943432,192,32,utRho09
2200,yjbL,8520318,8520642,8520318,324,0,utRho09
2201,yjbQ,8540428,8540476,8540428,48,0,utRho09
2202,yjcB,8550328,8550328,8550082,246,266,utRho09
2203,yjcC,8550836,8550942,8550836,106,44,utRho09
2204,yjcD,8556628,8556958,8556628,330,82,utRho09
2205,yjcE,8559658,8559960,8559658,302,2,utRho09
2206,yjcF,8566212,8566212,8566150,62,0,utRho09
2207,yjcO,8594660,8594660,8594250,410,0,utRho09
2208,yjdA,8654128,8654270,8654128,142,0,utRho09
2209,yjdC,8726660,8726660,8726616,44,30,utRho09
2210,yjdK,8704780,8705168,8704780,388,58,utRho09
2211,yjdL,8713034,8713034,8712822,212,0,utRho09
2212,yjdM,8653672,8653672,8653468,204,52,utRho09
2213,yjeF,8787354,8788132,8787354,778,3186,utRho09
2214,yjeI,8745522,8745618,8745522,96,4,utRho09
2215,yjeJ,8748806,8748806,8748468,338,64,utRho09
2216,yjeV,8785472,8785784,8785472,312,132,utRho09
2217,yjfP,8833512,8833904,8833512,392,46,utRho09
2218,yjfY,8849656,8849656,8849582,74,0,utRho09
2219,yjfZ,8855052,8855052,8854844,208,2,utRho09
2220,yjgA,8916162,8916162,8915730,432,28,utRho09
2221,yjgL,8950802,8950874,8950802,72,0,utRho09
2222,yjgM,8959342,8959342,8959074,268,0,utRho09
2223,yjgN,8959132,8959460,8959132,328,0,utRho09
2224,yjgR,8980170,8980170,8980126,44,172,utRho09
2225,yjgZ,9002116,9002520,9002116,404,142,utRho09
2226,yjhB,9007764,9008116,9007764,352,2,utRho09
2227,yjhG,9048452,9048452,9048188,264,218,utRho09
2228,yjhU,9041080,9041080,9040648,432,160,utRho09
2229,yjiA,9178096,9178096,9177730,366,582,utRho09
2230,yjiJ,9125364,9125364,9125350,14,0,utRho09
2231,yjiK,9127270,9127270,9127422,152,142,utRho09
2232,yjiL,9129604,9129604,9129378,226,0,utRho09
2233,yjiS,9143410,9143502,9143410,92,0,utRho09
2234,yjiY,9182734,9182734,9182558,176,358,utRho09
2235,yjjA,9200674,9200674,9200378,296,182,utRho09
2236,yjjB,18408708,18408708,18407800,908,16,utRho09
2237,yjjJ,9243314,9243538,9243314,224,46,utRho09
2238,yjjK,9261132,9261132,9261044,88,2,utRho09
2239,yjjL,9189764,9189764,9189444,320,0,utRho09
2240,yjjM,9191894,9191894,9191702,192,8,utRho09
2241,yjjP,9206068,9206068,9205716,352,102,utRho09
2242,yjjQ,9206638,9206954,9206638,316,32,utRho09
2243,yjjX,9267798,9267798,9267490,308,860,utRho09
2244,yjjY,9280716,9280804,9280716,88,636,utRho09
2245,yjjZ,9211554,9211608,9211554,54,50,utRho09
2246,yjtD,9281676,9281884,9281676,208,2,utRho09
2247,ykfB,532454,532454,532174,280,170,utRho09
2248,ykfI,527636,527636,527338,298,88,utRho09
2249,ykgB,637050,637050,636638,412,0,utRho09
2250,ykgC,640430,640430,640002,428,0,utRho09
2251,ykgD,640232,640454,640232,222,0,utRho09
2252,ykgE,642962,643216,642962,254,12,utRho09
2253,ykgJ,608524,608524,608364,160,14,utRho09
2254,ykgL,623878,624224,623878,346,16,utRho09
2255,ykgM,625610,625610,625554,56,0,utRho09
2256,ykgR,626570,626570,626484,86,2,utRho09
2257,ylaC,958576,958576,958502,74,630,utRho09
2258,yliE,1745938,1745958,1745938,20,0,utRho09
2259,ymcE,2103660,2103694,2103660,34,68,utRho09
2260,ymdA,2210450,2210828,2210450,378,142,utRho09
2261,ymdB,2211428,2211640,2211428,212,38,utRho09
2262,ymfD,2395322,2395322,2395064,258,404,utRho09
2263,ymfI,2402880,2402994,2402880,114,0,utRho09
2264,ymfJ,2404518,2404518,2404168,350,278,utRho09
2265,ymfK,2406176,2406176,2405866,310,0,utRho09
2266,ymfT,2405766,2406048,2405766,282,2,utRho09
2267,ymgE,2489110,2489456,2489110,346,4,utRho09
2268,ymgF,2437628,2437966,2437628,338,4,utRho09
2269,ymiA,2670112,2670320,2670112,208,134,utRho09
2270,ymjA,2715620,2715620,2715336,284,444,utRho09
2271,ynaI,2791946,2791946,2791844,102,0,utRho09
2272,ynaK,2850438,2850754,2850438,316,4,utRho09
2273,ynbA,2954924,2955242,2954924,318,2,utRho09
2274,yncD,3046552,3046552,3046130,422,70,utRho09
2275,yncE,3046454,3046614,3046454,160,0,utRho09
2276,yncG,3052456,3052494,3052456,38,44,utRho09
2277,yncL,3034492,3034492,3034388,104,10,utRho09
2278,yneE,3218364,3218364,3218044,320,0,utRho09
2279,yneF,3223748,3223748,3223708,40,0,utRho09
2280,yneJ,3229560,3229608,3229560,48,16,utRho09
2281,yneK,3231100,3231526,3231100,426,2,utRho09
2282,yneM,3245176,3245292,3245176,116,72,utRho09
2283,ynfA,3311398,3311398,3311346,52,12,utRho09
2284,ynfB,3311418,3311616,3311418,198,352,utRho09
2285,ynfC,3315094,3315094,3314914,180,2,utRho09
2286,ynfD,3314828,3315130,3314828,302,60,utRho09
2287,ynfE,3316006,3316138,3316006,132,40,utRho09
2288,ynfK,3334670,3334670,3334438,232,160,utRho09
2289,ynfL,3339304,3339304,3339184,120,0,utRho09
2290,ynfM,3339260,3339398,3339260,138,2,utRho09
2291,ynfN,3276598,3276598,3276218,380,18,utRho09
2292,ynfO,3273454,3273512,3273454,58,0,utRho09
2293,ynhG,3517890,3517890,3517450,440,224,utRho09
2294,yniA,3615158,3615592,3615158,434,4,utRho09
2295,yniB,3618526,3618526,3618466,60,2,utRho09
2296,yniC,3618652,3618760,3618652,108,2,utRho09
2297,yniD,3610202,3610330,3610202,128,0,utRho09
2298,ynjE,3678880,3678934,3678880,54,2,utRho09
2299,ynjF,3683222,3683222,3682806,416,28,utRho09
2300,ynjH,3684376,3684376,3684270,106,0,utRho09
2301,ynjI,3690022,3690022,3689742,280,38,utRho09
2302,yoaB,3786642,3786734,3786642,92,208,utRho09
2303,yoaC,3787932,3788146,3787932,214,212,utRho09
2304,yoaE,3803544,3803544,3803170,374,0,utRho09
2305,yoaF,3755444,3755444,3755064,380,354,utRho09
2306,yoaH,3789866,3789866,3789462,404,558,utRho09
2307,yobB,3850418,3850880,3850418,462,328,utRho09
2308,yobF,3815586,3815586,3815182,404,4,utRho09
2309,yobH,3817800,3817850,3817800,50,0,utRho09
2310,yodB,4084352,4084736,4084352,384,8,utRho09
2311,yodC,4057008,4057008,4056740,268,2,utRho09
2312,yohC,4451358,4451358,4451262,96,0,utRho09
2313,yohD,4451526,4451602,4451526,76,2,utRho09
2314,yohJ,4460986,4461248,4460986,262,0,utRho09
2315,yohO,4431172,4431314,4431172,142,0,utRho09
2316,yojI,4617282,4617282,4617230,52,0,utRho09
2317,ypdI,4988988,4989396,4988988,408,6,utRho09
2318,ypfG,5165786,5165786,5165554,232,2,utRho09
2319,ypfM,5182140,5182140,5181732,408,332,utRho09
2320,yphB,5349590,5349590,5349376,214,16,utRho09
2321,ypjA,5565644,5565644,5565452,192,10,utRho09
2322,ypjB,5569636,5569636,5568858,778,2,utRho09
2323,ypjD,5495860,5495774,5495860,86,0,utRho09
2324,yqaE,5594170,5594170,5594056,114,22,utRho09
2325,yqcA,5846100,5846100,5845968,132,0,utRho09
2326,yqcE,5800944,5801184,5800944,240,0,utRho09
2327,yqeC,6030468,6030468,6030114,354,40,utRho09
2328,yqeF,5971618,5971618,5971184,434,12,utRho09
2329,yqeG,5971438,5971694,5971438,256,4,utRho09
2330,yqeH,5975016,5975072,5975016,56,24,utRho09
2331,yqeI,5976688,5977004,5976688,316,0,utRho09
2332,yqeK,5981140,5981140,5980720,420,22,utRho09
2333,yqfA,6086728,6086728,6086296,432,332,utRho09
2334,yqgA,6219042,6219106,6219042,64,0,utRho09
2335,yqgB,6172500,6172500,6172102,398,4156,utRho09
2336,yqgE,6185768,6185874,6185768,106,360,utRho09
2337,yqhA,6299150,6299150,6298942,208,2,utRho09
2338,yqhC,6310768,6310768,6310436,332,48,utRho09
2339,yqhD,6310604,6310710,6310604,106,48,utRho09
2340,yqhH,6316842,6317254,6316842,412,226,utRho09
2341,yqiC,6369662,6369680,6369662,18,2,utRho09
2342,yqiJ,6384108,6384416,6384108,308,58,utRho09
2343,yqjA,6495096,6495546,6495096,450,1008,utRho09
2344,yqjF,6500932,6501124,6500932,192,34,utRho09
2345,yqjG,6501948,6502048,6501948,100,0,utRho09
2346,yqjH,6433078,6433078,6432982,96,0,utRho09
2347,yqjI,6433506,6433558,6433506,52,0,utRho09
2348,yraH,6574552,6574852,6574552,300,0,utRho09
2349,yraP,6592144,6592818,6592144,674,316,utRho09
2350,yraQ,6596414,6596414,6596276,138,0,utRho09
2351,yraR,6598024,6598024,6597692,332,2,utRho09
2352,yrbG,13360844,13361100,13360844,256,144,utRho09
2353,yrbL,6696842,6696904,6696842,62,78,utRho09
2354,yrbN,6616172,6616172,6615866,306,5100,utRho09
2355,yrdB,6860176,6860176,6860046,130,6,utRho09
2356,yrfF,7052548,7052938,7052548,390,336,utRho09
2357,yrhB,7169440,7169518,7169440,78,0,utRho09
2358,ysaB,7451804,7451804,7451424,380,0,utRho09
2359,ysgA,8032686,8032686,8032338,348,20,utRho09
2360,ytfB,8857638,8857638,8857434,204,62,utRho09
2361,ytfE,8864018,8864018,8863966,52,0,utRho09
2362,ytfF,8866296,8866296,8866130,166,6,utRho09
2363,ytfH,8868164,8868226,8868164,62,0,utRho09
2364,ytfI,8875234,8875414,8875234,180,0,utRho09
2365,ytfJ,8878572,8878572,8878524,48,56,utRho09
2366,ytfK,8879022,8879174,8879022,152,168,utRho09
2367,ytfL,8882642,8882642,8882430,212,0,utRho09
2368,ytfQ,8899634,8899924,8899634,290,188,utRho09
2369,ytjB,9249598,9249598,9249578,20,2,utRho09
2370,yzfA,8896588,8896588,8896490,98,2,utRho09
2371,zapA,6111102,6111224,6111102,122,3258,utRho09
2372,zapB,8236772,8237030,8236772,258,184,utRho09
2373,zapC,2011700,2011904,2011700,204,10,utRho09
2374,zinT,4082692,4082750,4082692,58,2,utRho09
2375,zipA,5062814,5062814,5062466,348,0,utRho09
2376,zitB,1569716,1569716,1569646,70,0,utRho09
2377,zntA,7212844,7212902,7212844,58,0,utRho09
2378,zntR,6878336,6878336,6878260,76,8,utRho09
2379,znuA,3885322,3885322,3885166,156,0,utRho09
2380,znuC,3885268,3885324,3885268,56,0,utRho09
2381,zraP,8403424,8403424,8403376,48,0,utRho09
2382,zraS,8403810,8403852,8403810,42,4,utRho09
2383,zupT,6364866,6365100,6364866,234,182,utRho09
2384,zur,8520282,8520282,8520006,276,224,utRho09
2385,zwf,3872752,3872752,3872628,124,0,utRho09
0,C0343,2818676,2818728,2818676,52,0,utRho10
1,aaeB,6776526,6776526,6776376,150,0,utRho10
2,aaeR,6778762,6779040,6778762,278,458,utRho10
3,aaeX,6778860,6778860,6778674,186,588,utRho10
4,aat,1854920,1854920,1854864,56,0,utRho10
5,accA,416822,417242,416822,420,2658,utRho10
6,accB,6810280,6810872,6810280,592,7752,utRho10
7,accD,4868030,4868030,4867852,178,770,utRho10
8,aceB,8430804,8430956,8430804,152,502,utRho10
9,aceE,245938,246034,245938,96,62,utRho10
10,ackA,4826918,4826940,4826918,22,930,utRho10
11,acnA,2670848,2671662,2670848,814,1526,utRho10
12,acnB,263038,263230,263038,192,1226,utRho10
13,acpP,2303148,2303230,2303148,82,482,utRho10
14,acpS,5402324,5402324,5401996,328,714,utRho10
15,acrA,971396,971396,971238,158,130,utRho10
16,acrB,969370,969370,968806,564,1744,utRho10
17,acrD,5174950,5175190,5174950,240,46,utRho10
18,acrE,6827404,6827728,6827404,324,102,utRho10
19,acrR,971398,971522,971398,124,46,utRho10
20,acrZ,1589502,1589546,1589502,44,48,utRho10
21,acs,8575190,8575190,8574742,448,580,utRho10
22,actP,8569870,8569870,8569804,66,56,utRho10
23,ada,4620854,4620854,4620810,44,0,utRho10
24,add,3404404,3404466,3404404,62,20,utRho10
25,ade,7687802,7687928,7687802,126,252,utRho10
26,adhE,2596826,2596826,2596242,584,148,utRho10
27,adhP,3107988,3107988,3107676,312,618,utRho10
28,adiA,8681112,8681112,8681042,70,62,utRho10
29,adiC,8674404,8674404,8674062,342,220,utRho10
30,adiY,8676084,8676084,8675858,226,0,utRho10
31,adk,994278,994350,994278,72,1156,utRho10
32,adrA,807374,807406,807374,32,60,utRho10
33,aer,6438240,6438240,6438152,88,106,utRho10
34,aes,1000102,1000102,999946,156,1000,utRho10
35,agaR,6557406,6557406,6557330,76,0,utRho10
36,agaS,6563778,6563952,6563778,174,2,utRho10
37,agp,2131118,2131170,2131118,52,0,utRho10
38,agrA,7296126,7296126,7296126,0,0,utRho10
39,agrB,7296588,7296588,7296588,0,0,utRho10
40,ahpC,1277386,1277890,1277386,504,894,utRho10
41,ahpF,1278004,1279506,1278004,1502,48600,utRho10
42,ahr,8992698,8992698,8992418,280,122,utRho10
43,aidB,8828494,8828550,8828494,56,0,utRho10
44,ais,4731512,4731512,4731240,272,66,utRho10
45,alaA,4814816,4815122,4814816,306,116,utRho10
46,alaC,4996798,4996798,4996590,208,80,utRho10
47,alaE,5598140,5598328,5598140,188,62,utRho10
48,alaS,5644180,5644180,5644022,158,1554,utRho10
49,alaW,5036612,5036612,5036462,150,6,utRho10
50,aldA,2976380,2976464,2976380,84,214,utRho10
51,aldB,7513070,7513070,7513022,48,560,utRho10
52,alkA,4295118,4295118,4295080,38,82,utRho10
53,alkB,4618890,4618890,4618682,208,48,utRho10
54,allA,1064780,1064902,1064780,122,84,utRho10
55,allD,1092822,1092822,1092726,96,50,utRho10
56,allE,1088112,1088112,1088092,20,8,utRho10
57,allS,1064600,1064600,1064442,158,0,utRho10
58,alr,8531178,8531564,8531178,386,2370,utRho10
59,alsE,8617334,8617334,8616956,378,40,utRho10
60,alsK,8615990,8615990,8615598,392,390,utRho10
61,alx,6476740,6477160,6476740,420,0,utRho10
62,amiA,5104482,5104704,5104482,222,32,utRho10
63,amiC,5898378,5898378,5898020,358,1790,utRho10
64,amn,4110062,4110122,4110062,60,88,utRho10
65,ampC,8758006,8758006,8757888,118,48,utRho10
66,ampD,237362,237466,237362,104,176,utRho10
67,ampG,907372,907372,907090,282,408,utRho10
68,ampH,792726,792726,792574,152,176,utRho10
69,amyA,4012230,4012312,4012230,82,70,utRho10
70,anmK,3439346,3439346,3439204,142,0,utRho10
71,ansB,6201580,6201580,6201456,124,334,utRho10
72,ansP,3052040,3052040,3051960,80,198,utRho10
73,apaG,104068,104068,103212,856,5676,utRho10
74,apaH,102586,102586,102444,142,7614,utRho10
75,apbE,4623188,4623188,4623068,120,0,utRho10
76,appA,2081198,2081234,2081198,36,0,utRho10
77,appC,2075420,2075480,2075420,60,0,utRho10
78,appY,1167134,1167362,1167134,228,0,utRho10
79,apt,982620,982824,982620,204,370,utRho10
80,aqpZ,1832424,1832424,1832094,330,60,utRho10
81,araB,140150,140150,140096,54,106,utRho10
82,araC,140482,140774,140482,292,618,utRho10
83,araE,5964416,5964416,5964364,52,0,utRho10
84,araF,3972476,3972476,3972256,220,174,utRho10
85,araH,3967120,3967120,3967086,34,64,utRho10
86,araJ,825058,825058,824962,96,436,utRho10
87,arcA,9281602,9281602,9280612,990,3390,utRho10
88,arcB,6706098,6706098,6706050,48,156,utRho10
89,arcZ,6701154,6701154,6701154,0,0,utRho10
90,arfA,6877346,6877346,6877298,48,782,utRho10
91,argA,5898312,5898484,5898312,172,766,utRho10
92,argC,8309770,8310002,8309770,232,78,utRho10
93,argD,6980442,6980442,6980360,82,120,utRho10
94,argE,8310156,8310156,8309694,462,146,utRho10
95,argF,580680,580680,580610,70,0,utRho10
96,argG,6637124,6637274,6637124,150,458,utRho10
97,argI,8956688,8956688,8956622,66,142,utRho10
98,argO,6137672,6137672,6137616,56,720,utRho10
99,argP,6119460,6119506,6119460,46,670,utRho10
100,argR,6769204,6769406,6769204,202,314,utRho10
101,argS,3920002,3920124,3920002,122,0,utRho10
102,argT,4855698,4855698,4855582,116,336,utRho10
103,argU,1129406,1129446,1129406,40,0,utRho10
104,argW,4932616,4932618,4932616,2,60,utRho10
105,argX,7964728,7964750,7964728,22,12,utRho10
106,aroF,5482402,5482402,5482300,102,0,utRho10
107,aroG,1571182,1571266,1571182,84,574,utRho10
108,aroH,3576636,3576870,3576636,234,482,utRho10
109,aroK,7038760,7038760,7038128,632,1138,utRho10
110,aroL,812560,812810,812560,250,1100,utRho10
111,aroP,243342,243342,243102,240,24,utRho10
112,arpA,8445382,8445382,8444974,408,280,utRho10
113,arrS,7316108,7316108,7316108,0,0,utRho10
114,arsR,7297024,7297056,7297024,32,164,utRho10
115,artJ,1801252,1801252,1801150,102,32,utRho10
116,artP,1807686,1807686,1807468,218,2080,utRho10
117,ascF,5678858,5679048,5678858,190,0,utRho10
118,ascG,5678574,5678574,5678528,46,0,utRho10
119,aslB,7965562,7965916,7965562,354,47088,utRho10
120,asnA,7854258,7854310,7854258,52,466,utRho10
121,asnB,1398444,1398444,1398354,90,1356,utRho10
122,asnC,23562186,23562186,23562018,168,294,utRho10
123,asnS,1978088,1978088,1977970,118,6606,utRho10
124,asnT,4089082,4089098,4089082,16,154,utRho10
125,asnU,4119690,4119702,4119690,12,6,utRho10
126,asnV,4124504,4124520,4124504,16,234,utRho10
127,aspA,17473728,17473728,17473308,420,84,utRho10
128,aspC,1971486,1971486,1971418,68,1766,utRho10
129,aspS,3901402,3901402,3901044,358,230,utRho10
130,aspT,7893560,7893744,7893560,184,113846,utRho10
131,aspV,473826,473862,473826,36,4,utRho10
132,asr,3342654,3342752,3342654,98,76,utRho10
133,astC,3664088,3664088,3663964,124,48,utRho10
134,astE,3654138,3654138,3653846,292,68,utRho10
135,atoD,4646824,4646894,4646824,70,536,utRho10
136,atpB,7844540,7844540,7844102,438,450,utRho10
137,atpC,7832118,7832118,7831944,174,2368,utRho10
138,atpI,7845050,7845050,7844880,170,76,utRho10
139,avtA,7479348,7479410,7479348,62,640,utRho10
140,azoR,2965982,2965982,2965720,262,214,utRho10
141,azuC,3976002,3976002,3975918,84,16,utRho10
142,bacA,6408350,6408350,6408262,88,898,utRho10
143,bamA,394052,395856,394052,1804,974,utRho10
144,bamB,5277950,5277950,5277304,646,968,utRho10
145,bamC,5198028,5198028,5197730,298,848,utRho10
146,bamD,5471922,5472292,5471922,370,12672,utRho10
147,bamE,5506972,5507210,5506972,238,216,utRho10
148,basS,8666954,8666954,8666544,410,2020,utRho10
149,bax,7474468,7474468,7474354,114,28,utRho10
150,bcp,5200874,5200956,5200874,82,1406,utRho10
151,bcsB,7385346,7385346,7385214,132,70,utRho10
152,bcsE,7392644,7392916,7392644,272,0,utRho10
153,bdcA,8948128,8948128,8948106,22,2276,utRho10
154,bdcR,8948192,8948248,8948192,56,760,utRho10
155,bdm,3112680,3112680,3112560,120,12,utRho10
156,betA,654522,654522,654494,28,132,utRho10
157,betI,658722,658722,658668,54,154,utRho10
158,betT,658842,658926,658842,84,146,utRho10
159,bfr,6933498,6933498,6933450,48,16,utRho10
160,bglG,23440182,23440182,23439402,780,942,utRho10
161,bglX,4444240,4444240,4443978,262,76,utRho10
162,bhsA,2337962,2338146,2337962,184,160,utRho10
163,bioA,1618584,1618584,1618514,70,0,utRho10
164,bioB,1618604,1618688,1618604,84,0,utRho10
165,bioH,7089716,7089716,7089688,28,60,utRho10
166,bisC,7433026,7433026,7432788,238,554,utRho10
167,blc,8755490,8755490,8755444,46,0,utRho10
168,blr,3409024,3409102,3409024,78,108,utRho10
169,bluF,2431226,2431226,2430950,276,570,utRho10
170,bluR,2428226,2428226,2428118,108,0,utRho10
171,bolA,908698,908944,908698,246,90,utRho10
172,borD,1157842,1157842,1157786,56,0,utRho10
173,brnQ,838976,839182,838976,206,840,utRho10
174,bssR,1756492,1756496,1756492,4,0,utRho10
175,bssS,2242116,2242116,2241910,206,878,utRho10
176,btuB,8326798,8327278,8326798,480,3324,utRho10
177,cadB,8720212,8720212,8720062,150,162,utRho10
178,cadC,8723926,8723926,8723868,58,0,utRho10
179,caiE,70998,70998,70742,256,88,utRho10
180,caiF,68436,68600,68436,164,36,utRho10
181,caiT,84074,84074,83862,212,0,utRho10
182,can,285406,285406,285340,66,24,utRho10
183,carA,59102,59302,59102,200,40,utRho10
184,carB,61550,61634,61550,84,318,utRho10
185,cas2,5757830,5757830,5757706,124,470,utRho10
186,casA,5768638,5768638,5768276,362,0,utRho10
187,cbl,4121882,4121882,4121828,54,1852,utRho10
188,cbpA,2128074,2128074,2127550,524,480,utRho10
189,cbrA,7738628,7738754,7738628,126,0,utRho10
190,cbrB,7794958,7795012,7794958,54,342,utRho10
191,ccmH,4585242,4585242,4584820,422,0,utRho10
192,cdaR,364894,364926,364894,32,68,utRho10
193,cdd,4463638,4463688,4463638,50,0,utRho10
194,cdh,8219814,8219860,8219814,46,946,utRho10
195,cdsA,391110,391354,391110,244,2182,utRho10
196,cedA,3627484,3627484,3627326,158,146,utRho10
197,cfa,3482402,3482826,3482402,424,798,utRho10
198,chaC,2544844,2544972,2544844,128,210,utRho10
199,chbB,3643452,3643452,3643238,214,0,utRho10
200,chbG,3634624,3634624,3634270,354,0,utRho10
201,cheW,3946924,3946924,3946678,246,2008,utRho10
202,chiA,6939792,6939792,6939706,86,78,utRho10
203,chiP,1416472,1416668,1416472,196,104,utRho10
204,cho,3646984,3647030,3646984,46,66,utRho10
205,chpS,8896804,8896894,8896804,90,330,utRho10
206,cirA,4493884,4493884,4493538,346,240,utRho10
207,citC,1304078,1304078,1303712,366,110,utRho10
208,citT,1293264,1293264,1293160,104,4,utRho10
209,clcA,350104,350214,350104,110,2,utRho10
210,clpA,1846160,1846528,1846160,368,138,utRho10
211,clpB,5468410,5468410,5468346,64,234,utRho10
212,clpP,913154,913354,913154,200,388,utRho10
213,clpS,1845500,1845826,1845500,326,550,utRho10
214,clpX,914404,914852,914404,448,1022,utRho10
215,clsA,2617346,2617346,2617290,56,108,utRho10
216,clsC,2212584,2212710,2212584,126,548,utRho10
217,cmk,1922330,1922402,1922330,72,72,utRho10
218,cnu,3409522,3409898,3409522,376,2508,utRho10
219,coaA,8350214,8350214,8350052,162,1068,utRho10
220,cobC,1340092,1340092,1339814,278,524,utRho10
221,cobT,4129202,4129202,4128934,268,106,utRho10
222,cobU,4131944,4131944,4131528,416,766,utRho10
223,codB,709768,709844,709768,76,0,utRho10
224,comR,2337726,2337726,2337664,62,0,utRho10
225,copA,1022822,1022822,1022758,64,16,utRho10
226,corA,8002388,8002852,8002388,464,22366,utRho10
227,cpdB,8873258,8873258,8873130,128,446,utRho10
228,cptB,6082198,6082198,6082140,58,130,utRho10
229,cpxA,8210202,8210202,8209950,252,416,utRho10
230,cpxP,8211570,8211640,8211570,70,70,utRho10
231,cpxR,8211372,8211372,8211340,32,0,utRho10
232,cra,175894,176056,175894,162,2,utRho10
233,crcB,1316016,1316016,1315876,140,736,utRho10
234,creA,9270486,9271042,9270486,556,608,utRho10
235,creD,9276320,9276356,9276320,36,208,utRho10
236,crl,515620,515658,515620,38,1390,utRho10
237,crp,6971906,6972240,6971906,334,2716,utRho10
238,crr,5070960,5071668,5070960,708,2786,utRho10
239,csdA,5886414,5886674,5886414,260,484,utRho10
240,csgB,2207718,2207902,2207718,184,0,utRho10
241,csgD,2206688,2206688,2206392,296,484,utRho10
242,csgG,2203510,2203510,2203368,142,212,utRho10
243,csiD,5577854,5577970,5577854,116,30,utRho10
244,csiE,5330802,5330870,5330802,68,688,utRho10
245,csiR,5590942,5591348,5590942,406,118,utRho10
246,cspA,7439778,7440098,7439778,320,122430,utRho10
247,cspB,3283430,3283430,3283108,322,232,utRho10
248,cspC,3815018,3815018,3814870,148,650,utRho10
249,cspD,1845352,1845352,1845180,172,1584,utRho10
250,cspE,1314294,1314584,1314294,290,158,utRho10
251,cspF,3283380,3283710,3283380,330,278,utRho10
252,cspG,2102610,2102922,2102610,312,3956,utRho10
253,cspH,2102746,2102746,2102350,396,336,utRho10
254,cspI,3277624,3277624,3277334,290,112,utRho10
255,csrA,5638746,5638746,5638292,454,1240,utRho10
256,csrB,5849048,5849048,5849048,0,0,utRho10
257,csrC,8102072,8102072,8102072,0,0,utRho10
258,csrD,6806850,6806850,6806664,186,124,utRho10
259,cstA,1259710,1259788,1259710,78,0,utRho10
260,cueO,274090,274166,274090,76,0,utRho10
261,cueR,1027948,1027986,1027948,38,0,utRho10
262,curA,3037784,3038054,3037784,270,606,utRho10
263,cusC,1191146,1191200,1191146,54,38,utRho10
264,cusR,1190924,1190924,1190886,38,40,utRho10
265,cutA,8730784,8730784,8730712,72,764,utRho10
266,cutC,3918534,3918534,3917920,614,130,utRho10
267,cvpA,4861600,4861600,4861526,74,34,utRho10
268,cvrA,2484328,2484328,2484142,186,24,utRho10
269,cyaA,7981548,7982306,7981548,758,656,utRho10
270,cyaR,4334228,4334224,4334228,4,0,utRho10
271,cyaY,7988166,7988166,7988118,48,340,utRho10
272,cybB,2981522,2981804,2981522,282,384,utRho10
273,cycA,8859560,8859728,8859560,168,1102,utRho10
274,cydA,1542340,1542916,1542340,576,14,utRho10
275,cydC,1858800,1858800,1858390,410,116,utRho10
276,cydD,1862062,1862062,1861924,138,78,utRho10
277,cydX,1548300,1548392,1548300,92,118,utRho10
278,cynR,717418,717418,717380,38,84,utRho10
279,cynT,1435092,1435196,1435092,104,0,utRho10
280,cyoA,903306,903306,903220,86,4814,utRho10
281,cyoE,895540,895540,895410,130,1190,utRho10
282,cysB,2667576,2667710,2667576,134,408,utRho10
283,cysC,5748056,5748056,5747984,72,156,utRho10
284,cysD,5752736,5752736,5752658,78,2,utRho10
285,cysE,7565362,7565362,7565124,238,372,utRho10
286,cysG,6995508,6995656,6995508,148,252,utRho10
287,cysJ,5783928,5783928,5783796,132,2170,utRho10
288,cysK,5064688,5064818,5064688,130,0,utRho10
289,cysP,5087114,5087114,5087056,58,322,utRho10
290,cysS,1109154,1109222,1109154,68,138,utRho10
291,cysT,3984100,3984100,3983974,126,66,utRho10
292,cysZ,5062766,5062926,5062766,160,540,utRho10
293,cytR,8249018,8249018,8248912,106,26,utRho10
294,dacA,1328002,1328002,1327926,76,194,utRho10
295,dacB,6657714,6657926,6657714,212,114,utRho10
296,dacC,1761306,1761454,1761306,148,614,utRho10
297,dadA,2475018,2475142,2475018,124,122,utRho10
298,dam,7032504,7032504,7031826,678,1464,utRho10
299,damX,7035200,7035200,7034612,588,572,utRho10
300,dapA,5199568,5199568,5199520,48,94,utRho10
301,dapB,56576,56748,56576,172,148,utRho10
302,dapD,371954,371954,371894,60,162,utRho10
303,dapE,5183120,5183214,5183120,94,610,utRho10
304,dcp,3254844,3254844,3254760,84,86,utRho10
305,dcrB,7219534,7219910,7219534,376,320,utRho10
306,dctA,7366996,7366996,7366894,102,330,utRho10
307,dcuA,8733686,8733686,8733546,140,70,utRho10
308,dcuB,8698182,8698182,8697488,694,2378,utRho10
309,dcuC,1312166,1312166,1311936,230,724,utRho10
310,dcuD,6749166,6749738,6749166,572,126,utRho10
311,dcuR,8701130,8701130,8700068,1062,794,utRho10
312,dcuS,8703370,8703370,8703324,46,264,utRho10
313,dcyD,3999016,3999016,3998960,56,12,utRho10
314,ddpX,3126498,3126498,3126152,346,186,utRho10
315,deaD,6615818,6615818,6615720,98,7136,utRho10
316,dedA,4869880,4869880,4869482,398,11324,utRho10
317,dedD,4863750,4863750,4863368,382,112,utRho10
318,def,6867300,6867380,6867300,80,358,utRho10
319,degP,361690,361768,361690,78,62,utRho10
320,degQ,6761308,6761486,6761308,178,4928,utRho10
321,deoB,9239134,9239206,9239134,72,0,utRho10
322,deoC,9233358,9234646,9233358,1288,444,utRho10
323,dfp,7625406,7625462,7625406,56,0,utRho10
324,dgcZ,3247758,3247758,3247700,58,40,utRho10
325,dgkA,8512914,8513274,8512914,360,600,utRho10
326,dgt,358392,358474,358392,82,390,utRho10
327,dhaK,2501888,2501888,2501676,212,264,utRho10
328,dhaR,2502006,2502132,2502006,126,96,utRho10
329,dicB,3299194,3299218,3299194,24,0,utRho10
330,dicC,3295752,3295752,3295700,52,0,utRho10
331,dinB,501760,501796,501760,36,0,utRho10
332,dinD,7635398,7635520,7635398,122,482,utRho10
333,dinG,1666146,1666140,1666146,6,10,utRho10
334,dinI,2243018,2243018,2242974,44,1442,utRho10
335,dinJ,493230,493230,493004,226,64,utRho10
336,dinQ,7295964,7295964,7295576,388,1088,utRho10
337,djlA,114536,114728,114536,192,108,utRho10
338,dkgA,6313142,6313246,6313142,104,320,utRho10
339,dkgB,458196,458334,458196,138,320,utRho10
340,dksA,321502,321502,321208,294,928,utRho10
341,dld,4444164,4444370,4444164,206,38,utRho10
342,dmlA,3763424,3763824,3763424,400,708,utRho10
343,dmlR,3763710,3763710,3763618,92,266,utRho10
344,dmsA,1881646,1881918,1881646,272,60,utRho10
345,dnaA,7767922,7767922,7767458,464,1186,utRho10
346,dnaB,8528566,8528628,8528566,62,910,utRho10
347,dnaK,24096,24326,24096,230,3710,utRho10
348,dnaN,7765466,7765466,7764642,824,792,utRho10
349,dnaQ,471868,472134,471868,266,2372,utRho10
350,dnaT,18406460,18406460,18406068,392,4080,utRho10
351,dnaX,984112,984184,984112,72,974,utRho10
352,dosP,3131486,3131486,3131466,20,0,utRho10
353,dpiB,1303968,1304470,1303968,502,176,utRho10
354,dppA,7415740,7415740,7415410,330,2340,utRho10
355,dps,1697900,1697900,1697822,78,0,utRho10
356,dsbA,8086754,8086836,8086754,82,1334,utRho10
357,dsbB,2466294,2466294,2466060,234,0,utRho10
358,dsbC,6079266,6079266,6077644,1622,2002,utRho10
359,dsbG,1277600,1277600,1277146,454,354,utRho10
360,dsdA,4958242,4958404,4958242,162,140,utRho10
361,dsdC,4955492,4955492,4955258,234,172,utRho10
362,dsdX,4955642,4955694,4955642,52,152,utRho10
363,dsrA,4050626,4050626,4050626,0,0,utRho10
364,dsrB,4049686,4049686,4049646,40,1378,utRho10
365,dtpD,1485340,1485340,1485112,228,168,utRho10
366,dusA,8523200,8523338,8523200,138,4338,utRho10
367,dusB,6820492,6820560,6820492,68,42,utRho10
368,dusC,4460790,4460790,4460770,20,0,utRho10
369,dut,7627704,7627864,7627704,160,322,utRho10
370,dxr,386670,387042,386670,372,568,utRho10
371,ebgA,6445102,6445266,6445102,164,224,utRho10
372,ebgR,6442874,6442932,6442874,58,94,utRho10
373,ecnB,8753018,8753106,8753018,88,1606,utRho10
374,eco,4607594,4607810,4607594,216,14,utRho10
375,ecpA,621594,621594,621342,252,168,utRho10
376,ecpB,620238,620238,620052,186,130,utRho10
377,ecpR,622964,622964,622672,292,0,utRho10
378,eda,3866218,3866218,3865512,706,224,utRho10
379,edd,3869426,3869426,3869208,218,8,utRho10
380,efeO,2164308,2164486,2164308,178,48,utRho10
381,efeU_1,2162614,2162712,2162614,98,146,utRho10
382,efp,8751134,8751398,8751134,264,4890,utRho10
383,elaA,4763372,4763372,4763086,286,2,utRho10
384,elaD,4765308,4765426,4765308,118,136,utRho10
385,elfA,1995530,1995736,1995530,206,0,utRho10
386,elfD,1996642,1996980,1996642,338,0,utRho10
387,emrD,7707690,7707844,7707690,154,116,utRho10
388,emrK,4966896,4966896,4966678,218,12,utRho10
389,emrY,4964668,4964668,4964352,316,200,utRho10
390,emtA,2486250,2486360,2486250,110,134,utRho10
391,endA,12361100,12361388,12361100,288,200,utRho10
392,eno,5817692,5817692,5815882,1810,8452,utRho10
393,entC,1249662,1249770,1249662,108,0,utRho10
394,entD,1220508,1220508,1220158,350,0,utRho10
395,entH,1258584,1258600,1258584,16,0,utRho10
396,entS,1244506,1244600,1244506,94,0,utRho10
397,envR,6827266,6827266,6826930,336,0,utRho10
398,epd,12295292,12295292,12294764,528,136,utRho10
399,epmA,8765236,8765286,8765236,50,162,utRho10
400,epmB,8751406,8751406,8751314,92,2836,utRho10
401,eptB,7421162,7421162,7420950,212,126,utRho10
402,eptC,8300622,8300622,8300530,92,512,utRho10
403,erfK,4126708,4126708,4126646,62,1924,utRho10
404,erpA,353122,353220,353122,98,36,utRho10
405,esrE,8039956,8039956,8039956,0,0,utRho10
406,essD,1153746,1154796,1153746,1050,734,utRho10
407,etk,2088606,2088606,2088420,186,836,utRho10
408,evgA,4967262,4967510,4967262,248,38,utRho10
409,exbB,6304028,6304028,6303968,60,118,utRho10
410,exbD,6302780,6302780,6302486,294,104,utRho10
411,exuR,6493016,6493304,6493016,288,2,utRho10
412,exuT,6490004,6490208,6490004,204,24,utRho10
413,fabA,2032996,2032996,2032940,56,50,utRho10
414,fabB,4883282,4883282,4883210,72,74,utRho10
415,fabH,2297032,2297518,2297032,486,4638,utRho10
416,fabI,2702236,2702236,2702078,158,74,utRho10
417,fadB,8062026,8062026,8061942,84,52,utRho10
418,fadD,3779614,3779614,3779492,122,28,utRho10
419,fadE,486812,486812,486606,206,168,utRho10
420,fadH,6463248,6463330,6463248,82,236,utRho10
421,fadI,4921022,4921022,4920938,84,182,utRho10
422,fadL,4922410,4922600,4922410,190,176,utRho10
423,fadM,928720,928804,928720,84,32,utRho10
424,fadR,2469810,2469876,2469810,66,0,utRho10
425,fbaB,4357334,4357334,4357128,206,20,utRho10
426,fdhE,8162722,8162722,8162456,266,1294,utRho10
427,fdhF,8598814,8598814,8598732,82,306,utRho10
428,fdnG,3094744,3094802,3094744,58,26,utRho10
429,fdrA,1093012,1093360,1093012,348,230,utRho10
430,feaB,2894994,2895038,2894994,44,0,utRho10
431,feaR,2894734,2894734,2894566,168,0,utRho10
432,fecA,9033454,9033454,9033354,100,52,utRho10
433,fecE,9023288,9023288,9022914,374,5830,utRho10
434,fecI,9036564,9036564,9036470,94,412,utRho10
435,feoA,7080114,7080326,7080114,212,260,utRho10
436,fepA,1225334,1225334,1224988,346,0,utRho10
437,fepB,1249454,1249454,1249020,434,72,utRho10
438,fepD,1244468,1244468,1244378,90,0,utRho10
439,fes,1225374,1225630,1225374,256,136,utRho10
440,ffh,5495706,5495706,5495590,116,304,utRho10
441,ffs,952576,952848,952576,272,1520,utRho10
442,fhuA,334884,334968,334884,84,538,utRho10
443,fhuE,2323294,2323294,2323102,192,20,utRho10
444,fhuF,9211504,9211504,9211326,178,109270,utRho10
445,fic,6983296,6983296,6982926,370,1162,utRho10
446,fieF,8212864,8212938,8212864,74,10,utRho10
447,fimA,9085388,9086230,9085388,842,2180,utRho10
448,fimB,9081334,9081914,9081334,580,1938,utRho10
449,fimE,9083742,9084074,9083742,332,1858,utRho10
450,fimZ,1129214,1129214,1128960,254,2,utRho10
451,fiu,1683296,1683296,1683062,234,70,utRho10
452,fixA,84650,84806,84650,156,2,utRho10
453,fkpA,6955050,6955050,6954838,212,7314,utRho10
454,fldA,2846084,2846084,2845860,224,3980,utRho10
455,fldB,6079644,6079710,6079644,66,60,utRho10
456,flgA,2261770,2261770,2261726,44,1172,utRho10
457,flgB,2261986,2262036,2261986,50,160,utRho10
458,flgK,2276702,2276756,2276702,54,722,utRho10
459,flgM,2260330,2260330,2260256,74,490,utRho10
460,flgN,2259828,2259828,2259660,168,248,utRho10
461,flhB,3932432,3932432,3932382,50,2644,utRho10
462,flhC,3955864,3955864,3955688,176,372,utRho10
463,flhD,3957154,3957154,3956394,760,1620,utRho10
464,fliA,4003638,4003638,4003578,60,1352,utRho10
465,fliC,4007352,4007352,4007212,140,884,utRho10
466,fliD,4007634,4007744,4007634,110,400,utRho10
467,fliE,4026186,4026186,4026028,158,428,utRho10
468,fliF,4026292,4026458,4026292,166,360,utRho10
469,fliL,4039168,4039236,4039168,68,172,utRho10
470,flk,4875824,4875900,4875824,76,330,utRho10
471,flu,4142634,4143078,4142634,444,494,utRho10
472,flxA,3292776,3292810,3292776,34,170,utRho10
473,fnr,2799104,2799104,2799052,52,2,utRho10
474,fnrS,2818258,2818258,2818258,0,0,utRho10
475,focA,1909628,1909628,1908932,696,2672,utRho10
476,folA,99598,99646,99598,48,192,utRho10
477,folB,6409296,6409296,6409178,118,24,utRho10
478,folD,1115562,1115562,1115482,80,98,utRho10
479,folE,4487696,4487696,4487304,392,3504,utRho10
480,fpr,8228998,8228998,8228944,54,0,utRho10
481,frc,4986878,4986878,4986508,370,154,utRho10
482,frdA,8764824,8764824,8764636,188,142,utRho10
483,frdD,8758948,8758948,8758732,216,3332,utRho10
484,fre,8052886,8053054,8052886,168,980,utRho10
485,frlA,6999518,6999820,6999518,302,734,utRho10
486,frr,385624,385744,385624,120,1214,utRho10
487,frsA,513004,513054,513004,50,112,utRho10
488,fruB,4527194,4527194,4526990,204,0,utRho10
489,frvR,8179804,8179804,8179710,94,0,utRho10
490,fryA,5008986,5008986,5008970,16,88,utRho10
491,fsaA,1727060,1727284,1727060,224,426,utRho10
492,fsr,1009710,1009710,1009392,318,202,utRho10
493,ftnA,3977364,3977432,3977364,68,4,utRho10
494,ftnB,3973550,3973850,3973550,300,252,utRho10
495,ftsA,207122,207964,207122,842,502,utRho10
496,ftsB,5745802,5745802,5745640,162,150,utRho10
497,ftsH,6654204,6654204,6653870,334,936,utRho10
498,ftsK,1865858,1866448,1865858,590,982,utRho10
499,ftsL,181376,182064,181376,688,2020,utRho10
500,ftsP,6325732,6325732,6325338,394,284,utRho10
501,ftsQ,205484,206310,205484,826,258,utRho10
502,ftsX,7204512,7204512,7204172,340,370,utRho10
503,ftsZ,209272,210610,209272,1338,300,utRho10
504,fucA,5867708,5867708,5867376,332,2296,utRho10
505,fucP,5868238,5868470,5868238,232,208,utRho10
506,fumA,6753760,6753760,6753508,252,2128,utRho10
507,fumB,8694696,8694696,8694652,44,0,utRho10
508,fumC,3373418,3373418,3373176,242,4,utRho10
509,fur,2842892,2842892,2842584,308,7512,utRho10
510,fusA,6947370,6947370,6947028,342,35382,utRho10
511,fxsA,8737206,8737328,8737206,122,154,utRho10
512,gabD,5581824,5582546,5581824,722,1632,utRho10
513,gadA,7335214,7335214,7335160,54,0,utRho10
514,gadB,3144144,3144144,3144090,54,44,utRho10
515,gadC,3141168,3141168,3140978,190,278,utRho10
516,gadE,7315600,7316732,7315600,1132,524,utRho10
517,gadW,7329562,7329562,7329236,326,0,utRho10
518,gadX,14663356,14663356,14663240,116,964,utRho10
519,gadY,7329728,7329728,7329728,0,0,utRho10
520,galE,1584354,1584354,1584110,244,96,utRho10
521,galF,4228702,4228702,4228654,48,62,utRho10
522,galM,1577796,1577796,1577674,122,620,utRho10
523,galP,6176510,6176568,6176510,58,32,utRho10
524,galR,5953138,5953198,5953138,60,84,utRho10
525,galS,4483420,4483420,4483336,84,0,utRho10
526,galU,2582810,2582914,2582810,104,420,utRho10
527,gapA,3724480,3725542,3724480,1062,2336,utRho10
528,garP,6549868,6549868,6549814,54,132,utRho10
529,gatY,4354468,4354468,4354408,60,18,utRho10
530,gatZ,4352864,4352864,4352642,222,7652,utRho10
531,gcd,282558,282558,282450,108,70,utRho10
532,gcl,1067814,1067832,1067814,18,0,utRho10
533,gcvA,5885278,5885278,5885134,144,0,utRho10
534,gcvB,5885392,5885392,5885392,0,0,utRho10
535,gcvR,5199758,5199812,5199758,54,2,utRho10
536,gcvT,6101544,6101544,6101334,210,1418,utRho10
537,gdhA,3684616,3684742,3684616,126,0,utRho10
538,gfcA,2099668,2099668,2099488,180,1546,utRho10
539,gfcD,2096236,2096236,2095890,346,2938,utRho10
540,ghrA,2195648,2195772,2195648,124,58,utRho10
541,ghrB,7434378,7434620,7434378,242,1324,utRho10
542,glcA,6242728,6242728,6242558,170,196,utRho10
543,glcC,6256412,6256544,6256412,132,74,utRho10
544,glcD,6256152,6256152,6256042,110,164,utRho10
545,gldA,8278092,8278092,8278070,22,0,utRho10
546,glgA,7136784,7136784,7136066,718,3904,utRho10
547,glgB,7147314,7147314,7147004,310,198,utRho10
548,glgC,7139142,7139142,7138656,486,400,utRho10
549,glgP,7133546,7133546,7133162,384,1842,utRho10
550,glgS,6384024,6384024,6383878,146,40,utRho10
551,glgX,7142838,7142838,7142638,200,0,utRho10
552,glk,5018922,5018922,5018852,70,146,utRho10
553,glmS,7827622,7827622,7827336,286,4192,utRho10
554,glmU,7830652,7830652,7830400,252,1624,utRho10
555,glmY,10765360,10765360,10765360,0,0,utRho10
556,glmZ,7972864,7972864,7972864,0,0,utRho10
557,glnA,16232888,16232888,16232136,752,300,utRho10
558,glnB,5375052,5375052,5374816,236,668,utRho10
559,glnD,377310,377310,377300,10,20,utRho10
560,glnE,6399602,6399602,6399282,320,0,utRho10
561,glnH,1696396,1696396,1696008,388,440,utRho10
562,glnK,945112,945196,945112,84,2,utRho10
563,glnL,8112742,8112742,8112678,64,0,utRho10
564,glnQ,1693262,1693262,1692926,336,422,utRho10
565,glnS,1411998,1412186,1411998,188,598,utRho10
566,gloA,3455602,3455674,3455602,72,122,utRho10
567,gloB,469852,469852,469564,288,2704,utRho10
568,glpA,4705166,4705294,4705166,128,0,utRho10
569,glpD,7123942,7124026,7123942,84,4,utRho10
570,glpE,7123698,7123698,7123646,52,78,utRho10
571,glpF,8236322,8236322,8236180,142,492,utRho10
572,glpG,7122960,7122960,7122904,56,132,utRho10
573,glpR,7121782,7121782,7121210,572,742,utRho10
574,glpT,4704902,4704902,4704748,154,192,utRho10
575,glpX,8231212,8231212,8231158,54,9116,utRho10
576,glrK,5382246,5382246,5382196,50,2422,utRho10
577,gltA,1509534,1509534,1508936,598,5662,utRho10
578,gltB,6709018,6709264,6709018,246,534,utRho10
579,gltI,1375792,1375792,1375494,298,2860,utRho10
580,gltP,8588536,8588962,8588536,426,1438,utRho10
581,gltS,7657382,7657382,7657330,52,1114,utRho10
582,gltX,5041568,5041568,5041344,224,222,utRho10
583,gluQ,320286,320286,320224,62,26,utRho10
584,glyA,5371148,5371148,5371014,134,172,utRho10
585,glyQ,7450708,7450708,7450636,72,178,utRho10
586,glyS,7448990,7448990,7448794,196,3162,utRho10
587,glyU,5998128,5998128,5998114,14,18,utRho10
588,glyV,8784626,8784720,8784626,94,344,utRho10
589,glyW,3984360,3984360,3984234,126,46,utRho10
590,gmhB,445612,445666,445612,54,50,utRho10
591,gmk,7642776,7642856,7642776,80,80,utRho10
592,gmr,2693686,2693686,2693484,202,678,utRho10
593,gnd,4202648,4202648,4202536,112,908,utRho10
594,gnsB,3275692,3275692,3275564,128,2,utRho10
595,gntK,14310580,14310580,14310368,212,712,utRho10
596,gntP,9102668,9102668,9102592,76,134,utRho10
597,gntR,7157760,7157760,7157452,308,704,utRho10
598,gntT,7092810,7093118,7092810,308,1220,utRho10
599,gntU,7154170,7154170,7154122,48,118,utRho10
600,gntX,7089334,7089764,7089334,430,290,utRho10
601,gor,7292224,7292598,7292224,374,766,utRho10
602,gpmA,1575340,1575340,1575190,150,2,utRho10
603,gpmM,7570374,7570520,7570374,146,0,utRho10
604,gpsA,7567620,7567620,7567322,298,7118,utRho10
605,gpt,511828,511954,511828,126,1164,utRho10
606,grcA,5433046,5433046,5432898,148,2450,utRho10
607,greA,6657728,6657728,6657430,298,2036,utRho10
608,greB,7073488,7073624,7073488,136,242,utRho10
609,groL,8741566,8742050,8741566,484,584,utRho10
610,groS,8741232,8741376,8741232,144,560,utRho10
611,grpE,5501494,5501494,5501416,78,230,utRho10
612,grxA,1781552,1781552,1781506,46,92,utRho10
613,grxB,2248206,2248206,2248108,98,764,utRho10
614,grxC,7569152,7569152,7568884,268,5386,utRho10
615,grxD,3468324,3468324,3468202,122,6426,utRho10
616,gspA,6911268,6911268,6910796,472,386,utRho10
617,gspC,6910964,6911156,6910964,192,146,utRho10
618,gss,6277220,6277220,6277044,176,70,utRho10
619,gstA,3428654,3428754,3428654,100,0,utRho10
620,gstB,1761038,1761038,1760960,78,284,utRho10
621,guaB,5268214,5268214,5268140,74,130,utRho10
622,gudD,5839026,5839026,5838770,256,0,utRho10
623,gyrA,4678914,4678914,4678840,74,152,utRho10
624,gyrB,7760300,7760300,7760238,62,404,utRho10
625,hcaE,5337964,5338064,5337964,100,3134,utRho10
626,hcaR,5337928,5337928,5337792,136,4266,utRho10
627,hcaT,5336106,5336106,5335692,414,732,utRho10
628,hchA,4071260,4071670,4071260,410,0,utRho10
629,hcp,1828258,1828258,1827628,630,504,utRho10
630,hcr,1824400,1824400,1824300,100,0,utRho10
631,hdeA,7313582,7313582,7313480,102,2,utRho10
632,hdeD,7313920,7313990,7313920,70,376,utRho10
633,hdfR,7896320,7896320,7895934,386,1972,utRho10
634,hdhA,3396244,3396244,3396080,164,60,utRho10
635,helD,2048876,2048942,2048876,66,48,utRho10
636,hemA,2527166,2527428,2527166,262,322,utRho10
637,hemB,779722,779722,779454,268,936,utRho10
638,hemF,5106410,5106450,5106410,40,0,utRho10
639,hemH,996062,996110,996062,48,1204,utRho10
640,hemL,349882,349882,349764,118,10,utRho10
641,hemN,8103886,8104090,8103886,204,102,utRho10
642,hepA,127176,127176,126528,648,1474,utRho10
643,hflD,2385372,2385372,2385262,110,356,utRho10
644,hfq,8799602,8800576,8799602,974,6772,utRho10
645,hha,961006,961006,960616,390,260,utRho10
646,hicA,3018442,3018572,3018442,130,0,utRho10
647,higA,6468682,6468682,6468288,394,650,utRho10
648,higB,6468960,6468960,6468910,50,36,utRho10
649,hinT,2323642,2323770,2323642,128,0,utRho10
650,hipB,3184964,3184964,3184884,80,62,utRho10
651,hisB,4186720,4186936,4186720,216,602,utRho10
652,hisJ,4853674,4853674,4853576,98,124,utRho10
653,hisL,8359856,8359984,8359856,128,76,utRho10
654,hisS,5281284,5281284,5281150,134,358,utRho10
655,hlpA,400910,400964,400910,54,330,utRho10
656,hlyE,2460932,2460932,2460788,144,1452,utRho10
657,hmp,5371594,5371670,5371594,76,84,utRho10
658,hns,2585916,2585916,2585844,72,1202,utRho10
659,hofM,7045856,7045856,7045502,354,0,utRho10
660,hokA,7441620,7441620,7441200,420,13206,utRho10
661,hokC,33902,33902,33806,96,102,utRho10
662,hokE,1215462,1215672,1215462,210,0,utRho10
663,holC,8968546,8968546,8968560,14,562,utRho10
664,holD,9215562,9215606,9215562,44,0,utRho10
665,holE,3850040,3850216,3850040,176,5856,utRho10
666,hpt,282720,282862,282720,142,688,utRho10
667,hrpB,324150,324210,324150,60,88,utRho10
668,hscB,5319048,5319048,5318934,114,2574,utRho10
669,hscC,1367188,1367188,1366786,402,442,utRho10
670,hsdS,9163004,9163004,9162924,80,234,utRho10
671,hslJ,2883560,2883560,2883486,74,56,utRho10
672,hslO,7059344,7059548,7059344,204,5582,utRho10
673,hslR,7058220,7058696,7058220,476,1244,utRho10
674,hslV,8244708,8244708,8244574,134,410,utRho10
675,hsrA,7881412,7881412,7881224,188,86,utRho10
676,htgA,21286,21660,21286,374,14548,utRho10
677,htpG,989634,990240,989634,606,33122,utRho10
678,htpX,3825236,3825236,3825152,84,60,utRho10
679,htrE,311036,311036,310852,184,1260,utRho10
680,htrL,7587668,7587668,7587366,302,84,utRho10
681,hupA,8400352,8400562,8400352,210,122,utRho10
682,hupB,1845220,1845804,1845220,584,560,utRho10
683,hyaA,2063968,2064278,2063968,310,0,utRho10
684,hybO,6292726,6292726,6292522,204,5326,utRho10
685,hycA,5700922,5700922,5700870,52,104,utRho10
686,hycI,5686204,5686204,5686086,118,530,utRho10
687,hydN,5676264,5676264,5676210,54,50,utRho10
688,hyfA,5202342,5202402,5202342,60,42,utRho10
689,hypA,11402508,11402588,11402508,80,536,utRho10
690,hypB,11403356,11404004,11403356,648,256,utRho10
691,hypF,5676210,5676210,5674850,1360,3400,utRho10
692,hypT,9116634,9116634,9116578,56,0,utRho10
693,hyuA,6019660,6020056,6019660,396,2,utRho10
694,iaaA,1733074,1733136,1733074,62,0,utRho10
695,iadA,9119074,9119074,9119052,22,100,utRho10
696,iap,5753072,5753162,5753072,90,0,utRho10
697,ibaG,6673966,6673966,6673606,360,360,utRho10
698,ibpA,7735036,7735036,7734844,192,556,utRho10
699,ibpB,7733962,7733962,7733794,168,610,utRho10
700,icd,2389922,2390246,2389922,324,160,utRho10
701,iclR,8447304,8447304,8447256,48,0,utRho10
702,idi,6065876,6066130,6065876,254,398,utRho10
703,idnD,8988870,8988870,8988812,58,56,utRho10
704,idnK,8989194,8989246,8989194,52,84,utRho10
705,ihfA,3591442,3591442,3591104,338,352,utRho10
706,ihfB,1927498,1927656,1927498,158,712,utRho10
707,ileS,43666,44782,43666,1116,3520,utRho10
708,ileX,6431194,6431196,6431194,2,66,utRho10
709,ilvA,15820940,15821324,15820940,384,784,utRho10
710,ilvC,7915824,7915940,7915824,116,36,utRho10
711,ilvE,15809552,15809936,15809552,384,1284,utRho10
712,ilvI,170840,171260,170840,420,4,utRho10
713,ilvL,23701308,23701932,23701308,624,54,utRho10
714,ilvY,7915734,7915734,7915640,94,214,utRho10
715,inaA,4698998,4698998,4698944,54,424,utRho10
716,infA,1853370,1853370,1852886,484,2178,utRho10
717,infC,3602692,3602692,3601276,1416,3166,utRho10
718,insA-5,3958452,3958452,3958430,22,38,utRho10
719,insA-7,9036758,9037054,9036758,296,390,utRho10
720,insC-5,6372080,6372284,6372080,204,10278,utRho10
721,insEF-2,785238,785238,785820,582,1986,utRho10
722,insEF-4,2190310,2190310,2190892,582,1812,utRho10
723,insG,9007098,9007098,9006862,236,0,utRho10
724,insH-1,550596,550596,550234,362,1292,utRho10
725,insH-11,7306538,7306538,7306396,142,456,utRho10
726,insH-2,1151548,1151548,1151506,42,160,utRho10
727,insH-3,1378444,1378444,1378026,418,724,utRho10
728,insH-4,2791942,2792152,2791942,210,144,utRho10
729,insH-5,2857852,2857852,2857452,400,24,utRho10
730,insH-6,4135022,4135022,4134642,380,734,utRho10
731,insH-7,4206186,4206186,4205822,364,7296,utRho10
732,insH-9,6260050,6260356,6260050,306,280,utRho10
733,insI-3,9017372,9017372,9017234,138,114,utRho10
734,insJ,7441188,7441360,7441188,172,5694,utRho10
735,insK,7442130,7442308,7442130,178,128,utRho10
736,insL-1,30760,30890,30760,130,1172,utRho10
737,insL-2,1216112,1216130,1216112,18,340,utRho10
738,insL-3,5028644,5028662,5028644,18,376,utRho10
739,insN-1,540452,540484,540452,32,0,utRho10
740,intD,1132202,1132202,1131956,246,8910,utRho10
741,intR,2826520,2826520,2826470,50,44,utRho10
742,intS,4933026,4933090,4933026,64,4332,utRho10
743,intZ,5117386,5117542,5117386,156,2140,utRho10
744,iraD,9113152,9113986,9113152,834,232,utRho10
745,iraM,2424246,2424246,2424006,240,348,utRho10
746,iraP,802638,802772,802638,134,0,utRho10
747,iscA,5319924,5319924,5319772,152,1356,utRho10
748,iscR,5324398,5324398,5324262,136,13046,utRho10
749,iscX,5313834,5313834,5313472,362,3078,utRho10
750,ispF,5743968,5743968,5743560,408,2486,utRho10
751,ispG,5283908,5283908,5283608,300,752,utRho10
752,ispU,389568,389806,389568,238,0,utRho10
753,isrA,2811502,2811502,2811618,116,0,utRho10
754,istr-1,7706384,7706384,7706384,0,0,utRho10
755,istr-2,7706514,7706514,7706514,0,0,utRho10
756,ivbL,15412092,15412092,15411952,140,548,utRho10
757,ivy,480638,480686,480638,48,120,utRho10
758,katE,3627628,3627734,3627628,106,266,utRho10
759,katG,8267624,8267670,8267624,46,26,utRho10
760,kbaZ,6557732,6557828,6557732,96,0,utRho10
761,kbl,7585154,7585154,7585102,52,844,utRho10
762,kch,2621046,2621046,2620538,508,784,utRho10
763,kdgR,3820506,3820506,3820198,308,0,utRho10
764,kdpE,1443788,1443788,1443466,322,84,utRho10
765,kdpF,1457698,1457698,1457642,56,42,utRho10
766,kdsA,2535708,2536330,2535708,622,2896,utRho10
767,kdsC,6683438,6684546,6683438,1108,2040,utRho10
768,kduI,5968388,5968388,5968248,140,2912,utRho10
769,kefF,94160,94492,94160,332,1144,utRho10
770,kgtP,5451624,5451624,5451492,132,1248,utRho10
771,kup,7862206,7862632,7862206,426,354,utRho10
772,lacI,735076,735076,735020,56,0,utRho10
773,lacZ,1465508,1465508,1465220,288,404,utRho10
774,ldcA,2486394,2486394,2486160,234,184,utRho10
775,ldhA,2885830,2885830,2885686,144,2,utRho10
776,ldrA,2538954,2538954,2538550,404,4046,utRho10
777,ldrB,2540024,2540024,2539620,404,1536,utRho10
778,ldrC,2541092,2541092,2540690,402,1214,utRho10
779,ldrD,7400544,7400544,7400174,370,1110,utRho10
780,lepA,5414392,5414392,5414248,144,318,utRho10
781,lepB,5410928,5410928,5410618,310,942,utRho10
782,leuD,159188,159188,158906,282,40,utRho10
783,leuE,3761600,3761600,3761518,82,70,utRho10
784,leuL,168048,168048,167416,632,44,utRho10
785,leuO,168308,168736,168308,428,124,utRho10
786,leuQ,9212864,9212864,9212802,62,0,utRho10
787,leuU,6644556,6644556,6644316,240,2592,utRho10
788,leuV,9212546,9212546,9212330,216,2024,utRho10
789,leuX,8992772,8992810,8992772,38,40,utRho10
790,lexA,8514174,8514230,8514174,56,182,utRho10
791,lhr,3456706,3458174,3456706,1468,3640,utRho10
792,ligA,5060402,5060402,5060352,50,0,utRho10
793,ligB,7642576,7642576,7642340,236,236,utRho10
794,lipA,1320602,1320602,1320432,170,154,utRho10
795,lipB,1324802,1324802,1324556,246,3634,utRho10
796,lit,2397032,2397390,2397032,358,3794,utRho10
797,livJ,7199524,7199524,7199316,208,2914,utRho10
798,livK,7195510,7195510,7195120,390,410,utRho10
799,lldP,7554578,7554798,7554578,220,3070,utRho10
800,lnt,1381968,1381968,1381762,206,910,utRho10
801,loiP,6163784,6163826,6163784,42,388,utRho10
802,lolA,1874656,1874738,1874656,82,586,utRho10
803,lolB,2527112,2527112,2527000,112,166,utRho10
804,lolC,2350748,2350854,2350748,106,0,utRho10
805,lon,917630,917776,917630,146,314,utRho10
806,lpcA,486936,487086,486936,150,78,utRho10
807,lpd,255434,255824,255434,390,3144,utRho10
808,lplA,9248476,9248476,9248234,242,750,utRho10
809,lplT,5947878,5947878,5947724,154,48,utRho10
810,lpoA,6586422,6586800,6586422,378,264,utRho10
811,lpp,3514592,3514842,3514592,250,84,utRho10
812,lptA,6686598,6686760,6686598,162,418,utRho10
813,lptB,6686792,6687888,6686792,1096,1378,utRho10
814,lptD,114672,114672,114218,454,1726,utRho10
815,lptF,8972244,8972436,8972244,192,266,utRho10
816,lpxC,213016,213114,213016,98,6742,utRho10
817,lpxD,401920,401942,401920,22,110,utRho10
818,lpxL,2233418,2233418,2233164,254,0,utRho10
819,lpxM,3880456,3880456,3880386,70,262,utRho10
820,lpxP,4991156,4991290,4991156,134,164,utRho10
821,lrhA,4813312,4813312,4813282,30,80,utRho10
822,lrp,1864656,1865190,1864656,534,302,utRho10
823,lspA,50028,50414,50028,386,432,utRho10
824,lsrA,3202920,3202980,3202920,60,104,utRho10
825,lsrR,3202514,3202514,3202482,32,0,utRho10
826,ltaE,1818640,1818640,1818588,52,0,utRho10
827,luxS,5630130,5630130,5629466,664,32548,utRho10
828,lysA,5957902,5957902,5957798,104,20,utRho10
829,lysC,8467232,8467232,8466466,766,1066,utRho10
830,lysP,4497120,4497120,4497064,56,0,utRho10
831,lysR,5957900,5958042,5957900,142,64,utRho10
832,lysT,1561028,1561108,1561028,80,146,utRho10
833,lysU,8709610,8709610,8709434,176,94,utRho10
834,macB,1840188,1840694,1840188,506,474,utRho10
835,maeA,3111484,3111484,3111338,146,3438,utRho10
836,mak,820236,820288,820236,52,66,utRho10
837,malE,8492928,8492928,8492838,90,0,utRho10
838,malI,3398456,3398456,3398360,96,0,utRho10
839,malK,8493472,8493568,8493472,96,0,utRho10
840,malP,7105020,7105020,7104946,74,980,utRho10
841,malQ,7100798,7100798,7100140,658,22,utRho10
842,malS,14949880,14949988,14949880,108,88,utRho10
843,malT,7106048,7106170,7106048,122,96,utRho10
844,malX,3398626,3398710,3398626,84,0,utRho10
845,malZ,1689980,1690072,1689980,92,2980,utRho10
846,manA,3377102,3377152,3377102,50,8,utRho10
847,manX,3803866,3804096,3803866,230,138,utRho10
848,marC,3237882,3237882,3237816,66,484,utRho10
849,marR,3238186,3238240,3238186,54,404,utRho10
850,matP,2036918,2036970,2036918,52,264,utRho10
851,mazE,5822736,5822736,5822678,58,60,utRho10
852,mazG,5821720,5821720,5821370,350,3930,utRho10
853,mcbA,1684306,1684306,1684112,194,106,utRho10
854,mcbR,3040192,3040524,3040192,332,122,utRho10
855,mcrA,2420278,2420692,2420278,414,194,utRho10
856,mcrC,9156124,9156124,9155916,208,622,utRho10
857,mdaB,6344814,6345060,6344814,246,206,utRho10
858,mdfA,1767138,1767346,1767138,208,20,utRho10
859,mdh,6768940,6768940,6768536,404,164,utRho10
860,mdoB,9198988,9198988,9198882,106,5714,utRho10
861,mdoD,2993290,2993712,2993290,422,32,utRho10
862,mdoG,2218514,2218670,2218514,156,20,utRho10
863,mdtA,4307958,4308032,4307958,74,370,utRho10
864,mdtE,7318168,7318464,7318168,296,790,utRho10
865,mdtK,3486538,3486914,3486538,376,2158,utRho10
866,mdtP,8602472,8602472,8602060,412,264,utRho10
867,melA,8683774,8683822,8683774,48,0,utRho10
868,melR,8683300,8683300,8683256,44,188,utRho10
869,menA,8240812,8240812,8240698,114,32,utRho10
870,menB,4753774,4753774,4753638,136,204,utRho10
871,mepH,3468714,3468870,3468714,156,0,utRho10
872,mepM,3883666,3883666,3883270,396,480,utRho10
873,mepS,4539840,4539958,4539840,118,300,utRho10
874,metA,8428318,8428560,8428318,242,322,utRho10
875,metB,8257272,8257344,8257272,72,900,utRho10
876,metC,6304150,6304472,6304150,322,268,utRho10
877,metE,8025768,8026106,8025768,338,3114,utRho10
878,metF,8265092,8265232,8265092,140,168,utRho10
879,metG,4388538,4388600,4388538,62,10,utRho10
880,metH,8447010,8447656,8447010,646,1882,utRho10
881,metJ,8257116,8257116,8256790,326,242,utRho10
882,metK,6173154,6173412,6173154,258,84,utRho10
883,metN,445428,445428,445290,138,40,utRho10
884,metR,8025710,8025710,8025632,78,0,utRho10
885,metT,1394326,1394326,1394266,60,398,utRho10
886,metY,19910250,19910250,19909734,516,2124,utRho10
887,metZ,11789528,11789548,11789528,20,0,utRho10
888,mfd,2348056,2348056,2347928,128,24,utRho10
889,mglA,4478782,4478782,4478578,204,82,utRho10
890,mglB,4481132,4481132,4480696,436,6610,utRho10
891,mglC,4475918,4475918,4475506,412,106,utRho10
892,mgrB,3817584,3817584,3817532,52,98,utRho10
893,mgrR,3245828,3245828,3245828,0,0,utRho10
894,mgsA,2054082,2054082,2054030,52,82,utRho10
895,mgtL,8934560,8934862,8934560,302,68,utRho10
896,mhpA,737038,737222,737038,184,56,utRho10
897,mhpR,737072,737072,736840,232,0,utRho10
898,mhpT,750772,750918,750772,146,0,utRho10
899,miaA,8797964,8798504,8797964,540,4782,utRho10
900,micA,5629604,5629604,5629604,0,0,utRho10
901,micC,2874242,2874238,2874242,4,0,utRho10
902,micF,4626168,4626168,4626168,0,0,utRho10
903,micM,1014408,1014408,1014408,0,0,utRho10
904,minE,2449422,2449422,2449090,332,460,utRho10
905,mioC,7852950,7852950,7852910,40,0,utRho10
906,mipA,3733012,3733012,3732944,68,1622,utRho10
907,mlaA,4930270,4930270,4930014,256,0,utRho10
908,mlc,3337206,3337206,3337128,78,0,utRho10
909,mlrA,4429498,4429732,4429498,234,130,utRho10
910,mltA,5894546,5894546,5894356,190,200,utRho10
911,mltD,468050,468050,467910,140,78,utRho10
912,mltF,5391534,5391602,5391534,68,48,utRho10
913,mmuP,550238,550650,550238,412,1482,utRho10
914,mngA,1531622,1531968,1531622,346,1058,utRho10
915,mngR,1531852,1531852,1531750,102,670,utRho10
916,mnmG,7851348,7851348,7851266,82,5672,utRho10
917,mntH,5025470,5025470,5025412,58,160,utRho10
918,mntP,3810918,3811376,3810918,458,1730,utRho10
919,mntR,1706160,1706366,1706160,206,220,utRho10
920,mntS,1706128,1706128,1705994,134,346,utRho10
921,moaA,1633654,1634088,1633654,434,1238,utRho10
922,moaB,1635954,1636110,1635954,156,1694,utRho10
923,mobA,8084242,8084242,8083998,244,302,utRho10
924,mocA,6030112,6030320,6030112,208,12,utRho10
925,modA,1589990,1590178,1589990,188,112,utRho10
926,moeA,1732788,1732788,1732728,60,6,utRho10
927,mokB,2984610,2984610,2984258,352,418,utRho10
928,molR_1,4392888,4392948,4392888,60,128,utRho10
929,motA,3954604,3954604,3954278,326,272,utRho10
930,mpaA,2781278,2781278,2781196,82,344,utRho10
931,mpl,8911456,8911570,8911456,114,20,utRho10
932,mppA,2786108,2786454,2786108,346,170,utRho10
933,mprA,5621494,5621540,5621494,46,1758,utRho10
934,mqo,4613848,4613848,4613508,340,1260,utRho10
935,mqsA,6336742,6336742,6336492,250,492,utRho10
936,mqsR,6337306,6337306,6337088,218,740,utRho10
937,mraZ,179192,179268,179192,76,50,utRho10
938,mrcA,7045652,7045742,7045652,90,0,utRho10
939,mrcB,329442,329460,329442,18,0,utRho10
940,mreB,13605424,13605424,13604348,1076,2036,utRho10
941,mreD,6798166,6798166,6797750,416,414,utRho10
942,mrp,4388360,4388360,4388336,24,20,utRho10
943,mscK,972984,973072,972984,88,140,utRho10
944,mscL,6876002,6876048,6876002,46,1586,utRho10
945,mscS,6139742,6139742,6139614,128,202,utRho10
946,msrA,8884522,8884522,8884352,170,780,utRho10
947,msrB,3725168,3725168,3724858,310,0,utRho10
948,msyB,2228426,2228426,2228362,64,586,utRho10
949,mtfA,4087236,4087302,4087236,66,1366,utRho10
950,mtgA,6699662,6699662,6699618,44,2074,utRho10
951,mtlA,30177504,30178248,30177504,744,3696,utRho10
952,mtn,358366,358366,358306,60,956,utRho10
953,mtr,6611864,6611864,6611634,230,106,utRho10
954,mug,6430992,6430992,6430946,46,446,utRho10
955,murQ,5091466,5091546,5091466,80,0,utRho10
956,murR,5091586,5091586,5091218,368,122,utRho10
957,mutH,5939164,5939324,5939164,160,266,utRho10
958,mutL,8794092,8794824,8794092,732,17418,utRho10
959,mutM,7622554,7622554,7622304,250,2124,utRho10
960,mutS,5714038,5714186,5714038,148,844,utRho10
961,mutY,18617466,18618078,18617466,612,354,utRho10
962,nac,4123956,4123956,4123866,90,1176,utRho10
963,nadA,1564122,1564170,1564122,48,58,utRho10
964,nadB,5420714,5420840,5420714,126,28,utRho10
965,nadC,237326,237326,237290,36,106,utRho10
966,nadE,3644604,3644916,3644604,312,302,utRho10
967,nadK,5501526,5501662,5501526,136,274,utRho10
968,nagA,1406350,1406350,1405502,848,1666,utRho10
969,nagB,1407416,1407416,1407222,194,52,utRho10
970,nagC,1404016,1404016,1403188,828,162,utRho10
971,nagE,1407680,1407888,1407680,208,114,utRho10
972,nagK,2357080,2357186,2357080,106,86,utRho10
973,nanA,6747240,6747240,6747152,88,36,utRho10
974,nanC,9079856,9079856,9079002,854,122,utRho10
975,nanR,6749406,6749406,6748978,428,988,utRho10
976,nanS,9075406,9075406,9075188,218,0,utRho10
977,napF,4607390,4607390,4606994,396,586,utRho10
978,narG,2559614,2559728,2559614,114,316,utRho10
979,narK,2555642,2555914,2555642,272,0,utRho10
980,narP,4580844,4581000,4580844,156,122,utRho10
981,narQ,5171154,5171462,5171154,308,206,utRho10
982,narU,3088326,3088326,3088120,206,202,utRho10
983,narW,3077374,3077374,3074618,2756,372,utRho10
984,narX,2555554,2555554,2555236,318,0,utRho10
985,narZ,3085380,3085380,3085180,200,62,utRho10
986,ndh,2331984,2332170,2331984,186,168,utRho10
987,ndk,5289920,5289920,5289728,192,120,utRho10
988,nemR,6904084,6904092,6904084,8,596,utRho10
989,nepI,7683542,7683542,7683478,64,220,utRho10
990,nfo,4501612,4501680,4501612,68,340,utRho10
991,nfsB,1210906,1210906,1210848,58,94,utRho10
992,nfuA,7090916,7091248,7090916,332,512,utRho10
993,nhaA,34634,34978,34634,344,554,utRho10
994,nhaB,2469534,2469534,2469434,100,0,utRho10
995,nhoA,3067926,3068048,3067926,122,54,utRho10
996,nikA,7226878,7227334,7226878,456,10284,utRho10
997,nikR,7237074,7237176,7237074,102,204,utRho10
998,nirB,6987974,6988022,6987974,48,154,utRho10
999,nlpA,7680034,7680034,7679986,48,42,utRho10
1000,nlpC,3585654,3585654,3585462,192,88,utRho10
1001,nlpD,5737658,5737658,5737506,152,72,utRho10
1002,nlpI,6618080,6618080,6617848,232,170,utRho10
1003,nmpC,1153740,1153740,1153650,90,0,utRho10
1004,nohA,3273206,3273206,3272734,472,1428,utRho10
1005,norR,5664614,5664614,5664578,36,0,utRho10
1006,norV,5664878,5664952,5664878,74,0,utRho10
1007,nrdA,4689510,4689730,4689510,220,4628,utRho10
1008,nrdD,8925676,8925676,8925320,356,3738,utRho10
1009,nrdH,5601312,5601446,5601312,134,62,utRho10
1010,nrdR,865954,866004,865954,50,12,utRho10
1011,nrfA,8575342,8575528,8575342,186,146,utRho10
1012,nsrR,8812088,8812380,8812088,292,15216,utRho10
1013,nudB,3897348,3897348,3897264,84,0,utRho10
1014,nudC,8393428,8393806,8393428,378,54,utRho10
1015,nudE,7052658,7052658,7052298,360,1360,utRho10
1016,nudG,3682876,3682980,3682876,104,108,utRho10
1017,nudI,4729050,4729108,4729050,58,0,utRho10
1018,nudJ,2388874,2388874,2388576,298,556,utRho10
1019,nuoA,4810670,4810670,4810144,526,4656,utRho10
1020,nuoN,4783434,4783434,4783010,424,1298,utRho10
1021,nupC,5026018,5026084,5026018,66,0,utRho10
1022,nupG,6211302,6211428,6211302,126,20,utRho10
1023,ogrK,4335096,4335096,4335040,56,52,utRho10
1024,ogt,2800568,2800568,2800472,96,90,utRho10
1025,ohsC,5401036,5401040,5401036,4,74,utRho10
1026,ompA,2040382,2040382,2040106,276,21240,utRho10
1027,ompC,4625774,4625774,4625498,276,52,utRho10
1028,ompF,1974184,1974184,1973964,220,288,utRho10
1029,ompL,8128958,8128958,8128590,368,100,utRho10
1030,ompN,2874158,2874158,2873786,372,120,utRho10
1031,ompR,7073510,7073510,7073168,342,624,utRho10
1032,ompT,1171330,1171330,1171266,64,80,utRho10
1033,ompW,2627982,2628040,2627982,58,22,utRho10
1034,ompX,1700418,1700900,1700418,482,1424,utRho10
1035,omrA,5952378,5952378,5952378,0,0,utRho10
1036,omrB,5952770,5952770,5952770,0,0,utRho10
1037,oppA,2602170,2602364,2602170,194,10572,utRho10
1038,orn,8783168,8783208,8783168,40,0,utRho10
1039,osmB,2686952,2686952,2686656,296,2792,utRho10
1040,osmC,3113192,3113250,3113192,58,40,utRho10
1041,osmE,3644566,3644566,3644512,54,0,utRho10
1042,osmF,4439046,4439046,4438962,84,1000,utRho10
1043,osmY,9222306,9222792,9222306,486,1146,utRho10
1044,otsA,3963302,3963302,3963224,78,96,utRho10
1045,otsB,3964930,3964930,3964774,156,1246,utRho10
1046,oxc,4984288,4984288,4983900,388,294,utRho10
1047,oxyR,8316914,8316980,8316914,66,702,utRho10
1048,oxyS,8316788,8316788,8316788,0,0,utRho10
1049,paaA,2907730,2907854,2907730,124,0,utRho10
1050,paaX,2927018,2927078,2927018,60,0,utRho10
1051,paaZ,2907340,2907340,2907284,56,0,utRho10
1052,pabA,6981702,6981702,6981658,44,112,utRho10
1053,pabB,3789256,3789610,3789256,354,686,utRho10
1054,pabC,2306186,2306600,2306186,414,720,utRho10
1055,pagP,1313052,1313114,1313052,62,46,utRho10
1056,panB,299260,299260,299202,58,3428,utRho10
1057,panC,297840,297840,297590,250,348,utRho10
1058,panD,293490,293490,293388,102,476,utRho10
1059,panZ,7195656,7195968,7195656,312,64,utRho10
1060,parC,6332060,6332060,6331946,114,360,utRho10
1061,patA,6438916,6438988,6438916,72,68,utRho10
1062,patD,3030830,3031156,3030830,326,42,utRho10
1063,pbpC,5294986,5294986,5294650,336,0,utRho10
1064,pbpG,4450132,4450132,4449740,392,184,utRho10
1065,pck,7065358,7065636,7065358,278,4302,utRho10
1066,pcnB,318782,318782,318252,530,876,utRho10
1067,pdhR,244068,244184,244068,116,0,utRho10
1068,pdxB,4875768,4875768,4875702,66,0,utRho10
1069,pdxH,3436068,3436068,3436014,54,424,utRho10
1070,pdxJ,5403626,5403626,5403458,168,544,utRho10
1071,pdxK,5074638,5074638,5074474,164,134,utRho10
1072,pepA,8972278,8972278,8971902,376,276,utRho10
1073,pepD,511618,511618,511432,186,2636,utRho10
1074,pepN,1981182,1981244,1981182,62,206,utRho10
1075,pepQ,8062294,8062322,8062294,28,72,utRho10
1076,pepT,2371646,2371688,2371646,42,66,utRho10
1077,pfkA,8214948,8215104,8214948,156,164,utRho10
1078,pfkB,3612646,3612740,3612646,94,46,utRho10
1079,pflA,1902456,1902456,1902160,296,70,utRho10
1080,pflB,1907850,1907850,1907108,742,950,utRho10
1081,pflD,8287716,8287990,8287716,274,0,utRho10
1082,pgaA,2185046,2185046,2184578,468,264,utRho10
1083,pgi,8467444,8467516,8467444,72,62,utRho10
1084,pgk,12291428,12291428,12290488,940,3508,utRho10
1085,pgl,1597078,1597172,1597078,94,152,utRho10
1086,pgpB,2678324,2678660,2678324,336,484,utRho10
1087,pgpC,5397276,5397276,5397100,176,242,utRho10
1088,pgrR,2783744,2783982,2783744,238,666,utRho10
1089,pheL,5475158,5475198,5475158,40,112,utRho10
1090,pheM,7197204,7197204,7197080,124,32,utRho10
1091,pheP,1203858,1203918,1203858,60,10,utRho10
1092,pheU,8725254,8725254,8725252,2,26,utRho10
1093,pheV,6220730,6220732,6220730,2,8,utRho10
1094,phnC,8650412,8650412,8650330,82,12,utRho10
1095,phoA,803414,803494,803414,80,50,utRho10
1096,phoB,834202,834284,834202,82,4,utRho10
1097,phoE,520316,520316,520200,116,304,utRho10
1098,phoH,2169730,2169984,2169730,254,152,utRho10
1099,phoP,2381016,2381016,2380894,122,3084,utRho10
1100,phoQ,2379880,2379880,2379552,328,1050,utRho10
1101,phoU,7815330,7815330,7815156,174,272,utRho10
1102,phr,1478842,1479014,1478842,172,0,utRho10
1103,pinE,2419054,2419370,2419054,316,366,utRho10
1104,pinQ,3267168,3267244,3267168,76,464,utRho10
1105,pinR,2867424,2867424,2867348,76,774,utRho10
1106,pitA,7275224,7275284,7275224,60,42,utRho10
1107,pitB,6272806,6272806,6272742,64,104,utRho10
1108,pka,5439862,5439906,5439862,44,354,utRho10
1109,plaP,4174476,4174476,4174124,352,602,utRho10
1110,pldA,8009628,8009724,8009628,96,594,utRho10
1111,pldB,8018028,8018340,8018028,312,1996,utRho10
1112,plsB,8513196,8513196,8512932,264,424,utRho10
1113,pmbA,8915890,8915918,8915890,28,62,utRho10
1114,pmrD,4747148,4747148,4747076,72,0,utRho10
1115,pncB,1980828,1980828,1980712,116,52,utRho10
1116,pncC,5648788,5648788,5648692,96,0,utRho10
1117,pnp,6622652,6622652,6622336,316,64,utRho10
1118,pntA,3355950,3355950,3355806,144,0,utRho10
1119,pntB,3353096,3353096,3352720,376,80,utRho10
1120,polA,8093880,8093932,8093880,52,262,utRho10
1121,polB,131606,131606,131560,46,0,utRho10
1122,potD,2365700,2365700,2365658,42,2,utRho10
1123,potE,1436688,1436688,1436530,158,62,utRho10
1124,potF,1787268,1787568,1787268,300,292,utRho10
1125,poxB,1822152,1822152,1822098,54,364,utRho10
1126,ppa,8899372,8899372,8899304,68,166,utRho10
1127,ppc,8306380,8306380,8306196,184,106,utRho10
1128,ppdA,5928440,5928440,5928354,86,4578,utRho10
1129,ppdD,235410,235410,235098,312,480,utRho10
1130,pphA,3846770,3846770,3845938,832,9536,utRho10
1131,pphB,5719474,5719520,5719474,46,0,utRho10
1132,ppiA,6984898,6984898,6984594,304,92,utRho10
1133,ppiC,7919682,7919682,7919626,56,10,utRho10
1134,ppiD,923638,923830,923638,192,644,utRho10
1135,ppk,5245748,5246088,5245748,340,842,utRho10
1136,pppA,6228958,6228958,6228704,254,0,utRho10
1137,ppsA,3574322,3574322,3574224,98,0,utRho10
1138,ppsR,3574678,3574890,3574678,212,200,utRho10
1139,pptA,3065716,3066104,3065716,388,376,utRho10
1140,pqiA,2023318,2024002,2023318,684,48,utRho10
1141,prc,3830054,3830054,3829632,422,17310,utRho10
1142,preT,4467978,4468066,4467978,88,1904,utRho10
1143,prfC,9218688,9218828,9218688,140,1332,utRho10
1144,prkB,6968622,6968980,6968622,358,1732,utRho10
1145,prlC,7290476,7290476,7290364,112,314,utRho10
1146,prlF,6553944,6554004,6553944,60,450,utRho10
1147,proB,520432,520776,520432,344,662,utRho10
1148,proC,811372,811372,811288,84,0,utRho10
1149,proK,7417388,7417388,7417384,4,38,utRho10
1150,proL,4572414,4572422,4572414,8,0,utRho10
1151,proP,8660640,8661004,8660640,364,534,utRho10
1152,proS,437674,437674,437550,124,936,utRho10
1153,proV,5609126,5609630,5609126,504,272,utRho10
1154,prpB,697292,697364,697292,72,68,utRho10
1155,prpR,696942,696942,696886,56,80,utRho10
1156,prs,2524354,2524354,2523750,604,33084,utRho10
1157,psd,8781276,8781276,8780720,556,1538,utRho10
1158,psiE,8480600,8480650,8480600,50,0,utRho10
1159,pspA,2736076,2736158,2736076,82,0,utRho10
1160,pspF,2736080,2736080,2735824,256,0,utRho10
1161,pspG,8525632,8525680,8525632,48,42,utRho10
1162,pssA,5445156,5445454,5445156,298,6228,utRho10
1163,pstB,7817112,7817112,7816732,380,290,utRho10
1164,pstC,7821084,7821084,7820796,288,24,utRho10
1165,pstS,23469408,23469408,23469150,258,396,utRho10
1166,psuG,4517114,4517114,4516734,380,1700,utRho10
1167,psuT,4514992,4514992,4514670,322,0,utRho10
1168,pth,2517084,2517084,2517026,58,98,utRho10
1169,ptrA,5918022,5918022,5917768,254,0,utRho10
1170,ptrB,3857730,3857730,3857678,52,4272,utRho10
1171,ptsG,2315252,2315738,2315252,486,2976,utRho10
1172,ptsH,5066996,5067528,5066996,532,2728,utRho10
1173,purA,8809328,8809374,8809328,46,2,utRho10
1174,purC,5195562,5195562,5195236,326,46,utRho10
1175,purD,8411972,8411972,8411862,110,150,utRho10
1176,purE,1106284,1106284,1106200,84,1284,utRho10
1177,purH,8415254,8415254,8415064,190,128,utRho10
1178,purL,5391178,5391178,5391086,92,136,utRho10
1179,purM,5242306,5242394,5242306,88,62,utRho10
1180,purR,3475378,3475688,3475378,310,188,utRho10
1181,purT,3861438,3861762,3861438,324,732,utRho10
1182,purU,2577512,2577512,2577248,264,84,utRho10
1183,putA,2157850,2157850,2157764,86,0,utRho10
1184,putP,2158336,2158610,2158336,274,180,utRho10
1185,puuA,2721936,2721936,2721816,120,0,utRho10
1186,puuC,2725456,2725486,2725456,30,0,utRho10
1187,puuD,2722104,2722240,2722104,136,4,utRho10
1188,puuP,2718746,2718746,2718374,372,346,utRho10
1189,pykA,3874988,3875298,3874988,310,428,utRho10
1190,pykF,3510934,3511396,3510934,462,622,utRho10
1191,pyrC,2245286,2245286,2245214,72,68,utRho10
1192,pyrD,2009464,2009536,2009464,72,284,utRho10
1193,pyrE,7631970,7631970,7631536,434,232,utRho10
1194,pyrF,2683740,2683842,2683740,102,548,utRho10
1195,pyrG,5819594,5819594,5819332,262,2126,utRho10
1196,pyrH,383624,383710,383624,86,2660,utRho10
1197,pyrL,8945490,8945490,8945066,424,414,utRho10
1198,qmcA,1031646,1031646,1031546,100,222,utRho10
1199,qor,8528608,8528608,8528462,146,1784,utRho10
1200,qseB,6339502,6339656,6339502,154,518,utRho10
1201,queA,849970,850022,849970,52,1296,utRho10
1202,queE,5811212,5811212,5810836,376,1636,utRho10
1203,queF,5850642,5850696,5850642,54,20,utRho10
1204,queG,8788184,8788184,8788134,50,196472,utRho10
1205,racC,2835630,2835630,2835526,104,36,utRho10
1206,racR,2840898,2840898,2840482,416,180,utRho10
1207,raiA,5474208,5474308,5474208,100,2,utRho10
1208,rarD,8008594,8008594,8008356,238,258,utRho10
1209,ravA,7862256,7862256,7862186,70,96,utRho10
1210,rayT,495088,495274,495088,186,48,utRho10
1211,rbn,4763162,4763216,4763162,54,0,utRho10
1212,rbsD,7866644,7866702,7866644,58,0,utRho10
1213,rcnA,4371654,4371834,4371654,180,160,utRho10
1214,rcnB,4373768,4373920,4373768,152,68,utRho10
1215,rcnR,4371806,4371806,4371592,214,330,utRho10
1216,rcsA,4047672,4047936,4047672,264,11374,utRho10
1217,rcsB,4631390,4632354,4631390,964,536,utRho10
1218,rcsC,4640162,4640162,4639656,506,202,utRho10
1219,rcsD,4626904,4626976,4626904,72,232,utRho10
1220,rdgB,6193240,6193362,6193240,122,666,utRho10
1221,rdlA,2538646,2538646,2538646,0,0,utRho10
1222,rdlB,2539712,2539716,2539712,4,72,utRho10
1223,rdlC,2540782,2540786,2540782,4,2,utRho10
1224,rdlD,7400272,7400272,7400272,0,0,utRho10
1225,rdoA,8084782,8084830,8084782,48,20,utRho10
1226,recA,11295276,11295276,11295076,200,232,utRho10
1227,recC,5925014,5925014,5924856,158,96,utRho10
1228,recF,7763722,7763722,7762442,1280,8638,utRho10
1229,recN,5503518,5503590,5503518,72,0,utRho10
1230,recQ,8011666,8011728,8011666,62,182,utRho10
1231,relA,5828554,5828554,5827302,1252,532,utRho10
1232,relB,3291806,3291806,3291744,62,68,utRho10
1233,rem,3289950,3289950,3289804,146,170,utRho10
1234,rep,7921294,7921354,7921294,60,98,utRho10
1235,rfaD,7587730,7587974,7587730,244,750,utRho10
1236,rfaE,6393852,6393852,6393506,346,0,utRho10
1237,rfaH,8049930,8049930,8049642,288,2278,utRho10
1238,rfbX,4219436,4219436,4219168,268,3226,utRho10
1239,rfe,7935600,7935832,7935600,232,582,utRho10
1240,rhaB,8194944,8194944,8194896,48,0,utRho10
1241,rhaD,8188770,8188770,8188544,226,66,utRho10
1242,rhaS,8195422,8195472,8195422,50,0,utRho10
1243,rhaT,8201132,8201132,8201050,82,2,utRho10
1244,rhlE,1661566,1661744,1661566,178,172,utRho10
1245,rhoL,47593944,47594772,47593944,828,232368,utRho10
1246,rhsB,7238006,7238384,7238006,378,722,utRho10
1247,rhsC,1458758,1459166,1458758,408,0,utRho10
1248,rhsD,1046132,1046522,1046132,390,56,utRho10
1249,rhtA,1700608,1700608,1700194,414,310,utRho10
1250,rhtC,8015478,8015514,8015478,36,1406,utRho10
1251,ribA,2678468,2678468,2678320,148,402,utRho10
1252,ribC,3486916,3486916,3486484,432,3576,utRho10
1253,ribE,869008,869294,869008,286,5354,utRho10
1254,ribF,42766,42814,42766,48,0,utRho10
1255,ridA,8941892,8941892,8941826,66,100,utRho10
1256,rihA,1369204,1369204,1368824,380,3662,utRho10
1257,rihB,4510504,4510504,4510372,132,108,utRho10
1258,rimJ,2251044,2251124,2251044,80,234,utRho10
1259,rimK,1783752,1783934,1783752,182,554,utRho10
1260,rimL,2997486,2997876,2997486,390,54,utRho10
1261,rimO,1756140,1756140,1756070,70,78,utRho10
1262,rimP,6636350,6636350,6636012,338,448,utRho10
1263,rlmA,3814172,3814172,3814120,52,1744,utRho10
1264,rlmD,5830086,5830086,5830000,86,34,utRho10
1265,rlmE,6655520,6655520,6655328,192,1012,utRho10
1266,rlmF,1684384,1684664,1684384,280,162,utRho10
1267,rlmG,6471784,6471784,6471750,34,0,utRho10
1268,rlmI,2060002,2060002,2059938,64,538,utRho10
1269,rlmJ,7290700,7290770,7290700,70,12,utRho10
1270,rlmL,2015344,2015688,2015344,344,1946,utRho10
1271,rlpA,1330444,1330444,1330380,64,340,utRho10
1272,rluA,120900,120900,120692,208,530,utRho10
1273,rluF,8460324,8460708,8460324,384,232,utRho10
1274,rmf,2031006,2031430,2031006,424,1434,utRho10
1275,rna,1290068,1290068,1290006,62,24,utRho10
1276,rnb,2698258,2698258,2697824,434,2966,utRho10
1277,rnc,10816892,10816892,10816252,640,12820,utRho10
1278,rnd,3776122,3776122,3775982,140,254,utRho10
1279,rne,2289746,2289746,2288734,1012,7186,utRho10
1280,rnhA,472082,472082,472004,78,878,utRho10
1281,rnk,1288360,1288360,1287934,426,58,utRho10
1282,rnlA,5531788,5531836,5531788,48,554,utRho10
1283,rnlB,5533414,5533968,5533414,554,688,utRho10
1284,rnpB,19623552,19623552,19623552,0,0,utRho10
1285,rob,9270706,9270706,9270620,86,92,utRho10
1286,rodZ,5285868,5285868,5285688,180,40,utRho10
1287,rpe,7030306,7030306,7030118,188,230,utRho10
1288,rph,15266320,15266320,15266196,124,32,utRho10
1289,rpiA,6118706,6118706,6118650,56,1528,utRho10
1290,rpiB,8626514,8626700,8626514,186,170,utRho10
1291,rpiR,8626274,8626274,8625982,292,34,utRho10
1292,rplJ,8359246,8359992,8359246,746,8574,utRho10
1293,rplK,8356708,8356894,8356708,186,1100,utRho10
1294,rplM,6757344,6757344,6757302,42,10532,utRho10
1295,rplN,6896444,6896444,6896298,146,14292,utRho10
1296,rplS,5489284,5489284,5489060,224,20888,utRho10
1297,rplT,7199052,7199052,7198996,56,676,utRho10
1298,rplU,6667036,6667036,6666902,134,118,utRho10
1299,rplY,4564866,4565034,4564866,168,32,utRho10
1300,rpmA,6666450,6666450,6666238,212,1220,utRho10
1301,rpmB,15247980,15247980,15246696,1284,132108,utRho10
1302,rpmE,8253816,8254026,8253816,210,784,utRho10
1303,rpmF,2294676,2294734,2294676,58,59044,utRho10
1304,rpmH,7768130,7768672,7768130,542,7318,utRho10
1305,rpmI,3600854,3600854,3599998,856,11928,utRho10
1306,rpoB,8362126,8362490,8362126,364,722,utRho10
1307,rpoD,6424946,6426094,6424946,1148,28204,utRho10
1308,rpoE,5420372,5420372,5420024,348,0,utRho10
1309,rpoH,7202006,7202006,7201566,440,7158,utRho10
1310,rpoN,6689324,6689434,6689324,110,48,utRho10
1311,rpoS,5736236,5736236,5735102,1134,2778,utRho10
1312,rpoZ,7644154,7644212,7644154,58,578,utRho10
1313,rppH,5937986,5937986,5937954,32,38,utRho10
1314,rprA,3540744,3540744,3540744,0,0,utRho10
1315,rpsA,1923434,1923990,1923434,556,197894,utRho10
1316,rpsF,8850050,8850236,8850050,186,43554,utRho10
1317,rpsI,6756580,6756580,6756414,166,12098,utRho10
1318,rpsJ,6906884,6906884,6906540,344,13954,utRho10
1319,rpsL,6949242,6949242,6949104,138,720,utRho10
1320,rpsM,6885130,6885130,6884942,188,2552,utRho10
1321,rpsO,13247144,13247144,13246736,408,2892,utRho10
1322,rpsP,5492508,5492508,5492370,138,74,utRho10
1323,rpsT,42420,42420,42156,264,750,utRho10
1324,rpsU,12842584,12843124,12842584,540,4228,utRho10
1325,rraA,8238716,8238716,8238660,56,334,utRho10
1326,rraB,8956768,8956946,8956768,178,142,utRho10
1327,rrsA,8070478,8071062,8070478,584,6266,utRho10
1328,rrsB,16665468,16666636,16665468,1168,13036,utRho10
1329,rrsC,7883032,7883616,7883032,584,8156,utRho10
1330,rrsD,6858094,6858094,6857524,570,784,utRho10
1331,rrsE,8415726,8416294,8415726,568,870,utRho10
1332,rrsG,5462896,5462896,5462314,582,5478,utRho10
1333,rrsH,446970,447542,446970,572,946,utRho10
1334,rsd,8393908,8393908,8393616,292,204,utRho10
1335,rseA,5419264,5419264,5418808,456,44,utRho10
1336,rseP,392940,393092,392940,152,14,utRho10
1337,rseX,4067298,4067298,4067298,0,0,utRho10
1338,rsfS,1338144,1338144,1338072,72,482,utRho10
1339,rsgA,8783132,8783132,8783018,114,0,utRho10
1340,rsmA,105176,105176,104860,316,3248,utRho10
1341,rsmB,6869982,6870414,6869982,432,604,utRho10
1342,rsmC,9215736,9215736,9215400,336,212,utRho10
1343,rsmD,7208594,7208786,7208594,192,0,utRho10
1344,rsmE,6182036,6182268,6182036,232,640,utRho10
1345,rsmG,7847512,7847512,7847360,152,1622,utRho10
1346,rsmH,180020,180188,180020,168,106,utRho10
1347,rsmI,6587106,6587106,6586670,436,1060,utRho10
1348,rssA,2578212,2578412,2578212,200,916,utRho10
1349,rssB,2580440,2580484,2580440,44,192,utRho10
1350,rstA,3364276,3364300,3364276,24,0,utRho10
1351,rsuA,4561096,4561096,4560966,130,286,utRho10
1352,rsxA,3411510,3411534,3411510,24,0,utRho10
1353,rtcA,7114004,7114004,7113698,306,482,utRho10
1354,rtcB,7116214,7116214,7116158,56,0,utRho10
1355,rtn,4541356,4541452,4541356,96,80,utRho10
1356,rutA,2148052,2148052,2148022,30,88,utRho10
1357,rutG,2140090,2140090,2139678,412,34,utRho10
1358,rutR,2148226,2148484,2148226,258,416,utRho10
1359,ruvA,7784096,7784096,7783904,192,196,utRho10
1360,ruvB,7782176,7782176,7781424,752,872,utRho10
1361,ruvC,3894878,3894878,3894752,126,32,utRho10
1362,rybB,1776114,1776114,1776114,0,0,utRho10
1363,rydB,3529860,3529860,3529322,538,144,utRho10
1364,rydC,2983012,2983012,2983012,0,0,utRho10
1365,ryfA,5307398,5307710,5307398,312,218,utRho10
1366,ryfD,5468590,5468590,5468590,0,0,utRho10
1367,ryhB,7162032,7162032,7162032,0,0,utRho10
1368,ryjA,8556132,8556132,8556132,0,0,utRho10
1369,ryjB,9055954,9055954,9055954,0,0,utRho10
1370,sad,3229598,3229598,3229406,192,0,utRho10
1371,safA,3168056,3168056,3167918,138,138,utRho10
1372,sanA,4465368,4465756,4465368,388,88,utRho10
1373,sapF,2705314,2705314,2705268,46,54,utRho10
1374,sbcB,4165456,4165512,4165456,56,0,utRho10
1375,sbcC,831694,831694,831506,188,132,utRho10
1376,sbcD,833954,833954,833904,50,46,utRho10
1377,sbmA,793106,793278,793106,172,716,utRho10
1378,sbmC,4162650,4162650,4162524,126,0,utRho10
1379,sdaA,3793618,3793864,3793618,246,60,utRho10
1380,sdaC,5856070,5856458,5856070,388,1446,utRho10
1381,sdhC,1509916,1510354,1509916,438,31478,utRho10
1382,sdhD,1510808,1511120,1510808,312,5722,utRho10
1383,sdiA,3993834,3993834,3993664,170,420,utRho10
1384,secE,8354354,8354716,8354354,362,454,utRho10
1385,secG,6645180,6645180,6645010,170,770,utRho10
1386,selA,7522594,7522594,7522498,96,1040,utRho10
1387,selB,7519850,7519850,7519722,128,100,utRho10
1388,selC,7672396,7672444,7672396,48,50,utRho10
1389,selD,3696058,3696058,3696016,42,1958,utRho10
1390,seqA,1425884,1425974,1425884,90,478,utRho10
1391,serA,6117098,6117098,6116820,278,1512,utRho10
1392,serB,9249712,9249790,9249712,78,248,utRho10
1393,serC,3830380,3830612,3830380,232,0,utRho10
1394,serS,1878730,1878856,1878730,126,2644,utRho10
1395,serT,2063438,2063438,2063424,14,0,utRho10
1396,serU,4087124,4087124,4087114,10,192,utRho10
1397,serV,5637394,5637394,5637290,104,200,utRho10
1398,serW,1852014,1852014,1851942,72,106,utRho10
1399,serX,2195352,2195352,2195304,48,0,utRho10
1400,setB,4527426,4527726,4527426,300,138,utRho10
1401,setC,7673488,7673906,7673488,418,2650,utRho10
1402,sfmA,1116124,1116424,1116124,300,120,utRho10
1403,sfmC,1117606,1117948,1117606,342,0,utRho10
1404,sfsA,323030,323030,322972,58,304,utRho10
1405,sfsB,6669592,6669818,6669592,226,1552,utRho10
1406,sgrR,154676,154676,154598,78,32,utRho10
1407,sgrS,154734,154734,154734,0,0,utRho10
1408,shiA,4107068,4107286,4107068,218,54,utRho10
1409,sibA,4306622,4306622,4306622,0,0,utRho10
1410,sibB,4307292,4307292,4307292,0,0,utRho10
1411,sibC,6113702,6113702,6113702,0,0,utRho10
1412,sibD,6389730,6389730,6389730,0,0,utRho10
1413,sibE,6390480,6390480,6390480,0,0,utRho10
1414,sixA,4913998,4913998,4913624,374,52,utRho10
1415,slp,7307872,7307922,7307872,50,22,utRho10
1416,slt,9261400,9261466,9261400,66,112,utRho10
1417,slyA,3442028,3442028,3441648,380,82,utRho10
1418,slyB,3439496,3439752,3439496,256,52,utRho10
1419,slyD,6957398,6957398,6956994,404,360,utRho10
1420,slyX,6954862,6955280,6954862,418,8378,utRho10
1421,smf,6867372,6867372,6867120,252,424,utRho10
1422,smpB,5509534,5509792,5509534,258,920,utRho10
1423,smrA,2811872,2811958,2811872,86,196,utRho10
1424,smrB,4896872,4897212,4896872,340,320,utRho10
1425,smtA,1946808,1947074,1946808,266,84,utRho10
1426,sodA,8201518,8201620,8201518,102,5670,utRho10
1427,sodB,3470646,3470756,3470646,110,350,utRho10
1428,sodC,3449358,3449358,3449310,48,124,utRho10
1429,sohB,2658568,2658664,2658568,96,670,utRho10
1430,sokB,2984232,2984238,2984232,6,44,utRho10
1431,solA,2241218,2241218,2241172,46,2,utRho10
1432,soxR,8554894,8554938,8554894,44,128,utRho10
1433,soxS,8554846,8554846,8554766,80,122,utRho10
1434,speA,6172096,6172096,6171822,274,408,utRho10
1435,speB,6167892,6167892,6167594,298,264,utRho10
1436,speC,6218350,6218350,6218310,40,50,utRho10
1437,spf,8099798,8099798,8099798,0,0,utRho10
1438,sppA,3697422,3697674,3697422,252,244,utRho10
1439,spy,3651376,3651376,3651250,126,0,utRho10
1440,sra,3112092,3112092,3111926,166,92,utRho10
1441,sraB,2293178,2293178,2293178,0,0,utRho10
1442,sraC,3846132,3846132,3846132,0,0,utRho10
1443,srlA,5651582,5651664,5651582,82,66,utRho10
1444,srlR,5657720,5658094,5657720,374,814,utRho10
1445,srmB,5425752,5425792,5425752,40,98,utRho10
1446,sroA,151216,151216,151216,0,0,utRho10
1447,sroG,6369436,6369436,6369436,0,0,utRho10
1448,sroH,8380974,8380974,8380974,0,0,utRho10
1449,ssb,8548022,8548250,8548022,228,252,utRho10
1450,sseA,5304782,5304988,5304782,206,4538,utRho10
1451,sspA,6755138,6755138,6754840,298,586,utRho10
1452,ssrA,5511014,5511186,5511014,172,174,utRho10
1453,ssrS,12223036,12223932,12223036,896,1248,utRho10
1454,sstT,6479726,6479888,6479726,162,104,utRho10
1455,ssuB,1988282,1988282,1988088,194,242,utRho10
1456,ssuE,1995126,1995126,1995024,102,0,utRho10
1457,sthA,8321604,8321604,8321580,24,1672,utRho10
1458,stpA,5597156,5597156,5596990,166,54,utRho10
1459,sucA,3034344,3034824,3034344,480,4356,utRho10
1460,sufA,3528836,3528836,3528772,64,212,utRho10
1461,sufE,3518962,3518962,3518580,382,232,utRho10
1462,sugE,8753588,8753750,8753588,162,2184,utRho10
1463,sulA,2041894,2041894,2041838,56,4160,utRho10
1464,syd,5850738,5850738,5850560,178,50,utRho10
1465,symE,9159834,9159834,9159680,154,546,utRho10
1466,symR,9159670,9159670,9159670,0,0,utRho10
1467,tabA,8949566,8949724,8949566,158,62,utRho10
1468,talA,5157140,5157332,5157140,192,0,utRho10
1469,talB,16382,16476,16382,94,5940,utRho10
1470,tam,3214442,3214692,3214442,250,34,utRho10
1471,tamA,8884540,8884764,8884540,224,712,utRho10
1472,tar,3945432,3945432,3945382,50,184,utRho10
1473,tas,5943138,5943194,5943138,56,1262,utRho10
1474,tatA,16087636,16087780,16087636,144,216,utRho10
1475,tatE,1317742,1317894,1317742,152,120,utRho10
1476,tauA,770410,770464,770410,54,96,utRho10
1477,tdcA,6534186,6534186,6534130,56,0,utRho10
1478,tdcG,6519652,6519652,6519298,354,350,utRho10
1479,tdcR,6534380,6534760,6534380,380,44,utRho10
1480,tdk,2586986,2587054,2586986,68,56,utRho10
1481,tehA,3001072,3001146,3001072,74,0,utRho10
1482,tesA,1039898,1039898,1039530,368,178,utRho10
1483,tesB,950402,950402,950322,80,46,utRho10
1484,tfaE,2418532,2418532,2418238,294,216,utRho10
1485,tfaQ,3269912,3269912,3269770,142,532,utRho10
1486,tff,379424,379256,379424,168,60,utRho10
1487,tgt,852110,852274,852110,164,26,utRho10
1488,thiD,4369346,4369346,4369032,314,130,utRho10
1489,thiI,882936,883098,882936,162,436,utRho10
1490,thiM,4370902,4370902,4370602,300,1102,utRho10
1491,thiQ,146170,146170,145854,316,504,utRho10
1492,thrL,592,760,592,168,152,utRho10
1493,thrS,7210932,7210932,7210280,652,1028,utRho10
1494,thrU,8350762,8350776,8350762,14,4,utRho10
1495,thrV,6847414,6847414,6847310,104,187108,utRho10
1496,thrW,525682,525742,525682,60,1754,utRho10
1497,thyA,5930696,5930696,5930310,386,2180,utRho10
1498,tig,909986,910266,909986,280,1110,utRho10
1499,tisB,7706674,7707106,7706674,432,612,utRho10
1500,tktA,6163414,6163414,6163270,144,278,utRho10
1501,tktB,5158616,5159272,5158616,656,504,utRho10
1502,tldD,6784368,6784368,6784056,312,34,utRho10
1503,tmcA,5191876,5191876,5191718,158,112,utRho10
1504,tnaC,15553644,15553740,15553644,96,1860,utRho10
1505,tolB,1555074,1555480,1555074,406,346,utRho10
1506,tolC,6356008,6356230,6356008,222,710,utRho10
1507,tomB,961588,961588,961416,172,3422,utRho10
1508,tonB,2622108,2622178,2622108,70,288,utRho10
1509,topA,2661578,2662096,2661578,518,556,utRho10
1510,torC,2116112,2116168,2116112,56,10,utRho10
1511,torR,2115968,2115968,2115908,60,58,utRho10
1512,torS,2112364,2112364,2112356,8,0,utRho10
1513,torT,2112414,2112522,2112414,108,0,utRho10
1514,tpiA,8223138,8223138,8223014,124,232,utRho10
1515,tppB,3425342,3425538,3425342,196,6068,utRho10
1516,tpr,2574376,2574376,2574376,0,0,utRho10
1517,tpx,2777688,2777688,2777622,66,936,utRho10
1518,tqsA,3347780,3347826,3347780,46,0,utRho10
1519,treA,2494850,2494850,2494752,98,1370,utRho10
1520,treB,8932420,8932420,8932360,60,84,utRho10
1521,treF,7339102,7339184,7339102,82,284,utRho10
1522,treR,8934694,8934694,8934492,202,0,utRho10
1523,trg,2984878,2984940,2984878,62,264,utRho10
1524,trkG,2847342,2847564,2847342,222,364,utRho10
1525,trmA,8326590,8326590,8326540,50,222,utRho10
1526,trpA,2634678,2634678,2634444,234,378,utRho10
1527,trpC,2639888,2639888,2639570,318,0,utRho10
1528,trpL,5292432,5292432,5292328,104,0,utRho10
1529,trpR,9265408,9265520,9265408,112,322,utRho10
1530,trpS,7027394,7027394,7027276,118,2366,utRho10
1531,trpT,7893560,7893914,7893560,354,114558,utRho10
1532,trxA,7931294,7931522,7931294,228,438,utRho10
1533,trxB,1864156,1864156,1864100,56,64,utRho10
1534,trxC,5437350,5437470,5437350,120,256,utRho10
1535,tsaD,6421256,6421256,6421086,170,54,utRho10
1536,tsgA,6985038,6985136,6985038,98,50,utRho10
1537,tsr,9182824,9183314,9182824,490,268,utRho10
1538,tsx,864490,864490,864026,464,270,utRho10
1539,ttcA,2823970,2823970,2823896,74,2434,utRho10
1540,ttdA,6412848,6412926,6412848,78,30,utRho10
1541,ttdR,6412760,6412760,6412512,248,164,utRho10
1542,tufA,6943448,6943448,6942658,790,183448,utRho10
1543,tus,3368346,3368518,3368346,172,66,utRho10
1544,tusA,7218040,7218040,7217992,48,80,utRho10
1545,tusB,6950218,6950218,6949930,288,1370,utRho10
1546,tynA,2902996,2902996,2902698,298,0,utRho10
1547,typA,8116460,8116814,8116460,354,8084,utRho10
1548,tyrB,8534164,8534228,8534164,64,3426,utRho10
1549,tyrP,3979004,3979362,3979004,358,966,utRho10
1550,tyrR,2773384,2773440,2773384,56,32,utRho10
1551,tyrS,3434566,3434566,3434444,122,42,utRho10
1552,tyrT,2575330,2575330,2575244,86,48,utRho10
1553,uacT,6062378,6062734,6062378,356,382,utRho10
1554,ubiC,8504886,8505012,8504886,126,152,utRho10
1555,ubiD,8049618,8049976,8049618,358,2410,utRho10
1556,ubiE,8037494,8037710,8037494,216,104,utRho10
1557,ubiG,4679078,4679134,4679078,56,102,utRho10
1558,ucpA,5089342,5089342,5089246,96,0,utRho10
1559,udp,8032782,8032862,8032782,80,84,utRho10
1560,ugd,4199470,4199470,4199226,244,0,utRho10
1561,ugpB,7184852,7184852,7184650,202,2822,utRho10
1562,ugpQ,7176600,7176600,7176226,374,76,utRho10
1563,uhpT,7694396,7694396,7694334,62,100,utRho10
1564,uidA,3392304,3392304,3392142,162,136,utRho10
1565,uidC,3386012,3386012,3385702,310,0,utRho10
1566,uidR,3394150,3394150,3394104,46,194,utRho10
1567,ulaA,8839854,8839960,8839854,106,60,utRho10
1568,ulaG,8839350,8839350,8839250,100,204,utRho10
1569,ulaR,8837124,8837124,8836906,218,72,utRho10
1570,umpG,5741372,5741372,5740548,824,188,utRho10
1571,umpH,1400704,1400704,1400652,52,20,utRho10
1572,umuD,2461476,2461534,2461476,58,0,utRho10
1573,ung,5433476,5433508,5433476,32,72,utRho10
1574,uof,2843316,2843316,2842900,416,8360,utRho10
1575,upp,5241818,5241818,5241744,74,286,utRho10
1576,usg,4873780,4873780,4873298,482,616,utRho10
1577,ushA,1009772,1009828,1009772,56,74,utRho10
1578,uspA,7279966,7280222,7279966,256,596,utRho10
1579,uspB,7279696,7279696,7279440,256,370,utRho10
1580,uspC,3959172,3959506,3959172,334,144,utRho10
1581,uspE,2797318,2797318,2797244,74,280,utRho10
1582,uspF,2871282,2871282,2871238,44,186,utRho10
1583,uspG,1283806,1283806,1283734,72,2270,utRho10
1584,uvrA,8547872,8547872,8547742,130,448,utRho10
1585,uvrB,1626304,1627052,1626304,748,398,utRho10
1586,uvrC,3989758,3989758,3989412,346,112,utRho10
1587,uvrD,7995814,7995966,7995814,152,650,utRho10
1588,uvrY,3990812,3990812,3990718,94,108,utRho10
1589,uxaB,3221474,3221474,3221360,114,106,utRho10
1590,uxaC,6489714,6489714,6489482,232,78,utRho10
1591,uxuA,9103036,9103272,9103036,236,356,utRho10
1592,uxuR,9108916,9109152,9108916,236,110,utRho10
1593,valS,8967854,8967854,8967674,180,278,utRho10
1594,valU,5041848,5041862,5041848,14,58,utRho10
1595,valV,3492830,3492870,3492830,40,46,utRho10
1596,ves,3649968,3649968,3649874,94,38,utRho10
1597,waaA,7616512,7617080,7616512,568,648,utRho10
1598,waaH,7580298,7580298,7580162,136,0,utRho10
1599,waaQ,7616476,7616476,7616196,280,222,utRho10
1600,waaU,7598996,7598996,7598624,372,392,utRho10
1601,waaY,7602272,7602272,7601930,342,7216,utRho10
1602,wbbH,4214888,4214888,4214452,436,5894,utRho10
1603,wbbK,4209212,4209212,4209018,194,436,utRho10
1604,wcaM,4231868,4231868,4231792,76,0,utRho10
1605,wrbA,2135516,2135516,2135416,100,76,utRho10
1606,wza,4275166,4275166,4274486,680,272,utRho10
1607,wzxC,4240674,4240674,4240316,358,0,utRho10
1608,wzzB,4196950,4196950,4196602,348,160,utRho10
1609,xanP,7657642,7657890,7657642,248,220,utRho10
1610,xanQ,6048520,6048702,6048520,182,100,utRho10
1611,xapA,5049820,5049820,5049756,64,64,utRho10
1612,xapR,10090252,10090252,10089908,344,60,utRho10
1613,xdhA,6000514,6000690,6000514,176,694,utRho10
1614,xerD,6079702,6079702,6079486,216,158,utRho10
1615,xseA,5268394,5268464,5268394,70,132,utRho10
1616,xseB,882746,882746,882686,60,432,utRho10
1617,xthA,3664798,3664856,3664798,58,0,utRho10
1618,xylA,7461614,7461614,7461530,84,5024,utRho10
1619,xylE,8484540,8484540,8484508,32,0,utRho10
1620,xylF,7462138,7462262,7462138,124,378,utRho10
1621,xylR,7469812,7469958,7469812,146,40,utRho10
1622,yaaA,13230,13230,12918,312,90,utRho10
1623,yaaI,23876,23876,23572,304,1144,utRho10
1624,yaaJ,16034,16034,15918,116,72,utRho10
1625,yaaU,91184,91614,91184,430,298,utRho10
1626,yaaW,23084,23084,22712,372,192,utRho10
1627,yaaX,10060,10468,10060,408,282,utRho10
1628,yabI,142542,142702,142542,160,244,utRho10
1629,yacC,273880,273880,273834,46,894,utRho10
1630,yacH,262932,262932,262520,412,574,utRho10
1631,yacL,268678,268776,268678,98,630,utRho10
1632,yadD,293796,293936,293796,140,124,utRho10
1633,yadE,289930,290162,289930,232,752,utRho10
1634,yadN,314110,314110,313766,344,396,utRho10
1635,yadS,355572,355572,355248,324,3152,utRho10
1636,yadV,312470,312470,312402,68,134,utRho10
1637,yaeF,434270,434270,434006,264,44,utRho10
1638,yaeP,428374,428374,428250,124,1210,utRho10
1639,yaeQ,428176,428582,428176,406,1972,utRho10
1640,yaeR,423716,423754,423716,38,0,utRho10
1641,yafC,462166,462166,461762,404,288,utRho10
1642,yafD,462128,462244,462128,116,276,utRho10
1643,yafK,491986,491986,491610,376,1390,utRho10
1644,yafL,493282,493424,493282,142,54,utRho10
1645,yafN,503938,504010,503938,72,0,utRho10
1646,yafS,469568,469632,469568,64,1186,utRho10
1647,yafT,474470,474670,474470,200,100,utRho10
1648,yafV,480432,480432,480378,54,336,utRho10
1649,yafZ,536052,536052,536010,42,86,utRho10
1650,yagE,564446,564556,564446,110,74,utRho10
1651,yagG,570414,570790,570414,376,100,utRho10
1652,yagI,578384,578384,578324,60,22,utRho10
1653,yagK,586236,586236,585896,340,768,utRho10
1654,yagL,588062,588062,587836,226,612,utRho10
1655,yagN,591342,591342,591158,184,518,utRho10
1656,yahA,663746,664742,663746,996,2968,utRho10
1657,yahC,670136,670136,670044,92,2096,utRho10
1658,yahE,671478,671850,671478,372,316,utRho10
1659,yahM,690504,690808,690504,304,224,utRho10
1660,yahN,692872,692872,692674,198,198,utRho10
1661,yahO,692864,692968,692864,104,78,utRho10
1662,yaiE,816296,816354,816296,58,258,utRho10
1663,yaiI,811396,811528,811396,132,0,utRho10
1664,yaiO,761946,761946,761684,262,38,utRho10
1665,yaiP,767970,767970,767870,100,0,utRho10
1666,yaiS,769660,769660,769232,428,140,utRho10
1667,yaiV,788922,788922,788922,0,0,utRho10
1668,yaiY,799094,799094,798666,428,316,utRho10
1669,yaiZ,798888,799186,798888,298,1102,utRho10
1670,yajC,854410,854574,854410,164,1592,utRho10
1671,yajD,860938,861210,860938,272,496,utRho10
1672,yajI,866068,866068,865702,366,142,utRho10
1673,yajL,887496,887496,887282,214,946,utRho10
1674,yajQ,889316,889366,889316,50,382,utRho10
1675,yajR,893374,893374,893332,42,340,utRho10
1676,ybaB,987418,988152,987418,734,4376,utRho10
1677,ybaL,1006590,1006590,1006476,114,118,utRho10
1678,ybaM,980648,980648,980542,106,944,utRho10
1679,ybaN,981436,981764,981436,328,316,utRho10
1680,ybaO,936704,936766,936704,62,0,utRho10
1681,ybaP,1016568,1016568,1016160,408,968,utRho10
1682,ybaQ,1016348,1016436,1016348,88,224,utRho10
1683,ybaS,1023146,1023282,1023146,136,128,utRho10
1684,ybaV,927504,927874,927504,370,54,utRho10
1685,ybaY,950490,950758,950490,268,394,utRho10
1686,ybbB,1062724,1062724,1062452,272,0,utRho10
1687,ybbJ,1030154,1030154,1029718,436,916,utRho10
1688,ybbL,1031784,1031838,1031784,54,0,utRho10
1689,ybbN,1037136,1037136,1036558,578,1650,utRho10
1690,ybbO,1038658,1038658,1038298,360,960,utRho10
1691,ybbY,1080718,1081130,1080718,412,162,utRho10
1692,ybcH,1176140,1176140,1175962,178,240,utRho10
1693,ybcI,1113264,1113264,1113106,158,3910,utRho10
1694,ybcJ,1114050,1114050,1113746,304,280,utRho10
1695,ybcK,1137502,1137804,1137502,302,504,utRho10
1696,ybcL,1141690,1141786,1141690,96,0,utRho10
1697,ybcN,1144628,1144932,1144628,304,42,utRho10
1698,ybcQ,1147548,1147912,1147548,364,448,utRho10
1699,ybcW,1159610,1159760,1159610,150,36,utRho10
1700,ybdD,1263982,1264364,1263982,382,308,utRho10
1701,ybdF,1212106,1212106,1211772,334,112,utRho10
1702,ybdH,1267048,1267048,1266954,94,214,utRho10
1703,ybdJ,1212822,1212822,1212398,424,214,utRho10
1704,ybdK,1215122,1215122,1214766,356,3306,utRho10
1705,ybdL,1267114,1267172,1267114,58,14,utRho10
1706,ybdM,1271110,1271110,1270752,358,1106,utRho10
1707,ybdN,1273372,1273372,1273138,234,112,utRho10
1708,ybdR,1283844,1284176,1283844,332,2430,utRho10
1709,ybeD,1325412,1325412,1325284,128,194,utRho10
1710,ybeF,1323090,1323090,1322756,334,1868,utRho10
1711,ybeL,1349986,1350036,1349986,50,0,utRho10
1712,ybeQ,1353412,1353412,1353094,318,124,utRho10
1713,ybeR,1353120,1353422,1353120,302,124,utRho10
1714,ybeT,1358832,1358832,1358812,20,0,utRho10
1715,ybeU,1358924,1359016,1358924,92,0,utRho10
1716,ybeZ,1386938,1386938,1386834,104,8424,utRho10
1717,ybfA,1458074,1458268,1458074,194,92,utRho10
1718,ybfE,1423878,1423878,1423796,82,414,utRho10
1719,ybfF,1425692,1425692,1425604,88,478,utRho10
1720,ybfH,1433282,1433282,1433194,88,56,utRho10
1721,ybgA,1477840,1478002,1477840,162,92,utRho10
1722,ybgC,1549288,1549504,1549288,216,94,utRho10
1723,ybgD,1505916,1505916,1505590,326,15554,utRho10
1724,ybgI,1485238,1485654,1485238,416,0,utRho10
1725,ybgO,1498370,1498370,1497964,406,180,utRho10
1726,ybgS,1570992,1570992,1570634,358,182,utRho10
1727,ybhA,1597184,1597184,1596862,322,152,utRho10
1728,ybhB,1616070,1616070,1615818,252,118,utRho10
1729,ybhC,1614642,1614642,1614562,80,1186,utRho10
1730,ybhD,1601418,1601418,1601276,142,38,utRho10
1731,ybhH,1601104,1601518,1601104,414,100,utRho10
1732,ybhK,1633384,1633384,1633294,90,172,utRho10
1733,ybhM,1641556,1641586,1641556,30,0,utRho10
1734,ybhN,1645296,1645296,1644996,300,134,utRho10
1735,ybhQ,1649202,1649260,1649202,58,462,utRho10
1736,ybiA,1665920,1665920,1665900,20,32,utRho10
1737,ybiI,1676968,1676968,1676912,56,732,utRho10
1738,ybiO,1691328,1691328,1690960,368,580,utRho10
1739,ybiP,1705252,1705252,1705194,58,986,utRho10
1740,ybiS,1711572,1711572,1711488,84,376,utRho10
1741,ybiT,1711894,1711926,1711894,32,0,utRho10
1742,ybiU,1718212,1718212,1718122,90,144,utRho10
1743,ybiV,1720176,1720176,1720056,120,0,utRho10
1744,ybiW,1725566,1725566,1725212,354,3570,utRho10
1745,ybiX,1678548,1678548,1678414,134,234,utRho10
1746,ybjC,1781784,1781826,1781784,42,16,utRho10
1747,ybjE,1830154,1830154,1829714,440,400,utRho10
1748,ybjG,1767016,1767016,1766776,240,1512,utRho10
1749,ybjL,1779882,1779882,1779638,244,218,utRho10
1750,ybjM,1779770,1780178,1779770,408,358,utRho10
1751,ybjO,1795704,1795978,1795704,274,0,utRho10
1752,ybjP,1809046,1809046,1808934,112,0,utRho10
1753,ybjQ,1809034,1809186,1809034,152,0,utRho10
1754,ybjS,1813796,1813796,1813506,290,88,utRho10
1755,ybjX,1838206,1838206,1838168,38,0,utRho10
1756,ycaD,1891438,1891742,1891438,304,0,utRho10
1757,ycaI,1928210,1928640,1928210,430,160,utRho10
1758,ycaK,1899094,1899336,1899094,242,334,utRho10
1759,ycaL,1920264,1920528,1920264,264,92,utRho10
1760,ycaM,1894240,1894458,1894240,218,78,utRho10
1761,ycaR,1941284,1941346,1941284,62,4878,utRho10
1762,ycbB,1961862,1962094,1961862,232,296,utRho10
1763,ycbJ,1943344,1943504,1943344,160,0,utRho10
1764,ycbK,1966046,1966150,1966046,104,232,utRho10
1765,ycbZ,2036920,2036920,2036598,322,294,utRho10
1766,yccA,2062886,2062886,2062836,50,192,utRho10
1767,yccF,2048730,2048730,2048696,34,12,utRho10
1768,yccS,2047988,2047988,2047766,222,56,utRho10
1769,yccT,2055674,2055674,2055546,128,146,utRho10
1770,yccX,2059960,2060128,2059960,168,2014,utRho10
1771,ycdT,2185682,2185752,2185682,70,90,utRho10
1772,ycdU,2191266,2191686,2191266,420,416,utRho10
1773,ycdZ,2200504,2200592,2200504,88,0,utRho10
1774,yceA,2233544,2233614,2233544,70,104,utRho10
1775,yceD,2293298,2293588,2293298,290,7008,utRho10
1776,yceF,2293522,2293522,2293190,332,4552,utRho10
1777,yceH,2252154,2252314,2252154,160,676,utRho10
1778,yceI,2237282,2237282,2236952,330,914,utRho10
1779,yceJ,2238142,2238142,2238092,50,648,utRho10
1780,yceM,2253208,2253612,2253208,404,702,utRho10
1781,yceO,2239264,2239264,2238894,370,1598,utRho10
1782,yceQ,2288760,2289004,2288760,244,5628,utRho10
1783,ycfD,2376540,2376540,2376480,60,166,utRho10
1784,ycfJ,2334814,2335198,2334814,384,200,utRho10
1785,ycfS,2340834,2340834,2340748,86,0,utRho10
1786,ycfT,2350658,2350658,2350330,328,76,utRho10
1787,ycfZ,2362760,2362760,2362534,226,1618,utRho10
1788,ycgB,2474570,2474570,2474482,88,114,utRho10
1789,ycgG,2434614,2434656,2434614,42,338,utRho10
1790,ycgJ,2452956,2453200,2452956,244,118,utRho10
1791,ycgL,2455218,2455362,2455218,144,0,utRho10
1792,ycgN,2457366,2457660,2457366,294,346,utRho10
1793,ycgR,2489112,2489112,2489054,58,0,utRho10
1794,ycgV,2512222,2512222,2511904,318,1790,utRho10
1795,ycgX,2426568,2426568,2426214,354,30926,utRho10
1796,ycgY,2490166,2490320,2490166,154,1058,utRho10
1797,ycgZ,2431504,2431578,2431504,74,106,utRho10
1798,ychE,2596904,2597196,2596904,292,70,utRho10
1799,ychF,2515764,2515764,2515624,140,0,utRho10
1800,ychH,2517476,2517582,2517476,106,1498,utRho10
1801,ychJ,2578354,2578354,2578264,90,300,utRho10
1802,ychN,2547310,2547310,2547198,112,288,utRho10
1803,ychO,2547520,2547850,2547520,330,690,utRho10
1804,ychQ,2533798,2533848,2533798,50,54,utRho10
1805,yciA,2624828,2624828,2624492,336,344,utRho10
1806,yciB,2626110,2626110,2625780,330,1822,utRho10
1807,yciC,2627396,2627396,2627326,70,4,utRho10
1808,yciE,2630794,2630794,2630448,346,138,utRho10
1809,yciG,5264368,5264368,5264140,228,36,utRho10
1810,yciI,2621784,2621784,2621730,54,50,utRho10
1811,yciN,2661606,2661606,2661336,270,80,utRho10
1812,yciS,2680270,2680486,2680270,216,68,utRho10
1813,yciT,2689088,2689088,2688692,396,1214,utRho10
1814,yciU,2614718,2614718,2614300,418,2922,utRho10
1815,yciV,2646376,2646440,2646376,64,0,utRho10
1816,yciW,2700472,2700472,2700214,258,3170,utRho10
1817,yciZ,2689276,2689276,2689218,58,1272,utRho10
1818,ycjD,2703792,2703792,2703520,272,96,utRho10
1819,ycjG,2777748,2777860,2777748,112,332,utRho10
1820,ycjM,2740006,2740432,2740006,426,110,utRho10
1821,ycjW,2767982,2767982,2767922,60,12,utRho10
1822,ycjX,2768138,2768234,2768138,96,4,utRho10
1823,ycjY,5568288,5568288,5567460,828,1492,utRho10
1824,ydaE,2836438,2836438,2836016,422,896,utRho10
1825,ydaN,2816048,2816100,2816048,52,228,utRho10
1826,ydaS,2840340,2840730,2840340,390,114,utRho10
1827,ydbC,2948376,2948442,2948376,66,74,utRho10
1828,ydbD,2950132,2950288,2950132,156,0,utRho10
1829,ydbH,2885800,2886102,2885800,302,162,utRho10
1830,ydbJ,2881712,2882116,2881712,404,410,utRho10
1831,ydbK,2881692,2881692,2881568,124,48,utRho10
1832,ydcA,2983294,2983354,2983294,60,152,utRho10
1833,ydcF,2974404,2974470,2974404,66,0,utRho10
1834,ydcI,2990268,2990268,2990142,126,0,utRho10
1835,ydcJ,2990266,2990576,2990266,310,62,utRho10
1836,ydcK,3001280,3001280,3000898,382,4,utRho10
1837,ydcL,3004646,3004914,3004646,268,12,utRho10
1838,ydcN,3012308,3012344,3012308,36,390,utRho10
1839,ydcP,3013508,3013562,3013508,54,184,utRho10
1840,ydcR,3019956,3020006,3019956,50,0,utRho10
1841,ydcS,3022906,3023308,3022906,402,122,utRho10
1842,ydcX,3034442,3034778,3034442,336,498,utRho10
1843,ydcY,3035220,3035296,3035220,76,0,utRho10
1844,ydcZ,3036750,3036750,3036662,88,1270,utRho10
1845,yddB,3155332,3155332,3155238,94,0,utRho10
1846,yddE,3071738,3071738,3071716,22,0,utRho10
1847,yddG,3094410,3094410,3094338,72,0,utRho10
1848,yddJ,3089732,3089732,3089438,294,222,utRho10
1849,yddW,3137704,3137704,3137646,58,48,utRho10
1850,ydeA,3233910,3234056,3233910,146,232,utRho10
1851,ydeE,3242528,3242664,3242528,136,86,utRho10
1852,ydeI,3249118,3249118,3248994,124,66,utRho10
1853,ydeJ,3249376,3249546,3249376,170,0,utRho10
1854,ydeN,3165458,3165458,3165048,410,74,utRho10
1855,ydeP,3173328,3173328,3172972,356,172,utRho10
1856,ydeR,3176596,3176596,3176592,4,0,utRho10
1857,ydfA,3296872,3297016,3296872,144,46,utRho10
1858,ydfG,3254982,3255034,3254982,52,174,utRho10
1859,ydfH,3256652,3256704,3256652,52,80,utRho10
1860,ydfK,3265446,3266144,3265446,698,18650,utRho10
1861,ydgA,3379588,3379704,3379588,116,14,utRho10
1862,ydgC,3364124,3364124,3364060,64,150,utRho10
1863,ydgD,3343906,3343920,3343906,14,226,utRho10
1864,ydgH,3356754,3356854,3356754,100,0,utRho10
1865,ydgJ,3408798,3408798,3408616,182,368,utRho10
1866,ydgK,3410414,3410500,3410414,86,272,utRho10
1867,ydhB,3479618,3479618,3479596,22,0,utRho10
1868,ydhC,3479698,3479822,3479698,124,22,utRho10
1869,ydhF,3451310,3451310,3451264,46,0,utRho10
1870,ydhI,3441996,3442050,3441996,54,20,utRho10
1871,ydhL,3451864,3451864,3451840,24,264,utRho10
1872,ydhQ,3492404,3492404,3492254,150,36,utRho10
1873,ydhS,3494136,3494262,3494136,126,2780,utRho10
1874,ydhT,3499138,3499138,3499118,20,190,utRho10
1875,ydhY,3509284,3509284,3508954,330,142,utRho10
1876,ydhZ,3510418,3510418,3510282,136,198,utRho10
1877,ydiE,3579206,3579226,3579206,20,0,utRho10
1878,ydiH,3530582,3530582,3530406,176,0,utRho10
1879,ydiM,3541852,3542142,3541852,290,90,utRho10
1880,ydiN,3544818,3545024,3544818,206,0,utRho10
1881,ydiP,3558656,3558656,3558602,54,24,utRho10
1882,ydiU,3582508,3582508,3582488,20,178,utRho10
1883,ydiV,3584174,3584174,3584040,134,24,utRho10
1884,ydiY,3612500,3612500,3612166,334,74,utRho10
1885,ydjA,3697400,3697400,3697352,48,112,utRho10
1886,ydjE,3708082,3708082,3707958,124,86,utRho10
1887,ydjF,3709848,3709848,3709708,140,62,utRho10
1888,ydjM,3620340,3620422,3620340,82,0,utRho10
1889,ydjO,3626696,3626696,3626288,408,216,utRho10
1890,ydjX,3666434,3666802,3666434,368,2062,utRho10
1891,yeaE,3731448,3731448,3731272,176,78,utRho10
1892,yeaG,3733530,3733816,3733530,286,40,utRho10
1893,yeaI,3740486,3740770,3740486,284,72,utRho10
1894,yeaJ,3743874,3744082,3743874,208,156,utRho10
1895,yeaL,3748646,3748704,3748646,58,180,utRho10
1896,yeaM,3751296,3751296,3751152,144,0,utRho10
1897,yeaN,3750926,3751346,3750926,420,74,utRho10
1898,yeaO,3753554,3753818,3753554,264,38,utRho10
1899,yeaP,3755314,3755430,3755314,116,730,utRho10
1900,yeaQ,3758780,3758780,3758510,270,578,utRho10
1901,yeaR,3759988,3759988,3759896,92,74,utRho10
1902,yeaY,3781122,3781122,3781064,58,50,utRho10
1903,yebB,3892220,3892502,3892220,282,896,utRho10
1904,yebC,3896370,3896370,3896302,68,54,utRho10
1905,yebE,3859464,3859464,3859414,50,430,utRho10
1906,yebG,3861530,3861530,3861494,36,184,utRho10
1907,yebK,3873180,3873304,3873180,124,66,utRho10
1908,yebQ,3820314,3820552,3820314,238,0,utRho10
1909,yebS,3832238,3832516,3832238,278,16,utRho10
1910,yebV,3843430,3843560,3843430,130,0,utRho10
1911,yebW,3843914,3844242,3843914,328,1964,utRho10
1912,yecC,3995646,3995646,3995628,18,2,utRho10
1913,yecD,3901272,3901664,3901272,392,80,utRho10
1914,yecF,3991434,3991636,3991434,202,328,utRho10
1915,yecH,3979304,3979304,3978980,324,1166,utRho10
1916,yecJ,3975604,3975604,3975516,88,0,utRho10
1917,yecM,3919968,3919968,3919692,276,164,utRho10
1918,yecR,3976400,3976444,3976400,44,100,utRho10
1919,yecT,3923862,3923944,3923862,82,86,utRho10
1920,yedD,4016522,4016522,4016180,342,368,utRho10
1921,yedE,4016310,4016554,4016310,244,360,utRho10
1922,yedI,4058922,4058922,4058732,190,104,utRho10
1923,yedJ,4066446,4066446,4066158,288,56,utRho10
1924,yedV,4076404,4076404,4076304,100,242,utRho10
1925,yedX,4077680,4077912,4077680,232,0,utRho10
1926,yedY,4078572,4078956,4078572,384,854,utRho10
1927,yeeA,4161322,4161322,4161182,140,0,utRho10
1928,yeeE,4171104,4171104,4171050,54,154,utRho10
1929,yeeJ,4089526,4089822,4089526,296,5084,utRho10
1930,yeeN,4113508,4113716,4113508,208,2014,utRho10
1931,yeeO,4119444,4119444,4119692,248,0,utRho10
1932,yeeX,4158834,4158834,4158722,112,428,utRho10
1933,yeeZ,4178422,4178422,4178256,166,0,utRho10
1934,yefM,4179466,4179466,4179426,40,0,utRho10
1935,yegD,4295288,4295348,4295288,60,174,utRho10
1936,yegH,4275726,4275804,4275726,78,364,utRho10
1937,yegI,4302154,4302154,4301970,184,56,utRho10
1938,yegJ,4302032,4302370,4302032,338,164,utRho10
1939,yegQ,4331182,4331336,4331182,154,562,utRho10
1940,yegR,4336698,4336698,4336612,86,308,utRho10
1941,yegS,4337086,4337424,4337086,338,418,utRho10
1942,yegT,4357562,4357642,4357562,80,390,utRho10
1943,yegX,4367640,4367640,4367302,338,248,utRho10
1944,yehA,4376944,4376944,4376828,116,44,utRho10
1945,yehE,4385818,4385818,4385592,226,24,utRho10
1946,yehK,4407568,4407944,4407568,376,0,utRho10
1947,yehL,4408804,4409192,4408804,388,120,utRho10
1948,yeiB,4486146,4486146,4485934,212,42,utRho10
1949,yeiE,4499422,4499422,4499236,186,0,utRho10
1950,yeiG,4487776,4487820,4487776,44,110,utRho10
1951,yeiH,4499332,4499434,4499332,102,0,utRho10
1952,yeiI,4503306,4503400,4503306,94,278,utRho10
1953,yeiL,4510580,4510710,4510580,130,0,utRho10
1954,yeiP,4530834,4530900,4530834,66,584,utRho10
1955,yeiQ,4532328,4532490,4532328,162,650,utRho10
1956,yeiR,4535484,4535658,4535484,174,178,utRho10
1957,yeiW,4530840,4530840,4530590,250,718,utRho10
1958,yejA,4544624,4544728,4544624,104,30,utRho10
1959,yejG,4556892,4556892,4556474,418,6796,utRho10
1960,yejH,4561244,4561264,4561244,20,0,utRho10
1961,yejK,4568218,4568218,4567894,324,36,utRho10
1962,yejO,4578352,4578352,4577800,552,560,utRho10
1963,yfaD,4713380,4713808,4713380,428,576,utRho10
1964,yfaE,4696676,4697028,4696676,352,1104,utRho10
1965,yfaL,4688568,4688568,4688338,230,44,utRho10
1966,yfaP,4656398,4656398,4656286,112,0,utRho10
1967,yfaU,4717892,4717892,4717690,202,0,utRho10
1968,yfaY,4727310,4727310,4727266,44,42,utRho10
1969,yfaZ,4728744,4728744,4728550,194,2,utRho10
1970,yfbK,4771810,4771810,4771444,366,612,utRho10
1971,yfbL,4771500,4771720,4771500,220,388,utRho10
1972,yfbN,4777174,4777174,4776852,322,128,utRho10
1973,yfbO,4776916,4777162,4776916,246,104,utRho10
1974,yfbP,4777990,4778232,4777990,242,15724,utRho10
1975,yfbR,4817662,4817724,4817662,62,74,utRho10
1976,yfcI,4847424,4847424,4847078,346,1358,utRho10
1977,yfcJ,4880482,4880482,4880240,242,874,utRho10
1978,yfcL,4888502,4888502,4888338,164,88,utRho10
1979,yfcV,4911642,4911642,4911292,350,180,utRho10
1980,yfcZ,4921958,4921958,4921868,90,0,utRho10
1981,yfdF,4925604,4926024,4925604,420,17600,utRho10
1982,yfdG,4935474,4935710,4935474,236,0,utRho10
1983,yfdP,4946844,4947040,4946844,196,26,utRho10
1984,yfdX,4988866,4988866,4988804,62,28,utRho10
1985,yfdY,4990672,4990672,4990584,88,0,utRho10
1986,yfeA,5035784,5035784,5035664,120,38214,utRho10
1987,yfeC,5036668,5036934,5036668,266,196,utRho10
1988,yfeH,5053818,5053892,5053818,74,138,utRho10
1989,yfeK,5074630,5074684,5074630,54,0,utRho10
1990,yfeO,5018906,5019260,5018906,354,300,utRho10
1991,yfeR,5054078,5054078,5053712,366,140,utRho10
1992,yfeX,5101356,5101356,5101090,266,16,utRho10
1993,yfeY,5102486,5102486,5102432,54,0,utRho10
1994,yfeZ,5103842,5103842,5103452,390,0,utRho10
1995,yffO,5123804,5124222,5123804,418,220,utRho10
1996,yffQ,5126778,5127154,5126778,376,348,utRho10
1997,yffS,5128800,5128986,5128800,186,290,utRho10
1998,yfgC,5232052,5232188,5232052,136,114,utRho10
1999,yfgF,5258062,5258062,5257876,186,1026,utRho10
2000,yfgG,5258170,5258580,5258170,410,1184,utRho10
2001,yfgH,5259344,5259584,5259344,240,136,utRho10
2002,yfgM,5278866,5278866,5278566,300,530,utRho10
2003,yfhH,5397414,5397518,5397414,104,182,utRho10
2004,yfhM,5304648,5304648,5304574,74,48,utRho10
2005,yfhR,5328408,5328726,5328408,318,11578,utRho10
2006,yfiC,5425610,5425610,5425528,82,72,utRho10
2007,yfiE,5430688,5430688,5430640,48,1394,utRho10
2008,yfiL,5482630,5482720,5482630,90,0,utRho10
2009,yfiM,5448066,5448358,5448066,292,21592,utRho10
2010,yfiR,5483354,5483750,5483354,396,310,utRho10
2011,yfjH,5517326,5517326,5517200,126,64,utRho10
2012,yfjI,5517710,5517970,5517710,260,30,utRho10
2013,yfjJ,5521014,5521094,5521014,80,36,utRho10
2014,yfjM,5531970,5531970,5531552,418,3848,utRho10
2015,yfjP,5535080,5535420,5535080,340,1682,utRho10
2016,yfjW,5546570,5546636,5546570,66,0,utRho10
2017,yfjX,5551776,5551838,5551776,62,0,utRho10
2018,ygaC,5601180,5601180,5599988,1192,686,utRho10
2019,ygaM,5600242,5600292,5600242,50,120,utRho10
2020,ygaU,5593628,5593628,5593572,56,134,utRho10
2021,ygaZ,5619190,5619234,5619190,44,350,utRho10
2022,ygbA,5713656,5713656,5713612,44,88,utRho10
2023,ygbE,5746784,5746784,5746674,110,72,utRho10
2024,ygbI,5722882,5722882,5722528,354,442,utRho10
2025,ygbK,5724394,5724670,5724394,276,392,utRho10
2026,ygbL,5727074,5727186,5727074,112,78,utRho10
2027,ygbN,5729814,5730202,5729814,388,986,utRho10
2028,ygcG,5811210,5811422,5811210,212,94,utRho10
2029,ygcN,5785144,5785314,5785144,170,206,utRho10
2030,ygcU,5799214,5799214,5798836,378,22,utRho10
2031,ygcW,5800942,5800942,5800546,396,0,utRho10
2032,ygdD,5883442,5883442,5883262,180,34,utRho10
2033,ygdG,5861746,5861930,5861746,184,634,utRho10
2034,ygdI,5886526,5886526,5886290,236,508,utRho10
2035,ygdQ,5940784,5940840,5940784,56,68,utRho10
2036,ygdR,5942494,5942542,5942494,48,106,utRho10
2037,ygeA,5961606,5961606,5961270,336,78,utRho10
2038,ygeH,5983758,5984188,5983758,430,504,utRho10
2039,ygeI,5987162,5987276,5987162,114,5286,utRho10
2040,ygeR,6000078,6000078,5999782,296,406,utRho10
2041,ygeV,6011694,6011694,6011572,122,0,utRho10
2042,ygeW,6012234,6012524,6012234,290,600,utRho10
2043,ygfB,6110946,6110946,6110888,58,0,utRho10
2044,ygfK,6031984,6032120,6031984,136,0,utRho10
2045,ygfS,6058328,6058328,6058024,304,0,utRho10
2046,ygfZ,6082564,6082626,6082564,62,522,utRho10
2047,yggC,6149512,6149512,6149378,134,162,utRho10
2048,yggE,6136370,6136370,6136160,210,80,utRho10
2049,yggI,6179176,6179510,6179176,334,768,utRho10
2050,yggL,6204508,6204508,6204266,242,192,utRho10
2051,yggM,6199514,6199514,6199130,384,354,utRho10
2052,yggN,6203596,6203596,6203246,350,384,utRho10
2053,yggX,18623958,18624558,18623958,600,672,utRho10
2054,yghA,6298966,6299324,6298966,358,48,utRho10
2055,yghB,6307058,6307126,6307058,68,136,utRho10
2056,yghD,6222614,6222614,6222252,362,1396,utRho10
2057,yghF,6225798,6225798,6225840,42,312,utRho10
2058,yghJ,6238640,6238640,6238224,416,2,utRho10
2059,yghQ,6265186,6265186,6264816,370,366,utRho10
2060,yghT,6267830,6268262,6267830,432,396,utRho10
2061,yghU,6277400,6277454,6277400,54,82,utRho10
2062,yghW,6293506,6293506,6293474,32,46,utRho10
2063,yghZ,6295562,6295794,6295562,232,440,utRho10
2064,ygiD,6365122,6365122,6364868,254,7874,utRho10
2065,ygiH,6409066,6409388,6409066,322,176,utRho10
2066,ygiL,6370622,6370828,6370622,206,276,utRho10
2067,ygiM,6402084,6402414,6402084,330,228,utRho10
2068,ygiN,6346156,6346284,6346156,128,858,utRho10
2069,ygiQ,6322620,6322620,6322292,328,1426,utRho10
2070,ygiS,6335462,6335462,6335436,26,0,utRho10
2071,ygiV,6338582,6338582,6338462,120,134,utRho10
2072,ygiW,6339774,6339774,6339352,422,1372,utRho10
2073,ygiZ,6344506,6344506,6344422,84,0,utRho10
2074,ygjH,6442528,6442528,6442494,34,22,utRho10
2075,ygjI,6452140,6452468,6452140,328,42,utRho10
2076,ygjQ,6472730,6473080,6472730,350,866,utRho10
2077,ygjR,6474564,6474586,6474564,22,0,utRho10
2078,ygjV,6483638,6483638,6483488,150,6,utRho10
2079,yhaB,6535632,6535708,6535632,76,0,utRho10
2080,yhaH,6504498,6504608,6504498,110,244,utRho10
2081,yhaI,6505400,6505822,6505400,422,360,utRho10
2082,yhaJ,6508560,6508560,6508428,132,36,utRho10
2083,yhaK,6508538,6508638,6508538,100,54,utRho10
2084,yhbQ,6599878,6599932,6599878,54,320,utRho10
2085,yhbT,6602736,6602736,6602552,184,212,utRho10
2086,yhbU,6602558,6602970,6602558,412,224,utRho10
2087,yhbX,6643302,6643302,6643226,76,0,utRho10
2088,yhbY,6655518,6655580,6655518,62,490,utRho10
2089,yhcA,6723956,6724224,6723956,268,112,utRho10
2090,yhcB,6760364,6760382,6760364,18,0,utRho10
2091,yhcC,6708470,6708470,6708100,370,622,utRho10
2092,yhcF,6733440,6733852,6733440,412,518,utRho10
2093,yhcH,6739124,6739124,6738956,168,540,utRho10
2094,yhcM,6760312,6760312,6759994,318,198,utRho10
2095,yhcN,6770812,6771076,6770812,264,244,utRho10
2096,yhcO,6772606,6772606,6772258,348,0,utRho10
2097,yhdH,6806560,6806968,6806560,408,296,utRho10
2098,yhdJ,6823234,6823306,6823234,72,0,utRho10
2099,yhdN,6879092,6879092,6879018,74,2930,utRho10
2100,yhdT,6814702,6814750,6814702,48,570,utRho10
2101,yhdU,6824994,6825242,6824994,248,974,utRho10
2102,yhdV,6836392,6836780,6836392,388,808,utRho10
2103,yhdW,6837944,6838298,6837944,354,0,utRho10
2104,yheO,6953082,6953082,6952880,202,384,utRho10
2105,yheV,6957970,6957970,6957584,386,82,utRho10
2106,yhfA,6971902,6971902,6971636,266,834,utRho10
2107,yhfG,6983294,6983294,6983240,54,806,utRho10
2108,yhfL,6998622,6998896,6998622,274,456,utRho10
2109,yhfY,7023244,7023244,7022844,400,150,utRho10
2110,yhgA,7086294,7086334,7086294,40,30,utRho10
2111,yhgE,7065176,7065176,7064878,298,216,utRho10
2112,yhgF,7074352,7074770,7074352,418,4910,utRho10
2113,yhhA,7173458,7173886,7173458,428,302,utRho10
2114,yhhI,7248346,7248756,7248346,410,80,utRho10
2115,yhhJ,7253696,7253696,7253606,90,38,utRho10
2116,yhhM,7211588,7211588,7211220,368,792,utRho10
2117,yhhN,7211150,7211502,7211150,352,540,utRho10
2118,yhhQ,7218238,7218434,7218238,196,544,utRho10
2119,yhhT,7223682,7223730,7223682,48,114,utRho10
2120,yhhX,7162032,7162032,7161610,422,94,utRho10
2121,yhhY,7162222,7162276,7162222,54,68,utRho10
2122,yhhZ,7163516,7163726,7163516,210,276,utRho10
2123,yhiD,7312220,7312220,7311804,416,3914,utRho10
2124,yhiJ,7265190,7265190,7265180,10,84,utRho10
2125,yhiM,7269270,7269682,7269270,412,1970,utRho10
2126,yhiN,7275000,7275000,7274820,180,102,utRho10
2127,yhjA,7338522,7338522,7338376,146,62,utRho10
2128,yhjB,7344090,7344090,7343788,302,1068,utRho10
2129,yhjC,7344272,7344684,7344272,412,240,utRho10
2130,yhjD,7346660,7346724,7346660,64,170,utRho10
2131,yhjE,7349274,7349572,7349274,298,1012,utRho10
2132,yhjG,7356824,7356824,7356730,94,62,utRho10
2133,yhjH,7358458,7358458,7358374,84,1182,utRho10
2134,yhjJ,7364032,7364032,7363880,152,158,utRho10
2135,yhjK,7371296,7371296,7371158,138,118,utRho10
2136,yhjR,7392750,7392750,7392370,380,0,utRho10
2137,yhjV,7400796,7401126,7400796,330,2316,utRho10
2138,yhjX,7424194,7424194,7424014,180,216,utRho10
2139,yhjY,7425966,7425966,7425868,98,128,utRho10
2140,yiaB,7455654,7455654,7455496,158,52,utRho10
2141,yiaD,7432712,7433094,7432712,382,978,utRho10
2142,yiaF,7438194,7438194,7438088,106,484,utRho10
2143,yiaG,7438862,7438956,7438862,94,452,utRho10
2144,yiaJ,7485236,7485236,7485064,172,930,utRho10
2145,yiaK,7485348,7485466,7485348,118,48,utRho10
2146,yiaT,7503924,7503924,7503736,188,6,utRho10
2147,yiaU,7503792,7503984,7503792,192,6,utRho10
2148,yiaY,7515856,7515856,7515654,202,306,utRho10
2149,yibF,7523950,7523950,7523910,40,12,utRho10
2150,yibG,7536128,7536354,7536128,226,22,utRho10
2151,yibL,7553194,7553330,7553194,136,366,utRho10
2152,yibN,7570112,7570112,7570030,82,440,utRho10
2153,yibT,7552848,7552848,7552760,88,1072,utRho10
2154,yicC,7633290,7633352,7633290,62,0,utRho10
2155,yicH,7660862,7660914,7660862,52,136,utRho10
2156,yicJ,7673328,7673328,7671858,1470,9728,utRho10
2157,yicN,7685018,7685018,7684804,214,140,utRho10
2158,yicO,7687914,7687914,7687578,336,252,utRho10
2159,yicR,15250308,15250308,15250236,72,0,utRho10
2160,yidB,7755230,7755230,7754930,300,124,utRho10
2161,yidE,7732780,7732780,7732546,234,52,utRho10
2162,yidF,7711580,7711580,7711222,358,272,utRho10
2163,yidQ,7735088,7735456,7735088,368,1018,utRho10
2164,yidR,7738824,7738824,7738618,206,40,utRho10
2165,yieE,7787658,7787738,7787658,80,166,utRho10
2166,yieH,7793314,7793548,7793314,234,290,utRho10
2167,yieK,7798928,7798928,7798786,142,0,utRho10
2168,yifB,7900350,7900350,7899998,352,332,utRho10
2169,yifL,7988984,7989044,7988984,60,3398,utRho10
2170,yigF,8005750,8005750,8005598,152,19128,utRho10
2171,yigI,8009448,8009448,8009394,54,282,utRho10
2172,yigM,8022100,8022152,8022100,52,96,utRho10
2173,yihA,8101970,8101970,8101458,512,86,utRho10
2174,yihD,8084098,8084138,8084098,40,104,utRho10
2175,yihF,8088110,8088398,8088110,288,302,utRho10
2176,yihG,8093304,8093304,8093204,100,42,utRho10
2177,yihI,8102616,8102694,8102616,78,0,utRho10
2178,yihL,8120506,8120894,8120506,388,86,utRho10
2179,yihN,8124332,8124494,8124332,162,82,utRho10
2180,yihO,8131942,8131942,8131532,410,0,utRho10
2181,yihQ,8138892,8138892,8138552,340,116,utRho10
2182,yihV,8147064,8147478,8147064,414,102,utRho10
2183,yihX,8151096,8151106,8151096,10,32,utRho10
2184,yiiE,8158192,8158582,8158192,390,608,utRho10
2185,yiiF,8159124,8159502,8159124,378,906,utRho10
2186,yiiG,8173762,8174004,8173762,242,0,utRho10
2187,yiiM,8205506,8205644,8205506,138,1402,utRho10
2188,yiiQ,8224624,8224624,8224428,196,0,utRho10
2189,yiiS,8225738,8225934,8225738,196,304,utRho10
2190,yijE,8272178,8272216,8272178,38,44,utRho10
2191,yijF,8275728,8275728,8275314,414,494,utRho10
2192,yijO,8296858,8296858,8296634,224,330,utRho10
2193,yjaA,8426240,8426468,8426240,228,109644,utRho10
2194,yjaB,8428312,8428312,8428246,66,390,utRho10
2195,yjaG,8398746,8399008,8398746,262,1400,utRho10
2196,yjaH,8401022,8401132,8401022,110,74,utRho10
2197,yjaZ,8379506,8379572,8379506,66,0,utRho10
2198,yjbB,8455204,8455462,8455204,258,48,utRho10
2199,yjbE,16943432,16943624,16943432,192,100,utRho10
2200,yjbL,8520318,8520642,8520318,324,278,utRho10
2201,yjbQ,8540428,8540476,8540428,48,104,utRho10
2202,yjcB,8550328,8550328,8550082,246,294,utRho10
2203,yjcC,8550836,8550942,8550836,106,266,utRho10
2204,yjcD,8556628,8556958,8556628,330,332,utRho10
2205,yjcE,8559658,8559960,8559658,302,0,utRho10
2206,yjcF,8566212,8566212,8566150,62,0,utRho10
2207,yjcO,8594660,8594660,8594250,410,34,utRho10
2208,yjdA,8654128,8654270,8654128,142,30,utRho10
2209,yjdC,8726660,8726660,8726616,44,2,utRho10
2210,yjdK,8704780,8705168,8704780,388,548,utRho10
2211,yjdL,8713034,8713034,8712822,212,80,utRho10
2212,yjdM,8653672,8653672,8653468,204,296,utRho10
2213,yjeF,8787354,8788132,8787354,778,326438,utRho10
2214,yjeI,8745522,8745618,8745522,96,0,utRho10
2215,yjeJ,8748806,8748806,8748468,338,1382,utRho10
2216,yjeV,8785472,8785784,8785472,312,8286,utRho10
2217,yjfP,8833512,8833904,8833512,392,178,utRho10
2218,yjfY,8849656,8849656,8849582,74,0,utRho10
2219,yjfZ,8855052,8855052,8854844,208,546,utRho10
2220,yjgA,8916162,8916162,8915730,432,564,utRho10
2221,yjgL,8950802,8950874,8950802,72,0,utRho10
2222,yjgM,8959342,8959342,8959074,268,240,utRho10
2223,yjgN,8959132,8959460,8959132,328,192,utRho10
2224,yjgR,8980170,8980170,8980126,44,392,utRho10
2225,yjgZ,9002116,9002520,9002116,404,10870,utRho10
2226,yjhB,9007764,9008116,9007764,352,362,utRho10
2227,yjhG,9048452,9048452,9048188,264,1944,utRho10
2228,yjhU,9041080,9041080,9040648,432,362,utRho10
2229,yjiA,9178096,9178096,9177730,366,286,utRho10
2230,yjiJ,9125364,9125364,9125350,14,0,utRho10
2231,yjiK,9127270,9127270,9127422,152,196,utRho10
2232,yjiL,9129604,9129604,9129378,226,18,utRho10
2233,yjiS,9143410,9143502,9143410,92,228,utRho10
2234,yjiY,9182734,9182734,9182558,176,490,utRho10
2235,yjjA,9200674,9200674,9200378,296,1674,utRho10
2236,yjjB,18408708,18408708,18407800,908,1236,utRho10
2237,yjjJ,9243314,9243538,9243314,224,0,utRho10
2238,yjjK,9261132,9261132,9261044,88,402,utRho10
2239,yjjL,9189764,9189764,9189444,320,52,utRho10
2240,yjjM,9191894,9191894,9191702,192,490,utRho10
2241,yjjP,9206068,9206068,9205716,352,25040,utRho10
2242,yjjQ,9206638,9206954,9206638,316,19526,utRho10
2243,yjjX,9267798,9267798,9267490,308,1356,utRho10
2244,yjjY,9280716,9280804,9280716,88,300,utRho10
2245,yjjZ,9211554,9211608,9211554,54,78786,utRho10
2246,yjtD,9281676,9281884,9281676,208,46,utRho10
2247,ykfB,532454,532454,532174,280,8862,utRho10
2248,ykfI,527636,527636,527338,298,1664,utRho10
2249,ykgB,637050,637050,636638,412,126,utRho10
2250,ykgC,640430,640430,640002,428,30,utRho10
2251,ykgD,640232,640454,640232,222,30,utRho10
2252,ykgE,642962,643216,642962,254,550,utRho10
2253,ykgJ,608524,608524,608364,160,130,utRho10
2254,ykgL,623878,624224,623878,346,66,utRho10
2255,ykgM,625610,625610,625554,56,0,utRho10
2256,ykgR,626570,626570,626484,86,38,utRho10
2257,ylaC,958576,958576,958502,74,3448,utRho10
2258,yliE,1745938,1745958,1745938,20,0,utRho10
2259,ymcE,2103660,2103694,2103660,34,78,utRho10
2260,ymdA,2210450,2210828,2210450,378,126,utRho10
2261,ymdB,2211428,2211640,2211428,212,116,utRho10
2262,ymfD,2395322,2395322,2395064,258,1368,utRho10
2263,ymfI,2402880,2402994,2402880,114,50,utRho10
2264,ymfJ,2404518,2404518,2404168,350,132,utRho10
2265,ymfK,2406176,2406176,2405866,310,168,utRho10
2266,ymfT,2405766,2406048,2405766,282,178,utRho10
2267,ymgE,2489110,2489456,2489110,346,1180,utRho10
2268,ymgF,2437628,2437966,2437628,338,370,utRho10
2269,ymiA,2670112,2670320,2670112,208,172,utRho10
2270,ymjA,2715620,2715620,2715336,284,564,utRho10
2271,ynaI,2791946,2791946,2791844,102,50,utRho10
2272,ynaK,2850438,2850754,2850438,316,40,utRho10
2273,ynbA,2954924,2955242,2954924,318,0,utRho10
2274,yncD,3046552,3046552,3046130,422,60,utRho10
2275,yncE,3046454,3046614,3046454,160,34,utRho10
2276,yncG,3052456,3052494,3052456,38,128,utRho10
2277,yncL,3034492,3034492,3034388,104,220,utRho10
2278,yneE,3218364,3218364,3218044,320,116,utRho10
2279,yneF,3223748,3223748,3223708,40,2,utRho10
2280,yneJ,3229560,3229608,3229560,48,0,utRho10
2281,yneK,3231100,3231526,3231100,426,730,utRho10
2282,yneM,3245176,3245292,3245176,116,1422,utRho10
2283,ynfA,3311398,3311398,3311346,52,0,utRho10
2284,ynfB,3311418,3311616,3311418,198,162,utRho10
2285,ynfC,3315094,3315094,3314914,180,0,utRho10
2286,ynfD,3314828,3315130,3314828,302,16,utRho10
2287,ynfE,3316006,3316138,3316006,132,118,utRho10
2288,ynfK,3334670,3334670,3334438,232,70,utRho10
2289,ynfL,3339304,3339304,3339184,120,0,utRho10
2290,ynfM,3339260,3339398,3339260,138,18,utRho10
2291,ynfN,3276598,3276598,3276218,380,76,utRho10
2292,ynfO,3273454,3273512,3273454,58,330,utRho10
2293,ynhG,3517890,3517890,3517450,440,94,utRho10
2294,yniA,3615158,3615592,3615158,434,182,utRho10
2295,yniB,3618526,3618526,3618466,60,92,utRho10
2296,yniC,3618652,3618760,3618652,108,42,utRho10
2297,yniD,3610202,3610330,3610202,128,102,utRho10
2298,ynjE,3678880,3678934,3678880,54,44,utRho10
2299,ynjF,3683222,3683222,3682806,416,524,utRho10
2300,ynjH,3684376,3684376,3684270,106,144,utRho10
2301,ynjI,3690022,3690022,3689742,280,410,utRho10
2302,yoaB,3786642,3786734,3786642,92,218,utRho10
2303,yoaC,3787932,3788146,3787932,214,256,utRho10
2304,yoaE,3803544,3803544,3803170,374,630,utRho10
2305,yoaF,3755444,3755444,3755064,380,938,utRho10
2306,yoaH,3789866,3789866,3789462,404,1070,utRho10
2307,yobB,3850418,3850880,3850418,462,906,utRho10
2308,yobF,3815586,3815586,3815182,404,820,utRho10
2309,yobH,3817800,3817850,3817800,50,534,utRho10
2310,yodB,4084352,4084736,4084352,384,2242,utRho10
2311,yodC,4057008,4057008,4056740,268,324,utRho10
2312,yohC,4451358,4451358,4451262,96,98,utRho10
2313,yohD,4451526,4451602,4451526,76,42,utRho10
2314,yohJ,4460986,4461248,4460986,262,156,utRho10
2315,yohO,4431172,4431314,4431172,142,182,utRho10
2316,yojI,4617282,4617282,4617230,52,0,utRho10
2317,ypdI,4988988,4989396,4988988,408,278,utRho10
2318,ypfG,5165786,5165786,5165554,232,120,utRho10
2319,ypfM,5182140,5182140,5181732,408,504,utRho10
2320,yphB,5349590,5349590,5349376,214,20,utRho10
2321,ypjA,5565644,5565644,5565452,192,114,utRho10
2322,ypjB,5569636,5569636,5568858,778,134,utRho10
2323,ypjD,5495860,5495774,5495860,86,0,utRho10
2324,yqaE,5594170,5594170,5594056,114,44,utRho10
2325,yqcA,5846100,5846100,5845968,132,126,utRho10
2326,yqcE,5800944,5801184,5800944,240,0,utRho10
2327,yqeC,6030468,6030468,6030114,354,24,utRho10
2328,yqeF,5971618,5971618,5971184,434,228,utRho10
2329,yqeG,5971438,5971694,5971438,256,132,utRho10
2330,yqeH,5975016,5975072,5975016,56,296,utRho10
2331,yqeI,5976688,5977004,5976688,316,156,utRho10
2332,yqeK,5981140,5981140,5980720,420,1992,utRho10
2333,yqfA,6086728,6086728,6086296,432,734,utRho10
2334,yqgA,6219042,6219106,6219042,64,0,utRho10
2335,yqgB,6172500,6172500,6172102,398,4332,utRho10
2336,yqgE,6185768,6185874,6185768,106,508,utRho10
2337,yqhA,6299150,6299150,6298942,208,48,utRho10
2338,yqhC,6310768,6310768,6310436,332,424,utRho10
2339,yqhD,6310604,6310710,6310604,106,218,utRho10
2340,yqhH,6316842,6317254,6316842,412,968,utRho10
2341,yqiC,6369662,6369680,6369662,18,66,utRho10
2342,yqiJ,6384108,6384416,6384108,308,312,utRho10
2343,yqjA,6495096,6495546,6495096,450,3912,utRho10
2344,yqjF,6500932,6501124,6500932,192,712,utRho10
2345,yqjG,6501948,6502048,6501948,100,18,utRho10
2346,yqjH,6433078,6433078,6432982,96,52,utRho10
2347,yqjI,6433506,6433558,6433506,52,0,utRho10
2348,yraH,6574552,6574852,6574552,300,96,utRho10
2349,yraP,6592144,6592818,6592144,674,1004,utRho10
2350,yraQ,6596414,6596414,6596276,138,0,utRho10
2351,yraR,6598024,6598024,6597692,332,266,utRho10
2352,yrbG,13360844,13361100,13360844,256,4,utRho10
2353,yrbL,6696842,6696904,6696842,62,1606,utRho10
2354,yrbN,6616172,6616172,6615866,306,18264,utRho10
2355,yrdB,6860176,6860176,6860046,130,132,utRho10
2356,yrfF,7052548,7052938,7052548,390,782,utRho10
2357,yrhB,7169440,7169518,7169440,78,36,utRho10
2358,ysaB,7451804,7451804,7451424,380,12,utRho10
2359,ysgA,8032686,8032686,8032338,348,310,utRho10
2360,ytfB,8857638,8857638,8857434,204,1610,utRho10
2361,ytfE,8864018,8864018,8863966,52,126,utRho10
2362,ytfF,8866296,8866296,8866130,166,350,utRho10
2363,ytfH,8868164,8868226,8868164,62,220,utRho10
2364,ytfI,8875234,8875414,8875234,180,236,utRho10
2365,ytfJ,8878572,8878572,8878524,48,176,utRho10
2366,ytfK,8879022,8879174,8879022,152,460,utRho10
2367,ytfL,8882642,8882642,8882430,212,178,utRho10
2368,ytfQ,8899634,8899924,8899634,290,226,utRho10
2369,ytjB,9249598,9249598,9249578,20,74,utRho10
2370,yzfA,8896588,8896588,8896490,98,62,utRho10
2371,zapA,6111102,6111224,6111102,122,1604,utRho10
2372,zapB,8236772,8237030,8236772,258,282,utRho10
2373,zapC,2011700,2011904,2011700,204,112,utRho10
2374,zinT,4082692,4082750,4082692,58,482,utRho10
2375,zipA,5062814,5062814,5062466,348,234,utRho10
2376,zitB,1569716,1569716,1569646,70,146,utRho10
2377,zntA,7212844,7212902,7212844,58,90,utRho10
2378,zntR,6878336,6878336,6878260,76,114,utRho10
2379,znuA,3885322,3885322,3885166,156,48,utRho10
2380,znuC,3885268,3885324,3885268,56,14,utRho10
2381,zraP,8403424,8403424,8403376,48,10,utRho10
2382,zraS,8403810,8403852,8403810,42,0,utRho10
2383,zupT,6364866,6365100,6364866,234,7626,utRho10
2384,zur,8520282,8520282,8520006,276,690,utRho10
2385,zwf,3872752,3872752,3872628,124,62,utRho10
0,C0343,2818676,2818728,2818676,52,0,utRho11
1,aaeB,6776526,6776526,6776376,150,0,utRho11
2,aaeR,6778762,6779040,6778762,278,272,utRho11
3,aaeX,6778860,6778860,6778674,186,384,utRho11
4,aat,1854920,1854920,1854864,56,0,utRho11
5,accA,416822,417242,416822,420,2354,utRho11
6,accB,6810280,6810872,6810280,592,9532,utRho11
7,accD,4868030,4868030,4867852,178,302,utRho11
8,aceB,8430804,8430956,8430804,152,4,utRho11
9,aceE,245938,246034,245938,96,422,utRho11
10,ackA,4826918,4826940,4826918,22,2480,utRho11
11,acnA,2670848,2671662,2670848,814,1204,utRho11
12,acnB,263038,263230,263038,192,1252,utRho11
13,acpP,2303148,2303230,2303148,82,634,utRho11
14,acpS,5402324,5402324,5401996,328,1082,utRho11
15,acrA,971396,971396,971238,158,112,utRho11
16,acrB,969370,969370,968806,564,3332,utRho11
17,acrD,5174950,5175190,5174950,240,80,utRho11
18,acrE,6827404,6827728,6827404,324,252,utRho11
19,acrR,971398,971522,971398,124,278,utRho11
20,acrZ,1589502,1589546,1589502,44,4,utRho11
21,acs,8575190,8575190,8574742,448,344,utRho11
22,actP,8569870,8569870,8569804,66,0,utRho11
23,ada,4620854,4620854,4620810,44,0,utRho11
24,add,3404404,3404466,3404404,62,72,utRho11
25,ade,7687802,7687928,7687802,126,0,utRho11
26,adhE,2596826,2596826,2596242,584,0,utRho11
27,adhP,3107988,3107988,3107676,312,1242,utRho11
28,adiA,8681112,8681112,8681042,70,26,utRho11
29,adiC,8674404,8674404,8674062,342,190,utRho11
30,adiY,8676084,8676084,8675858,226,0,utRho11
31,adk,994278,994350,994278,72,778,utRho11
32,adrA,807374,807406,807374,32,0,utRho11
33,aer,6438240,6438240,6438152,88,256,utRho11
34,aes,1000102,1000102,999946,156,470,utRho11
35,agaR,6557406,6557406,6557330,76,78,utRho11
36,agaS,6563778,6563952,6563778,174,0,utRho11
37,agp,2131118,2131170,2131118,52,0,utRho11
38,agrA,7296126,7296126,7296126,0,0,utRho11
39,agrB,7296588,7296588,7296588,0,0,utRho11
40,ahpC,1277386,1277890,1277386,504,538,utRho11
41,ahpF,1278004,1279506,1278004,1502,60174,utRho11
42,ahr,8992698,8992698,8992418,280,40,utRho11
43,aidB,8828494,8828550,8828494,56,64,utRho11
44,ais,4731512,4731512,4731240,272,0,utRho11
45,alaA,4814816,4815122,4814816,306,84,utRho11
46,alaC,4996798,4996798,4996590,208,0,utRho11
47,alaE,5598140,5598328,5598140,188,164,utRho11
48,alaS,5644180,5644180,5644022,158,2550,utRho11
49,alaW,5036612,5036612,5036462,150,4,utRho11
50,aldA,2976380,2976464,2976380,84,216,utRho11
51,aldB,7513070,7513070,7513022,48,196,utRho11
52,alkA,4295118,4295118,4295080,38,132,utRho11
53,alkB,4618890,4618890,4618682,208,0,utRho11
54,allA,1064780,1064902,1064780,122,0,utRho11
55,allD,1092822,1092822,1092726,96,0,utRho11
56,allE,1088112,1088112,1088092,20,56,utRho11
57,allS,1064600,1064600,1064442,158,0,utRho11
58,alr,8531178,8531564,8531178,386,4070,utRho11
59,alsE,8617334,8617334,8616956,378,270,utRho11
60,alsK,8615990,8615990,8615598,392,56,utRho11
61,alx,6476740,6477160,6476740,420,0,utRho11
62,amiA,5104482,5104704,5104482,222,0,utRho11
63,amiC,5898378,5898378,5898020,358,980,utRho11
64,amn,4110062,4110122,4110062,60,114,utRho11
65,ampC,8758006,8758006,8757888,118,0,utRho11
66,ampD,237362,237466,237362,104,60,utRho11
67,ampG,907372,907372,907090,282,866,utRho11
68,ampH,792726,792726,792574,152,68,utRho11
69,amyA,4012230,4012312,4012230,82,74,utRho11
70,anmK,3439346,3439346,3439204,142,0,utRho11
71,ansB,6201580,6201580,6201456,124,328,utRho11
72,ansP,3052040,3052040,3051960,80,100,utRho11
73,apaG,104068,104068,103212,856,5912,utRho11
74,apaH,102586,102586,102444,142,9998,utRho11
75,apbE,4623188,4623188,4623068,120,0,utRho11
76,appA,2081198,2081234,2081198,36,0,utRho11
77,appC,2075420,2075480,2075420,60,0,utRho11
78,appY,1167134,1167362,1167134,228,0,utRho11
79,apt,982620,982824,982620,204,338,utRho11
80,aqpZ,1832424,1832424,1832094,330,0,utRho11
81,araB,140150,140150,140096,54,0,utRho11
82,araC,140482,140774,140482,292,146,utRho11
83,araE,5964416,5964416,5964364,52,0,utRho11
84,araF,3972476,3972476,3972256,220,120,utRho11
85,araH,3967120,3967120,3967086,34,0,utRho11
86,araJ,825058,825058,824962,96,102,utRho11
87,arcA,9281602,9281602,9280612,990,2806,utRho11
88,arcB,6706098,6706098,6706050,48,0,utRho11
89,arcZ,6701154,6701154,6701154,0,0,utRho11
90,arfA,6877346,6877346,6877298,48,714,utRho11
91,argA,5898312,5898484,5898312,172,430,utRho11
92,argC,8309770,8310002,8309770,232,0,utRho11
93,argD,6980442,6980442,6980360,82,0,utRho11
94,argE,8310156,8310156,8309694,462,40,utRho11
95,argF,580680,580680,580610,70,0,utRho11
96,argG,6637124,6637274,6637124,150,286,utRho11
97,argI,8956688,8956688,8956622,66,0,utRho11
98,argO,6137672,6137672,6137616,56,586,utRho11
99,argP,6119460,6119506,6119460,46,110,utRho11
100,argR,6769204,6769406,6769204,202,148,utRho11
101,argS,3920002,3920124,3920002,122,0,utRho11
102,argT,4855698,4855698,4855582,116,64,utRho11
103,argU,1129406,1129446,1129406,40,0,utRho11
104,argW,4932616,4932618,4932616,2,0,utRho11
105,argX,7964728,7964750,7964728,22,4,utRho11
106,aroF,5482402,5482402,5482300,102,62,utRho11
107,aroG,1571182,1571266,1571182,84,150,utRho11
108,aroH,3576636,3576870,3576636,234,770,utRho11
109,aroK,7038760,7038760,7038128,632,1172,utRho11
110,aroL,812560,812810,812560,250,1154,utRho11
111,aroP,243342,243342,243102,240,0,utRho11
112,arpA,8445382,8445382,8444974,408,118,utRho11
113,arrS,7316108,7316108,7316108,0,0,utRho11
114,arsR,7297024,7297056,7297024,32,178,utRho11
115,artJ,1801252,1801252,1801150,102,0,utRho11
116,artP,1807686,1807686,1807468,218,516,utRho11
117,ascF,5678858,5679048,5678858,190,10,utRho11
118,ascG,5678574,5678574,5678528,46,46,utRho11
119,aslB,7965562,7965916,7965562,354,43942,utRho11
120,asnA,7854258,7854310,7854258,52,210,utRho11
121,asnB,1398444,1398444,1398354,90,1712,utRho11
122,asnC,23562186,23562186,23562018,168,258,utRho11
123,asnS,1978088,1978088,1977970,118,7936,utRho11
124,asnT,4089082,4089098,4089082,16,272,utRho11
125,asnU,4119690,4119702,4119690,12,2,utRho11
126,asnV,4124504,4124520,4124504,16,156,utRho11
127,aspA,17473728,17473728,17473308,420,0,utRho11
128,aspC,1971486,1971486,1971418,68,2158,utRho11
129,aspS,3901402,3901402,3901044,358,68,utRho11
130,aspT,7893560,7893744,7893560,184,121312,utRho11
131,aspV,473826,473862,473826,36,10,utRho11
132,asr,3342654,3342752,3342654,98,0,utRho11
133,astC,3664088,3664088,3663964,124,0,utRho11
134,astE,3654138,3654138,3653846,292,0,utRho11
135,atoD,4646824,4646894,4646824,70,364,utRho11
136,atpB,7844540,7844540,7844102,438,300,utRho11
137,atpC,7832118,7832118,7831944,174,2800,utRho11
138,atpI,7845050,7845050,7844880,170,52,utRho11
139,avtA,7479348,7479410,7479348,62,648,utRho11
140,azoR,2965982,2965982,2965720,262,118,utRho11
141,azuC,3976002,3976002,3975918,84,0,utRho11
142,bacA,6408350,6408350,6408262,88,234,utRho11
143,bamA,394052,395856,394052,1804,630,utRho11
144,bamB,5277950,5277950,5277304,646,1452,utRho11
145,bamC,5198028,5198028,5197730,298,622,utRho11
146,bamD,5471922,5472292,5471922,370,14118,utRho11
147,bamE,5506972,5507210,5506972,238,524,utRho11
148,basS,8666954,8666954,8666544,410,1844,utRho11
149,bax,7474468,7474468,7474354,114,0,utRho11
150,bcp,5200874,5200956,5200874,82,1682,utRho11
151,bcsB,7385346,7385346,7385214,132,56,utRho11
152,bcsE,7392644,7392916,7392644,272,0,utRho11
153,bdcA,8948128,8948128,8948106,22,728,utRho11
154,bdcR,8948192,8948248,8948192,56,184,utRho11
155,bdm,3112680,3112680,3112560,120,24,utRho11
156,betA,654522,654522,654494,28,210,utRho11
157,betI,658722,658722,658668,54,32,utRho11
158,betT,658842,658926,658842,84,44,utRho11
159,bfr,6933498,6933498,6933450,48,0,utRho11
160,bglG,23440182,23440182,23439402,780,0,utRho11
161,bglX,4444240,4444240,4443978,262,0,utRho11
162,bhsA,2337962,2338146,2337962,184,0,utRho11
163,bioA,1618584,1618584,1618514,70,52,utRho11
164,bioB,1618604,1618688,1618604,84,0,utRho11
165,bioH,7089716,7089716,7089688,28,80,utRho11
166,bisC,7433026,7433026,7432788,238,60,utRho11
167,blc,8755490,8755490,8755444,46,0,utRho11
168,blr,3409024,3409102,3409024,78,328,utRho11
169,bluF,2431226,2431226,2430950,276,814,utRho11
170,bluR,2428226,2428226,2428118,108,12,utRho11
171,bolA,908698,908944,908698,246,28,utRho11
172,borD,1157842,1157842,1157786,56,6,utRho11
173,brnQ,838976,839182,838976,206,732,utRho11
174,bssR,1756492,1756496,1756492,4,0,utRho11
175,bssS,2242116,2242116,2241910,206,304,utRho11
176,btuB,8326798,8327278,8326798,480,5698,utRho11
177,cadB,8720212,8720212,8720062,150,16,utRho11
178,cadC,8723926,8723926,8723868,58,8,utRho11
179,caiE,70998,70998,70742,256,0,utRho11
180,caiF,68436,68600,68436,164,2,utRho11
181,caiT,84074,84074,83862,212,50,utRho11
182,can,285406,285406,285340,66,98,utRho11
183,carA,59102,59302,59102,200,20,utRho11
184,carB,61550,61634,61550,84,50,utRho11
185,cas2,5757830,5757830,5757706,124,230,utRho11
186,casA,5768638,5768638,5768276,362,0,utRho11
187,cbl,4121882,4121882,4121828,54,1524,utRho11
188,cbpA,2128074,2128074,2127550,524,480,utRho11
189,cbrA,7738628,7738754,7738628,126,64,utRho11
190,cbrB,7794958,7795012,7794958,54,44,utRho11
191,ccmH,4585242,4585242,4584820,422,42,utRho11
192,cdaR,364894,364926,364894,32,0,utRho11
193,cdd,4463638,4463688,4463638,50,0,utRho11
194,cdh,8219814,8219860,8219814,46,224,utRho11
195,cdsA,391110,391354,391110,244,1492,utRho11
196,cedA,3627484,3627484,3627326,158,86,utRho11
197,cfa,3482402,3482826,3482402,424,136,utRho11
198,chaC,2544844,2544972,2544844,128,2,utRho11
199,chbB,3643452,3643452,3643238,214,0,utRho11
200,chbG,3634624,3634624,3634270,354,0,utRho11
201,cheW,3946924,3946924,3946678,246,2314,utRho11
202,chiA,6939792,6939792,6939706,86,0,utRho11
203,chiP,1416472,1416668,1416472,196,0,utRho11
204,cho,3646984,3647030,3646984,46,60,utRho11
205,chpS,8896804,8896894,8896804,90,224,utRho11
206,cirA,4493884,4493884,4493538,346,40,utRho11
207,citC,1304078,1304078,1303712,366,0,utRho11
208,citT,1293264,1293264,1293160,104,2,utRho11
209,clcA,350104,350214,350104,110,0,utRho11
210,clpA,1846160,1846528,1846160,368,28,utRho11
211,clpB,5468410,5468410,5468346,64,238,utRho11
212,clpP,913154,913354,913154,200,518,utRho11
213,clpS,1845500,1845826,1845500,326,0,utRho11
214,clpX,914404,914852,914404,448,1270,utRho11
215,clsA,2617346,2617346,2617290,56,150,utRho11
216,clsC,2212584,2212710,2212584,126,226,utRho11
217,cmk,1922330,1922402,1922330,72,34,utRho11
218,cnu,3409522,3409898,3409522,376,1344,utRho11
219,coaA,8350214,8350214,8350052,162,970,utRho11
220,cobC,1340092,1340092,1339814,278,516,utRho11
221,cobT,4129202,4129202,4128934,268,196,utRho11
222,cobU,4131944,4131944,4131528,416,428,utRho11
223,codB,709768,709844,709768,76,0,utRho11
224,comR,2337726,2337726,2337664,62,0,utRho11
225,copA,1022822,1022822,1022758,64,4,utRho11
226,corA,8002388,8002852,8002388,464,18584,utRho11
227,cpdB,8873258,8873258,8873130,128,196,utRho11
228,cptB,6082198,6082198,6082140,58,144,utRho11
229,cpxA,8210202,8210202,8209950,252,266,utRho11
230,cpxP,8211570,8211640,8211570,70,144,utRho11
231,cpxR,8211372,8211372,8211340,32,0,utRho11
232,cra,175894,176056,175894,162,72,utRho11
233,crcB,1316016,1316016,1315876,140,1438,utRho11
234,creA,9270486,9271042,9270486,556,366,utRho11
235,creD,9276320,9276356,9276320,36,198,utRho11
236,crl,515620,515658,515620,38,2248,utRho11
237,crp,6971906,6972240,6971906,334,2932,utRho11
238,crr,5070960,5071668,5070960,708,2632,utRho11
239,csdA,5886414,5886674,5886414,260,254,utRho11
240,csgB,2207718,2207902,2207718,184,0,utRho11
241,csgD,2206688,2206688,2206392,296,84,utRho11
242,csgG,2203510,2203510,2203368,142,98,utRho11
243,csiD,5577854,5577970,5577854,116,38,utRho11
244,csiE,5330802,5330870,5330802,68,252,utRho11
245,csiR,5590942,5591348,5590942,406,0,utRho11
246,cspA,7439778,7440098,7439778,320,125654,utRho11
247,cspB,3283430,3283430,3283108,322,104,utRho11
248,cspC,3815018,3815018,3814870,148,862,utRho11
249,cspD,1845352,1845352,1845180,172,994,utRho11
250,cspE,1314294,1314584,1314294,290,90,utRho11
251,cspF,3283380,3283710,3283380,330,56,utRho11
252,cspG,2102610,2102922,2102610,312,3550,utRho11
253,cspH,2102746,2102746,2102350,396,432,utRho11
254,cspI,3277624,3277624,3277334,290,0,utRho11
255,csrA,5638746,5638746,5638292,454,1790,utRho11
256,csrB,5849048,5849048,5849048,0,0,utRho11
257,csrC,8102072,8102072,8102072,0,0,utRho11
258,csrD,6806850,6806850,6806664,186,0,utRho11
259,cstA,1259710,1259788,1259710,78,0,utRho11
260,cueO,274090,274166,274090,76,92,utRho11
261,cueR,1027948,1027986,1027948,38,30,utRho11
262,curA,3037784,3038054,3037784,270,504,utRho11
263,cusC,1191146,1191200,1191146,54,0,utRho11
264,cusR,1190924,1190924,1190886,38,2,utRho11
265,cutA,8730784,8730784,8730712,72,456,utRho11
266,cutC,3918534,3918534,3917920,614,188,utRho11
267,cvpA,4861600,4861600,4861526,74,0,utRho11
268,cvrA,2484328,2484328,2484142,186,66,utRho11
269,cyaA,7981548,7982306,7981548,758,500,utRho11
270,cyaR,4334228,4334224,4334228,4,0,utRho11
271,cyaY,7988166,7988166,7988118,48,312,utRho11
272,cybB,2981522,2981804,2981522,282,334,utRho11
273,cycA,8859560,8859728,8859560,168,608,utRho11
274,cydA,1542340,1542916,1542340,576,266,utRho11
275,cydC,1858800,1858800,1858390,410,106,utRho11
276,cydD,1862062,1862062,1861924,138,38,utRho11
277,cydX,1548300,1548392,1548300,92,408,utRho11
278,cynR,717418,717418,717380,38,12,utRho11
279,cynT,1435092,1435196,1435092,104,0,utRho11
280,cyoA,903306,903306,903220,86,4308,utRho11
281,cyoE,895540,895540,895410,130,666,utRho11
282,cysB,2667576,2667710,2667576,134,244,utRho11
283,cysC,5748056,5748056,5747984,72,0,utRho11
284,cysD,5752736,5752736,5752658,78,60,utRho11
285,cysE,7565362,7565362,7565124,238,804,utRho11
286,cysG,6995508,6995656,6995508,148,540,utRho11
287,cysJ,5783928,5783928,5783796,132,2930,utRho11
288,cysK,5064688,5064818,5064688,130,0,utRho11
289,cysP,5087114,5087114,5087056,58,546,utRho11
290,cysS,1109154,1109222,1109154,68,80,utRho11
291,cysT,3984100,3984100,3983974,126,42,utRho11
292,cysZ,5062766,5062926,5062766,160,400,utRho11
293,cytR,8249018,8249018,8248912,106,128,utRho11
294,dacA,1328002,1328002,1327926,76,314,utRho11
295,dacB,6657714,6657926,6657714,212,152,utRho11
296,dacC,1761306,1761454,1761306,148,400,utRho11
297,dadA,2475018,2475142,2475018,124,0,utRho11
298,dam,7032504,7032504,7031826,678,1602,utRho11
299,damX,7035200,7035200,7034612,588,504,utRho11
300,dapA,5199568,5199568,5199520,48,0,utRho11
301,dapB,56576,56748,56576,172,292,utRho11
302,dapD,371954,371954,371894,60,250,utRho11
303,dapE,5183120,5183214,5183120,94,970,utRho11
304,dcp,3254844,3254844,3254760,84,22,utRho11
305,dcrB,7219534,7219910,7219534,376,626,utRho11
306,dctA,7366996,7366996,7366894,102,480,utRho11
307,dcuA,8733686,8733686,8733546,140,4,utRho11
308,dcuB,8698182,8698182,8697488,694,2304,utRho11
309,dcuC,1312166,1312166,1311936,230,242,utRho11
310,dcuD,6749166,6749738,6749166,572,208,utRho11
311,dcuR,8701130,8701130,8700068,1062,1104,utRho11
312,dcuS,8703370,8703370,8703324,46,126,utRho11
313,dcyD,3999016,3999016,3998960,56,0,utRho11
314,ddpX,3126498,3126498,3126152,346,60,utRho11
315,deaD,6615818,6615818,6615720,98,4686,utRho11
316,dedA,4869880,4869880,4869482,398,11972,utRho11
317,dedD,4863750,4863750,4863368,382,414,utRho11
318,def,6867300,6867380,6867300,80,74,utRho11
319,degP,361690,361768,361690,78,0,utRho11
320,degQ,6761308,6761486,6761308,178,5802,utRho11
321,deoB,9239134,9239206,9239134,72,0,utRho11
322,deoC,9233358,9234646,9233358,1288,160,utRho11
323,dfp,7625406,7625462,7625406,56,0,utRho11
324,dgcZ,3247758,3247758,3247700,58,0,utRho11
325,dgkA,8512914,8513274,8512914,360,604,utRho11
326,dgt,358392,358474,358392,82,104,utRho11
327,dhaK,2501888,2501888,2501676,212,482,utRho11
328,dhaR,2502006,2502132,2502006,126,252,utRho11
329,dicB,3299194,3299218,3299194,24,0,utRho11
330,dicC,3295752,3295752,3295700,52,66,utRho11
331,dinB,501760,501796,501760,36,0,utRho11
332,dinD,7635398,7635520,7635398,122,536,utRho11
333,dinG,1666146,1666140,1666146,6,4,utRho11
334,dinI,2243018,2243018,2242974,44,172,utRho11
335,dinJ,493230,493230,493004,226,70,utRho11
336,dinQ,7295964,7295964,7295576,388,1490,utRho11
337,djlA,114536,114728,114536,192,0,utRho11
338,dkgA,6313142,6313246,6313142,104,158,utRho11
339,dkgB,458196,458334,458196,138,336,utRho11
340,dksA,321502,321502,321208,294,446,utRho11
341,dld,4444164,4444370,4444164,206,46,utRho11
342,dmlA,3763424,3763824,3763424,400,192,utRho11
343,dmlR,3763710,3763710,3763618,92,46,utRho11
344,dmsA,1881646,1881918,1881646,272,52,utRho11
345,dnaA,7767922,7767922,7767458,464,1564,utRho11
346,dnaB,8528566,8528628,8528566,62,728,utRho11
347,dnaK,24096,24326,24096,230,832,utRho11
348,dnaN,7765466,7765466,7764642,824,882,utRho11
349,dnaQ,471868,472134,471868,266,1476,utRho11
350,dnaT,18406460,18406460,18406068,392,1632,utRho11
351,dnaX,984112,984184,984112,72,1234,utRho11
352,dosP,3131486,3131486,3131466,20,0,utRho11
353,dpiB,1303968,1304470,1303968,502,52,utRho11
354,dppA,7415740,7415740,7415410,330,2540,utRho11
355,dps,1697900,1697900,1697822,78,0,utRho11
356,dsbA,8086754,8086836,8086754,82,1470,utRho11
357,dsbB,2466294,2466294,2466060,234,0,utRho11
358,dsbC,6079266,6079266,6077644,1622,1540,utRho11
359,dsbG,1277600,1277600,1277146,454,352,utRho11
360,dsdA,4958242,4958404,4958242,162,100,utRho11
361,dsdC,4955492,4955492,4955258,234,230,utRho11
362,dsdX,4955642,4955694,4955642,52,166,utRho11
363,dsrA,4050626,4050626,4050626,0,0,utRho11
364,dsrB,4049686,4049686,4049646,40,780,utRho11
365,dtpD,1485340,1485340,1485112,228,50,utRho11
366,dusA,8523200,8523338,8523200,138,2272,utRho11
367,dusB,6820492,6820560,6820492,68,106,utRho11
368,dusC,4460790,4460790,4460770,20,0,utRho11
369,dut,7627704,7627864,7627704,160,1278,utRho11
370,dxr,386670,387042,386670,372,686,utRho11
371,ebgA,6445102,6445266,6445102,164,58,utRho11
372,ebgR,6442874,6442932,6442874,58,80,utRho11
373,ecnB,8753018,8753106,8753018,88,1284,utRho11
374,eco,4607594,4607810,4607594,216,0,utRho11
375,ecpA,621594,621594,621342,252,302,utRho11
376,ecpB,620238,620238,620052,186,118,utRho11
377,ecpR,622964,622964,622672,292,24,utRho11
378,eda,3866218,3866218,3865512,706,124,utRho11
379,edd,3869426,3869426,3869208,218,60,utRho11
380,efeO,2164308,2164486,2164308,178,416,utRho11
381,efeU_1,2162614,2162712,2162614,98,22,utRho11
382,efp,8751134,8751398,8751134,264,6140,utRho11
383,elaA,4763372,4763372,4763086,286,4,utRho11
384,elaD,4765308,4765426,4765308,118,316,utRho11
385,elfA,1995530,1995736,1995530,206,62,utRho11
386,elfD,1996642,1996980,1996642,338,0,utRho11
387,emrD,7707690,7707844,7707690,154,78,utRho11
388,emrK,4966896,4966896,4966678,218,138,utRho11
389,emrY,4964668,4964668,4964352,316,0,utRho11
390,emtA,2486250,2486360,2486250,110,0,utRho11
391,endA,12361100,12361388,12361100,288,4,utRho11
392,eno,5817692,5817692,5815882,1810,7638,utRho11
393,entC,1249662,1249770,1249662,108,0,utRho11
394,entD,1220508,1220508,1220158,350,144,utRho11
395,entH,1258584,1258600,1258584,16,0,utRho11
396,entS,1244506,1244600,1244506,94,0,utRho11
397,envR,6827266,6827266,6826930,336,0,utRho11
398,epd,12295292,12295292,12294764,528,76,utRho11
399,epmA,8765236,8765286,8765236,50,0,utRho11
400,epmB,8751406,8751406,8751314,92,3212,utRho11
401,eptB,7421162,7421162,7420950,212,38,utRho11
402,eptC,8300622,8300622,8300530,92,718,utRho11
403,erfK,4126708,4126708,4126646,62,1788,utRho11
404,erpA,353122,353220,353122,98,0,utRho11
405,esrE,8039956,8039956,8039956,0,0,utRho11
406,essD,1153746,1154796,1153746,1050,546,utRho11
407,etk,2088606,2088606,2088420,186,300,utRho11
408,evgA,4967262,4967510,4967262,248,0,utRho11
409,exbB,6304028,6304028,6303968,60,0,utRho11
410,exbD,6302780,6302780,6302486,294,96,utRho11
411,exuR,6493016,6493304,6493016,288,150,utRho11
412,exuT,6490004,6490208,6490004,204,0,utRho11
413,fabA,2032996,2032996,2032940,56,66,utRho11
414,fabB,4883282,4883282,4883210,72,68,utRho11
415,fabH,2297032,2297518,2297032,486,4146,utRho11
416,fabI,2702236,2702236,2702078,158,460,utRho11
417,fadB,8062026,8062026,8061942,84,0,utRho11
418,fadD,3779614,3779614,3779492,122,6,utRho11
419,fadE,486812,486812,486606,206,0,utRho11
420,fadH,6463248,6463330,6463248,82,14,utRho11
421,fadI,4921022,4921022,4920938,84,298,utRho11
422,fadL,4922410,4922600,4922410,190,0,utRho11
423,fadM,928720,928804,928720,84,2,utRho11
424,fadR,2469810,2469876,2469810,66,70,utRho11
425,fbaB,4357334,4357334,4357128,206,32,utRho11
426,fdhE,8162722,8162722,8162456,266,1768,utRho11
427,fdhF,8598814,8598814,8598732,82,0,utRho11
428,fdnG,3094744,3094802,3094744,58,0,utRho11
429,fdrA,1093012,1093360,1093012,348,0,utRho11
430,feaB,2894994,2895038,2894994,44,0,utRho11
431,feaR,2894734,2894734,2894566,168,98,utRho11
432,fecA,9033454,9033454,9033354,100,40,utRho11
433,fecE,9023288,9023288,9022914,374,8320,utRho11
434,fecI,9036564,9036564,9036470,94,290,utRho11
435,feoA,7080114,7080326,7080114,212,88,utRho11
436,fepA,1225334,1225334,1224988,346,40,utRho11
437,fepB,1249454,1249454,1249020,434,0,utRho11
438,fepD,1244468,1244468,1244378,90,0,utRho11
439,fes,1225374,1225630,1225374,256,350,utRho11
440,ffh,5495706,5495706,5495590,116,968,utRho11
441,ffs,952576,952848,952576,272,234,utRho11
442,fhuA,334884,334968,334884,84,320,utRho11
443,fhuE,2323294,2323294,2323102,192,204,utRho11
444,fhuF,9211504,9211504,9211326,178,133922,utRho11
445,fic,6983296,6983296,6982926,370,1298,utRho11
446,fieF,8212864,8212938,8212864,74,110,utRho11
447,fimA,9085388,9086230,9085388,842,1222,utRho11
448,fimB,9081334,9081914,9081334,580,1648,utRho11
449,fimE,9083742,9084074,9083742,332,1538,utRho11
450,fimZ,1129214,1129214,1128960,254,4,utRho11
451,fiu,1683296,1683296,1683062,234,24,utRho11
452,fixA,84650,84806,84650,156,0,utRho11
453,fkpA,6955050,6955050,6954838,212,7882,utRho11
454,fldA,2846084,2846084,2845860,224,4824,utRho11
455,fldB,6079644,6079710,6079644,66,208,utRho11
456,flgA,2261770,2261770,2261726,44,974,utRho11
457,flgB,2261986,2262036,2261986,50,146,utRho11
458,flgK,2276702,2276756,2276702,54,1562,utRho11
459,flgM,2260330,2260330,2260256,74,266,utRho11
460,flgN,2259828,2259828,2259660,168,212,utRho11
461,flhB,3932432,3932432,3932382,50,2842,utRho11
462,flhC,3955864,3955864,3955688,176,218,utRho11
463,flhD,3957154,3957154,3956394,760,1182,utRho11
464,fliA,4003638,4003638,4003578,60,2248,utRho11
465,fliC,4007352,4007352,4007212,140,1288,utRho11
466,fliD,4007634,4007744,4007634,110,760,utRho11
467,fliE,4026186,4026186,4026028,158,236,utRho11
468,fliF,4026292,4026458,4026292,166,398,utRho11
469,fliL,4039168,4039236,4039168,68,168,utRho11
470,flk,4875824,4875900,4875824,76,170,utRho11
471,flu,4142634,4143078,4142634,444,90,utRho11
472,flxA,3292776,3292810,3292776,34,82,utRho11
473,fnr,2799104,2799104,2799052,52,50,utRho11
474,fnrS,2818258,2818258,2818258,0,0,utRho11
475,focA,1909628,1909628,1908932,696,1010,utRho11
476,folA,99598,99646,99598,48,76,utRho11
477,folB,6409296,6409296,6409178,118,0,utRho11
478,folD,1115562,1115562,1115482,80,136,utRho11
479,folE,4487696,4487696,4487304,392,3154,utRho11
480,fpr,8228998,8228998,8228944,54,30,utRho11
481,frc,4986878,4986878,4986508,370,54,utRho11
482,frdA,8764824,8764824,8764636,188,58,utRho11
483,frdD,8758948,8758948,8758732,216,1486,utRho11
484,fre,8052886,8053054,8052886,168,1804,utRho11
485,frlA,6999518,6999820,6999518,302,720,utRho11
486,frr,385624,385744,385624,120,1440,utRho11
487,frsA,513004,513054,513004,50,362,utRho11
488,fruB,4527194,4527194,4526990,204,0,utRho11
489,frvR,8179804,8179804,8179710,94,0,utRho11
490,fryA,5008986,5008986,5008970,16,180,utRho11
491,fsaA,1727060,1727284,1727060,224,334,utRho11
492,fsr,1009710,1009710,1009392,318,76,utRho11
493,ftnA,3977364,3977432,3977364,68,0,utRho11
494,ftnB,3973550,3973850,3973550,300,0,utRho11
495,ftsA,207122,207964,207122,842,720,utRho11
496,ftsB,5745802,5745802,5745640,162,72,utRho11
497,ftsH,6654204,6654204,6653870,334,1040,utRho11
498,ftsK,1865858,1866448,1865858,590,1030,utRho11
499,ftsL,181376,182064,181376,688,2138,utRho11
500,ftsP,6325732,6325732,6325338,394,366,utRho11
501,ftsQ,205484,206310,205484,826,356,utRho11
502,ftsX,7204512,7204512,7204172,340,956,utRho11
503,ftsZ,209272,210610,209272,1338,140,utRho11
504,fucA,5867708,5867708,5867376,332,932,utRho11
505,fucP,5868238,5868470,5868238,232,24,utRho11
506,fumA,6753760,6753760,6753508,252,3352,utRho11
507,fumB,8694696,8694696,8694652,44,0,utRho11
508,fumC,3373418,3373418,3373176,242,56,utRho11
509,fur,2842892,2842892,2842584,308,6976,utRho11
510,fusA,6947370,6947370,6947028,342,31738,utRho11
511,fxsA,8737206,8737328,8737206,122,164,utRho11
512,gabD,5581824,5582546,5581824,722,1278,utRho11
513,gadA,7335214,7335214,7335160,54,0,utRho11
514,gadB,3144144,3144144,3144090,54,0,utRho11
515,gadC,3141168,3141168,3140978,190,336,utRho11
516,gadE,7315600,7316732,7315600,1132,272,utRho11
517,gadW,7329562,7329562,7329236,326,0,utRho11
518,gadX,14663356,14663356,14663240,116,484,utRho11
519,gadY,7329728,7329728,7329728,0,0,utRho11
520,galE,1584354,1584354,1584110,244,68,utRho11
521,galF,4228702,4228702,4228654,48,14,utRho11
522,galM,1577796,1577796,1577674,122,888,utRho11
523,galP,6176510,6176568,6176510,58,2,utRho11
524,galR,5953138,5953198,5953138,60,178,utRho11
525,galS,4483420,4483420,4483336,84,56,utRho11
526,galU,2582810,2582914,2582810,104,366,utRho11
527,gapA,3724480,3725542,3724480,1062,3910,utRho11
528,garP,6549868,6549868,6549814,54,62,utRho11
529,gatY,4354468,4354468,4354408,60,0,utRho11
530,gatZ,4352864,4352864,4352642,222,12672,utRho11
531,gcd,282558,282558,282450,108,14,utRho11
532,gcl,1067814,1067832,1067814,18,0,utRho11
533,gcvA,5885278,5885278,5885134,144,0,utRho11
534,gcvB,5885392,5885392,5885392,0,0,utRho11
535,gcvR,5199758,5199812,5199758,54,0,utRho11
536,gcvT,6101544,6101544,6101334,210,1396,utRho11
537,gdhA,3684616,3684742,3684616,126,0,utRho11
538,gfcA,2099668,2099668,2099488,180,1506,utRho11
539,gfcD,2096236,2096236,2095890,346,1112,utRho11
540,ghrA,2195648,2195772,2195648,124,4,utRho11
541,ghrB,7434378,7434620,7434378,242,1958,utRho11
542,glcA,6242728,6242728,6242558,170,178,utRho11
543,glcC,6256412,6256544,6256412,132,68,utRho11
544,glcD,6256152,6256152,6256042,110,130,utRho11
545,gldA,8278092,8278092,8278070,22,0,utRho11
546,glgA,7136784,7136784,7136066,718,1218,utRho11
547,glgB,7147314,7147314,7147004,310,296,utRho11
548,glgC,7139142,7139142,7138656,486,164,utRho11
549,glgP,7133546,7133546,7133162,384,848,utRho11
550,glgS,6384024,6384024,6383878,146,20,utRho11
551,glgX,7142838,7142838,7142638,200,0,utRho11
552,glk,5018922,5018922,5018852,70,162,utRho11
553,glmS,7827622,7827622,7827336,286,5840,utRho11
554,glmU,7830652,7830652,7830400,252,1428,utRho11
555,glmY,10765360,10765360,10765360,0,0,utRho11
556,glmZ,7972864,7972864,7972864,0,0,utRho11
557,glnA,16232888,16232888,16232136,752,428,utRho11
558,glnB,5375052,5375052,5374816,236,300,utRho11
559,glnD,377310,377310,377300,10,0,utRho11
560,glnE,6399602,6399602,6399282,320,0,utRho11
561,glnH,1696396,1696396,1696008,388,274,utRho11
562,glnK,945112,945196,945112,84,4,utRho11
563,glnL,8112742,8112742,8112678,64,0,utRho11
564,glnQ,1693262,1693262,1692926,336,350,utRho11
565,glnS,1411998,1412186,1411998,188,1552,utRho11
566,gloA,3455602,3455674,3455602,72,0,utRho11
567,gloB,469852,469852,469564,288,2864,utRho11
568,glpA,4705166,4705294,4705166,128,0,utRho11
569,glpD,7123942,7124026,7123942,84,14,utRho11
570,glpE,7123698,7123698,7123646,52,0,utRho11
571,glpF,8236322,8236322,8236180,142,508,utRho11
572,glpG,7122960,7122960,7122904,56,368,utRho11
573,glpR,7121782,7121782,7121210,572,660,utRho11
574,glpT,4704902,4704902,4704748,154,86,utRho11
575,glpX,8231212,8231212,8231158,54,11310,utRho11
576,glrK,5382246,5382246,5382196,50,1136,utRho11
577,gltA,1509534,1509534,1508936,598,8566,utRho11
578,gltB,6709018,6709264,6709018,246,700,utRho11
579,gltI,1375792,1375792,1375494,298,4600,utRho11
580,gltP,8588536,8588962,8588536,426,1756,utRho11
581,gltS,7657382,7657382,7657330,52,318,utRho11
582,gltX,5041568,5041568,5041344,224,226,utRho11
583,gluQ,320286,320286,320224,62,102,utRho11
584,glyA,5371148,5371148,5371014,134,160,utRho11
585,glyQ,7450708,7450708,7450636,72,328,utRho11
586,glyS,7448990,7448990,7448794,196,4254,utRho11
587,glyU,5998128,5998128,5998114,14,110,utRho11
588,glyV,8784626,8784720,8784626,94,316,utRho11
589,glyW,3984360,3984360,3984234,126,2,utRho11
590,gmhB,445612,445666,445612,54,0,utRho11
591,gmk,7642776,7642856,7642776,80,130,utRho11
592,gmr,2693686,2693686,2693484,202,694,utRho11
593,gnd,4202648,4202648,4202536,112,200,utRho11
594,gnsB,3275692,3275692,3275564,128,0,utRho11
595,gntK,14310580,14310580,14310368,212,780,utRho11
596,gntP,9102668,9102668,9102592,76,66,utRho11
597,gntR,7157760,7157760,7157452,308,464,utRho11
598,gntT,7092810,7093118,7092810,308,1456,utRho11
599,gntU,7154170,7154170,7154122,48,238,utRho11
600,gntX,7089334,7089764,7089334,430,80,utRho11
601,gor,7292224,7292598,7292224,374,1244,utRho11
602,gpmA,1575340,1575340,1575190,150,4,utRho11
603,gpmM,7570374,7570520,7570374,146,4,utRho11
604,gpsA,7567620,7567620,7567322,298,10234,utRho11
605,gpt,511828,511954,511828,126,1126,utRho11
606,grcA,5433046,5433046,5432898,148,838,utRho11
607,greA,6657728,6657728,6657430,298,2400,utRho11
608,greB,7073488,7073624,7073488,136,0,utRho11
609,groL,8741566,8742050,8741566,484,1588,utRho11
610,groS,8741232,8741376,8741232,144,578,utRho11
611,grpE,5501494,5501494,5501416,78,514,utRho11
612,grxA,1781552,1781552,1781506,46,68,utRho11
613,grxB,2248206,2248206,2248108,98,678,utRho11
614,grxC,7569152,7569152,7568884,268,4924,utRho11
615,grxD,3468324,3468324,3468202,122,9672,utRho11
616,gspA,6911268,6911268,6910796,472,82,utRho11
617,gspC,6910964,6911156,6910964,192,0,utRho11
618,gss,6277220,6277220,6277044,176,234,utRho11
619,gstA,3428654,3428754,3428654,100,14,utRho11
620,gstB,1761038,1761038,1760960,78,0,utRho11
621,guaB,5268214,5268214,5268140,74,84,utRho11
622,gudD,5839026,5839026,5838770,256,96,utRho11
623,gyrA,4678914,4678914,4678840,74,18,utRho11
624,gyrB,7760300,7760300,7760238,62,196,utRho11
625,hcaE,5337964,5338064,5337964,100,382,utRho11
626,hcaR,5337928,5337928,5337792,136,418,utRho11
627,hcaT,5336106,5336106,5335692,414,76,utRho11
628,hchA,4071260,4071670,4071260,410,84,utRho11
629,hcp,1828258,1828258,1827628,630,200,utRho11
630,hcr,1824400,1824400,1824300,100,44,utRho11
631,hdeA,7313582,7313582,7313480,102,0,utRho11
632,hdeD,7313920,7313990,7313920,70,174,utRho11
633,hdfR,7896320,7896320,7895934,386,1380,utRho11
634,hdhA,3396244,3396244,3396080,164,100,utRho11
635,helD,2048876,2048942,2048876,66,62,utRho11
636,hemA,2527166,2527428,2527166,262,2,utRho11
637,hemB,779722,779722,779454,268,418,utRho11
638,hemF,5106410,5106450,5106410,40,28,utRho11
639,hemH,996062,996110,996062,48,1256,utRho11
640,hemL,349882,349882,349764,118,16,utRho11
641,hemN,8103886,8104090,8103886,204,54,utRho11
642,hepA,127176,127176,126528,648,1600,utRho11
643,hflD,2385372,2385372,2385262,110,630,utRho11
644,hfq,8799602,8800576,8799602,974,3758,utRho11
645,hha,961006,961006,960616,390,190,utRho11
646,hicA,3018442,3018572,3018442,130,0,utRho11
647,higA,6468682,6468682,6468288,394,420,utRho11
648,higB,6468960,6468960,6468910,50,74,utRho11
649,hinT,2323642,2323770,2323642,128,0,utRho11
650,hipB,3184964,3184964,3184884,80,0,utRho11
651,hisB,4186720,4186936,4186720,216,894,utRho11
652,hisJ,4853674,4853674,4853576,98,30,utRho11
653,hisL,8359856,8359984,8359856,128,372,utRho11
654,hisS,5281284,5281284,5281150,134,238,utRho11
655,hlpA,400910,400964,400910,54,24,utRho11
656,hlyE,2460932,2460932,2460788,144,314,utRho11
657,hmp,5371594,5371670,5371594,76,70,utRho11
658,hns,2585916,2585916,2585844,72,1302,utRho11
659,hofM,7045856,7045856,7045502,354,0,utRho11
660,hokA,7441620,7441620,7441200,420,9470,utRho11
661,hokC,33902,33902,33806,96,292,utRho11
662,hokE,1215462,1215672,1215462,210,0,utRho11
663,holC,8968546,8968546,8968560,14,900,utRho11
664,holD,9215562,9215606,9215562,44,0,utRho11
665,holE,3850040,3850216,3850040,176,6314,utRho11
666,hpt,282720,282862,282720,142,576,utRho11
667,hrpB,324150,324210,324150,60,0,utRho11
668,hscB,5319048,5319048,5318934,114,2418,utRho11
669,hscC,1367188,1367188,1366786,402,940,utRho11
670,hsdS,9163004,9163004,9162924,80,266,utRho11
671,hslJ,2883560,2883560,2883486,74,216,utRho11
672,hslO,7059344,7059548,7059344,204,7318,utRho11
673,hslR,7058220,7058696,7058220,476,1376,utRho11
674,hslV,8244708,8244708,8244574,134,126,utRho11
675,hsrA,7881412,7881412,7881224,188,24,utRho11
676,htgA,21286,21660,21286,374,7936,utRho11
677,htpG,989634,990240,989634,606,32108,utRho11
678,htpX,3825236,3825236,3825152,84,0,utRho11
679,htrE,311036,311036,310852,184,830,utRho11
680,htrL,7587668,7587668,7587366,302,24,utRho11
681,hupA,8400352,8400562,8400352,210,0,utRho11
682,hupB,1845220,1845804,1845220,584,8,utRho11
683,hyaA,2063968,2064278,2063968,310,0,utRho11
684,hybO,6292726,6292726,6292522,204,5888,utRho11
685,hycA,5700922,5700922,5700870,52,18,utRho11
686,hycI,5686204,5686204,5686086,118,318,utRho11
687,hydN,5676264,5676264,5676210,54,0,utRho11
688,hyfA,5202342,5202402,5202342,60,104,utRho11
689,hypA,11402508,11402588,11402508,80,224,utRho11
690,hypB,11403356,11404004,11403356,648,0,utRho11
691,hypF,5676210,5676210,5674850,1360,2654,utRho11
692,hypT,9116634,9116634,9116578,56,0,utRho11
693,hyuA,6019660,6020056,6019660,396,0,utRho11
694,iaaA,1733074,1733136,1733074,62,0,utRho11
695,iadA,9119074,9119074,9119052,22,248,utRho11
696,iap,5753072,5753162,5753072,90,32,utRho11
697,ibaG,6673966,6673966,6673606,360,328,utRho11
698,ibpA,7735036,7735036,7734844,192,630,utRho11
699,ibpB,7733962,7733962,7733794,168,242,utRho11
700,icd,2389922,2390246,2389922,324,338,utRho11
701,iclR,8447304,8447304,8447256,48,164,utRho11
702,idi,6065876,6066130,6065876,254,100,utRho11
703,idnD,8988870,8988870,8988812,58,2,utRho11
704,idnK,8989194,8989246,8989194,52,84,utRho11
705,ihfA,3591442,3591442,3591104,338,930,utRho11
706,ihfB,1927498,1927656,1927498,158,862,utRho11
707,ileS,43666,44782,43666,1116,3090,utRho11
708,ileX,6431194,6431196,6431194,2,0,utRho11
709,ilvA,15820940,15821324,15820940,384,228,utRho11
710,ilvC,7915824,7915940,7915824,116,44,utRho11
711,ilvE,15809552,15809936,15809552,384,2364,utRho11
712,ilvI,170840,171260,170840,420,172,utRho11
713,ilvL,23701308,23701932,23701308,624,6,utRho11
714,ilvY,7915734,7915734,7915640,94,44,utRho11
715,inaA,4698998,4698998,4698944,54,354,utRho11
716,infA,1853370,1853370,1852886,484,2320,utRho11
717,infC,3602692,3602692,3601276,1416,5374,utRho11
718,insA-5,3958452,3958452,3958430,22,2,utRho11
719,insA-7,9036758,9037054,9036758,296,648,utRho11
720,insC-5,6372080,6372284,6372080,204,7926,utRho11
721,insEF-2,785238,785238,785820,582,926,utRho11
722,insEF-4,2190310,2190310,2190892,582,890,utRho11
723,insG,9007098,9007098,9006862,236,146,utRho11
724,insH-1,550596,550596,550234,362,556,utRho11
725,insH-11,7306538,7306538,7306396,142,116,utRho11
726,insH-2,1151548,1151548,1151506,42,48,utRho11
727,insH-3,1378444,1378444,1378026,418,852,utRho11
728,insH-4,2791942,2792152,2791942,210,174,utRho11
729,insH-5,2857852,2857852,2857452,400,0,utRho11
730,insH-6,4135022,4135022,4134642,380,772,utRho11
731,insH-7,4206186,4206186,4205822,364,5264,utRho11
732,insH-9,6260050,6260356,6260050,306,218,utRho11
733,insI-3,9017372,9017372,9017234,138,218,utRho11
734,insJ,7441188,7441360,7441188,172,4222,utRho11
735,insK,7442130,7442308,7442130,178,0,utRho11
736,insL-1,30760,30890,30760,130,720,utRho11
737,insL-2,1216112,1216130,1216112,18,90,utRho11
738,insL-3,5028644,5028662,5028644,18,304,utRho11
739,insN-1,540452,540484,540452,32,0,utRho11
740,intD,1132202,1132202,1131956,246,4204,utRho11
741,intR,2826520,2826520,2826470,50,0,utRho11
742,intS,4933026,4933090,4933026,64,5742,utRho11
743,intZ,5117386,5117542,5117386,156,2676,utRho11
744,iraD,9113152,9113986,9113152,834,120,utRho11
745,iraM,2424246,2424246,2424006,240,0,utRho11
746,iraP,802638,802772,802638,134,0,utRho11
747,iscA,5319924,5319924,5319772,152,1800,utRho11
748,iscR,5324398,5324398,5324262,136,15898,utRho11
749,iscX,5313834,5313834,5313472,362,5272,utRho11
750,ispF,5743968,5743968,5743560,408,3384,utRho11
751,ispG,5283908,5283908,5283608,300,622,utRho11
752,ispU,389568,389806,389568,238,224,utRho11
753,isrA,2811502,2811502,2811618,116,0,utRho11
754,istr-1,7706384,7706384,7706384,0,0,utRho11
755,istr-2,7706514,7706514,7706514,0,0,utRho11
756,ivbL,15412092,15412092,15411952,140,1200,utRho11
757,ivy,480638,480686,480638,48,82,utRho11
758,katE,3627628,3627734,3627628,106,90,utRho11
759,katG,8267624,8267670,8267624,46,190,utRho11
760,kbaZ,6557732,6557828,6557732,96,2,utRho11
761,kbl,7585154,7585154,7585102,52,912,utRho11
762,kch,2621046,2621046,2620538,508,580,utRho11
763,kdgR,3820506,3820506,3820198,308,126,utRho11
764,kdpE,1443788,1443788,1443466,322,0,utRho11
765,kdpF,1457698,1457698,1457642,56,0,utRho11
766,kdsA,2535708,2536330,2535708,622,2592,utRho11
767,kdsC,6683438,6684546,6683438,1108,4200,utRho11
768,kduI,5968388,5968388,5968248,140,4978,utRho11
769,kefF,94160,94492,94160,332,194,utRho11
770,kgtP,5451624,5451624,5451492,132,1878,utRho11
771,kup,7862206,7862632,7862206,426,112,utRho11
772,lacI,735076,735076,735020,56,0,utRho11
773,lacZ,1465508,1465508,1465220,288,292,utRho11
774,ldcA,2486394,2486394,2486160,234,0,utRho11
775,ldhA,2885830,2885830,2885686,144,0,utRho11
776,ldrA,2538954,2538954,2538550,404,4016,utRho11
777,ldrB,2540024,2540024,2539620,404,1292,utRho11
778,ldrC,2541092,2541092,2540690,402,1128,utRho11
779,ldrD,7400544,7400544,7400174,370,1484,utRho11
780,lepA,5414392,5414392,5414248,144,226,utRho11
781,lepB,5410928,5410928,5410618,310,904,utRho11
782,leuD,159188,159188,158906,282,246,utRho11
783,leuE,3761600,3761600,3761518,82,0,utRho11
784,leuL,168048,168048,167416,632,76,utRho11
785,leuO,168308,168736,168308,428,0,utRho11
786,leuQ,9212864,9212864,9212802,62,0,utRho11
787,leuU,6644556,6644556,6644316,240,2436,utRho11
788,leuV,9212546,9212546,9212330,216,3038,utRho11
789,leuX,8992772,8992810,8992772,38,0,utRho11
790,lexA,8514174,8514230,8514174,56,154,utRho11
791,lhr,3456706,3458174,3456706,1468,4496,utRho11
792,ligA,5060402,5060402,5060352,50,0,utRho11
793,ligB,7642576,7642576,7642340,236,336,utRho11
794,lipA,1320602,1320602,1320432,170,436,utRho11
795,lipB,1324802,1324802,1324556,246,4390,utRho11
796,lit,2397032,2397390,2397032,358,1488,utRho11
797,livJ,7199524,7199524,7199316,208,1982,utRho11
798,livK,7195510,7195510,7195120,390,418,utRho11
799,lldP,7554578,7554798,7554578,220,4446,utRho11
800,lnt,1381968,1381968,1381762,206,578,utRho11
801,loiP,6163784,6163826,6163784,42,228,utRho11
802,lolA,1874656,1874738,1874656,82,304,utRho11
803,lolB,2527112,2527112,2527000,112,26,utRho11
804,lolC,2350748,2350854,2350748,106,0,utRho11
805,lon,917630,917776,917630,146,1778,utRho11
806,lpcA,486936,487086,486936,150,2,utRho11
807,lpd,255434,255824,255434,390,3046,utRho11
808,lplA,9248476,9248476,9248234,242,732,utRho11
809,lplT,5947878,5947878,5947724,154,146,utRho11
810,lpoA,6586422,6586800,6586422,378,242,utRho11
811,lpp,3514592,3514842,3514592,250,226,utRho11
812,lptA,6686598,6686760,6686598,162,998,utRho11
813,lptB,6686792,6687888,6686792,1096,2680,utRho11
814,lptD,114672,114672,114218,454,2106,utRho11
815,lptF,8972244,8972436,8972244,192,76,utRho11
816,lpxC,213016,213114,213016,98,8306,utRho11
817,lpxD,401920,401942,401920,22,280,utRho11
818,lpxL,2233418,2233418,2233164,254,6,utRho11
819,lpxM,3880456,3880456,3880386,70,140,utRho11
820,lpxP,4991156,4991290,4991156,134,2,utRho11
821,lrhA,4813312,4813312,4813282,30,0,utRho11
822,lrp,1864656,1865190,1864656,534,906,utRho11
823,lspA,50028,50414,50028,386,1016,utRho11
824,lsrA,3202920,3202980,3202920,60,22,utRho11
825,lsrR,3202514,3202514,3202482,32,2,utRho11
826,ltaE,1818640,1818640,1818588,52,0,utRho11
827,luxS,5630130,5630130,5629466,664,18624,utRho11
828,lysA,5957902,5957902,5957798,104,44,utRho11
829,lysC,8467232,8467232,8466466,766,916,utRho11
830,lysP,4497120,4497120,4497064,56,0,utRho11
831,lysR,5957900,5958042,5957900,142,134,utRho11
832,lysT,1561028,1561108,1561028,80,282,utRho11
833,lysU,8709610,8709610,8709434,176,4,utRho11
834,macB,1840188,1840694,1840188,506,270,utRho11
835,maeA,3111484,3111484,3111338,146,3522,utRho11
836,mak,820236,820288,820236,52,0,utRho11
837,malE,8492928,8492928,8492838,90,76,utRho11
838,malI,3398456,3398456,3398360,96,0,utRho11
839,malK,8493472,8493568,8493472,96,132,utRho11
840,malP,7105020,7105020,7104946,74,316,utRho11
841,malQ,7100798,7100798,7100140,658,36,utRho11
842,malS,14949880,14949988,14949880,108,4,utRho11
843,malT,7106048,7106170,7106048,122,102,utRho11
844,malX,3398626,3398710,3398626,84,0,utRho11
845,malZ,1689980,1690072,1689980,92,4448,utRho11
846,manA,3377102,3377152,3377102,50,0,utRho11
847,manX,3803866,3804096,3803866,230,96,utRho11
848,marC,3237882,3237882,3237816,66,134,utRho11
849,marR,3238186,3238240,3238186,54,118,utRho11
850,matP,2036918,2036970,2036918,52,196,utRho11
851,mazE,5822736,5822736,5822678,58,56,utRho11
852,mazG,5821720,5821720,5821370,350,4930,utRho11
853,mcbA,1684306,1684306,1684112,194,0,utRho11
854,mcbR,3040192,3040524,3040192,332,52,utRho11
855,mcrA,2420278,2420692,2420278,414,0,utRho11
856,mcrC,9156124,9156124,9155916,208,250,utRho11
857,mdaB,6344814,6345060,6344814,246,92,utRho11
858,mdfA,1767138,1767346,1767138,208,0,utRho11
859,mdh,6768940,6768940,6768536,404,94,utRho11
860,mdoB,9198988,9198988,9198882,106,2870,utRho11
861,mdoD,2993290,2993712,2993290,422,0,utRho11
862,mdoG,2218514,2218670,2218514,156,100,utRho11
863,mdtA,4307958,4308032,4307958,74,490,utRho11
864,mdtE,7318168,7318464,7318168,296,546,utRho11
865,mdtK,3486538,3486914,3486538,376,1166,utRho11
866,mdtP,8602472,8602472,8602060,412,112,utRho11
867,melA,8683774,8683822,8683774,48,0,utRho11
868,melR,8683300,8683300,8683256,44,6,utRho11
869,menA,8240812,8240812,8240698,114,22,utRho11
870,menB,4753774,4753774,4753638,136,314,utRho11
871,mepH,3468714,3468870,3468714,156,0,utRho11
872,mepM,3883666,3883666,3883270,396,786,utRho11
873,mepS,4539840,4539958,4539840,118,384,utRho11
874,metA,8428318,8428560,8428318,242,326,utRho11
875,metB,8257272,8257344,8257272,72,800,utRho11
876,metC,6304150,6304472,6304150,322,100,utRho11
877,metE,8025768,8026106,8025768,338,1148,utRho11
878,metF,8265092,8265232,8265092,140,274,utRho11
879,metG,4388538,4388600,4388538,62,56,utRho11
880,metH,8447010,8447656,8447010,646,2426,utRho11
881,metJ,8257116,8257116,8256790,326,24,utRho11
882,metK,6173154,6173412,6173154,258,48,utRho11
883,metN,445428,445428,445290,138,8,utRho11
884,metR,8025710,8025710,8025632,78,0,utRho11
885,metT,1394326,1394326,1394266,60,216,utRho11
886,metY,19910250,19910250,19909734,516,636,utRho11
887,metZ,11789528,11789548,11789528,20,36,utRho11
888,mfd,2348056,2348056,2347928,128,110,utRho11
889,mglA,4478782,4478782,4478578,204,122,utRho11
890,mglB,4481132,4481132,4480696,436,7902,utRho11
891,mglC,4475918,4475918,4475506,412,286,utRho11
892,mgrB,3817584,3817584,3817532,52,46,utRho11
893,mgrR,3245828,3245828,3245828,0,0,utRho11
894,mgsA,2054082,2054082,2054030,52,18,utRho11
895,mgtL,8934560,8934862,8934560,302,0,utRho11
896,mhpA,737038,737222,737038,184,204,utRho11
897,mhpR,737072,737072,736840,232,102,utRho11
898,mhpT,750772,750918,750772,146,16,utRho11
899,miaA,8797964,8798504,8797964,540,1834,utRho11
900,micA,5629604,5629604,5629604,0,0,utRho11
901,micC,2874242,2874238,2874242,4,0,utRho11
902,micF,4626168,4626168,4626168,0,0,utRho11
903,micM,1014408,1014408,1014408,0,0,utRho11
904,minE,2449422,2449422,2449090,332,1578,utRho11
905,mioC,7852950,7852950,7852910,40,26,utRho11
906,mipA,3733012,3733012,3732944,68,2004,utRho11
907,mlaA,4930270,4930270,4930014,256,36,utRho11
908,mlc,3337206,3337206,3337128,78,206,utRho11
909,mlrA,4429498,4429732,4429498,234,8,utRho11
910,mltA,5894546,5894546,5894356,190,0,utRho11
911,mltD,468050,468050,467910,140,0,utRho11
912,mltF,5391534,5391602,5391534,68,0,utRho11
913,mmuP,550238,550650,550238,412,608,utRho11
914,mngA,1531622,1531968,1531622,346,430,utRho11
915,mngR,1531852,1531852,1531750,102,418,utRho11
916,mnmG,7851348,7851348,7851266,82,5928,utRho11
917,mntH,5025470,5025470,5025412,58,32,utRho11
918,mntP,3810918,3811376,3810918,458,1836,utRho11
919,mntR,1706160,1706366,1706160,206,22,utRho11
920,mntS,1706128,1706128,1705994,134,44,utRho11
921,moaA,1633654,1634088,1633654,434,846,utRho11
922,moaB,1635954,1636110,1635954,156,1846,utRho11
923,mobA,8084242,8084242,8083998,244,542,utRho11
924,mocA,6030112,6030320,6030112,208,18,utRho11
925,modA,1589990,1590178,1589990,188,30,utRho11
926,moeA,1732788,1732788,1732728,60,42,utRho11
927,mokB,2984610,2984610,2984258,352,530,utRho11
928,molR_1,4392888,4392948,4392888,60,246,utRho11
929,motA,3954604,3954604,3954278,326,116,utRho11
930,mpaA,2781278,2781278,2781196,82,252,utRho11
931,mpl,8911456,8911570,8911456,114,30,utRho11
932,mppA,2786108,2786454,2786108,346,28,utRho11
933,mprA,5621494,5621540,5621494,46,1414,utRho11
934,mqo,4613848,4613848,4613508,340,676,utRho11
935,mqsA,6336742,6336742,6336492,250,270,utRho11
936,mqsR,6337306,6337306,6337088,218,454,utRho11
937,mraZ,179192,179268,179192,76,4,utRho11
938,mrcA,7045652,7045742,7045652,90,0,utRho11
939,mrcB,329442,329460,329442,18,0,utRho11
940,mreB,13605424,13605424,13604348,1076,2944,utRho11
941,mreD,6798166,6798166,6797750,416,574,utRho11
942,mrp,4388360,4388360,4388336,24,112,utRho11
943,mscK,972984,973072,972984,88,120,utRho11
944,mscL,6876002,6876048,6876002,46,1326,utRho11
945,mscS,6139742,6139742,6139614,128,48,utRho11
946,msrA,8884522,8884522,8884352,170,464,utRho11
947,msrB,3725168,3725168,3724858,310,2,utRho11
948,msyB,2228426,2228426,2228362,64,280,utRho11
949,mtfA,4087236,4087302,4087236,66,924,utRho11
950,mtgA,6699662,6699662,6699618,44,930,utRho11
951,mtlA,30177504,30178248,30177504,744,1440,utRho11
952,mtn,358366,358366,358306,60,418,utRho11
953,mtr,6611864,6611864,6611634,230,140,utRho11
954,mug,6430992,6430992,6430946,46,610,utRho11
955,murQ,5091466,5091546,5091466,80,16,utRho11
956,murR,5091586,5091586,5091218,368,142,utRho11
957,mutH,5939164,5939324,5939164,160,328,utRho11
958,mutL,8794092,8794824,8794092,732,5836,utRho11
959,mutM,7622554,7622554,7622304,250,1896,utRho11
960,mutS,5714038,5714186,5714038,148,614,utRho11
961,mutY,18617466,18618078,18617466,612,6,utRho11
962,nac,4123956,4123956,4123866,90,818,utRho11
963,nadA,1564122,1564170,1564122,48,240,utRho11
964,nadB,5420714,5420840,5420714,126,0,utRho11
965,nadC,237326,237326,237290,36,134,utRho11
966,nadE,3644604,3644916,3644604,312,100,utRho11
967,nadK,5501526,5501662,5501526,136,378,utRho11
968,nagA,1406350,1406350,1405502,848,2320,utRho11
969,nagB,1407416,1407416,1407222,194,48,utRho11
970,nagC,1404016,1404016,1403188,828,0,utRho11
971,nagE,1407680,1407888,1407680,208,84,utRho11
972,nagK,2357080,2357186,2357080,106,0,utRho11
973,nanA,6747240,6747240,6747152,88,58,utRho11
974,nanC,9079856,9079856,9079002,854,44,utRho11
975,nanR,6749406,6749406,6748978,428,880,utRho11
976,nanS,9075406,9075406,9075188,218,0,utRho11
977,napF,4607390,4607390,4606994,396,80,utRho11
978,narG,2559614,2559728,2559614,114,66,utRho11
979,narK,2555642,2555914,2555642,272,4,utRho11
980,narP,4580844,4581000,4580844,156,0,utRho11
981,narQ,5171154,5171462,5171154,308,138,utRho11
982,narU,3088326,3088326,3088120,206,0,utRho11
983,narW,3077374,3077374,3074618,2756,292,utRho11
984,narX,2555554,2555554,2555236,318,0,utRho11
985,narZ,3085380,3085380,3085180,200,0,utRho11
986,ndh,2331984,2332170,2331984,186,228,utRho11
987,ndk,5289920,5289920,5289728,192,248,utRho11
988,nemR,6904084,6904092,6904084,8,256,utRho11
989,nepI,7683542,7683542,7683478,64,152,utRho11
990,nfo,4501612,4501680,4501612,68,136,utRho11
991,nfsB,1210906,1210906,1210848,58,2,utRho11
992,nfuA,7090916,7091248,7090916,332,1092,utRho11
993,nhaA,34634,34978,34634,344,444,utRho11
994,nhaB,2469534,2469534,2469434,100,32,utRho11
995,nhoA,3067926,3068048,3067926,122,0,utRho11
996,nikA,7226878,7227334,7226878,456,7610,utRho11
997,nikR,7237074,7237176,7237074,102,232,utRho11
998,nirB,6987974,6988022,6987974,48,156,utRho11
999,nlpA,7680034,7680034,7679986,48,0,utRho11
1000,nlpC,3585654,3585654,3585462,192,0,utRho11
1001,nlpD,5737658,5737658,5737506,152,130,utRho11
1002,nlpI,6618080,6618080,6617848,232,4,utRho11
1003,nmpC,1153740,1153740,1153650,90,0,utRho11
1004,nohA,3273206,3273206,3272734,472,252,utRho11
1005,norR,5664614,5664614,5664578,36,0,utRho11
1006,norV,5664878,5664952,5664878,74,0,utRho11
1007,nrdA,4689510,4689730,4689510,220,8334,utRho11
1008,nrdD,8925676,8925676,8925320,356,5822,utRho11
1009,nrdH,5601312,5601446,5601312,134,62,utRho11
1010,nrdR,865954,866004,865954,50,12,utRho11
1011,nrfA,8575342,8575528,8575342,186,0,utRho11
1012,nsrR,8812088,8812380,8812088,292,15248,utRho11
1013,nudB,3897348,3897348,3897264,84,0,utRho11
1014,nudC,8393428,8393806,8393428,378,40,utRho11
1015,nudE,7052658,7052658,7052298,360,848,utRho11
1016,nudG,3682876,3682980,3682876,104,0,utRho11
1017,nudI,4729050,4729108,4729050,58,0,utRho11
1018,nudJ,2388874,2388874,2388576,298,1102,utRho11
1019,nuoA,4810670,4810670,4810144,526,6262,utRho11
1020,nuoN,4783434,4783434,4783010,424,1258,utRho11
1021,nupC,5026018,5026084,5026018,66,52,utRho11
1022,nupG,6211302,6211428,6211302,126,146,utRho11
1023,ogrK,4335096,4335096,4335040,56,0,utRho11
1024,ogt,2800568,2800568,2800472,96,48,utRho11
1025,ohsC,5401036,5401040,5401036,4,68,utRho11
1026,ompA,2040382,2040382,2040106,276,23650,utRho11
1027,ompC,4625774,4625774,4625498,276,298,utRho11
1028,ompF,1974184,1974184,1973964,220,162,utRho11
1029,ompL,8128958,8128958,8128590,368,262,utRho11
1030,ompN,2874158,2874158,2873786,372,0,utRho11
1031,ompR,7073510,7073510,7073168,342,168,utRho11
1032,ompT,1171330,1171330,1171266,64,182,utRho11
1033,ompW,2627982,2628040,2627982,58,0,utRho11
1034,ompX,1700418,1700900,1700418,482,1044,utRho11
1035,omrA,5952378,5952378,5952378,0,0,utRho11
1036,omrB,5952770,5952770,5952770,0,0,utRho11
1037,oppA,2602170,2602364,2602170,194,10876,utRho11
1038,orn,8783168,8783208,8783168,40,50,utRho11
1039,osmB,2686952,2686952,2686656,296,3958,utRho11
1040,osmC,3113192,3113250,3113192,58,176,utRho11
1041,osmE,3644566,3644566,3644512,54,128,utRho11
1042,osmF,4439046,4439046,4438962,84,1258,utRho11
1043,osmY,9222306,9222792,9222306,486,998,utRho11
1044,otsA,3963302,3963302,3963224,78,76,utRho11
1045,otsB,3964930,3964930,3964774,156,566,utRho11
1046,oxc,4984288,4984288,4983900,388,2,utRho11
1047,oxyR,8316914,8316980,8316914,66,432,utRho11
1048,oxyS,8316788,8316788,8316788,0,0,utRho11
1049,paaA,2907730,2907854,2907730,124,0,utRho11
1050,paaX,2927018,2927078,2927018,60,0,utRho11
1051,paaZ,2907340,2907340,2907284,56,0,utRho11
1052,pabA,6981702,6981702,6981658,44,0,utRho11
1053,pabB,3789256,3789610,3789256,354,334,utRho11
1054,pabC,2306186,2306600,2306186,414,572,utRho11
1055,pagP,1313052,1313114,1313052,62,0,utRho11
1056,panB,299260,299260,299202,58,1570,utRho11
1057,panC,297840,297840,297590,250,462,utRho11
1058,panD,293490,293490,293388,102,264,utRho11
1059,panZ,7195656,7195968,7195656,312,104,utRho11
1060,parC,6332060,6332060,6331946,114,538,utRho11
1061,patA,6438916,6438988,6438916,72,0,utRho11
1062,patD,3030830,3031156,3030830,326,0,utRho11
1063,pbpC,5294986,5294986,5294650,336,0,utRho11
1064,pbpG,4450132,4450132,4449740,392,204,utRho11
1065,pck,7065358,7065636,7065358,278,4910,utRho11
1066,pcnB,318782,318782,318252,530,1190,utRho11
1067,pdhR,244068,244184,244068,116,42,utRho11
1068,pdxB,4875768,4875768,4875702,66,146,utRho11
1069,pdxH,3436068,3436068,3436014,54,246,utRho11
1070,pdxJ,5403626,5403626,5403458,168,204,utRho11
1071,pdxK,5074638,5074638,5074474,164,80,utRho11
1072,pepA,8972278,8972278,8971902,376,82,utRho11
1073,pepD,511618,511618,511432,186,3816,utRho11
1074,pepN,1981182,1981244,1981182,62,276,utRho11
1075,pepQ,8062294,8062322,8062294,28,0,utRho11
1076,pepT,2371646,2371688,2371646,42,76,utRho11
1077,pfkA,8214948,8215104,8214948,156,74,utRho11
1078,pfkB,3612646,3612740,3612646,94,0,utRho11
1079,pflA,1902456,1902456,1902160,296,38,utRho11
1080,pflB,1907850,1907850,1907108,742,1228,utRho11
1081,pflD,8287716,8287990,8287716,274,0,utRho11
1082,pgaA,2185046,2185046,2184578,468,14,utRho11
1083,pgi,8467444,8467516,8467444,72,0,utRho11
1084,pgk,12291428,12291428,12290488,940,4656,utRho11
1085,pgl,1597078,1597172,1597078,94,102,utRho11
1086,pgpB,2678324,2678660,2678324,336,484,utRho11
1087,pgpC,5397276,5397276,5397100,176,0,utRho11
1088,pgrR,2783744,2783982,2783744,238,366,utRho11
1089,pheL,5475158,5475198,5475158,40,0,utRho11
1090,pheM,7197204,7197204,7197080,124,248,utRho11
1091,pheP,1203858,1203918,1203858,60,90,utRho11
1092,pheU,8725254,8725254,8725252,2,0,utRho11
1093,pheV,6220730,6220732,6220730,2,0,utRho11
1094,phnC,8650412,8650412,8650330,82,82,utRho11
1095,phoA,803414,803494,803414,80,0,utRho11
1096,phoB,834202,834284,834202,82,0,utRho11
1097,phoE,520316,520316,520200,116,198,utRho11
1098,phoH,2169730,2169984,2169730,254,218,utRho11
1099,phoP,2381016,2381016,2380894,122,2808,utRho11
1100,phoQ,2379880,2379880,2379552,328,822,utRho11
1101,phoU,7815330,7815330,7815156,174,414,utRho11
1102,phr,1478842,1479014,1478842,172,208,utRho11
1103,pinE,2419054,2419370,2419054,316,214,utRho11
1104,pinQ,3267168,3267244,3267168,76,274,utRho11
1105,pinR,2867424,2867424,2867348,76,402,utRho11
1106,pitA,7275224,7275284,7275224,60,0,utRho11
1107,pitB,6272806,6272806,6272742,64,30,utRho11
1108,pka,5439862,5439906,5439862,44,96,utRho11
1109,plaP,4174476,4174476,4174124,352,826,utRho11
1110,pldA,8009628,8009724,8009628,96,270,utRho11
1111,pldB,8018028,8018340,8018028,312,1306,utRho11
1112,plsB,8513196,8513196,8512932,264,304,utRho11
1113,pmbA,8915890,8915918,8915890,28,156,utRho11
1114,pmrD,4747148,4747148,4747076,72,0,utRho11
1115,pncB,1980828,1980828,1980712,116,4,utRho11
1116,pncC,5648788,5648788,5648692,96,0,utRho11
1117,pnp,6622652,6622652,6622336,316,180,utRho11
1118,pntA,3355950,3355950,3355806,144,0,utRho11
1119,pntB,3353096,3353096,3352720,376,16,utRho11
1120,polA,8093880,8093932,8093880,52,136,utRho11
1121,polB,131606,131606,131560,46,0,utRho11
1122,potD,2365700,2365700,2365658,42,8,utRho11
1123,potE,1436688,1436688,1436530,158,0,utRho11
1124,potF,1787268,1787568,1787268,300,396,utRho11
1125,poxB,1822152,1822152,1822098,54,90,utRho11
1126,ppa,8899372,8899372,8899304,68,266,utRho11
1127,ppc,8306380,8306380,8306196,184,128,utRho11
1128,ppdA,5928440,5928440,5928354,86,3666,utRho11
1129,ppdD,235410,235410,235098,312,562,utRho11
1130,pphA,3846770,3846770,3845938,832,6220,utRho11
1131,pphB,5719474,5719520,5719474,46,204,utRho11
1132,ppiA,6984898,6984898,6984594,304,42,utRho11
1133,ppiC,7919682,7919682,7919626,56,6,utRho11
1134,ppiD,923638,923830,923638,192,446,utRho11
1135,ppk,5245748,5246088,5245748,340,650,utRho11
1136,pppA,6228958,6228958,6228704,254,2,utRho11
1137,ppsA,3574322,3574322,3574224,98,0,utRho11
1138,ppsR,3574678,3574890,3574678,212,242,utRho11
1139,pptA,3065716,3066104,3065716,388,280,utRho11
1140,pqiA,2023318,2024002,2023318,684,152,utRho11
1141,prc,3830054,3830054,3829632,422,20804,utRho11
1142,preT,4467978,4468066,4467978,88,1562,utRho11
1143,prfC,9218688,9218828,9218688,140,2096,utRho11
1144,prkB,6968622,6968980,6968622,358,1942,utRho11
1145,prlC,7290476,7290476,7290364,112,320,utRho11
1146,prlF,6553944,6554004,6553944,60,1008,utRho11
1147,proB,520432,520776,520432,344,308,utRho11
1148,proC,811372,811372,811288,84,24,utRho11
1149,proK,7417388,7417388,7417384,4,86,utRho11
1150,proL,4572414,4572422,4572414,8,0,utRho11
1151,proP,8660640,8661004,8660640,364,536,utRho11
1152,proS,437674,437674,437550,124,560,utRho11
1153,proV,5609126,5609630,5609126,504,106,utRho11
1154,prpB,697292,697364,697292,72,32,utRho11
1155,prpR,696942,696942,696886,56,0,utRho11
1156,prs,2524354,2524354,2523750,604,53142,utRho11
1157,psd,8781276,8781276,8780720,556,836,utRho11
1158,psiE,8480600,8480650,8480600,50,0,utRho11
1159,pspA,2736076,2736158,2736076,82,0,utRho11
1160,pspF,2736080,2736080,2735824,256,0,utRho11
1161,pspG,8525632,8525680,8525632,48,64,utRho11
1162,pssA,5445156,5445454,5445156,298,3604,utRho11
1163,pstB,7817112,7817112,7816732,380,28,utRho11
1164,pstC,7821084,7821084,7820796,288,140,utRho11
1165,pstS,23469408,23469408,23469150,258,768,utRho11
1166,psuG,4517114,4517114,4516734,380,972,utRho11
1167,psuT,4514992,4514992,4514670,322,124,utRho11
1168,pth,2517084,2517084,2517026,58,88,utRho11
1169,ptrA,5918022,5918022,5917768,254,0,utRho11
1170,ptrB,3857730,3857730,3857678,52,5446,utRho11
1171,ptsG,2315252,2315738,2315252,486,3394,utRho11
1172,ptsH,5066996,5067528,5066996,532,4148,utRho11
1173,purA,8809328,8809374,8809328,46,0,utRho11
1174,purC,5195562,5195562,5195236,326,0,utRho11
1175,purD,8411972,8411972,8411862,110,0,utRho11
1176,purE,1106284,1106284,1106200,84,2732,utRho11
1177,purH,8415254,8415254,8415064,190,72,utRho11
1178,purL,5391178,5391178,5391086,92,590,utRho11
1179,purM,5242306,5242394,5242306,88,0,utRho11
1180,purR,3475378,3475688,3475378,310,372,utRho11
1181,purT,3861438,3861762,3861438,324,280,utRho11
1182,purU,2577512,2577512,2577248,264,552,utRho11
1183,putA,2157850,2157850,2157764,86,0,utRho11
1184,putP,2158336,2158610,2158336,274,610,utRho11
1185,puuA,2721936,2721936,2721816,120,0,utRho11
1186,puuC,2725456,2725486,2725456,30,0,utRho11
1187,puuD,2722104,2722240,2722104,136,0,utRho11
1188,puuP,2718746,2718746,2718374,372,582,utRho11
1189,pykA,3874988,3875298,3874988,310,338,utRho11
1190,pykF,3510934,3511396,3510934,462,1362,utRho11
1191,pyrC,2245286,2245286,2245214,72,142,utRho11
1192,pyrD,2009464,2009536,2009464,72,330,utRho11
1193,pyrE,7631970,7631970,7631536,434,388,utRho11
1194,pyrF,2683740,2683842,2683740,102,254,utRho11
1195,pyrG,5819594,5819594,5819332,262,1890,utRho11
1196,pyrH,383624,383710,383624,86,2636,utRho11
1197,pyrL,8945490,8945490,8945066,424,14,utRho11
1198,qmcA,1031646,1031646,1031546,100,190,utRho11
1199,qor,8528608,8528608,8528462,146,1028,utRho11
1200,qseB,6339502,6339656,6339502,154,190,utRho11
1201,queA,849970,850022,849970,52,726,utRho11
1202,queE,5811212,5811212,5810836,376,416,utRho11
1203,queF,5850642,5850696,5850642,54,78,utRho11
1204,queG,8788184,8788184,8788134,50,82880,utRho11
1205,racC,2835630,2835630,2835526,104,0,utRho11
1206,racR,2840898,2840898,2840482,416,0,utRho11
1207,raiA,5474208,5474308,5474208,100,8,utRho11
1208,rarD,8008594,8008594,8008356,238,606,utRho11
1209,ravA,7862256,7862256,7862186,70,40,utRho11
1210,rayT,495088,495274,495088,186,44,utRho11
1211,rbn,4763162,4763216,4763162,54,2,utRho11
1212,rbsD,7866644,7866702,7866644,58,0,utRho11
1213,rcnA,4371654,4371834,4371654,180,10,utRho11
1214,rcnB,4373768,4373920,4373768,152,22,utRho11
1215,rcnR,4371806,4371806,4371592,214,20,utRho11
1216,rcsA,4047672,4047936,4047672,264,6012,utRho11
1217,rcsB,4631390,4632354,4631390,964,852,utRho11
1218,rcsC,4640162,4640162,4639656,506,266,utRho11
1219,rcsD,4626904,4626976,4626904,72,348,utRho11
1220,rdgB,6193240,6193362,6193240,122,1010,utRho11
1221,rdlA,2538646,2538646,2538646,0,0,utRho11
1222,rdlB,2539712,2539716,2539712,4,158,utRho11
1223,rdlC,2540782,2540786,2540782,4,0,utRho11
1224,rdlD,7400272,7400272,7400272,0,0,utRho11
1225,rdoA,8084782,8084830,8084782,48,40,utRho11
1226,recA,11295276,11295276,11295076,200,280,utRho11
1227,recC,5925014,5925014,5924856,158,0,utRho11
1228,recF,7763722,7763722,7762442,1280,13066,utRho11
1229,recN,5503518,5503590,5503518,72,48,utRho11
1230,recQ,8011666,8011728,8011666,62,0,utRho11
1231,relA,5828554,5828554,5827302,1252,384,utRho11
1232,relB,3291806,3291806,3291744,62,208,utRho11
1233,rem,3289950,3289950,3289804,146,0,utRho11
1234,rep,7921294,7921354,7921294,60,194,utRho11
1235,rfaD,7587730,7587974,7587730,244,172,utRho11
1236,rfaE,6393852,6393852,6393506,346,152,utRho11
1237,rfaH,8049930,8049930,8049642,288,2128,utRho11
1238,rfbX,4219436,4219436,4219168,268,3540,utRho11
1239,rfe,7935600,7935832,7935600,232,356,utRho11
1240,rhaB,8194944,8194944,8194896,48,0,utRho11
1241,rhaD,8188770,8188770,8188544,226,2,utRho11
1242,rhaS,8195422,8195472,8195422,50,0,utRho11
1243,rhaT,8201132,8201132,8201050,82,0,utRho11
1244,rhlE,1661566,1661744,1661566,178,94,utRho11
1245,rhoL,47593944,47594772,47593944,828,301704,utRho11
1246,rhsB,7238006,7238384,7238006,378,382,utRho11
1247,rhsC,1458758,1459166,1458758,408,0,utRho11
1248,rhsD,1046132,1046522,1046132,390,0,utRho11
1249,rhtA,1700608,1700608,1700194,414,0,utRho11
1250,rhtC,8015478,8015514,8015478,36,1032,utRho11
1251,ribA,2678468,2678468,2678320,148,138,utRho11
1252,ribC,3486916,3486916,3486484,432,2116,utRho11
1253,ribE,869008,869294,869008,286,6416,utRho11
1254,ribF,42766,42814,42766,48,42,utRho11
1255,ridA,8941892,8941892,8941826,66,130,utRho11
1256,rihA,1369204,1369204,1368824,380,3144,utRho11
1257,rihB,4510504,4510504,4510372,132,46,utRho11
1258,rimJ,2251044,2251124,2251044,80,42,utRho11
1259,rimK,1783752,1783934,1783752,182,316,utRho11
1260,rimL,2997486,2997876,2997486,390,182,utRho11
1261,rimO,1756140,1756140,1756070,70,0,utRho11
1262,rimP,6636350,6636350,6636012,338,650,utRho11
1263,rlmA,3814172,3814172,3814120,52,1008,utRho11
1264,rlmD,5830086,5830086,5830000,86,26,utRho11
1265,rlmE,6655520,6655520,6655328,192,1608,utRho11
1266,rlmF,1684384,1684664,1684384,280,120,utRho11
1267,rlmG,6471784,6471784,6471750,34,2,utRho11
1268,rlmI,2060002,2060002,2059938,64,378,utRho11
1269,rlmJ,7290700,7290770,7290700,70,88,utRho11
1270,rlmL,2015344,2015688,2015344,344,2370,utRho11
1271,rlpA,1330444,1330444,1330380,64,212,utRho11
1272,rluA,120900,120900,120692,208,606,utRho11
1273,rluF,8460324,8460708,8460324,384,112,utRho11
1274,rmf,2031006,2031430,2031006,424,2666,utRho11
1275,rna,1290068,1290068,1290006,62,0,utRho11
1276,rnb,2698258,2698258,2697824,434,3874,utRho11
1277,rnc,10816892,10816892,10816252,640,12372,utRho11
1278,rnd,3776122,3776122,3775982,140,302,utRho11
1279,rne,2289746,2289746,2288734,1012,9846,utRho11
1280,rnhA,472082,472082,472004,78,396,utRho11
1281,rnk,1288360,1288360,1287934,426,240,utRho11
1282,rnlA,5531788,5531836,5531788,48,438,utRho11
1283,rnlB,5533414,5533968,5533414,554,978,utRho11
1284,rnpB,19623552,19623552,19623552,0,0,utRho11
1285,rob,9270706,9270706,9270620,86,90,utRho11
1286,rodZ,5285868,5285868,5285688,180,76,utRho11
1287,rpe,7030306,7030306,7030118,188,176,utRho11
1288,rph,15266320,15266320,15266196,124,56,utRho11
1289,rpiA,6118706,6118706,6118650,56,458,utRho11
1290,rpiB,8626514,8626700,8626514,186,48,utRho11
1291,rpiR,8626274,8626274,8625982,292,0,utRho11
1292,rplJ,8359246,8359992,8359246,746,12764,utRho11
1293,rplK,8356708,8356894,8356708,186,918,utRho11
1294,rplM,6757344,6757344,6757302,42,10732,utRho11
1295,rplN,6896444,6896444,6896298,146,11052,utRho11
1296,rplS,5489284,5489284,5489060,224,21662,utRho11
1297,rplT,7199052,7199052,7198996,56,1876,utRho11
1298,rplU,6667036,6667036,6666902,134,0,utRho11
1299,rplY,4564866,4565034,4564866,168,356,utRho11
1300,rpmA,6666450,6666450,6666238,212,1060,utRho11
1301,rpmB,15247980,15247980,15246696,1284,166776,utRho11
1302,rpmE,8253816,8254026,8253816,210,1164,utRho11
1303,rpmF,2294676,2294734,2294676,58,58362,utRho11
1304,rpmH,7768130,7768672,7768130,542,7644,utRho11
1305,rpmI,3600854,3600854,3599998,856,15442,utRho11
1306,rpoB,8362126,8362490,8362126,364,1188,utRho11
1307,rpoD,6424946,6426094,6424946,1148,32998,utRho11
1308,rpoE,5420372,5420372,5420024,348,68,utRho11
1309,rpoH,7202006,7202006,7201566,440,8784,utRho11
1310,rpoN,6689324,6689434,6689324,110,50,utRho11
1311,rpoS,5736236,5736236,5735102,1134,2512,utRho11
1312,rpoZ,7644154,7644212,7644154,58,972,utRho11
1313,rppH,5937986,5937986,5937954,32,0,utRho11
1314,rprA,3540744,3540744,3540744,0,0,utRho11
1315,rpsA,1923434,1923990,1923434,556,222476,utRho11
1316,rpsF,8850050,8850236,8850050,186,49844,utRho11
1317,rpsI,6756580,6756580,6756414,166,12896,utRho11
1318,rpsJ,6906884,6906884,6906540,344,15436,utRho11
1319,rpsL,6949242,6949242,6949104,138,82,utRho11
1320,rpsM,6885130,6885130,6884942,188,2390,utRho11
1321,rpsO,13247144,13247144,13246736,408,3688,utRho11
1322,rpsP,5492508,5492508,5492370,138,104,utRho11
1323,rpsT,42420,42420,42156,264,1580,utRho11
1324,rpsU,12842584,12843124,12842584,540,3168,utRho11
1325,rraA,8238716,8238716,8238660,56,350,utRho11
1326,rraB,8956768,8956946,8956768,178,16,utRho11
1327,rrsA,8070478,8071062,8070478,584,7536,utRho11
1328,rrsB,16665468,16666636,16665468,1168,15708,utRho11
1329,rrsC,7883032,7883616,7883032,584,7748,utRho11
1330,rrsD,6858094,6858094,6857524,570,490,utRho11
1331,rrsE,8415726,8416294,8415726,568,1246,utRho11
1332,rrsG,5462896,5462896,5462314,582,6438,utRho11
1333,rrsH,446970,447542,446970,572,2036,utRho11
1334,rsd,8393908,8393908,8393616,292,136,utRho11
1335,rseA,5419264,5419264,5418808,456,0,utRho11
1336,rseP,392940,393092,392940,152,4,utRho11
1337,rseX,4067298,4067298,4067298,0,0,utRho11
1338,rsfS,1338144,1338144,1338072,72,244,utRho11
1339,rsgA,8783132,8783132,8783018,114,40,utRho11
1340,rsmA,105176,105176,104860,316,4080,utRho11
1341,rsmB,6869982,6870414,6869982,432,668,utRho11
1342,rsmC,9215736,9215736,9215400,336,408,utRho11
1343,rsmD,7208594,7208786,7208594,192,0,utRho11
1344,rsmE,6182036,6182268,6182036,232,318,utRho11
1345,rsmG,7847512,7847512,7847360,152,2906,utRho11
1346,rsmH,180020,180188,180020,168,138,utRho11
1347,rsmI,6587106,6587106,6586670,436,1098,utRho11
1348,rssA,2578212,2578412,2578212,200,598,utRho11
1349,rssB,2580440,2580484,2580440,44,122,utRho11
1350,rstA,3364276,3364300,3364276,24,0,utRho11
1351,rsuA,4561096,4561096,4560966,130,216,utRho11
1352,rsxA,3411510,3411534,3411510,24,2,utRho11
1353,rtcA,7114004,7114004,7113698,306,486,utRho11
1354,rtcB,7116214,7116214,7116158,56,84,utRho11
1355,rtn,4541356,4541452,4541356,96,6,utRho11
1356,rutA,2148052,2148052,2148022,30,0,utRho11
1357,rutG,2140090,2140090,2139678,412,56,utRho11
1358,rutR,2148226,2148484,2148226,258,366,utRho11
1359,ruvA,7784096,7784096,7783904,192,24,utRho11
1360,ruvB,7782176,7782176,7781424,752,720,utRho11
1361,ruvC,3894878,3894878,3894752,126,0,utRho11
1362,rybB,1776114,1776114,1776114,0,0,utRho11
1363,rydB,3529860,3529860,3529322,538,216,utRho11
1364,rydC,2983012,2983012,2983012,0,0,utRho11
1365,ryfA,5307398,5307710,5307398,312,240,utRho11
1366,ryfD,5468590,5468590,5468590,0,0,utRho11
1367,ryhB,7162032,7162032,7162032,0,0,utRho11
1368,ryjA,8556132,8556132,8556132,0,0,utRho11
1369,ryjB,9055954,9055954,9055954,0,0,utRho11
1370,sad,3229598,3229598,3229406,192,144,utRho11
1371,safA,3168056,3168056,3167918,138,46,utRho11
1372,sanA,4465368,4465756,4465368,388,128,utRho11
1373,sapF,2705314,2705314,2705268,46,160,utRho11
1374,sbcB,4165456,4165512,4165456,56,0,utRho11
1375,sbcC,831694,831694,831506,188,240,utRho11
1376,sbcD,833954,833954,833904,50,0,utRho11
1377,sbmA,793106,793278,793106,172,540,utRho11
1378,sbmC,4162650,4162650,4162524,126,2,utRho11
1379,sdaA,3793618,3793864,3793618,246,130,utRho11
1380,sdaC,5856070,5856458,5856070,388,1518,utRho11
1381,sdhC,1509916,1510354,1509916,438,43864,utRho11
1382,sdhD,1510808,1511120,1510808,312,9736,utRho11
1383,sdiA,3993834,3993834,3993664,170,150,utRho11
1384,secE,8354354,8354716,8354354,362,240,utRho11
1385,secG,6645180,6645180,6645010,170,998,utRho11
1386,selA,7522594,7522594,7522498,96,836,utRho11
1387,selB,7519850,7519850,7519722,128,324,utRho11
1388,selC,7672396,7672444,7672396,48,120,utRho11
1389,selD,3696058,3696058,3696016,42,2274,utRho11
1390,seqA,1425884,1425974,1425884,90,300,utRho11
1391,serA,6117098,6117098,6116820,278,566,utRho11
1392,serB,9249712,9249790,9249712,78,284,utRho11
1393,serC,3830380,3830612,3830380,232,0,utRho11
1394,serS,1878730,1878856,1878730,126,2568,utRho11
1395,serT,2063438,2063438,2063424,14,0,utRho11
1396,serU,4087124,4087124,4087114,10,2,utRho11
1397,serV,5637394,5637394,5637290,104,130,utRho11
1398,serW,1852014,1852014,1851942,72,164,utRho11
1399,serX,2195352,2195352,2195304,48,22,utRho11
1400,setB,4527426,4527726,4527426,300,68,utRho11
1401,setC,7673488,7673906,7673488,418,1730,utRho11
1402,sfmA,1116124,1116424,1116124,300,0,utRho11
1403,sfmC,1117606,1117948,1117606,342,0,utRho11
1404,sfsA,323030,323030,322972,58,560,utRho11
1405,sfsB,6669592,6669818,6669592,226,604,utRho11
1406,sgrR,154676,154676,154598,78,0,utRho11
1407,sgrS,154734,154734,154734,0,0,utRho11
1408,shiA,4107068,4107286,4107068,218,4,utRho11
1409,sibA,4306622,4306622,4306622,0,0,utRho11
1410,sibB,4307292,4307292,4307292,0,0,utRho11
1411,sibC,6113702,6113702,6113702,0,0,utRho11
1412,sibD,6389730,6389730,6389730,0,0,utRho11
1413,sibE,6390480,6390480,6390480,0,0,utRho11
1414,sixA,4913998,4913998,4913624,374,0,utRho11
1415,slp,7307872,7307922,7307872,50,0,utRho11
1416,slt,9261400,9261466,9261400,66,0,utRho11
1417,slyA,3442028,3442028,3441648,380,64,utRho11
1418,slyB,3439496,3439752,3439496,256,60,utRho11
1419,slyD,6957398,6957398,6956994,404,622,utRho11
1420,slyX,6954862,6955280,6954862,418,8598,utRho11
1421,smf,6867372,6867372,6867120,252,106,utRho11
1422,smpB,5509534,5509792,5509534,258,950,utRho11
1423,smrA,2811872,2811958,2811872,86,426,utRho11
1424,smrB,4896872,4897212,4896872,340,248,utRho11
1425,smtA,1946808,1947074,1946808,266,36,utRho11
1426,sodA,8201518,8201620,8201518,102,10232,utRho11
1427,sodB,3470646,3470756,3470646,110,464,utRho11
1428,sodC,3449358,3449358,3449310,48,2,utRho11
1429,sohB,2658568,2658664,2658568,96,598,utRho11
1430,sokB,2984232,2984238,2984232,6,26,utRho11
1431,solA,2241218,2241218,2241172,46,0,utRho11
1432,soxR,8554894,8554938,8554894,44,0,utRho11
1433,soxS,8554846,8554846,8554766,80,0,utRho11
1434,speA,6172096,6172096,6171822,274,612,utRho11
1435,speB,6167892,6167892,6167594,298,348,utRho11
1436,speC,6218350,6218350,6218310,40,188,utRho11
1437,spf,8099798,8099798,8099798,0,0,utRho11
1438,sppA,3697422,3697674,3697422,252,74,utRho11
1439,spy,3651376,3651376,3651250,126,102,utRho11
1440,sra,3112092,3112092,3111926,166,0,utRho11
1441,sraB,2293178,2293178,2293178,0,0,utRho11
1442,sraC,3846132,3846132,3846132,0,0,utRho11
1443,srlA,5651582,5651664,5651582,82,96,utRho11
1444,srlR,5657720,5658094,5657720,374,748,utRho11
1445,srmB,5425752,5425792,5425752,40,208,utRho11
1446,sroA,151216,151216,151216,0,0,utRho11
1447,sroG,6369436,6369436,6369436,0,0,utRho11
1448,sroH,8380974,8380974,8380974,0,0,utRho11
1449,ssb,8548022,8548250,8548022,228,170,utRho11
1450,sseA,5304782,5304988,5304782,206,7616,utRho11
1451,sspA,6755138,6755138,6754840,298,580,utRho11
1452,ssrA,5511014,5511186,5511014,172,158,utRho11
1453,ssrS,12223036,12223932,12223036,896,2232,utRho11
1454,sstT,6479726,6479888,6479726,162,44,utRho11
1455,ssuB,1988282,1988282,1988088,194,168,utRho11
1456,ssuE,1995126,1995126,1995024,102,0,utRho11
1457,sthA,8321604,8321604,8321580,24,888,utRho11
1458,stpA,5597156,5597156,5596990,166,132,utRho11
1459,sucA,3034344,3034824,3034344,480,3140,utRho11
1460,sufA,3528836,3528836,3528772,64,234,utRho11
1461,sufE,3518962,3518962,3518580,382,430,utRho11
1462,sugE,8753588,8753750,8753588,162,2516,utRho11
1463,sulA,2041894,2041894,2041838,56,4658,utRho11
1464,syd,5850738,5850738,5850560,178,218,utRho11
1465,symE,9159834,9159834,9159680,154,626,utRho11
1466,symR,9159670,9159670,9159670,0,0,utRho11
1467,tabA,8949566,8949724,8949566,158,0,utRho11
1468,talA,5157140,5157332,5157140,192,0,utRho11
1469,talB,16382,16476,16382,94,8148,utRho11
1470,tam,3214442,3214692,3214442,250,48,utRho11
1471,tamA,8884540,8884764,8884540,224,386,utRho11
1472,tar,3945432,3945432,3945382,50,150,utRho11
1473,tas,5943138,5943194,5943138,56,1600,utRho11
1474,tatA,16087636,16087780,16087636,144,304,utRho11
1475,tatE,1317742,1317894,1317742,152,144,utRho11
1476,tauA,770410,770464,770410,54,56,utRho11
1477,tdcA,6534186,6534186,6534130,56,0,utRho11
1478,tdcG,6519652,6519652,6519298,354,268,utRho11
1479,tdcR,6534380,6534760,6534380,380,62,utRho11
1480,tdk,2586986,2587054,2586986,68,0,utRho11
1481,tehA,3001072,3001146,3001072,74,0,utRho11
1482,tesA,1039898,1039898,1039530,368,326,utRho11
1483,tesB,950402,950402,950322,80,22,utRho11
1484,tfaE,2418532,2418532,2418238,294,232,utRho11
1485,tfaQ,3269912,3269912,3269770,142,346,utRho11
1486,tff,379424,379256,379424,168,0,utRho11
1487,tgt,852110,852274,852110,164,30,utRho11
1488,thiD,4369346,4369346,4369032,314,4,utRho11
1489,thiI,882936,883098,882936,162,320,utRho11
1490,thiM,4370902,4370902,4370602,300,720,utRho11
1491,thiQ,146170,146170,145854,316,514,utRho11
1492,thrL,592,760,592,168,352,utRho11
1493,thrS,7210932,7210932,7210280,652,1120,utRho11
1494,thrU,8350762,8350776,8350762,14,8,utRho11
1495,thrV,6847414,6847414,6847310,104,213490,utRho11
1496,thrW,525682,525742,525682,60,2098,utRho11
1497,thyA,5930696,5930696,5930310,386,3664,utRho11
1498,tig,909986,910266,909986,280,1066,utRho11
1499,tisB,7706674,7707106,7706674,432,682,utRho11
1500,tktA,6163414,6163414,6163270,144,156,utRho11
1501,tktB,5158616,5159272,5158616,656,802,utRho11
1502,tldD,6784368,6784368,6784056,312,68,utRho11
1503,tmcA,5191876,5191876,5191718,158,80,utRho11
1504,tnaC,15553644,15553740,15553644,96,1740,utRho11
1505,tolB,1555074,1555480,1555074,406,420,utRho11
1506,tolC,6356008,6356230,6356008,222,438,utRho11
1507,tomB,961588,961588,961416,172,2028,utRho11
1508,tonB,2622108,2622178,2622108,70,0,utRho11
1509,topA,2661578,2662096,2661578,518,82,utRho11
1510,torC,2116112,2116168,2116112,56,38,utRho11
1511,torR,2115968,2115968,2115908,60,70,utRho11
1512,torS,2112364,2112364,2112356,8,0,utRho11
1513,torT,2112414,2112522,2112414,108,0,utRho11
1514,tpiA,8223138,8223138,8223014,124,240,utRho11
1515,tppB,3425342,3425538,3425342,196,7350,utRho11
1516,tpr,2574376,2574376,2574376,0,0,utRho11
1517,tpx,2777688,2777688,2777622,66,848,utRho11
1518,tqsA,3347780,3347826,3347780,46,194,utRho11
1519,treA,2494850,2494850,2494752,98,1764,utRho11
1520,treB,8932420,8932420,8932360,60,226,utRho11
1521,treF,7339102,7339184,7339102,82,48,utRho11
1522,treR,8934694,8934694,8934492,202,0,utRho11
1523,trg,2984878,2984940,2984878,62,114,utRho11
1524,trkG,2847342,2847564,2847342,222,144,utRho11
1525,trmA,8326590,8326590,8326540,50,124,utRho11
1526,trpA,2634678,2634678,2634444,234,1042,utRho11
1527,trpC,2639888,2639888,2639570,318,0,utRho11
1528,trpL,5292432,5292432,5292328,104,0,utRho11
1529,trpR,9265408,9265520,9265408,112,208,utRho11
1530,trpS,7027394,7027394,7027276,118,2654,utRho11
1531,trpT,7893560,7893914,7893560,354,122216,utRho11
1532,trxA,7931294,7931522,7931294,228,550,utRho11
1533,trxB,1864156,1864156,1864100,56,0,utRho11
1534,trxC,5437350,5437470,5437350,120,86,utRho11
1535,tsaD,6421256,6421256,6421086,170,0,utRho11
1536,tsgA,6985038,6985136,6985038,98,14,utRho11
1537,tsr,9182824,9183314,9182824,490,356,utRho11
1538,tsx,864490,864490,864026,464,298,utRho11
1539,ttcA,2823970,2823970,2823896,74,3240,utRho11
1540,ttdA,6412848,6412926,6412848,78,0,utRho11
1541,ttdR,6412760,6412760,6412512,248,250,utRho11
1542,tufA,6943448,6943448,6942658,790,206746,utRho11
1543,tus,3368346,3368518,3368346,172,32,utRho11
1544,tusA,7218040,7218040,7217992,48,168,utRho11
1545,tusB,6950218,6950218,6949930,288,2090,utRho11
1546,tynA,2902996,2902996,2902698,298,0,utRho11
1547,typA,8116460,8116814,8116460,354,11388,utRho11
1548,tyrB,8534164,8534228,8534164,64,3810,utRho11
1549,tyrP,3979004,3979362,3979004,358,1646,utRho11
1550,tyrR,2773384,2773440,2773384,56,64,utRho11
1551,tyrS,3434566,3434566,3434444,122,32,utRho11
1552,tyrT,2575330,2575330,2575244,86,10,utRho11
1553,uacT,6062378,6062734,6062378,356,84,utRho11
1554,ubiC,8504886,8505012,8504886,126,58,utRho11
1555,ubiD,8049618,8049976,8049618,358,2228,utRho11
1556,ubiE,8037494,8037710,8037494,216,88,utRho11
1557,ubiG,4679078,4679134,4679078,56,0,utRho11
1558,ucpA,5089342,5089342,5089246,96,0,utRho11
1559,udp,8032782,8032862,8032782,80,40,utRho11
1560,ugd,4199470,4199470,4199226,244,4,utRho11
1561,ugpB,7184852,7184852,7184650,202,2154,utRho11
1562,ugpQ,7176600,7176600,7176226,374,44,utRho11
1563,uhpT,7694396,7694396,7694334,62,106,utRho11
1564,uidA,3392304,3392304,3392142,162,0,utRho11
1565,uidC,3386012,3386012,3385702,310,0,utRho11
1566,uidR,3394150,3394150,3394104,46,0,utRho11
1567,ulaA,8839854,8839960,8839854,106,136,utRho11
1568,ulaG,8839350,8839350,8839250,100,88,utRho11
1569,ulaR,8837124,8837124,8836906,218,0,utRho11
1570,umpG,5741372,5741372,5740548,824,42,utRho11
1571,umpH,1400704,1400704,1400652,52,0,utRho11
1572,umuD,2461476,2461534,2461476,58,0,utRho11
1573,ung,5433476,5433508,5433476,32,130,utRho11
1574,uof,2843316,2843316,2842900,416,7824,utRho11
1575,upp,5241818,5241818,5241744,74,460,utRho11
1576,usg,4873780,4873780,4873298,482,222,utRho11
1577,ushA,1009772,1009828,1009772,56,34,utRho11
1578,uspA,7279966,7280222,7279966,256,672,utRho11
1579,uspB,7279696,7279696,7279440,256,292,utRho11
1580,uspC,3959172,3959506,3959172,334,0,utRho11
1581,uspE,2797318,2797318,2797244,74,62,utRho11
1582,uspF,2871282,2871282,2871238,44,0,utRho11
1583,uspG,1283806,1283806,1283734,72,2272,utRho11
1584,uvrA,8547872,8547872,8547742,130,42,utRho11
1585,uvrB,1626304,1627052,1626304,748,980,utRho11
1586,uvrC,3989758,3989758,3989412,346,296,utRho11
1587,uvrD,7995814,7995966,7995814,152,226,utRho11
1588,uvrY,3990812,3990812,3990718,94,166,utRho11
1589,uxaB,3221474,3221474,3221360,114,178,utRho11
1590,uxaC,6489714,6489714,6489482,232,0,utRho11
1591,uxuA,9103036,9103272,9103036,236,462,utRho11
1592,uxuR,9108916,9109152,9108916,236,0,utRho11
1593,valS,8967854,8967854,8967674,180,970,utRho11
1594,valU,5041848,5041862,5041848,14,4,utRho11
1595,valV,3492830,3492870,3492830,40,40,utRho11
1596,ves,3649968,3649968,3649874,94,90,utRho11
1597,waaA,7616512,7617080,7616512,568,292,utRho11
1598,waaH,7580298,7580298,7580162,136,108,utRho11
1599,waaQ,7616476,7616476,7616196,280,208,utRho11
1600,waaU,7598996,7598996,7598624,372,150,utRho11
1601,waaY,7602272,7602272,7601930,342,7392,utRho11
1602,wbbH,4214888,4214888,4214452,436,4134,utRho11
1603,wbbK,4209212,4209212,4209018,194,96,utRho11
1604,wcaM,4231868,4231868,4231792,76,0,utRho11
1605,wrbA,2135516,2135516,2135416,100,16,utRho11
1606,wza,4275166,4275166,4274486,680,0,utRho11
1607,wzxC,4240674,4240674,4240316,358,0,utRho11
1608,wzzB,4196950,4196950,4196602,348,196,utRho11
1609,xanP,7657642,7657890,7657642,248,0,utRho11
1610,xanQ,6048520,6048702,6048520,182,20,utRho11
1611,xapA,5049820,5049820,5049756,64,2,utRho11
1612,xapR,10090252,10090252,10089908,344,0,utRho11
1613,xdhA,6000514,6000690,6000514,176,242,utRho11
1614,xerD,6079702,6079702,6079486,216,254,utRho11
1615,xseA,5268394,5268464,5268394,70,208,utRho11
1616,xseB,882746,882746,882686,60,212,utRho11
1617,xthA,3664798,3664856,3664798,58,0,utRho11
1618,xylA,7461614,7461614,7461530,84,1766,utRho11
1619,xylE,8484540,8484540,8484508,32,0,utRho11
1620,xylF,7462138,7462262,7462138,124,202,utRho11
1621,xylR,7469812,7469958,7469812,146,38,utRho11
1622,yaaA,13230,13230,12918,312,328,utRho11
1623,yaaI,23876,23876,23572,304,856,utRho11
1624,yaaJ,16034,16034,15918,116,0,utRho11
1625,yaaU,91184,91614,91184,430,0,utRho11
1626,yaaW,23084,23084,22712,372,146,utRho11
1627,yaaX,10060,10468,10060,408,16,utRho11
1628,yabI,142542,142702,142542,160,166,utRho11
1629,yacC,273880,273880,273834,46,1040,utRho11
1630,yacH,262932,262932,262520,412,36,utRho11
1631,yacL,268678,268776,268678,98,594,utRho11
1632,yadD,293796,293936,293796,140,62,utRho11
1633,yadE,289930,290162,289930,232,1292,utRho11
1634,yadN,314110,314110,313766,344,502,utRho11
1635,yadS,355572,355572,355248,324,2000,utRho11
1636,yadV,312470,312470,312402,68,86,utRho11
1637,yaeF,434270,434270,434006,264,0,utRho11
1638,yaeP,428374,428374,428250,124,602,utRho11
1639,yaeQ,428176,428582,428176,406,982,utRho11
1640,yaeR,423716,423754,423716,38,34,utRho11
1641,yafC,462166,462166,461762,404,38,utRho11
1642,yafD,462128,462244,462128,116,102,utRho11
1643,yafK,491986,491986,491610,376,2538,utRho11
1644,yafL,493282,493424,493282,142,0,utRho11
1645,yafN,503938,504010,503938,72,26,utRho11
1646,yafS,469568,469632,469568,64,1234,utRho11
1647,yafT,474470,474670,474470,200,0,utRho11
1648,yafV,480432,480432,480378,54,26,utRho11
1649,yafZ,536052,536052,536010,42,114,utRho11
1650,yagE,564446,564556,564446,110,0,utRho11
1651,yagG,570414,570790,570414,376,74,utRho11
1652,yagI,578384,578384,578324,60,44,utRho11
1653,yagK,586236,586236,585896,340,354,utRho11
1654,yagL,588062,588062,587836,226,488,utRho11
1655,yagN,591342,591342,591158,184,276,utRho11
1656,yahA,663746,664742,663746,996,2480,utRho11
1657,yahC,670136,670136,670044,92,766,utRho11
1658,yahE,671478,671850,671478,372,170,utRho11
1659,yahM,690504,690808,690504,304,394,utRho11
1660,yahN,692872,692872,692674,198,218,utRho11
1661,yahO,692864,692968,692864,104,72,utRho11
1662,yaiE,816296,816354,816296,58,76,utRho11
1663,yaiI,811396,811528,811396,132,54,utRho11
1664,yaiO,761946,761946,761684,262,68,utRho11
1665,yaiP,767970,767970,767870,100,0,utRho11
1666,yaiS,769660,769660,769232,428,0,utRho11
1667,yaiV,788922,788922,788922,0,0,utRho11
1668,yaiY,799094,799094,798666,428,374,utRho11
1669,yaiZ,798888,799186,798888,298,1734,utRho11
1670,yajC,854410,854574,854410,164,706,utRho11
1671,yajD,860938,861210,860938,272,760,utRho11
1672,yajI,866068,866068,865702,366,252,utRho11
1673,yajL,887496,887496,887282,214,308,utRho11
1674,yajQ,889316,889366,889316,50,136,utRho11
1675,yajR,893374,893374,893332,42,662,utRho11
1676,ybaB,987418,988152,987418,734,4496,utRho11
1677,ybaL,1006590,1006590,1006476,114,56,utRho11
1678,ybaM,980648,980648,980542,106,1536,utRho11
1679,ybaN,981436,981764,981436,328,164,utRho11
1680,ybaO,936704,936766,936704,62,0,utRho11
1681,ybaP,1016568,1016568,1016160,408,1178,utRho11
1682,ybaQ,1016348,1016436,1016348,88,174,utRho11
1683,ybaS,1023146,1023282,1023146,136,90,utRho11
1684,ybaV,927504,927874,927504,370,94,utRho11
1685,ybaY,950490,950758,950490,268,68,utRho11
1686,ybbB,1062724,1062724,1062452,272,2,utRho11
1687,ybbJ,1030154,1030154,1029718,436,940,utRho11
1688,ybbL,1031784,1031838,1031784,54,0,utRho11
1689,ybbN,1037136,1037136,1036558,578,1878,utRho11
1690,ybbO,1038658,1038658,1038298,360,1634,utRho11
1691,ybbY,1080718,1081130,1080718,412,352,utRho11
1692,ybcH,1176140,1176140,1175962,178,66,utRho11
1693,ybcI,1113264,1113264,1113106,158,3466,utRho11
1694,ybcJ,1114050,1114050,1113746,304,150,utRho11
1695,ybcK,1137502,1137804,1137502,302,34,utRho11
1696,ybcL,1141690,1141786,1141690,96,0,utRho11
1697,ybcN,1144628,1144932,1144628,304,36,utRho11
1698,ybcQ,1147548,1147912,1147548,364,524,utRho11
1699,ybcW,1159610,1159760,1159610,150,0,utRho11
1700,ybdD,1263982,1264364,1263982,382,594,utRho11
1701,ybdF,1212106,1212106,1211772,334,100,utRho11
1702,ybdH,1267048,1267048,1266954,94,2,utRho11
1703,ybdJ,1212822,1212822,1212398,424,0,utRho11
1704,ybdK,1215122,1215122,1214766,356,2610,utRho11
1705,ybdL,1267114,1267172,1267114,58,2,utRho11
1706,ybdM,1271110,1271110,1270752,358,726,utRho11
1707,ybdN,1273372,1273372,1273138,234,0,utRho11
1708,ybdR,1283844,1284176,1283844,332,2808,utRho11
1709,ybeD,1325412,1325412,1325284,128,102,utRho11
1710,ybeF,1323090,1323090,1322756,334,1292,utRho11
1711,ybeL,1349986,1350036,1349986,50,2,utRho11
1712,ybeQ,1353412,1353412,1353094,318,76,utRho11
1713,ybeR,1353120,1353422,1353120,302,76,utRho11
1714,ybeT,1358832,1358832,1358812,20,0,utRho11
1715,ybeU,1358924,1359016,1358924,92,0,utRho11
1716,ybeZ,1386938,1386938,1386834,104,11416,utRho11
1717,ybfA,1458074,1458268,1458074,194,6,utRho11
1718,ybfE,1423878,1423878,1423796,82,520,utRho11
1719,ybfF,1425692,1425692,1425604,88,508,utRho11
1720,ybfH,1433282,1433282,1433194,88,0,utRho11
1721,ybgA,1477840,1478002,1477840,162,0,utRho11
1722,ybgC,1549288,1549504,1549288,216,104,utRho11
1723,ybgD,1505916,1505916,1505590,326,8470,utRho11
1724,ybgI,1485238,1485654,1485238,416,0,utRho11
1725,ybgO,1498370,1498370,1497964,406,98,utRho11
1726,ybgS,1570992,1570992,1570634,358,80,utRho11
1727,ybhA,1597184,1597184,1596862,322,102,utRho11
1728,ybhB,1616070,1616070,1615818,252,142,utRho11
1729,ybhC,1614642,1614642,1614562,80,1322,utRho11
1730,ybhD,1601418,1601418,1601276,142,32,utRho11
1731,ybhH,1601104,1601518,1601104,414,64,utRho11
1732,ybhK,1633384,1633384,1633294,90,0,utRho11
1733,ybhM,1641556,1641586,1641556,30,0,utRho11
1734,ybhN,1645296,1645296,1644996,300,72,utRho11
1735,ybhQ,1649202,1649260,1649202,58,324,utRho11
1736,ybiA,1665920,1665920,1665900,20,34,utRho11
1737,ybiI,1676968,1676968,1676912,56,354,utRho11
1738,ybiO,1691328,1691328,1690960,368,686,utRho11
1739,ybiP,1705252,1705252,1705194,58,1184,utRho11
1740,ybiS,1711572,1711572,1711488,84,600,utRho11
1741,ybiT,1711894,1711926,1711894,32,22,utRho11
1742,ybiU,1718212,1718212,1718122,90,36,utRho11
1743,ybiV,1720176,1720176,1720056,120,0,utRho11
1744,ybiW,1725566,1725566,1725212,354,2222,utRho11
1745,ybiX,1678548,1678548,1678414,134,184,utRho11
1746,ybjC,1781784,1781826,1781784,42,8,utRho11
1747,ybjE,1830154,1830154,1829714,440,0,utRho11
1748,ybjG,1767016,1767016,1766776,240,2406,utRho11
1749,ybjL,1779882,1779882,1779638,244,124,utRho11
1750,ybjM,1779770,1780178,1779770,408,494,utRho11
1751,ybjO,1795704,1795978,1795704,274,0,utRho11
1752,ybjP,1809046,1809046,1808934,112,0,utRho11
1753,ybjQ,1809034,1809186,1809034,152,0,utRho11
1754,ybjS,1813796,1813796,1813506,290,188,utRho11
1755,ybjX,1838206,1838206,1838168,38,0,utRho11
1756,ycaD,1891438,1891742,1891438,304,0,utRho11
1757,ycaI,1928210,1928640,1928210,430,350,utRho11
1758,ycaK,1899094,1899336,1899094,242,66,utRho11
1759,ycaL,1920264,1920528,1920264,264,56,utRho11
1760,ycaM,1894240,1894458,1894240,218,110,utRho11
1761,ycaR,1941284,1941346,1941284,62,4258,utRho11
1762,ycbB,1961862,1962094,1961862,232,48,utRho11
1763,ycbJ,1943344,1943504,1943344,160,130,utRho11
1764,ycbK,1966046,1966150,1966046,104,332,utRho11
1765,ycbZ,2036920,2036920,2036598,322,160,utRho11
1766,yccA,2062886,2062886,2062836,50,140,utRho11
1767,yccF,2048730,2048730,2048696,34,0,utRho11
1768,yccS,2047988,2047988,2047766,222,68,utRho11
1769,yccT,2055674,2055674,2055546,128,128,utRho11
1770,yccX,2059960,2060128,2059960,168,1222,utRho11
1771,ycdT,2185682,2185752,2185682,70,2,utRho11
1772,ycdU,2191266,2191686,2191266,420,144,utRho11
1773,ycdZ,2200504,2200592,2200504,88,138,utRho11
1774,yceA,2233544,2233614,2233544,70,74,utRho11
1775,yceD,2293298,2293588,2293298,290,7574,utRho11
1776,yceF,2293522,2293522,2293190,332,4510,utRho11
1777,yceH,2252154,2252314,2252154,160,1134,utRho11
1778,yceI,2237282,2237282,2236952,330,512,utRho11
1779,yceJ,2238142,2238142,2238092,50,402,utRho11
1780,yceM,2253208,2253612,2253208,404,260,utRho11
1781,yceO,2239264,2239264,2238894,370,420,utRho11
1782,yceQ,2288760,2289004,2288760,244,8308,utRho11
1783,ycfD,2376540,2376540,2376480,60,164,utRho11
1784,ycfJ,2334814,2335198,2334814,384,202,utRho11
1785,ycfS,2340834,2340834,2340748,86,0,utRho11
1786,ycfT,2350658,2350658,2350330,328,0,utRho11
1787,ycfZ,2362760,2362760,2362534,226,1348,utRho11
1788,ycgB,2474570,2474570,2474482,88,150,utRho11
1789,ycgG,2434614,2434656,2434614,42,410,utRho11
1790,ycgJ,2452956,2453200,2452956,244,150,utRho11
1791,ycgL,2455218,2455362,2455218,144,0,utRho11
1792,ycgN,2457366,2457660,2457366,294,294,utRho11
1793,ycgR,2489112,2489112,2489054,58,52,utRho11
1794,ycgV,2512222,2512222,2511904,318,1464,utRho11
1795,ycgX,2426568,2426568,2426214,354,31158,utRho11
1796,ycgY,2490166,2490320,2490166,154,864,utRho11
1797,ycgZ,2431504,2431578,2431504,74,156,utRho11
1798,ychE,2596904,2597196,2596904,292,36,utRho11
1799,ychF,2515764,2515764,2515624,140,0,utRho11
1800,ychH,2517476,2517582,2517476,106,1576,utRho11
1801,ychJ,2578354,2578354,2578264,90,0,utRho11
1802,ychN,2547310,2547310,2547198,112,34,utRho11
1803,ychO,2547520,2547850,2547520,330,94,utRho11
1804,ychQ,2533798,2533848,2533798,50,50,utRho11
1805,yciA,2624828,2624828,2624492,336,106,utRho11
1806,yciB,2626110,2626110,2625780,330,2996,utRho11
1807,yciC,2627396,2627396,2627326,70,94,utRho11
1808,yciE,2630794,2630794,2630448,346,126,utRho11
1809,yciG,5264368,5264368,5264140,228,0,utRho11
1810,yciI,2621784,2621784,2621730,54,46,utRho11
1811,yciN,2661606,2661606,2661336,270,54,utRho11
1812,yciS,2680270,2680486,2680270,216,96,utRho11
1813,yciT,2689088,2689088,2688692,396,1224,utRho11
1814,yciU,2614718,2614718,2614300,418,3032,utRho11
1815,yciV,2646376,2646440,2646376,64,0,utRho11
1816,yciW,2700472,2700472,2700214,258,3116,utRho11
1817,yciZ,2689276,2689276,2689218,58,922,utRho11
1818,ycjD,2703792,2703792,2703520,272,130,utRho11
1819,ycjG,2777748,2777860,2777748,112,200,utRho11
1820,ycjM,2740006,2740432,2740006,426,612,utRho11
1821,ycjW,2767982,2767982,2767922,60,62,utRho11
1822,ycjX,2768138,2768234,2768138,96,0,utRho11
1823,ycjY,5568288,5568288,5567460,828,1108,utRho11
1824,ydaE,2836438,2836438,2836016,422,462,utRho11
1825,ydaN,2816048,2816100,2816048,52,92,utRho11
1826,ydaS,2840340,2840730,2840340,390,18,utRho11
1827,ydbC,2948376,2948442,2948376,66,0,utRho11
1828,ydbD,2950132,2950288,2950132,156,0,utRho11
1829,ydbH,2885800,2886102,2885800,302,2,utRho11
1830,ydbJ,2881712,2882116,2881712,404,80,utRho11
1831,ydbK,2881692,2881692,2881568,124,40,utRho11
1832,ydcA,2983294,2983354,2983294,60,96,utRho11
1833,ydcF,2974404,2974470,2974404,66,48,utRho11
1834,ydcI,2990268,2990268,2990142,126,32,utRho11
1835,ydcJ,2990266,2990576,2990266,310,92,utRho11
1836,ydcK,3001280,3001280,3000898,382,18,utRho11
1837,ydcL,3004646,3004914,3004646,268,0,utRho11
1838,ydcN,3012308,3012344,3012308,36,362,utRho11
1839,ydcP,3013508,3013562,3013508,54,24,utRho11
1840,ydcR,3019956,3020006,3019956,50,0,utRho11
1841,ydcS,3022906,3023308,3022906,402,126,utRho11
1842,ydcX,3034442,3034778,3034442,336,658,utRho11
1843,ydcY,3035220,3035296,3035220,76,60,utRho11
1844,ydcZ,3036750,3036750,3036662,88,920,utRho11
1845,yddB,3155332,3155332,3155238,94,0,utRho11
1846,yddE,3071738,3071738,3071716,22,0,utRho11
1847,yddG,3094410,3094410,3094338,72,32,utRho11
1848,yddJ,3089732,3089732,3089438,294,0,utRho11
1849,yddW,3137704,3137704,3137646,58,26,utRho11
1850,ydeA,3233910,3234056,3233910,146,314,utRho11
1851,ydeE,3242528,3242664,3242528,136,0,utRho11
1852,ydeI,3249118,3249118,3248994,124,60,utRho11
1853,ydeJ,3249376,3249546,3249376,170,0,utRho11
1854,ydeN,3165458,3165458,3165048,410,0,utRho11
1855,ydeP,3173328,3173328,3172972,356,0,utRho11
1856,ydeR,3176596,3176596,3176592,4,2,utRho11
1857,ydfA,3296872,3297016,3296872,144,2,utRho11
1858,ydfG,3254982,3255034,3254982,52,0,utRho11
1859,ydfH,3256652,3256704,3256652,52,150,utRho11
1860,ydfK,3265446,3266144,3265446,698,17872,utRho11
1861,ydgA,3379588,3379704,3379588,116,30,utRho11
1862,ydgC,3364124,3364124,3364060,64,0,utRho11
1863,ydgD,3343906,3343920,3343906,14,120,utRho11
1864,ydgH,3356754,3356854,3356754,100,4,utRho11
1865,ydgJ,3408798,3408798,3408616,182,170,utRho11
1866,ydgK,3410414,3410500,3410414,86,840,utRho11
1867,ydhB,3479618,3479618,3479596,22,66,utRho11
1868,ydhC,3479698,3479822,3479698,124,0,utRho11
1869,ydhF,3451310,3451310,3451264,46,0,utRho11
1870,ydhI,3441996,3442050,3441996,54,0,utRho11
1871,ydhL,3451864,3451864,3451840,24,44,utRho11
1872,ydhQ,3492404,3492404,3492254,150,58,utRho11
1873,ydhS,3494136,3494262,3494136,126,2264,utRho11
1874,ydhT,3499138,3499138,3499118,20,28,utRho11
1875,ydhY,3509284,3509284,3508954,330,46,utRho11
1876,ydhZ,3510418,3510418,3510282,136,20,utRho11
1877,ydiE,3579206,3579226,3579206,20,0,utRho11
1878,ydiH,3530582,3530582,3530406,176,0,utRho11
1879,ydiM,3541852,3542142,3541852,290,0,utRho11
1880,ydiN,3544818,3545024,3544818,206,0,utRho11
1881,ydiP,3558656,3558656,3558602,54,104,utRho11
1882,ydiU,3582508,3582508,3582488,20,178,utRho11
1883,ydiV,3584174,3584174,3584040,134,522,utRho11
1884,ydiY,3612500,3612500,3612166,334,38,utRho11
1885,ydjA,3697400,3697400,3697352,48,72,utRho11
1886,ydjE,3708082,3708082,3707958,124,0,utRho11
1887,ydjF,3709848,3709848,3709708,140,64,utRho11
1888,ydjM,3620340,3620422,3620340,82,0,utRho11
1889,ydjO,3626696,3626696,3626288,408,32,utRho11
1890,ydjX,3666434,3666802,3666434,368,2980,utRho11
1891,yeaE,3731448,3731448,3731272,176,24,utRho11
1892,yeaG,3733530,3733816,3733530,286,0,utRho11
1893,yeaI,3740486,3740770,3740486,284,0,utRho11
1894,yeaJ,3743874,3744082,3743874,208,52,utRho11
1895,yeaL,3748646,3748704,3748646,58,364,utRho11
1896,yeaM,3751296,3751296,3751152,144,0,utRho11
1897,yeaN,3750926,3751346,3750926,420,0,utRho11
1898,yeaO,3753554,3753818,3753554,264,72,utRho11
1899,yeaP,3755314,3755430,3755314,116,604,utRho11
1900,yeaQ,3758780,3758780,3758510,270,818,utRho11
1901,yeaR,3759988,3759988,3759896,92,192,utRho11
1902,yeaY,3781122,3781122,3781064,58,0,utRho11
1903,yebB,3892220,3892502,3892220,282,1052,utRho11
1904,yebC,3896370,3896370,3896302,68,6,utRho11
1905,yebE,3859464,3859464,3859414,50,276,utRho11
1906,yebG,3861530,3861530,3861494,36,76,utRho11
1907,yebK,3873180,3873304,3873180,124,28,utRho11
1908,yebQ,3820314,3820552,3820314,238,126,utRho11
1909,yebS,3832238,3832516,3832238,278,34,utRho11
1910,yebV,3843430,3843560,3843430,130,0,utRho11
1911,yebW,3843914,3844242,3843914,328,1748,utRho11
1912,yecC,3995646,3995646,3995628,18,0,utRho11
1913,yecD,3901272,3901664,3901272,392,48,utRho11
1914,yecF,3991434,3991636,3991434,202,144,utRho11
1915,yecH,3979304,3979304,3978980,324,2134,utRho11
1916,yecJ,3975604,3975604,3975516,88,0,utRho11
1917,yecM,3919968,3919968,3919692,276,176,utRho11
1918,yecR,3976400,3976444,3976400,44,60,utRho11
1919,yecT,3923862,3923944,3923862,82,36,utRho11
1920,yedD,4016522,4016522,4016180,342,352,utRho11
1921,yedE,4016310,4016554,4016310,244,118,utRho11
1922,yedI,4058922,4058922,4058732,190,100,utRho11
1923,yedJ,4066446,4066446,4066158,288,84,utRho11
1924,yedV,4076404,4076404,4076304,100,140,utRho11
1925,yedX,4077680,4077912,4077680,232,0,utRho11
1926,yedY,4078572,4078956,4078572,384,60,utRho11
1927,yeeA,4161322,4161322,4161182,140,2,utRho11
1928,yeeE,4171104,4171104,4171050,54,30,utRho11
1929,yeeJ,4089526,4089822,4089526,296,4964,utRho11
1930,yeeN,4113508,4113716,4113508,208,1204,utRho11
1931,yeeO,4119444,4119444,4119692,248,2,utRho11
1932,yeeX,4158834,4158834,4158722,112,260,utRho11
1933,yeeZ,4178422,4178422,4178256,166,16,utRho11
1934,yefM,4179466,4179466,4179426,40,0,utRho11
1935,yegD,4295288,4295348,4295288,60,0,utRho11
1936,yegH,4275726,4275804,4275726,78,200,utRho11
1937,yegI,4302154,4302154,4301970,184,0,utRho11
1938,yegJ,4302032,4302370,4302032,338,48,utRho11
1939,yegQ,4331182,4331336,4331182,154,132,utRho11
1940,yegR,4336698,4336698,4336612,86,422,utRho11
1941,yegS,4337086,4337424,4337086,338,146,utRho11
1942,yegT,4357562,4357642,4357562,80,132,utRho11
1943,yegX,4367640,4367640,4367302,338,146,utRho11
1944,yehA,4376944,4376944,4376828,116,0,utRho11
1945,yehE,4385818,4385818,4385592,226,34,utRho11
1946,yehK,4407568,4407944,4407568,376,2,utRho11
1947,yehL,4408804,4409192,4408804,388,48,utRho11
1948,yeiB,4486146,4486146,4485934,212,120,utRho11
1949,yeiE,4499422,4499422,4499236,186,2,utRho11
1950,yeiG,4487776,4487820,4487776,44,478,utRho11
1951,yeiH,4499332,4499434,4499332,102,62,utRho11
1952,yeiI,4503306,4503400,4503306,94,110,utRho11
1953,yeiL,4510580,4510710,4510580,130,0,utRho11
1954,yeiP,4530834,4530900,4530834,66,690,utRho11
1955,yeiQ,4532328,4532490,4532328,162,856,utRho11
1956,yeiR,4535484,4535658,4535484,174,162,utRho11
1957,yeiW,4530840,4530840,4530590,250,814,utRho11
1958,yejA,4544624,4544728,4544624,104,0,utRho11
1959,yejG,4556892,4556892,4556474,418,7178,utRho11
1960,yejH,4561244,4561264,4561244,20,0,utRho11
1961,yejK,4568218,4568218,4567894,324,44,utRho11
1962,yejO,4578352,4578352,4577800,552,190,utRho11
1963,yfaD,4713380,4713808,4713380,428,1618,utRho11
1964,yfaE,4696676,4697028,4696676,352,1008,utRho11
1965,yfaL,4688568,4688568,4688338,230,0,utRho11
1966,yfaP,4656398,4656398,4656286,112,14,utRho11
1967,yfaU,4717892,4717892,4717690,202,0,utRho11
1968,yfaY,4727310,4727310,4727266,44,62,utRho11
1969,yfaZ,4728744,4728744,4728550,194,154,utRho11
1970,yfbK,4771810,4771810,4771444,366,462,utRho11
1971,yfbL,4771500,4771720,4771500,220,434,utRho11
1972,yfbN,4777174,4777174,4776852,322,54,utRho11
1973,yfbO,4776916,4777162,4776916,246,54,utRho11
1974,yfbP,4777990,4778232,4777990,242,8774,utRho11
1975,yfbR,4817662,4817724,4817662,62,98,utRho11
1976,yfcI,4847424,4847424,4847078,346,1222,utRho11
1977,yfcJ,4880482,4880482,4880240,242,864,utRho11
1978,yfcL,4888502,4888502,4888338,164,120,utRho11
1979,yfcV,4911642,4911642,4911292,350,2,utRho11
1980,yfcZ,4921958,4921958,4921868,90,70,utRho11
1981,yfdF,4925604,4926024,4925604,420,17692,utRho11
1982,yfdG,4935474,4935710,4935474,236,52,utRho11
1983,yfdP,4946844,4947040,4946844,196,50,utRho11
1984,yfdX,4988866,4988866,4988804,62,0,utRho11
1985,yfdY,4990672,4990672,4990584,88,60,utRho11
1986,yfeA,5035784,5035784,5035664,120,36982,utRho11
1987,yfeC,5036668,5036934,5036668,266,184,utRho11
1988,yfeH,5053818,5053892,5053818,74,202,utRho11
1989,yfeK,5074630,5074684,5074630,54,40,utRho11
1990,yfeO,5018906,5019260,5018906,354,352,utRho11
1991,yfeR,5054078,5054078,5053712,366,240,utRho11
1992,yfeX,5101356,5101356,5101090,266,0,utRho11
1993,yfeY,5102486,5102486,5102432,54,64,utRho11
1994,yfeZ,5103842,5103842,5103452,390,0,utRho11
1995,yffO,5123804,5124222,5123804,418,12,utRho11
1996,yffQ,5126778,5127154,5126778,376,244,utRho11
1997,yffS,5128800,5128986,5128800,186,86,utRho11
1998,yfgC,5232052,5232188,5232052,136,0,utRho11
1999,yfgF,5258062,5258062,5257876,186,544,utRho11
2000,yfgG,5258170,5258580,5258170,410,1038,utRho11
2001,yfgH,5259344,5259584,5259344,240,74,utRho11
2002,yfgM,5278866,5278866,5278566,300,622,utRho11
2003,yfhH,5397414,5397518,5397414,104,0,utRho11
2004,yfhM,5304648,5304648,5304574,74,0,utRho11
2005,yfhR,5328408,5328726,5328408,318,13192,utRho11
2006,yfiC,5425610,5425610,5425528,82,2,utRho11
2007,yfiE,5430688,5430688,5430640,48,938,utRho11
2008,yfiL,5482630,5482720,5482630,90,0,utRho11
2009,yfiM,5448066,5448358,5448066,292,23582,utRho11
2010,yfiR,5483354,5483750,5483354,396,326,utRho11
2011,yfjH,5517326,5517326,5517200,126,0,utRho11
2012,yfjI,5517710,5517970,5517710,260,64,utRho11
2013,yfjJ,5521014,5521094,5521014,80,0,utRho11
2014,yfjM,5531970,5531970,5531552,418,3872,utRho11
2015,yfjP,5535080,5535420,5535080,340,1272,utRho11
2016,yfjW,5546570,5546636,5546570,66,0,utRho11
2017,yfjX,5551776,5551838,5551776,62,0,utRho11
2018,ygaC,5601180,5601180,5599988,1192,642,utRho11
2019,ygaM,5600242,5600292,5600242,50,144,utRho11
2020,ygaU,5593628,5593628,5593572,56,66,utRho11
2021,ygaZ,5619190,5619234,5619190,44,274,utRho11
2022,ygbA,5713656,5713656,5713612,44,46,utRho11
2023,ygbE,5746784,5746784,5746674,110,94,utRho11
2024,ygbI,5722882,5722882,5722528,354,12,utRho11
2025,ygbK,5724394,5724670,5724394,276,324,utRho11
2026,ygbL,5727074,5727186,5727074,112,70,utRho11
2027,ygbN,5729814,5730202,5729814,388,188,utRho11
2028,ygcG,5811210,5811422,5811210,212,40,utRho11
2029,ygcN,5785144,5785314,5785144,170,188,utRho11
2030,ygcU,5799214,5799214,5798836,378,98,utRho11
2031,ygcW,5800942,5800942,5800546,396,2,utRho11
2032,ygdD,5883442,5883442,5883262,180,160,utRho11
2033,ygdG,5861746,5861930,5861746,184,254,utRho11
2034,ygdI,5886526,5886526,5886290,236,448,utRho11
2035,ygdQ,5940784,5940840,5940784,56,0,utRho11
2036,ygdR,5942494,5942542,5942494,48,2,utRho11
2037,ygeA,5961606,5961606,5961270,336,78,utRho11
2038,ygeH,5983758,5984188,5983758,430,104,utRho11
2039,ygeI,5987162,5987276,5987162,114,532,utRho11
2040,ygeR,6000078,6000078,5999782,296,732,utRho11
2041,ygeV,6011694,6011694,6011572,122,116,utRho11
2042,ygeW,6012234,6012524,6012234,290,276,utRho11
2043,ygfB,6110946,6110946,6110888,58,98,utRho11
2044,ygfK,6031984,6032120,6031984,136,26,utRho11
2045,ygfS,6058328,6058328,6058024,304,2,utRho11
2046,ygfZ,6082564,6082626,6082564,62,422,utRho11
2047,yggC,6149512,6149512,6149378,134,190,utRho11
2048,yggE,6136370,6136370,6136160,210,192,utRho11
2049,yggI,6179176,6179510,6179176,334,478,utRho11
2050,yggL,6204508,6204508,6204266,242,228,utRho11
2051,yggM,6199514,6199514,6199130,384,392,utRho11
2052,yggN,6203596,6203596,6203246,350,100,utRho11
2053,yggX,18623958,18624558,18623958,600,0,utRho11
2054,yghA,6298966,6299324,6298966,358,42,utRho11
2055,yghB,6307058,6307126,6307058,68,2,utRho11
2056,yghD,6222614,6222614,6222252,362,1012,utRho11
2057,yghF,6225798,6225798,6225840,42,248,utRho11
2058,yghJ,6238640,6238640,6238224,416,0,utRho11
2059,yghQ,6265186,6265186,6264816,370,98,utRho11
2060,yghT,6267830,6268262,6267830,432,300,utRho11
2061,yghU,6277400,6277454,6277400,54,78,utRho11
2062,yghW,6293506,6293506,6293474,32,68,utRho11
2063,yghZ,6295562,6295794,6295562,232,176,utRho11
2064,ygiD,6365122,6365122,6364868,254,6260,utRho11
2065,ygiH,6409066,6409388,6409066,322,0,utRho11
2066,ygiL,6370622,6370828,6370622,206,82,utRho11
2067,ygiM,6402084,6402414,6402084,330,108,utRho11
2068,ygiN,6346156,6346284,6346156,128,694,utRho11
2069,ygiQ,6322620,6322620,6322292,328,1308,utRho11
2070,ygiS,6335462,6335462,6335436,26,70,utRho11
2071,ygiV,6338582,6338582,6338462,120,14,utRho11
2072,ygiW,6339774,6339774,6339352,422,528,utRho11
2073,ygiZ,6344506,6344506,6344422,84,66,utRho11
2074,ygjH,6442528,6442528,6442494,34,0,utRho11
2075,ygjI,6452140,6452468,6452140,328,10,utRho11
2076,ygjQ,6472730,6473080,6472730,350,304,utRho11
2077,ygjR,6474564,6474586,6474564,22,0,utRho11
2078,ygjV,6483638,6483638,6483488,150,0,utRho11
2079,yhaB,6535632,6535708,6535632,76,18,utRho11
2080,yhaH,6504498,6504608,6504498,110,252,utRho11
2081,yhaI,6505400,6505822,6505400,422,250,utRho11
2082,yhaJ,6508560,6508560,6508428,132,204,utRho11
2083,yhaK,6508538,6508638,6508538,100,204,utRho11
2084,yhbQ,6599878,6599932,6599878,54,520,utRho11
2085,yhbT,6602736,6602736,6602552,184,126,utRho11
2086,yhbU,6602558,6602970,6602558,412,126,utRho11
2087,yhbX,6643302,6643302,6643226,76,0,utRho11
2088,yhbY,6655518,6655580,6655518,62,1328,utRho11
2089,yhcA,6723956,6724224,6723956,268,2,utRho11
2090,yhcB,6760364,6760382,6760364,18,0,utRho11
2091,yhcC,6708470,6708470,6708100,370,778,utRho11
2092,yhcF,6733440,6733852,6733440,412,718,utRho11
2093,yhcH,6739124,6739124,6738956,168,296,utRho11
2094,yhcM,6760312,6760312,6759994,318,180,utRho11
2095,yhcN,6770812,6771076,6770812,264,800,utRho11
2096,yhcO,6772606,6772606,6772258,348,0,utRho11
2097,yhdH,6806560,6806968,6806560,408,0,utRho11
2098,yhdJ,6823234,6823306,6823234,72,0,utRho11
2099,yhdN,6879092,6879092,6879018,74,3694,utRho11
2100,yhdT,6814702,6814750,6814702,48,626,utRho11
2101,yhdU,6824994,6825242,6824994,248,370,utRho11
2102,yhdV,6836392,6836780,6836392,388,352,utRho11
2103,yhdW,6837944,6838298,6837944,354,0,utRho11
2104,yheO,6953082,6953082,6952880,202,748,utRho11
2105,yheV,6957970,6957970,6957584,386,130,utRho11
2106,yhfA,6971902,6971902,6971636,266,1042,utRho11
2107,yhfG,6983294,6983294,6983240,54,786,utRho11
2108,yhfL,6998622,6998896,6998622,274,210,utRho11
2109,yhfY,7023244,7023244,7022844,400,56,utRho11
2110,yhgA,7086294,7086334,7086294,40,0,utRho11
2111,yhgE,7065176,7065176,7064878,298,176,utRho11
2112,yhgF,7074352,7074770,7074352,418,5138,utRho11
2113,yhhA,7173458,7173886,7173458,428,166,utRho11
2114,yhhI,7248346,7248756,7248346,410,36,utRho11
2115,yhhJ,7253696,7253696,7253606,90,190,utRho11
2116,yhhM,7211588,7211588,7211220,368,304,utRho11
2117,yhhN,7211150,7211502,7211150,352,340,utRho11
2118,yhhQ,7218238,7218434,7218238,196,972,utRho11
2119,yhhT,7223682,7223730,7223682,48,12,utRho11
2120,yhhX,7162032,7162032,7161610,422,0,utRho11
2121,yhhY,7162222,7162276,7162222,54,0,utRho11
2122,yhhZ,7163516,7163726,7163516,210,158,utRho11
2123,yhiD,7312220,7312220,7311804,416,3440,utRho11
2124,yhiJ,7265190,7265190,7265180,10,2,utRho11
2125,yhiM,7269270,7269682,7269270,412,1138,utRho11
2126,yhiN,7275000,7275000,7274820,180,130,utRho11
2127,yhjA,7338522,7338522,7338376,146,0,utRho11
2128,yhjB,7344090,7344090,7343788,302,320,utRho11
2129,yhjC,7344272,7344684,7344272,412,36,utRho11
2130,yhjD,7346660,7346724,7346660,64,0,utRho11
2131,yhjE,7349274,7349572,7349274,298,744,utRho11
2132,yhjG,7356824,7356824,7356730,94,120,utRho11
2133,yhjH,7358458,7358458,7358374,84,302,utRho11
2134,yhjJ,7364032,7364032,7363880,152,406,utRho11
2135,yhjK,7371296,7371296,7371158,138,36,utRho11
2136,yhjR,7392750,7392750,7392370,380,0,utRho11
2137,yhjV,7400796,7401126,7400796,330,2206,utRho11
2138,yhjX,7424194,7424194,7424014,180,28,utRho11
2139,yhjY,7425966,7425966,7425868,98,0,utRho11
2140,yiaB,7455654,7455654,7455496,158,88,utRho11
2141,yiaD,7432712,7433094,7432712,382,220,utRho11
2142,yiaF,7438194,7438194,7438088,106,124,utRho11
2143,yiaG,7438862,7438956,7438862,94,82,utRho11
2144,yiaJ,7485236,7485236,7485064,172,208,utRho11
2145,yiaK,7485348,7485466,7485348,118,92,utRho11
2146,yiaT,7503924,7503924,7503736,188,0,utRho11
2147,yiaU,7503792,7503984,7503792,192,0,utRho11
2148,yiaY,7515856,7515856,7515654,202,4,utRho11
2149,yibF,7523950,7523950,7523910,40,92,utRho11
2150,yibG,7536128,7536354,7536128,226,2,utRho11
2151,yibL,7553194,7553330,7553194,136,70,utRho11
2152,yibN,7570112,7570112,7570030,82,174,utRho11
2153,yibT,7552848,7552848,7552760,88,896,utRho11
2154,yicC,7633290,7633352,7633290,62,116,utRho11
2155,yicH,7660862,7660914,7660862,52,0,utRho11
2156,yicJ,7673328,7673328,7671858,1470,12554,utRho11
2157,yicN,7685018,7685018,7684804,214,0,utRho11
2158,yicO,7687914,7687914,7687578,336,0,utRho11
2159,yicR,15250308,15250308,15250236,72,0,utRho11
2160,yidB,7755230,7755230,7754930,300,88,utRho11
2161,yidE,7732780,7732780,7732546,234,84,utRho11
2162,yidF,7711580,7711580,7711222,358,152,utRho11
2163,yidQ,7735088,7735456,7735088,368,920,utRho11
2164,yidR,7738824,7738824,7738618,206,150,utRho11
2165,yieE,7787658,7787738,7787658,80,8,utRho11
2166,yieH,7793314,7793548,7793314,234,168,utRho11
2167,yieK,7798928,7798928,7798786,142,4,utRho11
2168,yifB,7900350,7900350,7899998,352,436,utRho11
2169,yifL,7988984,7989044,7988984,60,3790,utRho11
2170,yigF,8005750,8005750,8005598,152,8146,utRho11
2171,yigI,8009448,8009448,8009394,54,4,utRho11
2172,yigM,8022100,8022152,8022100,52,258,utRho11
2173,yihA,8101970,8101970,8101458,512,62,utRho11
2174,yihD,8084098,8084138,8084098,40,0,utRho11
2175,yihF,8088110,8088398,8088110,288,134,utRho11
2176,yihG,8093304,8093304,8093204,100,64,utRho11
2177,yihI,8102616,8102694,8102616,78,0,utRho11
2178,yihL,8120506,8120894,8120506,388,244,utRho11
2179,yihN,8124332,8124494,8124332,162,2,utRho11
2180,yihO,8131942,8131942,8131532,410,44,utRho11
2181,yihQ,8138892,8138892,8138552,340,0,utRho11
2182,yihV,8147064,8147478,8147064,414,126,utRho11
2183,yihX,8151096,8151106,8151096,10,54,utRho11
2184,yiiE,8158192,8158582,8158192,390,248,utRho11
2185,yiiF,8159124,8159502,8159124,378,838,utRho11
2186,yiiG,8173762,8174004,8173762,242,0,utRho11
2187,yiiM,8205506,8205644,8205506,138,1152,utRho11
2188,yiiQ,8224624,8224624,8224428,196,124,utRho11
2189,yiiS,8225738,8225934,8225738,196,238,utRho11
2190,yijE,8272178,8272216,8272178,38,76,utRho11
2191,yijF,8275728,8275728,8275314,414,814,utRho11
2192,yijO,8296858,8296858,8296634,224,136,utRho11
2193,yjaA,8426240,8426468,8426240,228,120246,utRho11
2194,yjaB,8428312,8428312,8428246,66,410,utRho11
2195,yjaG,8398746,8399008,8398746,262,1590,utRho11
2196,yjaH,8401022,8401132,8401022,110,360,utRho11
2197,yjaZ,8379506,8379572,8379506,66,0,utRho11
2198,yjbB,8455204,8455462,8455204,258,0,utRho11
2199,yjbE,16943432,16943624,16943432,192,664,utRho11
2200,yjbL,8520318,8520642,8520318,324,70,utRho11
2201,yjbQ,8540428,8540476,8540428,48,190,utRho11
2202,yjcB,8550328,8550328,8550082,246,234,utRho11
2203,yjcC,8550836,8550942,8550836,106,132,utRho11
2204,yjcD,8556628,8556958,8556628,330,96,utRho11
2205,yjcE,8559658,8559960,8559658,302,0,utRho11
2206,yjcF,8566212,8566212,8566150,62,0,utRho11
2207,yjcO,8594660,8594660,8594250,410,14,utRho11
2208,yjdA,8654128,8654270,8654128,142,0,utRho11
2209,yjdC,8726660,8726660,8726616,44,10,utRho11
2210,yjdK,8704780,8705168,8704780,388,378,utRho11
2211,yjdL,8713034,8713034,8712822,212,0,utRho11
2212,yjdM,8653672,8653672,8653468,204,220,utRho11
2213,yjeF,8787354,8788132,8787354,778,138078,utRho11
2214,yjeI,8745522,8745618,8745522,96,82,utRho11
2215,yjeJ,8748806,8748806,8748468,338,764,utRho11
2216,yjeV,8785472,8785784,8785472,312,5100,utRho11
2217,yjfP,8833512,8833904,8833512,392,46,utRho11
2218,yjfY,8849656,8849656,8849582,74,22,utRho11
2219,yjfZ,8855052,8855052,8854844,208,512,utRho11
2220,yjgA,8916162,8916162,8915730,432,386,utRho11
2221,yjgL,8950802,8950874,8950802,72,0,utRho11
2222,yjgM,8959342,8959342,8959074,268,460,utRho11
2223,yjgN,8959132,8959460,8959132,328,176,utRho11
2224,yjgR,8980170,8980170,8980126,44,78,utRho11
2225,yjgZ,9002116,9002520,9002116,404,4704,utRho11
2226,yjhB,9007764,9008116,9007764,352,332,utRho11
2227,yjhG,9048452,9048452,9048188,264,1518,utRho11
2228,yjhU,9041080,9041080,9040648,432,534,utRho11
2229,yjiA,9178096,9178096,9177730,366,46,utRho11
2230,yjiJ,9125364,9125364,9125350,14,0,utRho11
2231,yjiK,9127270,9127270,9127422,152,294,utRho11
2232,yjiL,9129604,9129604,9129378,226,0,utRho11
2233,yjiS,9143410,9143502,9143410,92,108,utRho11
2234,yjiY,9182734,9182734,9182558,176,212,utRho11
2235,yjjA,9200674,9200674,9200378,296,262,utRho11
2236,yjjB,18408708,18408708,18407800,908,608,utRho11
2237,yjjJ,9243314,9243538,9243314,224,0,utRho11
2238,yjjK,9261132,9261132,9261044,88,164,utRho11
2239,yjjL,9189764,9189764,9189444,320,208,utRho11
2240,yjjM,9191894,9191894,9191702,192,156,utRho11
2241,yjjP,9206068,9206068,9205716,352,5348,utRho11
2242,yjjQ,9206638,9206954,9206638,316,7128,utRho11
2243,yjjX,9267798,9267798,9267490,308,2080,utRho11
2244,yjjY,9280716,9280804,9280716,88,282,utRho11
2245,yjjZ,9211554,9211608,9211554,54,100674,utRho11
2246,yjtD,9281676,9281884,9281676,208,168,utRho11
2247,ykfB,532454,532454,532174,280,4950,utRho11
2248,ykfI,527636,527636,527338,298,1078,utRho11
2249,ykgB,637050,637050,636638,412,4,utRho11
2250,ykgC,640430,640430,640002,428,64,utRho11
2251,ykgD,640232,640454,640232,222,68,utRho11
2252,ykgE,642962,643216,642962,254,296,utRho11
2253,ykgJ,608524,608524,608364,160,66,utRho11
2254,ykgL,623878,624224,623878,346,228,utRho11
2255,ykgM,625610,625610,625554,56,0,utRho11
2256,ykgR,626570,626570,626484,86,0,utRho11
2257,ylaC,958576,958576,958502,74,3374,utRho11
2258,yliE,1745938,1745958,1745938,20,0,utRho11
2259,ymcE,2103660,2103694,2103660,34,2,utRho11
2260,ymdA,2210450,2210828,2210450,378,184,utRho11
2261,ymdB,2211428,2211640,2211428,212,56,utRho11
2262,ymfD,2395322,2395322,2395064,258,1476,utRho11
2263,ymfI,2402880,2402994,2402880,114,0,utRho11
2264,ymfJ,2404518,2404518,2404168,350,82,utRho11
2265,ymfK,2406176,2406176,2405866,310,120,utRho11
2266,ymfT,2405766,2406048,2405766,282,148,utRho11
2267,ymgE,2489110,2489456,2489110,346,1122,utRho11
2268,ymgF,2437628,2437966,2437628,338,8,utRho11
2269,ymiA,2670112,2670320,2670112,208,130,utRho11
2270,ymjA,2715620,2715620,2715336,284,456,utRho11
2271,ynaI,2791946,2791946,2791844,102,60,utRho11
2272,ynaK,2850438,2850754,2850438,316,0,utRho11
2273,ynbA,2954924,2955242,2954924,318,0,utRho11
2274,yncD,3046552,3046552,3046130,422,106,utRho11
2275,yncE,3046454,3046614,3046454,160,0,utRho11
2276,yncG,3052456,3052494,3052456,38,10,utRho11
2277,yncL,3034492,3034492,3034388,104,184,utRho11
2278,yneE,3218364,3218364,3218044,320,0,utRho11
2279,yneF,3223748,3223748,3223708,40,4,utRho11
2280,yneJ,3229560,3229608,3229560,48,108,utRho11
2281,yneK,3231100,3231526,3231100,426,0,utRho11
2282,yneM,3245176,3245292,3245176,116,1014,utRho11
2283,ynfA,3311398,3311398,3311346,52,0,utRho11
2284,ynfB,3311418,3311616,3311418,198,696,utRho11
2285,ynfC,3315094,3315094,3314914,180,40,utRho11
2286,ynfD,3314828,3315130,3314828,302,40,utRho11
2287,ynfE,3316006,3316138,3316006,132,170,utRho11
2288,ynfK,3334670,3334670,3334438,232,34,utRho11
2289,ynfL,3339304,3339304,3339184,120,0,utRho11
2290,ynfM,3339260,3339398,3339260,138,0,utRho11
2291,ynfN,3276598,3276598,3276218,380,120,utRho11
2292,ynfO,3273454,3273512,3273454,58,76,utRho11
2293,ynhG,3517890,3517890,3517450,440,168,utRho11
2294,yniA,3615158,3615592,3615158,434,348,utRho11
2295,yniB,3618526,3618526,3618466,60,100,utRho11
2296,yniC,3618652,3618760,3618652,108,0,utRho11
2297,yniD,3610202,3610330,3610202,128,502,utRho11
2298,ynjE,3678880,3678934,3678880,54,24,utRho11
2299,ynjF,3683222,3683222,3682806,416,78,utRho11
2300,ynjH,3684376,3684376,3684270,106,74,utRho11
2301,ynjI,3690022,3690022,3689742,280,96,utRho11
2302,yoaB,3786642,3786734,3786642,92,110,utRho11
2303,yoaC,3787932,3788146,3787932,214,676,utRho11
2304,yoaE,3803544,3803544,3803170,374,196,utRho11
2305,yoaF,3755444,3755444,3755064,380,850,utRho11
2306,yoaH,3789866,3789866,3789462,404,722,utRho11
2307,yobB,3850418,3850880,3850418,462,888,utRho11
2308,yobF,3815586,3815586,3815182,404,578,utRho11
2309,yobH,3817800,3817850,3817800,50,1200,utRho11
2310,yodB,4084352,4084736,4084352,384,1582,utRho11
2311,yodC,4057008,4057008,4056740,268,196,utRho11
2312,yohC,4451358,4451358,4451262,96,20,utRho11
2313,yohD,4451526,4451602,4451526,76,0,utRho11
2314,yohJ,4460986,4461248,4460986,262,160,utRho11
2315,yohO,4431172,4431314,4431172,142,0,utRho11
2316,yojI,4617282,4617282,4617230,52,2,utRho11
2317,ypdI,4988988,4989396,4988988,408,0,utRho11
2318,ypfG,5165786,5165786,5165554,232,16,utRho11
2319,ypfM,5182140,5182140,5181732,408,276,utRho11
2320,yphB,5349590,5349590,5349376,214,34,utRho11
2321,ypjA,5565644,5565644,5565452,192,36,utRho11
2322,ypjB,5569636,5569636,5568858,778,4,utRho11
2323,ypjD,5495860,5495774,5495860,86,0,utRho11
2324,yqaE,5594170,5594170,5594056,114,14,utRho11
2325,yqcA,5846100,5846100,5845968,132,140,utRho11
2326,yqcE,5800944,5801184,5800944,240,0,utRho11
2327,yqeC,6030468,6030468,6030114,354,78,utRho11
2328,yqeF,5971618,5971618,5971184,434,10,utRho11
2329,yqeG,5971438,5971694,5971438,256,140,utRho11
2330,yqeH,5975016,5975072,5975016,56,164,utRho11
2331,yqeI,5976688,5977004,5976688,316,36,utRho11
2332,yqeK,5981140,5981140,5980720,420,992,utRho11
2333,yqfA,6086728,6086728,6086296,432,770,utRho11
2334,yqgA,6219042,6219106,6219042,64,2,utRho11
2335,yqgB,6172500,6172500,6172102,398,5296,utRho11
2336,yqgE,6185768,6185874,6185768,106,964,utRho11
2337,yqhA,6299150,6299150,6298942,208,6,utRho11
2338,yqhC,6310768,6310768,6310436,332,20,utRho11
2339,yqhD,6310604,6310710,6310604,106,18,utRho11
2340,yqhH,6316842,6317254,6316842,412,1624,utRho11
2341,yqiC,6369662,6369680,6369662,18,2,utRho11
2342,yqiJ,6384108,6384416,6384108,308,700,utRho11
2343,yqjA,6495096,6495546,6495096,450,5216,utRho11
2344,yqjF,6500932,6501124,6500932,192,662,utRho11
2345,yqjG,6501948,6502048,6501948,100,0,utRho11
2346,yqjH,6433078,6433078,6432982,96,0,utRho11
2347,yqjI,6433506,6433558,6433506,52,0,utRho11
2348,yraH,6574552,6574852,6574552,300,66,utRho11
2349,yraP,6592144,6592818,6592144,674,1104,utRho11
2350,yraQ,6596414,6596414,6596276,138,2,utRho11
2351,yraR,6598024,6598024,6597692,332,160,utRho11
2352,yrbG,13360844,13361100,13360844,256,0,utRho11
2353,yrbL,6696842,6696904,6696842,62,1054,utRho11
2354,yrbN,6616172,6616172,6615866,306,14604,utRho11
2355,yrdB,6860176,6860176,6860046,130,168,utRho11
2356,yrfF,7052548,7052938,7052548,390,614,utRho11
2357,yrhB,7169440,7169518,7169440,78,0,utRho11
2358,ysaB,7451804,7451804,7451424,380,0,utRho11
2359,ysgA,8032686,8032686,8032338,348,80,utRho11
2360,ytfB,8857638,8857638,8857434,204,542,utRho11
2361,ytfE,8864018,8864018,8863966,52,6,utRho11
2362,ytfF,8866296,8866296,8866130,166,96,utRho11
2363,ytfH,8868164,8868226,8868164,62,274,utRho11
2364,ytfI,8875234,8875414,8875234,180,166,utRho11
2365,ytfJ,8878572,8878572,8878524,48,120,utRho11
2366,ytfK,8879022,8879174,8879022,152,454,utRho11
2367,ytfL,8882642,8882642,8882430,212,352,utRho11
2368,ytfQ,8899634,8899924,8899634,290,408,utRho11
2369,ytjB,9249598,9249598,9249578,20,150,utRho11
2370,yzfA,8896588,8896588,8896490,98,18,utRho11
2371,zapA,6111102,6111224,6111102,122,2648,utRho11
2372,zapB,8236772,8237030,8236772,258,582,utRho11
2373,zapC,2011700,2011904,2011700,204,18,utRho11
2374,zinT,4082692,4082750,4082692,58,346,utRho11
2375,zipA,5062814,5062814,5062466,348,164,utRho11
2376,zitB,1569716,1569716,1569646,70,106,utRho11
2377,zntA,7212844,7212902,7212844,58,84,utRho11
2378,zntR,6878336,6878336,6878260,76,142,utRho11
2379,znuA,3885322,3885322,3885166,156,0,utRho11
2380,znuC,3885268,3885324,3885268,56,0,utRho11
2381,zraP,8403424,8403424,8403376,48,90,utRho11
2382,zraS,8403810,8403852,8403810,42,0,utRho11
2383,zupT,6364866,6365100,6364866,234,6234,utRho11
2384,zur,8520282,8520282,8520006,276,300,utRho11
2385,zwf,3872752,3872752,3872628,124,20,utRho11
0,C0343,2818676,2818728,2818676,52,4,utRho12
1,aaeB,6776526,6776526,6776376,150,0,utRho12
2,aaeR,6778762,6779040,6778762,278,326,utRho12
3,aaeX,6778860,6778860,6778674,186,464,utRho12
4,aat,1854920,1854920,1854864,56,0,utRho12
5,accA,416822,417242,416822,420,2394,utRho12
6,accB,6810280,6810872,6810280,592,8722,utRho12
7,accD,4868030,4868030,4867852,178,594,utRho12
8,aceB,8430804,8430956,8430804,152,186,utRho12
9,aceE,245938,246034,245938,96,190,utRho12
10,ackA,4826918,4826940,4826918,22,960,utRho12
11,acnA,2670848,2671662,2670848,814,862,utRho12
12,acnB,263038,263230,263038,192,868,utRho12
13,acpP,2303148,2303230,2303148,82,414,utRho12
14,acpS,5402324,5402324,5401996,328,422,utRho12
15,acrA,971396,971396,971238,158,134,utRho12
16,acrB,969370,969370,968806,564,1682,utRho12
17,acrD,5174950,5175190,5174950,240,50,utRho12
18,acrE,6827404,6827728,6827404,324,362,utRho12
19,acrR,971398,971522,971398,124,48,utRho12
20,acrZ,1589502,1589546,1589502,44,22,utRho12
21,acs,8575190,8575190,8574742,448,242,utRho12
22,actP,8569870,8569870,8569804,66,0,utRho12
23,ada,4620854,4620854,4620810,44,80,utRho12
24,add,3404404,3404466,3404404,62,28,utRho12
25,ade,7687802,7687928,7687802,126,126,utRho12
26,adhE,2596826,2596826,2596242,584,2,utRho12
27,adhP,3107988,3107988,3107676,312,852,utRho12
28,adiA,8681112,8681112,8681042,70,20,utRho12
29,adiC,8674404,8674404,8674062,342,0,utRho12
30,adiY,8676084,8676084,8675858,226,0,utRho12
31,adk,994278,994350,994278,72,724,utRho12
32,adrA,807374,807406,807374,32,0,utRho12
33,aer,6438240,6438240,6438152,88,204,utRho12
34,aes,1000102,1000102,999946,156,330,utRho12
35,agaR,6557406,6557406,6557330,76,0,utRho12
36,agaS,6563778,6563952,6563778,174,0,utRho12
37,agp,2131118,2131170,2131118,52,0,utRho12
38,agrA,7296126,7296126,7296126,0,0,utRho12
39,agrB,7296588,7296588,7296588,0,0,utRho12
40,ahpC,1277386,1277890,1277386,504,650,utRho12
41,ahpF,1278004,1279506,1278004,1502,45570,utRho12
42,ahr,8992698,8992698,8992418,280,28,utRho12
43,aidB,8828494,8828550,8828494,56,0,utRho12
44,ais,4731512,4731512,4731240,272,0,utRho12
45,alaA,4814816,4815122,4814816,306,52,utRho12
46,alaC,4996798,4996798,4996590,208,28,utRho12
47,alaE,5598140,5598328,5598140,188,146,utRho12
48,alaS,5644180,5644180,5644022,158,2106,utRho12
49,alaW,5036612,5036612,5036462,150,12,utRho12
50,aldA,2976380,2976464,2976380,84,228,utRho12
51,aldB,7513070,7513070,7513022,48,192,utRho12
52,alkA,4295118,4295118,4295080,38,0,utRho12
53,alkB,4618890,4618890,4618682,208,0,utRho12
54,allA,1064780,1064902,1064780,122,0,utRho12
55,allD,1092822,1092822,1092726,96,0,utRho12
56,allE,1088112,1088112,1088092,20,26,utRho12
57,allS,1064600,1064600,1064442,158,14,utRho12
58,alr,8531178,8531564,8531178,386,1798,utRho12
59,alsE,8617334,8617334,8616956,378,0,utRho12
60,alsK,8615990,8615990,8615598,392,152,utRho12
61,alx,6476740,6477160,6476740,420,0,utRho12
62,amiA,5104482,5104704,5104482,222,0,utRho12
63,amiC,5898378,5898378,5898020,358,444,utRho12
64,amn,4110062,4110122,4110062,60,0,utRho12
65,ampC,8758006,8758006,8757888,118,0,utRho12
66,ampD,237362,237466,237362,104,210,utRho12
67,ampG,907372,907372,907090,282,282,utRho12
68,ampH,792726,792726,792574,152,0,utRho12
69,amyA,4012230,4012312,4012230,82,64,utRho12
70,anmK,3439346,3439346,3439204,142,44,utRho12
71,ansB,6201580,6201580,6201456,124,4,utRho12
72,ansP,3052040,3052040,3051960,80,152,utRho12
73,apaG,104068,104068,103212,856,4672,utRho12
74,apaH,102586,102586,102444,142,6470,utRho12
75,apbE,4623188,4623188,4623068,120,0,utRho12
76,appA,2081198,2081234,2081198,36,0,utRho12
77,appC,2075420,2075480,2075420,60,0,utRho12
78,appY,1167134,1167362,1167134,228,0,utRho12
79,apt,982620,982824,982620,204,84,utRho12
80,aqpZ,1832424,1832424,1832094,330,130,utRho12
81,araB,140150,140150,140096,54,0,utRho12
82,araC,140482,140774,140482,292,240,utRho12
83,araE,5964416,5964416,5964364,52,0,utRho12
84,araF,3972476,3972476,3972256,220,140,utRho12
85,araH,3967120,3967120,3967086,34,28,utRho12
86,araJ,825058,825058,824962,96,94,utRho12
87,arcA,9281602,9281602,9280612,990,3270,utRho12
88,arcB,6706098,6706098,6706050,48,132,utRho12
89,arcZ,6701154,6701154,6701154,0,0,utRho12
90,arfA,6877346,6877346,6877298,48,784,utRho12
91,argA,5898312,5898484,5898312,172,212,utRho12
92,argC,8309770,8310002,8309770,232,0,utRho12
93,argD,6980442,6980442,6980360,82,0,utRho12
94,argE,8310156,8310156,8309694,462,0,utRho12
95,argF,580680,580680,580610,70,0,utRho12
96,argG,6637124,6637274,6637124,150,336,utRho12
97,argI,8956688,8956688,8956622,66,0,utRho12
98,argO,6137672,6137672,6137616,56,498,utRho12
99,argP,6119460,6119506,6119460,46,38,utRho12
100,argR,6769204,6769406,6769204,202,86,utRho12
101,argS,3920002,3920124,3920002,122,0,utRho12
102,argT,4855698,4855698,4855582,116,326,utRho12
103,argU,1129406,1129446,1129406,40,0,utRho12
104,argW,4932616,4932618,4932616,2,0,utRho12
105,argX,7964728,7964750,7964728,22,26,utRho12
106,aroF,5482402,5482402,5482300,102,86,utRho12
107,aroG,1571182,1571266,1571182,84,454,utRho12
108,aroH,3576636,3576870,3576636,234,346,utRho12
109,aroK,7038760,7038760,7038128,632,1684,utRho12
110,aroL,812560,812810,812560,250,328,utRho12
111,aroP,243342,243342,243102,240,48,utRho12
112,arpA,8445382,8445382,8444974,408,154,utRho12
113,arrS,7316108,7316108,7316108,0,0,utRho12
114,arsR,7297024,7297056,7297024,32,216,utRho12
115,artJ,1801252,1801252,1801150,102,0,utRho12
116,artP,1807686,1807686,1807468,218,214,utRho12
117,ascF,5678858,5679048,5678858,190,0,utRho12
118,ascG,5678574,5678574,5678528,46,0,utRho12
119,aslB,7965562,7965916,7965562,354,25358,utRho12
120,asnA,7854258,7854310,7854258,52,294,utRho12
121,asnB,1398444,1398444,1398354,90,510,utRho12
122,asnC,23562186,23562186,23562018,168,312,utRho12
123,asnS,1978088,1978088,1977970,118,6032,utRho12
124,asnT,4089082,4089098,4089082,16,304,utRho12
125,asnU,4119690,4119702,4119690,12,0,utRho12
126,asnV,4124504,4124520,4124504,16,72,utRho12
127,aspA,17473728,17473728,17473308,420,232,utRho12
128,aspC,1971486,1971486,1971418,68,1410,utRho12
129,aspS,3901402,3901402,3901044,358,236,utRho12
130,aspT,7893560,7893744,7893560,184,121404,utRho12
131,aspV,473826,473862,473826,36,66,utRho12
132,asr,3342654,3342752,3342654,98,56,utRho12
133,astC,3664088,3664088,3663964,124,0,utRho12
134,astE,3654138,3654138,3653846,292,0,utRho12
135,atoD,4646824,4646894,4646824,70,72,utRho12
136,atpB,7844540,7844540,7844102,438,496,utRho12
137,atpC,7832118,7832118,7831944,174,1730,utRho12
138,atpI,7845050,7845050,7844880,170,0,utRho12
139,avtA,7479348,7479410,7479348,62,386,utRho12
140,azoR,2965982,2965982,2965720,262,142,utRho12
141,azuC,3976002,3976002,3975918,84,44,utRho12
142,bacA,6408350,6408350,6408262,88,214,utRho12
143,bamA,394052,395856,394052,1804,594,utRho12
144,bamB,5277950,5277950,5277304,646,914,utRho12
145,bamC,5198028,5198028,5197730,298,634,utRho12
146,bamD,5471922,5472292,5471922,370,8702,utRho12
147,bamE,5506972,5507210,5506972,238,150,utRho12
148,basS,8666954,8666954,8666544,410,768,utRho12
149,bax,7474468,7474468,7474354,114,48,utRho12
150,bcp,5200874,5200956,5200874,82,1206,utRho12
151,bcsB,7385346,7385346,7385214,132,0,utRho12
152,bcsE,7392644,7392916,7392644,272,70,utRho12
153,bdcA,8948128,8948128,8948106,22,140,utRho12
154,bdcR,8948192,8948248,8948192,56,0,utRho12
155,bdm,3112680,3112680,3112560,120,0,utRho12
156,betA,654522,654522,654494,28,574,utRho12
157,betI,658722,658722,658668,54,0,utRho12
158,betT,658842,658926,658842,84,50,utRho12
159,bfr,6933498,6933498,6933450,48,0,utRho12
160,bglG,23440182,23440182,23439402,780,492,utRho12
161,bglX,4444240,4444240,4443978,262,0,utRho12
162,bhsA,2337962,2338146,2337962,184,50,utRho12
163,bioA,1618584,1618584,1618514,70,0,utRho12
164,bioB,1618604,1618688,1618604,84,0,utRho12
165,bioH,7089716,7089716,7089688,28,0,utRho12
166,bisC,7433026,7433026,7432788,238,200,utRho12
167,blc,8755490,8755490,8755444,46,64,utRho12
168,blr,3409024,3409102,3409024,78,126,utRho12
169,bluF,2431226,2431226,2430950,276,358,utRho12
170,bluR,2428226,2428226,2428118,108,2,utRho12
171,bolA,908698,908944,908698,246,0,utRho12
172,borD,1157842,1157842,1157786,56,0,utRho12
173,brnQ,838976,839182,838976,206,788,utRho12
174,bssR,1756492,1756496,1756492,4,0,utRho12
175,bssS,2242116,2242116,2241910,206,218,utRho12
176,btuB,8326798,8327278,8326798,480,3096,utRho12
177,cadB,8720212,8720212,8720062,150,90,utRho12
178,cadC,8723926,8723926,8723868,58,22,utRho12
179,caiE,70998,70998,70742,256,0,utRho12
180,caiF,68436,68600,68436,164,46,utRho12
181,caiT,84074,84074,83862,212,0,utRho12
182,can,285406,285406,285340,66,148,utRho12
183,carA,59102,59302,59102,200,0,utRho12
184,carB,61550,61634,61550,84,208,utRho12
185,cas2,5757830,5757830,5757706,124,134,utRho12
186,casA,5768638,5768638,5768276,362,16,utRho12
187,cbl,4121882,4121882,4121828,54,1688,utRho12
188,cbpA,2128074,2128074,2127550,524,150,utRho12
189,cbrA,7738628,7738754,7738628,126,38,utRho12
190,cbrB,7794958,7795012,7794958,54,48,utRho12
191,ccmH,4585242,4585242,4584820,422,50,utRho12
192,cdaR,364894,364926,364894,32,0,utRho12
193,cdd,4463638,4463688,4463638,50,114,utRho12
194,cdh,8219814,8219860,8219814,46,266,utRho12
195,cdsA,391110,391354,391110,244,1856,utRho12
196,cedA,3627484,3627484,3627326,158,76,utRho12
197,cfa,3482402,3482826,3482402,424,344,utRho12
198,chaC,2544844,2544972,2544844,128,118,utRho12
199,chbB,3643452,3643452,3643238,214,0,utRho12
200,chbG,3634624,3634624,3634270,354,0,utRho12
201,cheW,3946924,3946924,3946678,246,1974,utRho12
202,chiA,6939792,6939792,6939706,86,0,utRho12
203,chiP,1416472,1416668,1416472,196,0,utRho12
204,cho,3646984,3647030,3646984,46,0,utRho12
205,chpS,8896804,8896894,8896804,90,254,utRho12
206,cirA,4493884,4493884,4493538,346,74,utRho12
207,citC,1304078,1304078,1303712,366,36,utRho12
208,citT,1293264,1293264,1293160,104,0,utRho12
209,clcA,350104,350214,350104,110,0,utRho12
210,clpA,1846160,1846528,1846160,368,108,utRho12
211,clpB,5468410,5468410,5468346,64,0,utRho12
212,clpP,913154,913354,913154,200,1014,utRho12
213,clpS,1845500,1845826,1845500,326,152,utRho12
214,clpX,914404,914852,914404,448,782,utRho12
215,clsA,2617346,2617346,2617290,56,260,utRho12
216,clsC,2212584,2212710,2212584,126,454,utRho12
217,cmk,1922330,1922402,1922330,72,0,utRho12
218,cnu,3409522,3409898,3409522,376,1302,utRho12
219,coaA,8350214,8350214,8350052,162,850,utRho12
220,cobC,1340092,1340092,1339814,278,90,utRho12
221,cobT,4129202,4129202,4128934,268,44,utRho12
222,cobU,4131944,4131944,4131528,416,174,utRho12
223,codB,709768,709844,709768,76,16,utRho12
224,comR,2337726,2337726,2337664,62,0,utRho12
225,copA,1022822,1022822,1022758,64,32,utRho12
226,corA,8002388,8002852,8002388,464,13142,utRho12
227,cpdB,8873258,8873258,8873130,128,388,utRho12
228,cptB,6082198,6082198,6082140,58,56,utRho12
229,cpxA,8210202,8210202,8209950,252,322,utRho12
230,cpxP,8211570,8211640,8211570,70,134,utRho12
231,cpxR,8211372,8211372,8211340,32,88,utRho12
232,cra,175894,176056,175894,162,0,utRho12
233,crcB,1316016,1316016,1315876,140,486,utRho12
234,creA,9270486,9271042,9270486,556,174,utRho12
235,creD,9276320,9276356,9276320,36,172,utRho12
236,crl,515620,515658,515620,38,1558,utRho12
237,crp,6971906,6972240,6971906,334,3414,utRho12
238,crr,5070960,5071668,5070960,708,2912,utRho12
239,csdA,5886414,5886674,5886414,260,260,utRho12
240,csgB,2207718,2207902,2207718,184,0,utRho12
241,csgD,2206688,2206688,2206392,296,152,utRho12
242,csgG,2203510,2203510,2203368,142,264,utRho12
243,csiD,5577854,5577970,5577854,116,28,utRho12
244,csiE,5330802,5330870,5330802,68,124,utRho12
245,csiR,5590942,5591348,5590942,406,0,utRho12
246,cspA,7439778,7440098,7439778,320,93494,utRho12
247,cspB,3283430,3283430,3283108,322,196,utRho12
248,cspC,3815018,3815018,3814870,148,506,utRho12
249,cspD,1845352,1845352,1845180,172,1182,utRho12
250,cspE,1314294,1314584,1314294,290,128,utRho12
251,cspF,3283380,3283710,3283380,330,60,utRho12
252,cspG,2102610,2102922,2102610,312,3880,utRho12
253,cspH,2102746,2102746,2102350,396,242,utRho12
254,cspI,3277624,3277624,3277334,290,56,utRho12
255,csrA,5638746,5638746,5638292,454,1148,utRho12
256,csrB,5849048,5849048,5849048,0,0,utRho12
257,csrC,8102072,8102072,8102072,0,0,utRho12
258,csrD,6806850,6806850,6806664,186,88,utRho12
259,cstA,1259710,1259788,1259710,78,0,utRho12
260,cueO,274090,274166,274090,76,0,utRho12
261,cueR,1027948,1027986,1027948,38,98,utRho12
262,curA,3037784,3038054,3037784,270,220,utRho12
263,cusC,1191146,1191200,1191146,54,56,utRho12
264,cusR,1190924,1190924,1190886,38,0,utRho12
265,cutA,8730784,8730784,8730712,72,356,utRho12
266,cutC,3918534,3918534,3917920,614,78,utRho12
267,cvpA,4861600,4861600,4861526,74,24,utRho12
268,cvrA,2484328,2484328,2484142,186,84,utRho12
269,cyaA,7981548,7982306,7981548,758,786,utRho12
270,cyaR,4334228,4334224,4334228,4,0,utRho12
271,cyaY,7988166,7988166,7988118,48,244,utRho12
272,cybB,2981522,2981804,2981522,282,386,utRho12
273,cycA,8859560,8859728,8859560,168,848,utRho12
274,cydA,1542340,1542916,1542340,576,98,utRho12
275,cydC,1858800,1858800,1858390,410,4,utRho12
276,cydD,1862062,1862062,1861924,138,0,utRho12
277,cydX,1548300,1548392,1548300,92,284,utRho12
278,cynR,717418,717418,717380,38,0,utRho12
279,cynT,1435092,1435196,1435092,104,112,utRho12
280,cyoA,903306,903306,903220,86,3440,utRho12
281,cyoE,895540,895540,895410,130,958,utRho12
282,cysB,2667576,2667710,2667576,134,104,utRho12
283,cysC,5748056,5748056,5747984,72,20,utRho12
284,cysD,5752736,5752736,5752658,78,0,utRho12
285,cysE,7565362,7565362,7565124,238,466,utRho12
286,cysG,6995508,6995656,6995508,148,198,utRho12
287,cysJ,5783928,5783928,5783796,132,1492,utRho12
288,cysK,5064688,5064818,5064688,130,12,utRho12
289,cysP,5087114,5087114,5087056,58,312,utRho12
290,cysS,1109154,1109222,1109154,68,58,utRho12
291,cysT,3984100,3984100,3983974,126,212,utRho12
292,cysZ,5062766,5062926,5062766,160,140,utRho12
293,cytR,8249018,8249018,8248912,106,26,utRho12
294,dacA,1328002,1328002,1327926,76,302,utRho12
295,dacB,6657714,6657926,6657714,212,70,utRho12
296,dacC,1761306,1761454,1761306,148,202,utRho12
297,dadA,2475018,2475142,2475018,124,0,utRho12
298,dam,7032504,7032504,7031826,678,1434,utRho12
299,damX,7035200,7035200,7034612,588,392,utRho12
300,dapA,5199568,5199568,5199520,48,0,utRho12
301,dapB,56576,56748,56576,172,128,utRho12
302,dapD,371954,371954,371894,60,160,utRho12
303,dapE,5183120,5183214,5183120,94,780,utRho12
304,dcp,3254844,3254844,3254760,84,2,utRho12
305,dcrB,7219534,7219910,7219534,376,52,utRho12
306,dctA,7366996,7366996,7366894,102,346,utRho12
307,dcuA,8733686,8733686,8733546,140,0,utRho12
308,dcuB,8698182,8698182,8697488,694,2078,utRho12
309,dcuC,1312166,1312166,1311936,230,256,utRho12
310,dcuD,6749166,6749738,6749166,572,76,utRho12
311,dcuR,8701130,8701130,8700068,1062,758,utRho12
312,dcuS,8703370,8703370,8703324,46,106,utRho12
313,dcyD,3999016,3999016,3998960,56,0,utRho12
314,ddpX,3126498,3126498,3126152,346,10,utRho12
315,deaD,6615818,6615818,6615720,98,5348,utRho12
316,dedA,4869880,4869880,4869482,398,9496,utRho12
317,dedD,4863750,4863750,4863368,382,100,utRho12
318,def,6867300,6867380,6867300,80,58,utRho12
319,degP,361690,361768,361690,78,0,utRho12
320,degQ,6761308,6761486,6761308,178,4528,utRho12
321,deoB,9239134,9239206,9239134,72,54,utRho12
322,deoC,9233358,9234646,9233358,1288,220,utRho12
323,dfp,7625406,7625462,7625406,56,4,utRho12
324,dgcZ,3247758,3247758,3247700,58,0,utRho12
325,dgkA,8512914,8513274,8512914,360,416,utRho12
326,dgt,358392,358474,358392,82,104,utRho12
327,dhaK,2501888,2501888,2501676,212,158,utRho12
328,dhaR,2502006,2502132,2502006,126,38,utRho12
329,dicB,3299194,3299218,3299194,24,0,utRho12
330,dicC,3295752,3295752,3295700,52,0,utRho12
331,dinB,501760,501796,501760,36,0,utRho12
332,dinD,7635398,7635520,7635398,122,206,utRho12
333,dinG,1666146,1666140,1666146,6,0,utRho12
334,dinI,2243018,2243018,2242974,44,202,utRho12
335,dinJ,493230,493230,493004,226,76,utRho12
336,dinQ,7295964,7295964,7295576,388,1448,utRho12
337,djlA,114536,114728,114536,192,0,utRho12
338,dkgA,6313142,6313246,6313142,104,38,utRho12
339,dkgB,458196,458334,458196,138,234,utRho12
340,dksA,321502,321502,321208,294,542,utRho12
341,dld,4444164,4444370,4444164,206,0,utRho12
342,dmlA,3763424,3763824,3763424,400,114,utRho12
343,dmlR,3763710,3763710,3763618,92,14,utRho12
344,dmsA,1881646,1881918,1881646,272,0,utRho12
345,dnaA,7767922,7767922,7767458,464,1160,utRho12
346,dnaB,8528566,8528628,8528566,62,316,utRho12
347,dnaK,24096,24326,24096,230,1258,utRho12
348,dnaN,7765466,7765466,7764642,824,1284,utRho12
349,dnaQ,471868,472134,471868,266,1118,utRho12
350,dnaT,18406460,18406460,18406068,392,836,utRho12
351,dnaX,984112,984184,984112,72,716,utRho12
352,dosP,3131486,3131486,3131466,20,8,utRho12
353,dpiB,1303968,1304470,1303968,502,156,utRho12
354,dppA,7415740,7415740,7415410,330,3150,utRho12
355,dps,1697900,1697900,1697822,78,0,utRho12
356,dsbA,8086754,8086836,8086754,82,1938,utRho12
357,dsbB,2466294,2466294,2466060,234,0,utRho12
358,dsbC,6079266,6079266,6077644,1622,1782,utRho12
359,dsbG,1277600,1277600,1277146,454,136,utRho12
360,dsdA,4958242,4958404,4958242,162,120,utRho12
361,dsdC,4955492,4955492,4955258,234,2,utRho12
362,dsdX,4955642,4955694,4955642,52,2,utRho12
363,dsrA,4050626,4050626,4050626,0,0,utRho12
364,dsrB,4049686,4049686,4049646,40,484,utRho12
365,dtpD,1485340,1485340,1485112,228,166,utRho12
366,dusA,8523200,8523338,8523200,138,2696,utRho12
367,dusB,6820492,6820560,6820492,68,216,utRho12
368,dusC,4460790,4460790,4460770,20,0,utRho12
369,dut,7627704,7627864,7627704,160,1418,utRho12
370,dxr,386670,387042,386670,372,942,utRho12
371,ebgA,6445102,6445266,6445102,164,54,utRho12
372,ebgR,6442874,6442932,6442874,58,52,utRho12
373,ecnB,8753018,8753106,8753018,88,694,utRho12
374,eco,4607594,4607810,4607594,216,50,utRho12
375,ecpA,621594,621594,621342,252,244,utRho12
376,ecpB,620238,620238,620052,186,22,utRho12
377,ecpR,622964,622964,622672,292,54,utRho12
378,eda,3866218,3866218,3865512,706,0,utRho12
379,edd,3869426,3869426,3869208,218,116,utRho12
380,efeO,2164308,2164486,2164308,178,62,utRho12
381,efeU_1,2162614,2162712,2162614,98,24,utRho12
382,efp,8751134,8751398,8751134,264,4268,utRho12
383,elaA,4763372,4763372,4763086,286,142,utRho12
384,elaD,4765308,4765426,4765308,118,122,utRho12
385,elfA,1995530,1995736,1995530,206,64,utRho12
386,elfD,1996642,1996980,1996642,338,110,utRho12
387,emrD,7707690,7707844,7707690,154,100,utRho12
388,emrK,4966896,4966896,4966678,218,0,utRho12
389,emrY,4964668,4964668,4964352,316,120,utRho12
390,emtA,2486250,2486360,2486250,110,0,utRho12
391,endA,12361100,12361388,12361100,288,0,utRho12
392,eno,5817692,5817692,5815882,1810,6350,utRho12
393,entC,1249662,1249770,1249662,108,0,utRho12
394,entD,1220508,1220508,1220158,350,0,utRho12
395,entH,1258584,1258600,1258584,16,0,utRho12
396,entS,1244506,1244600,1244506,94,146,utRho12
397,envR,6827266,6827266,6826930,336,20,utRho12
398,epd,12295292,12295292,12294764,528,152,utRho12
399,epmA,8765236,8765286,8765236,50,62,utRho12
400,epmB,8751406,8751406,8751314,92,2344,utRho12
401,eptB,7421162,7421162,7420950,212,0,utRho12
402,eptC,8300622,8300622,8300530,92,296,utRho12
403,erfK,4126708,4126708,4126646,62,784,utRho12
404,erpA,353122,353220,353122,98,46,utRho12
405,esrE,8039956,8039956,8039956,0,0,utRho12
406,essD,1153746,1154796,1153746,1050,898,utRho12
407,etk,2088606,2088606,2088420,186,452,utRho12
408,evgA,4967262,4967510,4967262,248,28,utRho12
409,exbB,6304028,6304028,6303968,60,36,utRho12
410,exbD,6302780,6302780,6302486,294,230,utRho12
411,exuR,6493016,6493304,6493016,288,34,utRho12
412,exuT,6490004,6490208,6490004,204,0,utRho12
413,fabA,2032996,2032996,2032940,56,70,utRho12
414,fabB,4883282,4883282,4883210,72,0,utRho12
415,fabH,2297032,2297518,2297032,486,4022,utRho12
416,fabI,2702236,2702236,2702078,158,124,utRho12
417,fadB,8062026,8062026,8061942,84,16,utRho12
418,fadD,3779614,3779614,3779492,122,118,utRho12
419,fadE,486812,486812,486606,206,74,utRho12
420,fadH,6463248,6463330,6463248,82,0,utRho12
421,fadI,4921022,4921022,4920938,84,126,utRho12
422,fadL,4922410,4922600,4922410,190,0,utRho12
423,fadM,928720,928804,928720,84,112,utRho12
424,fadR,2469810,2469876,2469810,66,34,utRho12
425,fbaB,4357334,4357334,4357128,206,0,utRho12
426,fdhE,8162722,8162722,8162456,266,1540,utRho12
427,fdhF,8598814,8598814,8598732,82,30,utRho12
428,fdnG,3094744,3094802,3094744,58,0,utRho12
429,fdrA,1093012,1093360,1093012,348,0,utRho12
430,feaB,2894994,2895038,2894994,44,52,utRho12
431,feaR,2894734,2894734,2894566,168,0,utRho12
432,fecA,9033454,9033454,9033354,100,4,utRho12
433,fecE,9023288,9023288,9022914,374,4602,utRho12
434,fecI,9036564,9036564,9036470,94,214,utRho12
435,feoA,7080114,7080326,7080114,212,158,utRho12
436,fepA,1225334,1225334,1224988,346,0,utRho12
437,fepB,1249454,1249454,1249020,434,16,utRho12
438,fepD,1244468,1244468,1244378,90,86,utRho12
439,fes,1225374,1225630,1225374,256,50,utRho12
440,ffh,5495706,5495706,5495590,116,628,utRho12
441,ffs,952576,952848,952576,272,340,utRho12
442,fhuA,334884,334968,334884,84,486,utRho12
443,fhuE,2323294,2323294,2323102,192,20,utRho12
444,fhuF,9211504,9211504,9211326,178,82302,utRho12
445,fic,6983296,6983296,6982926,370,876,utRho12
446,fieF,8212864,8212938,8212864,74,0,utRho12
447,fimA,9085388,9086230,9085388,842,1476,utRho12
448,fimB,9081334,9081914,9081334,580,1638,utRho12
449,fimE,9083742,9084074,9083742,332,1666,utRho12
450,fimZ,1129214,1129214,1128960,254,18,utRho12
451,fiu,1683296,1683296,1683062,234,20,utRho12
452,fixA,84650,84806,84650,156,40,utRho12
453,fkpA,6955050,6955050,6954838,212,7342,utRho12
454,fldA,2846084,2846084,2845860,224,4196,utRho12
455,fldB,6079644,6079710,6079644,66,140,utRho12
456,flgA,2261770,2261770,2261726,44,110,utRho12
457,flgB,2261986,2262036,2261986,50,46,utRho12
458,flgK,2276702,2276756,2276702,54,894,utRho12
459,flgM,2260330,2260330,2260256,74,288,utRho12
460,flgN,2259828,2259828,2259660,168,184,utRho12
461,flhB,3932432,3932432,3932382,50,1416,utRho12
462,flhC,3955864,3955864,3955688,176,174,utRho12
463,flhD,3957154,3957154,3956394,760,574,utRho12
464,fliA,4003638,4003638,4003578,60,1064,utRho12
465,fliC,4007352,4007352,4007212,140,836,utRho12
466,fliD,4007634,4007744,4007634,110,214,utRho12
467,fliE,4026186,4026186,4026028,158,308,utRho12
468,fliF,4026292,4026458,4026292,166,142,utRho12
469,fliL,4039168,4039236,4039168,68,134,utRho12
470,flk,4875824,4875900,4875824,76,14,utRho12
471,flu,4142634,4143078,4142634,444,232,utRho12
472,flxA,3292776,3292810,3292776,34,242,utRho12
473,fnr,2799104,2799104,2799052,52,72,utRho12
474,fnrS,2818258,2818258,2818258,0,0,utRho12
475,focA,1909628,1909628,1908932,696,2030,utRho12
476,folA,99598,99646,99598,48,52,utRho12
477,folB,6409296,6409296,6409178,118,104,utRho12
478,folD,1115562,1115562,1115482,80,132,utRho12
479,folE,4487696,4487696,4487304,392,2648,utRho12
480,fpr,8228998,8228998,8228944,54,76,utRho12
481,frc,4986878,4986878,4986508,370,0,utRho12
482,frdA,8764824,8764824,8764636,188,98,utRho12
483,frdD,8758948,8758948,8758732,216,916,utRho12
484,fre,8052886,8053054,8052886,168,1868,utRho12
485,frlA,6999518,6999820,6999518,302,228,utRho12
486,frr,385624,385744,385624,120,1346,utRho12
487,frsA,513004,513054,513004,50,254,utRho12
488,fruB,4527194,4527194,4526990,204,2,utRho12
489,frvR,8179804,8179804,8179710,94,0,utRho12
490,fryA,5008986,5008986,5008970,16,88,utRho12
491,fsaA,1727060,1727284,1727060,224,418,utRho12
492,fsr,1009710,1009710,1009392,318,102,utRho12
493,ftnA,3977364,3977432,3977364,68,32,utRho12
494,ftnB,3973550,3973850,3973550,300,22,utRho12
495,ftsA,207122,207964,207122,842,398,utRho12
496,ftsB,5745802,5745802,5745640,162,34,utRho12
497,ftsH,6654204,6654204,6653870,334,592,utRho12
498,ftsK,1865858,1866448,1865858,590,1424,utRho12
499,ftsL,181376,182064,181376,688,1514,utRho12
500,ftsP,6325732,6325732,6325338,394,114,utRho12
501,ftsQ,205484,206310,205484,826,168,utRho12
502,ftsX,7204512,7204512,7204172,340,400,utRho12
503,ftsZ,209272,210610,209272,1338,192,utRho12
504,fucA,5867708,5867708,5867376,332,466,utRho12
505,fucP,5868238,5868470,5868238,232,10,utRho12
506,fumA,6753760,6753760,6753508,252,3228,utRho12
507,fumB,8694696,8694696,8694652,44,36,utRho12
508,fumC,3373418,3373418,3373176,242,0,utRho12
509,fur,2842892,2842892,2842584,308,7264,utRho12
510,fusA,6947370,6947370,6947028,342,30242,utRho12
511,fxsA,8737206,8737328,8737206,122,136,utRho12
512,gabD,5581824,5582546,5581824,722,1064,utRho12
513,gadA,7335214,7335214,7335160,54,0,utRho12
514,gadB,3144144,3144144,3144090,54,0,utRho12
515,gadC,3141168,3141168,3140978,190,62,utRho12
516,gadE,7315600,7316732,7315600,1132,292,utRho12
517,gadW,7329562,7329562,7329236,326,0,utRho12
518,gadX,14663356,14663356,14663240,116,492,utRho12
519,gadY,7329728,7329728,7329728,0,0,utRho12
520,galE,1584354,1584354,1584110,244,48,utRho12
521,galF,4228702,4228702,4228654,48,52,utRho12
522,galM,1577796,1577796,1577674,122,312,utRho12
523,galP,6176510,6176568,6176510,58,44,utRho12
524,galR,5953138,5953198,5953138,60,28,utRho12
525,galS,4483420,4483420,4483336,84,84,utRho12
526,galU,2582810,2582914,2582810,104,478,utRho12
527,gapA,3724480,3725542,3724480,1062,3958,utRho12
528,garP,6549868,6549868,6549814,54,78,utRho12
529,gatY,4354468,4354468,4354408,60,8,utRho12
530,gatZ,4352864,4352864,4352642,222,8136,utRho12
531,gcd,282558,282558,282450,108,98,utRho12
532,gcl,1067814,1067832,1067814,18,0,utRho12
533,gcvA,5885278,5885278,5885134,144,0,utRho12
534,gcvB,5885392,5885392,5885392,0,0,utRho12
535,gcvR,5199758,5199812,5199758,54,20,utRho12
536,gcvT,6101544,6101544,6101334,210,1198,utRho12
537,gdhA,3684616,3684742,3684616,126,0,utRho12
538,gfcA,2099668,2099668,2099488,180,818,utRho12
539,gfcD,2096236,2096236,2095890,346,1392,utRho12
540,ghrA,2195648,2195772,2195648,124,4,utRho12
541,ghrB,7434378,7434620,7434378,242,1056,utRho12
542,glcA,6242728,6242728,6242558,170,164,utRho12
543,glcC,6256412,6256544,6256412,132,0,utRho12
544,glcD,6256152,6256152,6256042,110,24,utRho12
545,gldA,8278092,8278092,8278070,22,0,utRho12
546,glgA,7136784,7136784,7136066,718,848,utRho12
547,glgB,7147314,7147314,7147004,310,76,utRho12
548,glgC,7139142,7139142,7138656,486,474,utRho12
549,glgP,7133546,7133546,7133162,384,312,utRho12
550,glgS,6384024,6384024,6383878,146,0,utRho12
551,glgX,7142838,7142838,7142638,200,0,utRho12
552,glk,5018922,5018922,5018852,70,92,utRho12
553,glmS,7827622,7827622,7827336,286,5004,utRho12
554,glmU,7830652,7830652,7830400,252,698,utRho12
555,glmY,10765360,10765360,10765360,0,0,utRho12
556,glmZ,7972864,7972864,7972864,0,0,utRho12
557,glnA,16232888,16232888,16232136,752,244,utRho12
558,glnB,5375052,5375052,5374816,236,566,utRho12
559,glnD,377310,377310,377300,10,88,utRho12
560,glnE,6399602,6399602,6399282,320,4,utRho12
561,glnH,1696396,1696396,1696008,388,0,utRho12
562,glnK,945112,945196,945112,84,30,utRho12
563,glnL,8112742,8112742,8112678,64,38,utRho12
564,glnQ,1693262,1693262,1692926,336,24,utRho12
565,glnS,1411998,1412186,1411998,188,876,utRho12
566,gloA,3455602,3455674,3455602,72,184,utRho12
567,gloB,469852,469852,469564,288,1760,utRho12
568,glpA,4705166,4705294,4705166,128,0,utRho12
569,glpD,7123942,7124026,7123942,84,70,utRho12
570,glpE,7123698,7123698,7123646,52,0,utRho12
571,glpF,8236322,8236322,8236180,142,234,utRho12
572,glpG,7122960,7122960,7122904,56,198,utRho12
573,glpR,7121782,7121782,7121210,572,172,utRho12
574,glpT,4704902,4704902,4704748,154,110,utRho12
575,glpX,8231212,8231212,8231158,54,9046,utRho12
576,glrK,5382246,5382246,5382196,50,1758,utRho12
577,gltA,1509534,1509534,1508936,598,4628,utRho12
578,gltB,6709018,6709264,6709018,246,414,utRho12
579,gltI,1375792,1375792,1375494,298,3092,utRho12
580,gltP,8588536,8588962,8588536,426,570,utRho12
581,gltS,7657382,7657382,7657330,52,502,utRho12
582,gltX,5041568,5041568,5041344,224,20,utRho12
583,gluQ,320286,320286,320224,62,66,utRho12
584,glyA,5371148,5371148,5371014,134,0,utRho12
585,glyQ,7450708,7450708,7450636,72,110,utRho12
586,glyS,7448990,7448990,7448794,196,2844,utRho12
587,glyU,5998128,5998128,5998114,14,0,utRho12
588,glyV,8784626,8784720,8784626,94,232,utRho12
589,glyW,3984360,3984360,3984234,126,0,utRho12
590,gmhB,445612,445666,445612,54,0,utRho12
591,gmk,7642776,7642856,7642776,80,22,utRho12
592,gmr,2693686,2693686,2693484,202,336,utRho12
593,gnd,4202648,4202648,4202536,112,940,utRho12
594,gnsB,3275692,3275692,3275564,128,38,utRho12
595,gntK,14310580,14310580,14310368,212,652,utRho12
596,gntP,9102668,9102668,9102592,76,68,utRho12
597,gntR,7157760,7157760,7157452,308,524,utRho12
598,gntT,7092810,7093118,7092810,308,860,utRho12
599,gntU,7154170,7154170,7154122,48,0,utRho12
600,gntX,7089334,7089764,7089334,430,20,utRho12
601,gor,7292224,7292598,7292224,374,296,utRho12
602,gpmA,1575340,1575340,1575190,150,20,utRho12
603,gpmM,7570374,7570520,7570374,146,0,utRho12
604,gpsA,7567620,7567620,7567322,298,7856,utRho12
605,gpt,511828,511954,511828,126,888,utRho12
606,grcA,5433046,5433046,5432898,148,1304,utRho12
607,greA,6657728,6657728,6657430,298,1494,utRho12
608,greB,7073488,7073624,7073488,136,86,utRho12
609,groL,8741566,8742050,8741566,484,380,utRho12
610,groS,8741232,8741376,8741232,144,578,utRho12
611,grpE,5501494,5501494,5501416,78,216,utRho12
612,grxA,1781552,1781552,1781506,46,0,utRho12
613,grxB,2248206,2248206,2248108,98,122,utRho12
614,grxC,7569152,7569152,7568884,268,6004,utRho12
615,grxD,3468324,3468324,3468202,122,8134,utRho12
616,gspA,6911268,6911268,6910796,472,86,utRho12
617,gspC,6910964,6911156,6910964,192,8,utRho12
618,gss,6277220,6277220,6277044,176,0,utRho12
619,gstA,3428654,3428754,3428654,100,0,utRho12
620,gstB,1761038,1761038,1760960,78,58,utRho12
621,guaB,5268214,5268214,5268140,74,190,utRho12
622,gudD,5839026,5839026,5838770,256,34,utRho12
623,gyrA,4678914,4678914,4678840,74,56,utRho12
624,gyrB,7760300,7760300,7760238,62,228,utRho12
625,hcaE,5337964,5338064,5337964,100,190,utRho12
626,hcaR,5337928,5337928,5337792,136,204,utRho12
627,hcaT,5336106,5336106,5335692,414,96,utRho12
628,hchA,4071260,4071670,4071260,410,10,utRho12
629,hcp,1828258,1828258,1827628,630,754,utRho12
630,hcr,1824400,1824400,1824300,100,74,utRho12
631,hdeA,7313582,7313582,7313480,102,0,utRho12
632,hdeD,7313920,7313990,7313920,70,0,utRho12
633,hdfR,7896320,7896320,7895934,386,860,utRho12
634,hdhA,3396244,3396244,3396080,164,104,utRho12
635,helD,2048876,2048942,2048876,66,0,utRho12
636,hemA,2527166,2527428,2527166,262,110,utRho12
637,hemB,779722,779722,779454,268,94,utRho12
638,hemF,5106410,5106450,5106410,40,0,utRho12
639,hemH,996062,996110,996062,48,656,utRho12
640,hemL,349882,349882,349764,118,0,utRho12
641,hemN,8103886,8104090,8103886,204,122,utRho12
642,hepA,127176,127176,126528,648,1342,utRho12
643,hflD,2385372,2385372,2385262,110,112,utRho12
644,hfq,8799602,8800576,8799602,974,3126,utRho12
645,hha,961006,961006,960616,390,178,utRho12
646,hicA,3018442,3018572,3018442,130,154,utRho12
647,higA,6468682,6468682,6468288,394,364,utRho12
648,higB,6468960,6468960,6468910,50,0,utRho12
649,hinT,2323642,2323770,2323642,128,0,utRho12
650,hipB,3184964,3184964,3184884,80,18,utRho12
651,hisB,4186720,4186936,4186720,216,806,utRho12
652,hisJ,4853674,4853674,4853576,98,42,utRho12
653,hisL,8359856,8359984,8359856,128,76,utRho12
654,hisS,5281284,5281284,5281150,134,286,utRho12
655,hlpA,400910,400964,400910,54,178,utRho12
656,hlyE,2460932,2460932,2460788,144,296,utRho12
657,hmp,5371594,5371670,5371594,76,0,utRho12
658,hns,2585916,2585916,2585844,72,1022,utRho12
659,hofM,7045856,7045856,7045502,354,0,utRho12
660,hokA,7441620,7441620,7441200,420,6966,utRho12
661,hokC,33902,33902,33806,96,166,utRho12
662,hokE,1215462,1215672,1215462,210,22,utRho12
663,holC,8968546,8968546,8968560,14,490,utRho12
664,holD,9215562,9215606,9215562,44,0,utRho12
665,holE,3850040,3850216,3850040,176,4680,utRho12
666,hpt,282720,282862,282720,142,204,utRho12
667,hrpB,324150,324210,324150,60,94,utRho12
668,hscB,5319048,5319048,5318934,114,1188,utRho12
669,hscC,1367188,1367188,1366786,402,374,utRho12
670,hsdS,9163004,9163004,9162924,80,58,utRho12
671,hslJ,2883560,2883560,2883486,74,82,utRho12
672,hslO,7059344,7059548,7059344,204,4566,utRho12
673,hslR,7058220,7058696,7058220,476,940,utRho12
674,hslV,8244708,8244708,8244574,134,250,utRho12
675,hsrA,7881412,7881412,7881224,188,144,utRho12
676,htgA,21286,21660,21286,374,5402,utRho12
677,htpG,989634,990240,989634,606,26374,utRho12
678,htpX,3825236,3825236,3825152,84,0,utRho12
679,htrE,311036,311036,310852,184,490,utRho12
680,htrL,7587668,7587668,7587366,302,102,utRho12
681,hupA,8400352,8400562,8400352,210,94,utRho12
682,hupB,1845220,1845804,1845220,584,244,utRho12
683,hyaA,2063968,2064278,2063968,310,96,utRho12
684,hybO,6292726,6292726,6292522,204,3592,utRho12
685,hycA,5700922,5700922,5700870,52,0,utRho12
686,hycI,5686204,5686204,5686086,118,268,utRho12
687,hydN,5676264,5676264,5676210,54,0,utRho12
688,hyfA,5202342,5202402,5202342,60,36,utRho12
689,hypA,11402508,11402588,11402508,80,116,utRho12
690,hypB,11403356,11404004,11403356,648,240,utRho12
691,hypF,5676210,5676210,5674850,1360,1566,utRho12
692,hypT,9116634,9116634,9116578,56,0,utRho12
693,hyuA,6019660,6020056,6019660,396,0,utRho12
694,iaaA,1733074,1733136,1733074,62,0,utRho12
695,iadA,9119074,9119074,9119052,22,36,utRho12
696,iap,5753072,5753162,5753072,90,0,utRho12
697,ibaG,6673966,6673966,6673606,360,196,utRho12
698,ibpA,7735036,7735036,7734844,192,244,utRho12
699,ibpB,7733962,7733962,7733794,168,50,utRho12
700,icd,2389922,2390246,2389922,324,280,utRho12
701,iclR,8447304,8447304,8447256,48,56,utRho12
702,idi,6065876,6066130,6065876,254,0,utRho12
703,idnD,8988870,8988870,8988812,58,0,utRho12
704,idnK,8989194,8989246,8989194,52,4,utRho12
705,ihfA,3591442,3591442,3591104,338,692,utRho12
706,ihfB,1927498,1927656,1927498,158,608,utRho12
707,ileS,43666,44782,43666,1116,3834,utRho12
708,ileX,6431194,6431196,6431194,2,0,utRho12
709,ilvA,15820940,15821324,15820940,384,96,utRho12
710,ilvC,7915824,7915940,7915824,116,26,utRho12
711,ilvE,15809552,15809936,15809552,384,660,utRho12
712,ilvI,170840,171260,170840,420,196,utRho12
713,ilvL,23701308,23701932,23701308,624,66,utRho12
714,ilvY,7915734,7915734,7915640,94,32,utRho12
715,inaA,4698998,4698998,4698944,54,150,utRho12
716,infA,1853370,1853370,1852886,484,1798,utRho12
717,infC,3602692,3602692,3601276,1416,3468,utRho12
718,insA-5,3958452,3958452,3958430,22,26,utRho12
719,insA-7,9036758,9037054,9036758,296,494,utRho12
720,insC-5,6372080,6372284,6372080,204,6468,utRho12
721,insEF-2,785238,785238,785820,582,714,utRho12
722,insEF-4,2190310,2190310,2190892,582,682,utRho12
723,insG,9007098,9007098,9006862,236,42,utRho12
724,insH-1,550596,550596,550234,362,360,utRho12
725,insH-11,7306538,7306538,7306396,142,52,utRho12
726,insH-2,1151548,1151548,1151506,42,98,utRho12
727,insH-3,1378444,1378444,1378026,418,456,utRho12
728,insH-4,2791942,2792152,2791942,210,76,utRho12
729,insH-5,2857852,2857852,2857452,400,40,utRho12
730,insH-6,4135022,4135022,4134642,380,568,utRho12
731,insH-7,4206186,4206186,4205822,364,6010,utRho12
732,insH-9,6260050,6260356,6260050,306,138,utRho12
733,insI-3,9017372,9017372,9017234,138,80,utRho12
734,insJ,7441188,7441360,7441188,172,3366,utRho12
735,insK,7442130,7442308,7442130,178,0,utRho12
736,insL-1,30760,30890,30760,130,678,utRho12
737,insL-2,1216112,1216130,1216112,18,74,utRho12
738,insL-3,5028644,5028662,5028644,18,68,utRho12
739,insN-1,540452,540484,540452,32,0,utRho12
740,intD,1132202,1132202,1131956,246,2990,utRho12
741,intR,2826520,2826520,2826470,50,0,utRho12
742,intS,4933026,4933090,4933026,64,4744,utRho12
743,intZ,5117386,5117542,5117386,156,856,utRho12
744,iraD,9113152,9113986,9113152,834,192,utRho12
745,iraM,2424246,2424246,2424006,240,78,utRho12
746,iraP,802638,802772,802638,134,0,utRho12
747,iscA,5319924,5319924,5319772,152,1048,utRho12
748,iscR,5324398,5324398,5324262,136,12624,utRho12
749,iscX,5313834,5313834,5313472,362,3524,utRho12
750,ispF,5743968,5743968,5743560,408,1828,utRho12
751,ispG,5283908,5283908,5283608,300,714,utRho12
752,ispU,389568,389806,389568,238,16,utRho12
753,isrA,2811502,2811502,2811618,116,0,utRho12
754,istr-1,7706384,7706384,7706384,0,0,utRho12
755,istr-2,7706514,7706514,7706514,0,0,utRho12
756,ivbL,15412092,15412092,15411952,140,532,utRho12
757,ivy,480638,480686,480638,48,2,utRho12
758,katE,3627628,3627734,3627628,106,76,utRho12
759,katG,8267624,8267670,8267624,46,54,utRho12
760,kbaZ,6557732,6557828,6557732,96,0,utRho12
761,kbl,7585154,7585154,7585102,52,668,utRho12
762,kch,2621046,2621046,2620538,508,402,utRho12
763,kdgR,3820506,3820506,3820198,308,8,utRho12
764,kdpE,1443788,1443788,1443466,322,2,utRho12
765,kdpF,1457698,1457698,1457642,56,0,utRho12
766,kdsA,2535708,2536330,2535708,622,2054,utRho12
767,kdsC,6683438,6684546,6683438,1108,1724,utRho12
768,kduI,5968388,5968388,5968248,140,3116,utRho12
769,kefF,94160,94492,94160,332,188,utRho12
770,kgtP,5451624,5451624,5451492,132,1626,utRho12
771,kup,7862206,7862632,7862206,426,4,utRho12
772,lacI,735076,735076,735020,56,0,utRho12
773,lacZ,1465508,1465508,1465220,288,24,utRho12
774,ldcA,2486394,2486394,2486160,234,44,utRho12
775,ldhA,2885830,2885830,2885686,144,0,utRho12
776,ldrA,2538954,2538954,2538550,404,3274,utRho12
777,ldrB,2540024,2540024,2539620,404,1044,utRho12
778,ldrC,2541092,2541092,2540690,402,648,utRho12
779,ldrD,7400544,7400544,7400174,370,1462,utRho12
780,lepA,5414392,5414392,5414248,144,300,utRho12
781,lepB,5410928,5410928,5410618,310,572,utRho12
782,leuD,159188,159188,158906,282,60,utRho12
783,leuE,3761600,3761600,3761518,82,0,utRho12
784,leuL,168048,168048,167416,632,0,utRho12
785,leuO,168308,168736,168308,428,192,utRho12
786,leuQ,9212864,9212864,9212802,62,0,utRho12
787,leuU,6644556,6644556,6644316,240,2588,utRho12
788,leuV,9212546,9212546,9212330,216,3474,utRho12
789,leuX,8992772,8992810,8992772,38,0,utRho12
790,lexA,8514174,8514230,8514174,56,102,utRho12
791,lhr,3456706,3458174,3456706,1468,1778,utRho12
792,ligA,5060402,5060402,5060352,50,36,utRho12
793,ligB,7642576,7642576,7642340,236,344,utRho12
794,lipA,1320602,1320602,1320432,170,88,utRho12
795,lipB,1324802,1324802,1324556,246,3226,utRho12
796,lit,2397032,2397390,2397032,358,1174,utRho12
797,livJ,7199524,7199524,7199316,208,1842,utRho12
798,livK,7195510,7195510,7195120,390,70,utRho12
799,lldP,7554578,7554798,7554578,220,2990,utRho12
800,lnt,1381968,1381968,1381762,206,244,utRho12
801,loiP,6163784,6163826,6163784,42,212,utRho12
802,lolA,1874656,1874738,1874656,82,390,utRho12
803,lolB,2527112,2527112,2527000,112,110,utRho12
804,lolC,2350748,2350854,2350748,106,0,utRho12
805,lon,917630,917776,917630,146,1078,utRho12
806,lpcA,486936,487086,486936,150,0,utRho12
807,lpd,255434,255824,255434,390,3594,utRho12
808,lplA,9248476,9248476,9248234,242,1092,utRho12
809,lplT,5947878,5947878,5947724,154,0,utRho12
810,lpoA,6586422,6586800,6586422,378,162,utRho12
811,lpp,3514592,3514842,3514592,250,410,utRho12
812,lptA,6686598,6686760,6686598,162,198,utRho12
813,lptB,6686792,6687888,6686792,1096,1670,utRho12
814,lptD,114672,114672,114218,454,2178,utRho12
815,lptF,8972244,8972436,8972244,192,72,utRho12
816,lpxC,213016,213114,213016,98,6500,utRho12
817,lpxD,401920,401942,401920,22,178,utRho12
818,lpxL,2233418,2233418,2233164,254,112,utRho12
819,lpxM,3880456,3880456,3880386,70,44,utRho12
820,lpxP,4991156,4991290,4991156,134,244,utRho12
821,lrhA,4813312,4813312,4813282,30,50,utRho12
822,lrp,1864656,1865190,1864656,534,398,utRho12
823,lspA,50028,50414,50028,386,536,utRho12
824,lsrA,3202920,3202980,3202920,60,24,utRho12
825,lsrR,3202514,3202514,3202482,32,0,utRho12
826,ltaE,1818640,1818640,1818588,52,0,utRho12
827,luxS,5630130,5630130,5629466,664,16656,utRho12
828,lysA,5957902,5957902,5957798,104,62,utRho12
829,lysC,8467232,8467232,8466466,766,254,utRho12
830,lysP,4497120,4497120,4497064,56,0,utRho12
831,lysR,5957900,5958042,5957900,142,60,utRho12
832,lysT,1561028,1561108,1561028,80,142,utRho12
833,lysU,8709610,8709610,8709434,176,126,utRho12
834,macB,1840188,1840694,1840188,506,268,utRho12
835,maeA,3111484,3111484,3111338,146,2804,utRho12
836,mak,820236,820288,820236,52,44,utRho12
837,malE,8492928,8492928,8492838,90,0,utRho12
838,malI,3398456,3398456,3398360,96,0,utRho12
839,malK,8493472,8493568,8493472,96,0,utRho12
840,malP,7105020,7105020,7104946,74,488,utRho12
841,malQ,7100798,7100798,7100140,658,100,utRho12
842,malS,14949880,14949988,14949880,108,0,utRho12
843,malT,7106048,7106170,7106048,122,172,utRho12
844,malX,3398626,3398710,3398626,84,0,utRho12
845,malZ,1689980,1690072,1689980,92,2420,utRho12
846,manA,3377102,3377152,3377102,50,0,utRho12
847,manX,3803866,3804096,3803866,230,14,utRho12
848,marC,3237882,3237882,3237816,66,0,utRho12
849,marR,3238186,3238240,3238186,54,244,utRho12
850,matP,2036918,2036970,2036918,52,106,utRho12
851,mazE,5822736,5822736,5822678,58,0,utRho12
852,mazG,5821720,5821720,5821370,350,3438,utRho12
853,mcbA,1684306,1684306,1684112,194,2,utRho12
854,mcbR,3040192,3040524,3040192,332,72,utRho12
855,mcrA,2420278,2420692,2420278,414,0,utRho12
856,mcrC,9156124,9156124,9155916,208,234,utRho12
857,mdaB,6344814,6345060,6344814,246,36,utRho12
858,mdfA,1767138,1767346,1767138,208,0,utRho12
859,mdh,6768940,6768940,6768536,404,78,utRho12
860,mdoB,9198988,9198988,9198882,106,1444,utRho12
861,mdoD,2993290,2993712,2993290,422,0,utRho12
862,mdoG,2218514,2218670,2218514,156,344,utRho12
863,mdtA,4307958,4308032,4307958,74,212,utRho12
864,mdtE,7318168,7318464,7318168,296,580,utRho12
865,mdtK,3486538,3486914,3486538,376,872,utRho12
866,mdtP,8602472,8602472,8602060,412,192,utRho12
867,melA,8683774,8683822,8683774,48,0,utRho12
868,melR,8683300,8683300,8683256,44,32,utRho12
869,menA,8240812,8240812,8240698,114,50,utRho12
870,menB,4753774,4753774,4753638,136,158,utRho12
871,mepH,3468714,3468870,3468714,156,34,utRho12
872,mepM,3883666,3883666,3883270,396,660,utRho12
873,mepS,4539840,4539958,4539840,118,288,utRho12
874,metA,8428318,8428560,8428318,242,406,utRho12
875,metB,8257272,8257344,8257272,72,520,utRho12
876,metC,6304150,6304472,6304150,322,86,utRho12
877,metE,8025768,8026106,8025768,338,962,utRho12
878,metF,8265092,8265232,8265092,140,60,utRho12
879,metG,4388538,4388600,4388538,62,6,utRho12
880,metH,8447010,8447656,8447010,646,1528,utRho12
881,metJ,8257116,8257116,8256790,326,92,utRho12
882,metK,6173154,6173412,6173154,258,182,utRho12
883,metN,445428,445428,445290,138,0,utRho12
884,metR,8025710,8025710,8025632,78,12,utRho12
885,metT,1394326,1394326,1394266,60,290,utRho12
886,metY,19910250,19910250,19909734,516,408,utRho12
887,metZ,11789528,11789548,11789528,20,80,utRho12
888,mfd,2348056,2348056,2347928,128,20,utRho12
889,mglA,4478782,4478782,4478578,204,202,utRho12
890,mglB,4481132,4481132,4480696,436,7684,utRho12
891,mglC,4475918,4475918,4475506,412,36,utRho12
892,mgrB,3817584,3817584,3817532,52,18,utRho12
893,mgrR,3245828,3245828,3245828,0,0,utRho12
894,mgsA,2054082,2054082,2054030,52,170,utRho12
895,mgtL,8934560,8934862,8934560,302,216,utRho12
896,mhpA,737038,737222,737038,184,0,utRho12
897,mhpR,737072,737072,736840,232,0,utRho12
898,mhpT,750772,750918,750772,146,0,utRho12
899,miaA,8797964,8798504,8797964,540,1496,utRho12
900,micA,5629604,5629604,5629604,0,0,utRho12
901,micC,2874242,2874238,2874242,4,0,utRho12
902,micF,4626168,4626168,4626168,0,0,utRho12
903,micM,1014408,1014408,1014408,0,0,utRho12
904,minE,2449422,2449422,2449090,332,946,utRho12
905,mioC,7852950,7852950,7852910,40,18,utRho12
906,mipA,3733012,3733012,3732944,68,2512,utRho12
907,mlaA,4930270,4930270,4930014,256,0,utRho12
908,mlc,3337206,3337206,3337128,78,4,utRho12
909,mlrA,4429498,4429732,4429498,234,124,utRho12
910,mltA,5894546,5894546,5894356,190,0,utRho12
911,mltD,468050,468050,467910,140,0,utRho12
912,mltF,5391534,5391602,5391534,68,0,utRho12
913,mmuP,550238,550650,550238,412,550,utRho12
914,mngA,1531622,1531968,1531622,346,510,utRho12
915,mngR,1531852,1531852,1531750,102,434,utRho12
916,mnmG,7851348,7851348,7851266,82,5704,utRho12
917,mntH,5025470,5025470,5025412,58,78,utRho12
918,mntP,3810918,3811376,3810918,458,1256,utRho12
919,mntR,1706160,1706366,1706160,206,170,utRho12
920,mntS,1706128,1706128,1705994,134,70,utRho12
921,moaA,1633654,1634088,1633654,434,576,utRho12
922,moaB,1635954,1636110,1635954,156,1946,utRho12
923,mobA,8084242,8084242,8083998,244,68,utRho12
924,mocA,6030112,6030320,6030112,208,48,utRho12
925,modA,1589990,1590178,1589990,188,388,utRho12
926,moeA,1732788,1732788,1732728,60,70,utRho12
927,mokB,2984610,2984610,2984258,352,740,utRho12
928,molR_1,4392888,4392948,4392888,60,150,utRho12
929,motA,3954604,3954604,3954278,326,106,utRho12
930,mpaA,2781278,2781278,2781196,82,362,utRho12
931,mpl,8911456,8911570,8911456,114,24,utRho12
932,mppA,2786108,2786454,2786108,346,26,utRho12
933,mprA,5621494,5621540,5621494,46,1116,utRho12
934,mqo,4613848,4613848,4613508,340,694,utRho12
935,mqsA,6336742,6336742,6336492,250,192,utRho12
936,mqsR,6337306,6337306,6337088,218,982,utRho12
937,mraZ,179192,179268,179192,76,114,utRho12
938,mrcA,7045652,7045742,7045652,90,0,utRho12
939,mrcB,329442,329460,329442,18,0,utRho12
940,mreB,13605424,13605424,13604348,1076,2552,utRho12
941,mreD,6798166,6798166,6797750,416,120,utRho12
942,mrp,4388360,4388360,4388336,24,0,utRho12
943,mscK,972984,973072,972984,88,74,utRho12
944,mscL,6876002,6876048,6876002,46,1018,utRho12
945,mscS,6139742,6139742,6139614,128,0,utRho12
946,msrA,8884522,8884522,8884352,170,286,utRho12
947,msrB,3725168,3725168,3724858,310,0,utRho12
948,msyB,2228426,2228426,2228362,64,454,utRho12
949,mtfA,4087236,4087302,4087236,66,1252,utRho12
950,mtgA,6699662,6699662,6699618,44,514,utRho12
951,mtlA,30177504,30178248,30177504,744,584,utRho12
952,mtn,358366,358366,358306,60,392,utRho12
953,mtr,6611864,6611864,6611634,230,170,utRho12
954,mug,6430992,6430992,6430946,46,158,utRho12
955,murQ,5091466,5091546,5091466,80,0,utRho12
956,murR,5091586,5091586,5091218,368,0,utRho12
957,mutH,5939164,5939324,5939164,160,326,utRho12
958,mutL,8794092,8794824,8794092,732,5624,utRho12
959,mutM,7622554,7622554,7622304,250,1980,utRho12
960,mutS,5714038,5714186,5714038,148,734,utRho12
961,mutY,18617466,18618078,18617466,612,216,utRho12
962,nac,4123956,4123956,4123866,90,390,utRho12
963,nadA,1564122,1564170,1564122,48,52,utRho12
964,nadB,5420714,5420840,5420714,126,4,utRho12
965,nadC,237326,237326,237290,36,62,utRho12
966,nadE,3644604,3644916,3644604,312,164,utRho12
967,nadK,5501526,5501662,5501526,136,114,utRho12
968,nagA,1406350,1406350,1405502,848,1456,utRho12
969,nagB,1407416,1407416,1407222,194,0,utRho12
970,nagC,1404016,1404016,1403188,828,2,utRho12
971,nagE,1407680,1407888,1407680,208,54,utRho12
972,nagK,2357080,2357186,2357080,106,72,utRho12
973,nanA,6747240,6747240,6747152,88,22,utRho12
974,nanC,9079856,9079856,9079002,854,92,utRho12
975,nanR,6749406,6749406,6748978,428,364,utRho12
976,nanS,9075406,9075406,9075188,218,0,utRho12
977,napF,4607390,4607390,4606994,396,172,utRho12
978,narG,2559614,2559728,2559614,114,0,utRho12
979,narK,2555642,2555914,2555642,272,2,utRho12
980,narP,4580844,4581000,4580844,156,28,utRho12
981,narQ,5171154,5171462,5171154,308,256,utRho12
982,narU,3088326,3088326,3088120,206,32,utRho12
983,narW,3077374,3077374,3074618,2756,60,utRho12
984,narX,2555554,2555554,2555236,318,56,utRho12
985,narZ,3085380,3085380,3085180,200,0,utRho12
986,ndh,2331984,2332170,2331984,186,108,utRho12
987,ndk,5289920,5289920,5289728,192,36,utRho12
988,nemR,6904084,6904092,6904084,8,84,utRho12
989,nepI,7683542,7683542,7683478,64,104,utRho12
990,nfo,4501612,4501680,4501612,68,54,utRho12
991,nfsB,1210906,1210906,1210848,58,0,utRho12
992,nfuA,7090916,7091248,7090916,332,392,utRho12
993,nhaA,34634,34978,34634,344,138,utRho12
994,nhaB,2469534,2469534,2469434,100,0,utRho12
995,nhoA,3067926,3068048,3067926,122,0,utRho12
996,nikA,7226878,7227334,7226878,456,6328,utRho12
997,nikR,7237074,7237176,7237074,102,254,utRho12
998,nirB,6987974,6988022,6987974,48,24,utRho12
999,nlpA,7680034,7680034,7679986,48,72,utRho12
1000,nlpC,3585654,3585654,3585462,192,0,utRho12
1001,nlpD,5737658,5737658,5737506,152,10,utRho12
1002,nlpI,6618080,6618080,6617848,232,62,utRho12
1003,nmpC,1153740,1153740,1153650,90,0,utRho12
1004,nohA,3273206,3273206,3272734,472,304,utRho12
1005,norR,5664614,5664614,5664578,36,0,utRho12
1006,norV,5664878,5664952,5664878,74,0,utRho12
1007,nrdA,4689510,4689730,4689510,220,6412,utRho12
1008,nrdD,8925676,8925676,8925320,356,2904,utRho12
1009,nrdH,5601312,5601446,5601312,134,42,utRho12
1010,nrdR,865954,866004,865954,50,140,utRho12
1011,nrfA,8575342,8575528,8575342,186,88,utRho12
1012,nsrR,8812088,8812380,8812088,292,15148,utRho12
1013,nudB,3897348,3897348,3897264,84,92,utRho12
1014,nudC,8393428,8393806,8393428,378,0,utRho12
1015,nudE,7052658,7052658,7052298,360,952,utRho12
1016,nudG,3682876,3682980,3682876,104,0,utRho12
1017,nudI,4729050,4729108,4729050,58,0,utRho12
1018,nudJ,2388874,2388874,2388576,298,984,utRho12
1019,nuoA,4810670,4810670,4810144,526,5246,utRho12
1020,nuoN,4783434,4783434,4783010,424,630,utRho12
1021,nupC,5026018,5026084,5026018,66,0,utRho12
1022,nupG,6211302,6211428,6211302,126,142,utRho12
1023,ogrK,4335096,4335096,4335040,56,0,utRho12
1024,ogt,2800568,2800568,2800472,96,42,utRho12
1025,ohsC,5401036,5401040,5401036,4,50,utRho12
1026,ompA,2040382,2040382,2040106,276,19188,utRho12
1027,ompC,4625774,4625774,4625498,276,134,utRho12
1028,ompF,1974184,1974184,1973964,220,132,utRho12
1029,ompL,8128958,8128958,8128590,368,0,utRho12
1030,ompN,2874158,2874158,2873786,372,22,utRho12
1031,ompR,7073510,7073510,7073168,342,116,utRho12
1032,ompT,1171330,1171330,1171266,64,146,utRho12
1033,ompW,2627982,2628040,2627982,58,0,utRho12
1034,ompX,1700418,1700900,1700418,482,1758,utRho12
1035,omrA,5952378,5952378,5952378,0,0,utRho12
1036,omrB,5952770,5952770,5952770,0,0,utRho12
1037,oppA,2602170,2602364,2602170,194,9448,utRho12
1038,orn,8783168,8783208,8783168,40,0,utRho12
1039,osmB,2686952,2686952,2686656,296,1976,utRho12
1040,osmC,3113192,3113250,3113192,58,0,utRho12
1041,osmE,3644566,3644566,3644512,54,52,utRho12
1042,osmF,4439046,4439046,4438962,84,850,utRho12
1043,osmY,9222306,9222792,9222306,486,988,utRho12
1044,otsA,3963302,3963302,3963224,78,68,utRho12
1045,otsB,3964930,3964930,3964774,156,392,utRho12
1046,oxc,4984288,4984288,4983900,388,312,utRho12
1047,oxyR,8316914,8316980,8316914,66,334,utRho12
1048,oxyS,8316788,8316788,8316788,0,0,utRho12
1049,paaA,2907730,2907854,2907730,124,44,utRho12
1050,paaX,2927018,2927078,2927018,60,0,utRho12
1051,paaZ,2907340,2907340,2907284,56,0,utRho12
1052,pabA,6981702,6981702,6981658,44,34,utRho12
1053,pabB,3789256,3789610,3789256,354,206,utRho12
1054,pabC,2306186,2306600,2306186,414,916,utRho12
1055,pagP,1313052,1313114,1313052,62,0,utRho12
1056,panB,299260,299260,299202,58,862,utRho12
1057,panC,297840,297840,297590,250,152,utRho12
1058,panD,293490,293490,293388,102,102,utRho12
1059,panZ,7195656,7195968,7195656,312,430,utRho12
1060,parC,6332060,6332060,6331946,114,82,utRho12
1061,patA,6438916,6438988,6438916,72,0,utRho12
1062,patD,3030830,3031156,3030830,326,0,utRho12
1063,pbpC,5294986,5294986,5294650,336,0,utRho12
1064,pbpG,4450132,4450132,4449740,392,120,utRho12
1065,pck,7065358,7065636,7065358,278,4192,utRho12
1066,pcnB,318782,318782,318252,530,300,utRho12
1067,pdhR,244068,244184,244068,116,0,utRho12
1068,pdxB,4875768,4875768,4875702,66,126,utRho12
1069,pdxH,3436068,3436068,3436014,54,188,utRho12
1070,pdxJ,5403626,5403626,5403458,168,230,utRho12
1071,pdxK,5074638,5074638,5074474,164,262,utRho12
1072,pepA,8972278,8972278,8971902,376,346,utRho12
1073,pepD,511618,511618,511432,186,3228,utRho12
1074,pepN,1981182,1981244,1981182,62,234,utRho12
1075,pepQ,8062294,8062322,8062294,28,0,utRho12
1076,pepT,2371646,2371688,2371646,42,98,utRho12
1077,pfkA,8214948,8215104,8214948,156,78,utRho12
1078,pfkB,3612646,3612740,3612646,94,0,utRho12
1079,pflA,1902456,1902456,1902160,296,0,utRho12
1080,pflB,1907850,1907850,1907108,742,760,utRho12
1081,pflD,8287716,8287990,8287716,274,24,utRho12
1082,pgaA,2185046,2185046,2184578,468,82,utRho12
1083,pgi,8467444,8467516,8467444,72,0,utRho12
1084,pgk,12291428,12291428,12290488,940,968,utRho12
1085,pgl,1597078,1597172,1597078,94,82,utRho12
1086,pgpB,2678324,2678660,2678324,336,124,utRho12
1087,pgpC,5397276,5397276,5397100,176,4,utRho12
1088,pgrR,2783744,2783982,2783744,238,104,utRho12
1089,pheL,5475158,5475198,5475158,40,0,utRho12
1090,pheM,7197204,7197204,7197080,124,80,utRho12
1091,pheP,1203858,1203918,1203858,60,66,utRho12
1092,pheU,8725254,8725254,8725252,2,0,utRho12
1093,pheV,6220730,6220732,6220730,2,0,utRho12
1094,phnC,8650412,8650412,8650330,82,40,utRho12
1095,phoA,803414,803494,803414,80,124,utRho12
1096,phoB,834202,834284,834202,82,0,utRho12
1097,phoE,520316,520316,520200,116,84,utRho12
1098,phoH,2169730,2169984,2169730,254,0,utRho12
1099,phoP,2381016,2381016,2380894,122,1794,utRho12
1100,phoQ,2379880,2379880,2379552,328,644,utRho12
1101,phoU,7815330,7815330,7815156,174,500,utRho12
1102,phr,1478842,1479014,1478842,172,0,utRho12
1103,pinE,2419054,2419370,2419054,316,140,utRho12
1104,pinQ,3267168,3267244,3267168,76,570,utRho12
1105,pinR,2867424,2867424,2867348,76,472,utRho12
1106,pitA,7275224,7275284,7275224,60,0,utRho12
1107,pitB,6272806,6272806,6272742,64,0,utRho12
1108,pka,5439862,5439906,5439862,44,56,utRho12
1109,plaP,4174476,4174476,4174124,352,1326,utRho12
1110,pldA,8009628,8009724,8009628,96,144,utRho12
1111,pldB,8018028,8018340,8018028,312,504,utRho12
1112,plsB,8513196,8513196,8512932,264,252,utRho12
1113,pmbA,8915890,8915918,8915890,28,32,utRho12
1114,pmrD,4747148,4747148,4747076,72,0,utRho12
1115,pncB,1980828,1980828,1980712,116,4,utRho12
1116,pncC,5648788,5648788,5648692,96,0,utRho12
1117,pnp,6622652,6622652,6622336,316,248,utRho12
1118,pntA,3355950,3355950,3355806,144,0,utRho12
1119,pntB,3353096,3353096,3352720,376,0,utRho12
1120,polA,8093880,8093932,8093880,52,68,utRho12
1121,polB,131606,131606,131560,46,0,utRho12
1122,potD,2365700,2365700,2365658,42,0,utRho12
1123,potE,1436688,1436688,1436530,158,0,utRho12
1124,potF,1787268,1787568,1787268,300,106,utRho12
1125,poxB,1822152,1822152,1822098,54,116,utRho12
1126,ppa,8899372,8899372,8899304,68,266,utRho12
1127,ppc,8306380,8306380,8306196,184,10,utRho12
1128,ppdA,5928440,5928440,5928354,86,3128,utRho12
1129,ppdD,235410,235410,235098,312,218,utRho12
1130,pphA,3846770,3846770,3845938,832,7398,utRho12
1131,pphB,5719474,5719520,5719474,46,318,utRho12
1132,ppiA,6984898,6984898,6984594,304,4,utRho12
1133,ppiC,7919682,7919682,7919626,56,224,utRho12
1134,ppiD,923638,923830,923638,192,414,utRho12
1135,ppk,5245748,5246088,5245748,340,286,utRho12
1136,pppA,6228958,6228958,6228704,254,48,utRho12
1137,ppsA,3574322,3574322,3574224,98,88,utRho12
1138,ppsR,3574678,3574890,3574678,212,18,utRho12
1139,pptA,3065716,3066104,3065716,388,96,utRho12
1140,pqiA,2023318,2024002,2023318,684,124,utRho12
1141,prc,3830054,3830054,3829632,422,19798,utRho12
1142,preT,4467978,4468066,4467978,88,1012,utRho12
1143,prfC,9218688,9218828,9218688,140,1544,utRho12
1144,prkB,6968622,6968980,6968622,358,836,utRho12
1145,prlC,7290476,7290476,7290364,112,234,utRho12
1146,prlF,6553944,6554004,6553944,60,156,utRho12
1147,proB,520432,520776,520432,344,122,utRho12
1148,proC,811372,811372,811288,84,0,utRho12
1149,proK,7417388,7417388,7417384,4,0,utRho12
1150,proL,4572414,4572422,4572414,8,32,utRho12
1151,proP,8660640,8661004,8660640,364,438,utRho12
1152,proS,437674,437674,437550,124,1024,utRho12
1153,proV,5609126,5609630,5609126,504,0,utRho12
1154,prpB,697292,697364,697292,72,0,utRho12
1155,prpR,696942,696942,696886,56,0,utRho12
1156,prs,2524354,2524354,2523750,604,32958,utRho12
1157,psd,8781276,8781276,8780720,556,1510,utRho12
1158,psiE,8480600,8480650,8480600,50,0,utRho12
1159,pspA,2736076,2736158,2736076,82,0,utRho12
1160,pspF,2736080,2736080,2735824,256,0,utRho12
1161,pspG,8525632,8525680,8525632,48,0,utRho12
1162,pssA,5445156,5445454,5445156,298,2226,utRho12
1163,pstB,7817112,7817112,7816732,380,174,utRho12
1164,pstC,7821084,7821084,7820796,288,192,utRho12
1165,pstS,23469408,23469408,23469150,258,324,utRho12
1166,psuG,4517114,4517114,4516734,380,922,utRho12
1167,psuT,4514992,4514992,4514670,322,0,utRho12
1168,pth,2517084,2517084,2517026,58,0,utRho12
1169,ptrA,5918022,5918022,5917768,254,22,utRho12
1170,ptrB,3857730,3857730,3857678,52,3246,utRho12
1171,ptsG,2315252,2315738,2315252,486,2500,utRho12
1172,ptsH,5066996,5067528,5066996,532,2950,utRho12
1173,purA,8809328,8809374,8809328,46,38,utRho12
1174,purC,5195562,5195562,5195236,326,0,utRho12
1175,purD,8411972,8411972,8411862,110,36,utRho12
1176,purE,1106284,1106284,1106200,84,1424,utRho12
1177,purH,8415254,8415254,8415064,190,0,utRho12
1178,purL,5391178,5391178,5391086,92,522,utRho12
1179,purM,5242306,5242394,5242306,88,0,utRho12
1180,purR,3475378,3475688,3475378,310,334,utRho12
1181,purT,3861438,3861762,3861438,324,200,utRho12
1182,purU,2577512,2577512,2577248,264,752,utRho12
1183,putA,2157850,2157850,2157764,86,0,utRho12
1184,putP,2158336,2158610,2158336,274,322,utRho12
1185,puuA,2721936,2721936,2721816,120,0,utRho12
1186,puuC,2725456,2725486,2725456,30,0,utRho12
1187,puuD,2722104,2722240,2722104,136,4,utRho12
1188,puuP,2718746,2718746,2718374,372,164,utRho12
1189,pykA,3874988,3875298,3874988,310,280,utRho12
1190,pykF,3510934,3511396,3510934,462,616,utRho12
1191,pyrC,2245286,2245286,2245214,72,242,utRho12
1192,pyrD,2009464,2009536,2009464,72,100,utRho12
1193,pyrE,7631970,7631970,7631536,434,22,utRho12
1194,pyrF,2683740,2683842,2683740,102,424,utRho12
1195,pyrG,5819594,5819594,5819332,262,1616,utRho12
1196,pyrH,383624,383710,383624,86,1862,utRho12
1197,pyrL,8945490,8945490,8945066,424,146,utRho12
1198,qmcA,1031646,1031646,1031546,100,68,utRho12
1199,qor,8528608,8528608,8528462,146,656,utRho12
1200,qseB,6339502,6339656,6339502,154,70,utRho12
1201,queA,849970,850022,849970,52,574,utRho12
1202,queE,5811212,5811212,5810836,376,818,utRho12
1203,queF,5850642,5850696,5850642,54,0,utRho12
1204,queG,8788184,8788184,8788134,50,75356,utRho12
1205,racC,2835630,2835630,2835526,104,0,utRho12
1206,racR,2840898,2840898,2840482,416,0,utRho12
1207,raiA,5474208,5474308,5474208,100,42,utRho12
1208,rarD,8008594,8008594,8008356,238,128,utRho12
1209,ravA,7862256,7862256,7862186,70,0,utRho12
1210,rayT,495088,495274,495088,186,148,utRho12
1211,rbn,4763162,4763216,4763162,54,30,utRho12
1212,rbsD,7866644,7866702,7866644,58,0,utRho12
1213,rcnA,4371654,4371834,4371654,180,136,utRho12
1214,rcnB,4373768,4373920,4373768,152,76,utRho12
1215,rcnR,4371806,4371806,4371592,214,204,utRho12
1216,rcsA,4047672,4047936,4047672,264,4080,utRho12
1217,rcsB,4631390,4632354,4631390,964,216,utRho12
1218,rcsC,4640162,4640162,4639656,506,114,utRho12
1219,rcsD,4626904,4626976,4626904,72,418,utRho12
1220,rdgB,6193240,6193362,6193240,122,390,utRho12
1221,rdlA,2538646,2538646,2538646,0,0,utRho12
1222,rdlB,2539712,2539716,2539712,4,58,utRho12
1223,rdlC,2540782,2540786,2540782,4,0,utRho12
1224,rdlD,7400272,7400272,7400272,0,0,utRho12
1225,rdoA,8084782,8084830,8084782,48,12,utRho12
1226,recA,11295276,11295276,11295076,200,396,utRho12
1227,recC,5925014,5925014,5924856,158,56,utRho12
1228,recF,7763722,7763722,7762442,1280,7480,utRho12
1229,recN,5503518,5503590,5503518,72,132,utRho12
1230,recQ,8011666,8011728,8011666,62,40,utRho12
1231,relA,5828554,5828554,5827302,1252,292,utRho12
1232,relB,3291806,3291806,3291744,62,52,utRho12
1233,rem,3289950,3289950,3289804,146,12,utRho12
1234,rep,7921294,7921354,7921294,60,136,utRho12
1235,rfaD,7587730,7587974,7587730,244,230,utRho12
1236,rfaE,6393852,6393852,6393506,346,0,utRho12
1237,rfaH,8049930,8049930,8049642,288,1308,utRho12
1238,rfbX,4219436,4219436,4219168,268,2600,utRho12
1239,rfe,7935600,7935832,7935600,232,228,utRho12
1240,rhaB,8194944,8194944,8194896,48,0,utRho12
1241,rhaD,8188770,8188770,8188544,226,0,utRho12
1242,rhaS,8195422,8195472,8195422,50,0,utRho12
1243,rhaT,8201132,8201132,8201050,82,80,utRho12
1244,rhlE,1661566,1661744,1661566,178,118,utRho12
1245,rhoL,47593944,47594772,47593944,828,205392,utRho12
1246,rhsB,7238006,7238384,7238006,378,430,utRho12
1247,rhsC,1458758,1459166,1458758,408,70,utRho12
1248,rhsD,1046132,1046522,1046132,390,0,utRho12
1249,rhtA,1700608,1700608,1700194,414,92,utRho12
1250,rhtC,8015478,8015514,8015478,36,962,utRho12
1251,ribA,2678468,2678468,2678320,148,86,utRho12
1252,ribC,3486916,3486916,3486484,432,1352,utRho12
1253,ribE,869008,869294,869008,286,6314,utRho12
1254,ribF,42766,42814,42766,48,90,utRho12
1255,ridA,8941892,8941892,8941826,66,98,utRho12
1256,rihA,1369204,1369204,1368824,380,2026,utRho12
1257,rihB,4510504,4510504,4510372,132,20,utRho12
1258,rimJ,2251044,2251124,2251044,80,2,utRho12
1259,rimK,1783752,1783934,1783752,182,418,utRho12
1260,rimL,2997486,2997876,2997486,390,424,utRho12
1261,rimO,1756140,1756140,1756070,70,12,utRho12
1262,rimP,6636350,6636350,6636012,338,722,utRho12
1263,rlmA,3814172,3814172,3814120,52,1028,utRho12
1264,rlmD,5830086,5830086,5830000,86,52,utRho12
1265,rlmE,6655520,6655520,6655328,192,1106,utRho12
1266,rlmF,1684384,1684664,1684384,280,110,utRho12
1267,rlmG,6471784,6471784,6471750,34,0,utRho12
1268,rlmI,2060002,2060002,2059938,64,280,utRho12
1269,rlmJ,7290700,7290770,7290700,70,194,utRho12
1270,rlmL,2015344,2015688,2015344,344,2018,utRho12
1271,rlpA,1330444,1330444,1330380,64,314,utRho12
1272,rluA,120900,120900,120692,208,304,utRho12
1273,rluF,8460324,8460708,8460324,384,92,utRho12
1274,rmf,2031006,2031430,2031006,424,2452,utRho12
1275,rna,1290068,1290068,1290006,62,10,utRho12
1276,rnb,2698258,2698258,2697824,434,1730,utRho12
1277,rnc,10816892,10816892,10816252,640,7860,utRho12
1278,rnd,3776122,3776122,3775982,140,138,utRho12
1279,rne,2289746,2289746,2288734,1012,5768,utRho12
1280,rnhA,472082,472082,472004,78,542,utRho12
1281,rnk,1288360,1288360,1287934,426,32,utRho12
1282,rnlA,5531788,5531836,5531788,48,410,utRho12
1283,rnlB,5533414,5533968,5533414,554,634,utRho12
1284,rnpB,19623552,19623552,19623552,0,0,utRho12
1285,rob,9270706,9270706,9270620,86,12,utRho12
1286,rodZ,5285868,5285868,5285688,180,16,utRho12
1287,rpe,7030306,7030306,7030118,188,140,utRho12
1288,rph,15266320,15266320,15266196,124,0,utRho12
1289,rpiA,6118706,6118706,6118650,56,224,utRho12
1290,rpiB,8626514,8626700,8626514,186,70,utRho12
1291,rpiR,8626274,8626274,8625982,292,22,utRho12
1292,rplJ,8359246,8359992,8359246,746,9828,utRho12
1293,rplK,8356708,8356894,8356708,186,778,utRho12
1294,rplM,6757344,6757344,6757302,42,11062,utRho12
1295,rplN,6896444,6896444,6896298,146,12688,utRho12
1296,rplS,5489284,5489284,5489060,224,22818,utRho12
1297,rplT,7199052,7199052,7198996,56,2020,utRho12
1298,rplU,6667036,6667036,6666902,134,142,utRho12
1299,rplY,4564866,4565034,4564866,168,108,utRho12
1300,rpmA,6666450,6666450,6666238,212,832,utRho12
1301,rpmB,15247980,15247980,15246696,1284,157416,utRho12
1302,rpmE,8253816,8254026,8253816,210,1240,utRho12
1303,rpmF,2294676,2294734,2294676,58,61248,utRho12
1304,rpmH,7768130,7768672,7768130,542,6818,utRho12
1305,rpmI,3600854,3600854,3599998,856,10982,utRho12
1306,rpoB,8362126,8362490,8362126,364,1002,utRho12
1307,rpoD,6424946,6426094,6424946,1148,25768,utRho12
1308,rpoE,5420372,5420372,5420024,348,0,utRho12
1309,rpoH,7202006,7202006,7201566,440,5454,utRho12
1310,rpoN,6689324,6689434,6689324,110,74,utRho12
1311,rpoS,5736236,5736236,5735102,1134,3146,utRho12
1312,rpoZ,7644154,7644212,7644154,58,672,utRho12
1313,rppH,5937986,5937986,5937954,32,0,utRho12
1314,rprA,3540744,3540744,3540744,0,0,utRho12
1315,rpsA,1923434,1923990,1923434,556,188168,utRho12
1316,rpsF,8850050,8850236,8850050,186,45962,utRho12
1317,rpsI,6756580,6756580,6756414,166,12494,utRho12
1318,rpsJ,6906884,6906884,6906540,344,14528,utRho12
1319,rpsL,6949242,6949242,6949104,138,210,utRho12
1320,rpsM,6885130,6885130,6884942,188,2378,utRho12
1321,rpsO,13247144,13247144,13246736,408,3204,utRho12
1322,rpsP,5492508,5492508,5492370,138,112,utRho12
1323,rpsT,42420,42420,42156,264,582,utRho12
1324,rpsU,12842584,12843124,12842584,540,2356,utRho12
1325,rraA,8238716,8238716,8238660,56,238,utRho12
1326,rraB,8956768,8956946,8956768,178,56,utRho12
1327,rrsA,8070478,8071062,8070478,584,7690,utRho12
1328,rrsB,16665468,16666636,16665468,1168,16024,utRho12
1329,rrsC,7883032,7883616,7883032,584,8748,utRho12
1330,rrsD,6858094,6858094,6857524,570,716,utRho12
1331,rrsE,8415726,8416294,8415726,568,1438,utRho12
1332,rrsG,5462896,5462896,5462314,582,5874,utRho12
1333,rrsH,446970,447542,446970,572,1082,utRho12
1334,rsd,8393908,8393908,8393616,292,56,utRho12
1335,rseA,5419264,5419264,5418808,456,120,utRho12
1336,rseP,392940,393092,392940,152,42,utRho12
1337,rseX,4067298,4067298,4067298,0,0,utRho12
1338,rsfS,1338144,1338144,1338072,72,266,utRho12
1339,rsgA,8783132,8783132,8783018,114,44,utRho12
1340,rsmA,105176,105176,104860,316,3250,utRho12
1341,rsmB,6869982,6870414,6869982,432,444,utRho12
1342,rsmC,9215736,9215736,9215400,336,292,utRho12
1343,rsmD,7208594,7208786,7208594,192,0,utRho12
1344,rsmE,6182036,6182268,6182036,232,424,utRho12
1345,rsmG,7847512,7847512,7847360,152,1588,utRho12
1346,rsmH,180020,180188,180020,168,20,utRho12
1347,rsmI,6587106,6587106,6586670,436,784,utRho12
1348,rssA,2578212,2578412,2578212,200,320,utRho12
1349,rssB,2580440,2580484,2580440,44,110,utRho12
1350,rstA,3364276,3364300,3364276,24,46,utRho12
1351,rsuA,4561096,4561096,4560966,130,372,utRho12
1352,rsxA,3411510,3411534,3411510,24,0,utRho12
1353,rtcA,7114004,7114004,7113698,306,118,utRho12
1354,rtcB,7116214,7116214,7116158,56,120,utRho12
1355,rtn,4541356,4541452,4541356,96,0,utRho12
1356,rutA,2148052,2148052,2148022,30,0,utRho12
1357,rutG,2140090,2140090,2139678,412,174,utRho12
1358,rutR,2148226,2148484,2148226,258,0,utRho12
1359,ruvA,7784096,7784096,7783904,192,288,utRho12
1360,ruvB,7782176,7782176,7781424,752,1048,utRho12
1361,ruvC,3894878,3894878,3894752,126,0,utRho12
1362,rybB,1776114,1776114,1776114,0,0,utRho12
1363,rydB,3529860,3529860,3529322,538,238,utRho12
1364,rydC,2983012,2983012,2983012,0,0,utRho12
1365,ryfA,5307398,5307710,5307398,312,94,utRho12
1366,ryfD,5468590,5468590,5468590,0,0,utRho12
1367,ryhB,7162032,7162032,7162032,0,0,utRho12
1368,ryjA,8556132,8556132,8556132,0,0,utRho12
1369,ryjB,9055954,9055954,9055954,0,0,utRho12
1370,sad,3229598,3229598,3229406,192,40,utRho12
1371,safA,3168056,3168056,3167918,138,56,utRho12
1372,sanA,4465368,4465756,4465368,388,48,utRho12
1373,sapF,2705314,2705314,2705268,46,154,utRho12
1374,sbcB,4165456,4165512,4165456,56,0,utRho12
1375,sbcC,831694,831694,831506,188,102,utRho12
1376,sbcD,833954,833954,833904,50,0,utRho12
1377,sbmA,793106,793278,793106,172,244,utRho12
1378,sbmC,4162650,4162650,4162524,126,0,utRho12
1379,sdaA,3793618,3793864,3793618,246,182,utRho12
1380,sdaC,5856070,5856458,5856070,388,748,utRho12
1381,sdhC,1509916,1510354,1509916,438,31172,utRho12
1382,sdhD,1510808,1511120,1510808,312,6294,utRho12
1383,sdiA,3993834,3993834,3993664,170,288,utRho12
1384,secE,8354354,8354716,8354354,362,238,utRho12
1385,secG,6645180,6645180,6645010,170,978,utRho12
1386,selA,7522594,7522594,7522498,96,992,utRho12
1387,selB,7519850,7519850,7519722,128,112,utRho12
1388,selC,7672396,7672444,7672396,48,40,utRho12
1389,selD,3696058,3696058,3696016,42,2626,utRho12
1390,seqA,1425884,1425974,1425884,90,430,utRho12
1391,serA,6117098,6117098,6116820,278,362,utRho12
1392,serB,9249712,9249790,9249712,78,70,utRho12
1393,serC,3830380,3830612,3830380,232,0,utRho12
1394,serS,1878730,1878856,1878730,126,1268,utRho12
1395,serT,2063438,2063438,2063424,14,0,utRho12
1396,serU,4087124,4087124,4087114,10,124,utRho12
1397,serV,5637394,5637394,5637290,104,298,utRho12
1398,serW,1852014,1852014,1851942,72,164,utRho12
1399,serX,2195352,2195352,2195304,48,0,utRho12
1400,setB,4527426,4527726,4527426,300,38,utRho12
1401,setC,7673488,7673906,7673488,418,1720,utRho12
1402,sfmA,1116124,1116424,1116124,300,0,utRho12
1403,sfmC,1117606,1117948,1117606,342,0,utRho12
1404,sfsA,323030,323030,322972,58,250,utRho12
1405,sfsB,6669592,6669818,6669592,226,1184,utRho12
1406,sgrR,154676,154676,154598,78,84,utRho12
1407,sgrS,154734,154734,154734,0,0,utRho12
1408,shiA,4107068,4107286,4107068,218,56,utRho12
1409,sibA,4306622,4306622,4306622,0,0,utRho12
1410,sibB,4307292,4307292,4307292,0,0,utRho12
1411,sibC,6113702,6113702,6113702,0,0,utRho12
1412,sibD,6389730,6389730,6389730,0,0,utRho12
1413,sibE,6390480,6390480,6390480,0,0,utRho12
1414,sixA,4913998,4913998,4913624,374,12,utRho12
1415,slp,7307872,7307922,7307872,50,98,utRho12
1416,slt,9261400,9261466,9261400,66,38,utRho12
1417,slyA,3442028,3442028,3441648,380,192,utRho12
1418,slyB,3439496,3439752,3439496,256,76,utRho12
1419,slyD,6957398,6957398,6956994,404,418,utRho12
1420,slyX,6954862,6955280,6954862,418,7598,utRho12
1421,smf,6867372,6867372,6867120,252,58,utRho12
1422,smpB,5509534,5509792,5509534,258,1116,utRho12
1423,smrA,2811872,2811958,2811872,86,164,utRho12
1424,smrB,4896872,4897212,4896872,340,330,utRho12
1425,smtA,1946808,1947074,1946808,266,0,utRho12
1426,sodA,8201518,8201620,8201518,102,8902,utRho12
1427,sodB,3470646,3470756,3470646,110,474,utRho12
1428,sodC,3449358,3449358,3449310,48,0,utRho12
1429,sohB,2658568,2658664,2658568,96,222,utRho12
1430,sokB,2984232,2984238,2984232,6,44,utRho12
1431,solA,2241218,2241218,2241172,46,30,utRho12
1432,soxR,8554894,8554938,8554894,44,176,utRho12
1433,soxS,8554846,8554846,8554766,80,0,utRho12
1434,speA,6172096,6172096,6171822,274,456,utRho12
1435,speB,6167892,6167892,6167594,298,252,utRho12
1436,speC,6218350,6218350,6218310,40,72,utRho12
1437,spf,8099798,8099798,8099798,0,0,utRho12
1438,sppA,3697422,3697674,3697422,252,54,utRho12
1439,spy,3651376,3651376,3651250,126,0,utRho12
1440,sra,3112092,3112092,3111926,166,0,utRho12
1441,sraB,2293178,2293178,2293178,0,0,utRho12
1442,sraC,3846132,3846132,3846132,0,0,utRho12
1443,srlA,5651582,5651664,5651582,82,60,utRho12
1444,srlR,5657720,5658094,5657720,374,330,utRho12
1445,srmB,5425752,5425792,5425752,40,62,utRho12
1446,sroA,151216,151216,151216,0,0,utRho12
1447,sroG,6369436,6369436,6369436,0,0,utRho12
1448,sroH,8380974,8380974,8380974,0,0,utRho12
1449,ssb,8548022,8548250,8548022,228,0,utRho12
1450,sseA,5304782,5304988,5304782,206,5958,utRho12
1451,sspA,6755138,6755138,6754840,298,168,utRho12
1452,ssrA,5511014,5511186,5511014,172,48,utRho12
1453,ssrS,12223036,12223932,12223036,896,876,utRho12
1454,sstT,6479726,6479888,6479726,162,56,utRho12
1455,ssuB,1988282,1988282,1988088,194,18,utRho12
1456,ssuE,1995126,1995126,1995024,102,24,utRho12
1457,sthA,8321604,8321604,8321580,24,1210,utRho12
1458,stpA,5597156,5597156,5596990,166,42,utRho12
1459,sucA,3034344,3034824,3034344,480,4160,utRho12
1460,sufA,3528836,3528836,3528772,64,22,utRho12
1461,sufE,3518962,3518962,3518580,382,562,utRho12
1462,sugE,8753588,8753750,8753588,162,1488,utRho12
1463,sulA,2041894,2041894,2041838,56,4452,utRho12
1464,syd,5850738,5850738,5850560,178,98,utRho12
1465,symE,9159834,9159834,9159680,154,314,utRho12
1466,symR,9159670,9159670,9159670,0,0,utRho12
1467,tabA,8949566,8949724,8949566,158,70,utRho12
1468,talA,5157140,5157332,5157140,192,50,utRho12
1469,talB,16382,16476,16382,94,4834,utRho12
1470,tam,3214442,3214692,3214442,250,6,utRho12
1471,tamA,8884540,8884764,8884540,224,192,utRho12
1472,tar,3945432,3945432,3945382,50,168,utRho12
1473,tas,5943138,5943194,5943138,56,1350,utRho12
1474,tatA,16087636,16087780,16087636,144,0,utRho12
1475,tatE,1317742,1317894,1317742,152,164,utRho12
1476,tauA,770410,770464,770410,54,0,utRho12
1477,tdcA,6534186,6534186,6534130,56,14,utRho12
1478,tdcG,6519652,6519652,6519298,354,94,utRho12
1479,tdcR,6534380,6534760,6534380,380,130,utRho12
1480,tdk,2586986,2587054,2586986,68,20,utRho12
1481,tehA,3001072,3001146,3001072,74,0,utRho12
1482,tesA,1039898,1039898,1039530,368,104,utRho12
1483,tesB,950402,950402,950322,80,0,utRho12
1484,tfaE,2418532,2418532,2418238,294,38,utRho12
1485,tfaQ,3269912,3269912,3269770,142,92,utRho12
1486,tff,379424,379256,379424,168,116,utRho12
1487,tgt,852110,852274,852110,164,0,utRho12
1488,thiD,4369346,4369346,4369032,314,78,utRho12
1489,thiI,882936,883098,882936,162,138,utRho12
1490,thiM,4370902,4370902,4370602,300,668,utRho12
1491,thiQ,146170,146170,145854,316,282,utRho12
1492,thrL,592,760,592,168,1160,utRho12
1493,thrS,7210932,7210932,7210280,652,580,utRho12
1494,thrU,8350762,8350776,8350762,14,2,utRho12
1495,thrV,6847414,6847414,6847310,104,185984,utRho12
1496,thrW,525682,525742,525682,60,1348,utRho12
1497,thyA,5930696,5930696,5930310,386,2664,utRho12
1498,tig,909986,910266,909986,280,1180,utRho12
1499,tisB,7706674,7707106,7706674,432,752,utRho12
1500,tktA,6163414,6163414,6163270,144,208,utRho12
1501,tktB,5158616,5159272,5158616,656,1116,utRho12
1502,tldD,6784368,6784368,6784056,312,0,utRho12
1503,tmcA,5191876,5191876,5191718,158,80,utRho12
1504,tnaC,15553644,15553740,15553644,96,1716,utRho12
1505,tolB,1555074,1555480,1555074,406,426,utRho12
1506,tolC,6356008,6356230,6356008,222,588,utRho12
1507,tomB,961588,961588,961416,172,2750,utRho12
1508,tonB,2622108,2622178,2622108,70,84,utRho12
1509,topA,2661578,2662096,2661578,518,248,utRho12
1510,torC,2116112,2116168,2116112,56,166,utRho12
1511,torR,2115968,2115968,2115908,60,66,utRho12
1512,torS,2112364,2112364,2112356,8,0,utRho12
1513,torT,2112414,2112522,2112414,108,0,utRho12
1514,tpiA,8223138,8223138,8223014,124,54,utRho12
1515,tppB,3425342,3425538,3425342,196,6022,utRho12
1516,tpr,2574376,2574376,2574376,0,0,utRho12
1517,tpx,2777688,2777688,2777622,66,602,utRho12
1518,tqsA,3347780,3347826,3347780,46,0,utRho12
1519,treA,2494850,2494850,2494752,98,1004,utRho12
1520,treB,8932420,8932420,8932360,60,56,utRho12
1521,treF,7339102,7339184,7339102,82,30,utRho12
1522,treR,8934694,8934694,8934492,202,48,utRho12
1523,trg,2984878,2984940,2984878,62,36,utRho12
1524,trkG,2847342,2847564,2847342,222,66,utRho12
1525,trmA,8326590,8326590,8326540,50,2,utRho12
1526,trpA,2634678,2634678,2634444,234,688,utRho12
1527,trpC,2639888,2639888,2639570,318,60,utRho12
1528,trpL,5292432,5292432,5292328,104,0,utRho12
1529,trpR,9265408,9265520,9265408,112,152,utRho12
1530,trpS,7027394,7027394,7027276,118,2120,utRho12
1531,trpT,7893560,7893914,7893560,354,122414,utRho12
1532,trxA,7931294,7931522,7931294,228,130,utRho12
1533,trxB,1864156,1864156,1864100,56,0,utRho12
1534,trxC,5437350,5437470,5437350,120,186,utRho12
1535,tsaD,6421256,6421256,6421086,170,0,utRho12
1536,tsgA,6985038,6985136,6985038,98,18,utRho12
1537,tsr,9182824,9183314,9182824,490,86,utRho12
1538,tsx,864490,864490,864026,464,108,utRho12
1539,ttcA,2823970,2823970,2823896,74,3694,utRho12
1540,ttdA,6412848,6412926,6412848,78,0,utRho12
1541,ttdR,6412760,6412760,6412512,248,116,utRho12
1542,tufA,6943448,6943448,6942658,790,174414,utRho12
1543,tus,3368346,3368518,3368346,172,104,utRho12
1544,tusA,7218040,7218040,7217992,48,0,utRho12
1545,tusB,6950218,6950218,6949930,288,694,utRho12
1546,tynA,2902996,2902996,2902698,298,0,utRho12
1547,typA,8116460,8116814,8116460,354,10044,utRho12
1548,tyrB,8534164,8534228,8534164,64,2890,utRho12
1549,tyrP,3979004,3979362,3979004,358,460,utRho12
1550,tyrR,2773384,2773440,2773384,56,54,utRho12
1551,tyrS,3434566,3434566,3434444,122,0,utRho12
1552,tyrT,2575330,2575330,2575244,86,188,utRho12
1553,uacT,6062378,6062734,6062378,356,0,utRho12
1554,ubiC,8504886,8505012,8504886,126,76,utRho12
1555,ubiD,8049618,8049976,8049618,358,1354,utRho12
1556,ubiE,8037494,8037710,8037494,216,100,utRho12
1557,ubiG,4679078,4679134,4679078,56,0,utRho12
1558,ucpA,5089342,5089342,5089246,96,0,utRho12
1559,udp,8032782,8032862,8032782,80,70,utRho12
1560,ugd,4199470,4199470,4199226,244,54,utRho12
1561,ugpB,7184852,7184852,7184650,202,1436,utRho12
1562,ugpQ,7176600,7176600,7176226,374,40,utRho12
1563,uhpT,7694396,7694396,7694334,62,52,utRho12
1564,uidA,3392304,3392304,3392142,162,6,utRho12
1565,uidC,3386012,3386012,3385702,310,0,utRho12
1566,uidR,3394150,3394150,3394104,46,42,utRho12
1567,ulaA,8839854,8839960,8839854,106,148,utRho12
1568,ulaG,8839350,8839350,8839250,100,98,utRho12
1569,ulaR,8837124,8837124,8836906,218,66,utRho12
1570,umpG,5741372,5741372,5740548,824,256,utRho12
1571,umpH,1400704,1400704,1400652,52,24,utRho12
1572,umuD,2461476,2461534,2461476,58,0,utRho12
1573,ung,5433476,5433508,5433476,32,216,utRho12
1574,uof,2843316,2843316,2842900,416,8128,utRho12
1575,upp,5241818,5241818,5241744,74,218,utRho12
1576,usg,4873780,4873780,4873298,482,232,utRho12
1577,ushA,1009772,1009828,1009772,56,0,utRho12
1578,uspA,7279966,7280222,7279966,256,170,utRho12
1579,uspB,7279696,7279696,7279440,256,138,utRho12
1580,uspC,3959172,3959506,3959172,334,214,utRho12
1581,uspE,2797318,2797318,2797244,74,54,utRho12
1582,uspF,2871282,2871282,2871238,44,154,utRho12
1583,uspG,1283806,1283806,1283734,72,1772,utRho12
1584,uvrA,8547872,8547872,8547742,130,160,utRho12
1585,uvrB,1626304,1627052,1626304,748,386,utRho12
1586,uvrC,3989758,3989758,3989412,346,128,utRho12
1587,uvrD,7995814,7995966,7995814,152,188,utRho12
1588,uvrY,3990812,3990812,3990718,94,354,utRho12
1589,uxaB,3221474,3221474,3221360,114,0,utRho12
1590,uxaC,6489714,6489714,6489482,232,0,utRho12
1591,uxuA,9103036,9103272,9103036,236,4,utRho12
1592,uxuR,9108916,9109152,9108916,236,68,utRho12
1593,valS,8967854,8967854,8967674,180,442,utRho12
1594,valU,5041848,5041862,5041848,14,44,utRho12
1595,valV,3492830,3492870,3492830,40,26,utRho12
1596,ves,3649968,3649968,3649874,94,0,utRho12
1597,waaA,7616512,7617080,7616512,568,920,utRho12
1598,waaH,7580298,7580298,7580162,136,72,utRho12
1599,waaQ,7616476,7616476,7616196,280,46,utRho12
1600,waaU,7598996,7598996,7598624,372,246,utRho12
1601,waaY,7602272,7602272,7601930,342,6316,utRho12
1602,wbbH,4214888,4214888,4214452,436,5274,utRho12
1603,wbbK,4209212,4209212,4209018,194,460,utRho12
1604,wcaM,4231868,4231868,4231792,76,0,utRho12
1605,wrbA,2135516,2135516,2135416,100,0,utRho12
1606,wza,4275166,4275166,4274486,680,0,utRho12
1607,wzxC,4240674,4240674,4240316,358,2,utRho12
1608,wzzB,4196950,4196950,4196602,348,140,utRho12
1609,xanP,7657642,7657890,7657642,248,0,utRho12
1610,xanQ,6048520,6048702,6048520,182,0,utRho12
1611,xapA,5049820,5049820,5049756,64,22,utRho12
1612,xapR,10090252,10090252,10089908,344,0,utRho12
1613,xdhA,6000514,6000690,6000514,176,264,utRho12
1614,xerD,6079702,6079702,6079486,216,204,utRho12
1615,xseA,5268394,5268464,5268394,70,300,utRho12
1616,xseB,882746,882746,882686,60,178,utRho12
1617,xthA,3664798,3664856,3664798,58,0,utRho12
1618,xylA,7461614,7461614,7461530,84,1640,utRho12
1619,xylE,8484540,8484540,8484508,32,0,utRho12
1620,xylF,7462138,7462262,7462138,124,88,utRho12
1621,xylR,7469812,7469958,7469812,146,54,utRho12
1622,yaaA,13230,13230,12918,312,154,utRho12
1623,yaaI,23876,23876,23572,304,144,utRho12
1624,yaaJ,16034,16034,15918,116,22,utRho12
1625,yaaU,91184,91614,91184,430,0,utRho12
1626,yaaW,23084,23084,22712,372,120,utRho12
1627,yaaX,10060,10468,10060,408,224,utRho12
1628,yabI,142542,142702,142542,160,50,utRho12
1629,yacC,273880,273880,273834,46,620,utRho12
1630,yacH,262932,262932,262520,412,244,utRho12
1631,yacL,268678,268776,268678,98,314,utRho12
1632,yadD,293796,293936,293796,140,138,utRho12
1633,yadE,289930,290162,289930,232,586,utRho12
1634,yadN,314110,314110,313766,344,456,utRho12
1635,yadS,355572,355572,355248,324,1714,utRho12
1636,yadV,312470,312470,312402,68,12,utRho12
1637,yaeF,434270,434270,434006,264,0,utRho12
1638,yaeP,428374,428374,428250,124,450,utRho12
1639,yaeQ,428176,428582,428176,406,700,utRho12
1640,yaeR,423716,423754,423716,38,0,utRho12
1641,yafC,462166,462166,461762,404,96,utRho12
1642,yafD,462128,462244,462128,116,46,utRho12
1643,yafK,491986,491986,491610,376,1288,utRho12
1644,yafL,493282,493424,493282,142,0,utRho12
1645,yafN,503938,504010,503938,72,18,utRho12
1646,yafS,469568,469632,469568,64,800,utRho12
1647,yafT,474470,474670,474470,200,120,utRho12
1648,yafV,480432,480432,480378,54,90,utRho12
1649,yafZ,536052,536052,536010,42,14,utRho12
1650,yagE,564446,564556,564446,110,48,utRho12
1651,yagG,570414,570790,570414,376,0,utRho12
1652,yagI,578384,578384,578324,60,132,utRho12
1653,yagK,586236,586236,585896,340,212,utRho12
1654,yagL,588062,588062,587836,226,344,utRho12
1655,yagN,591342,591342,591158,184,514,utRho12
1656,yahA,663746,664742,663746,996,1904,utRho12
1657,yahC,670136,670136,670044,92,436,utRho12
1658,yahE,671478,671850,671478,372,8,utRho12
1659,yahM,690504,690808,690504,304,88,utRho12
1660,yahN,692872,692872,692674,198,174,utRho12
1661,yahO,692864,692968,692864,104,4,utRho12
1662,yaiE,816296,816354,816296,58,130,utRho12
1663,yaiI,811396,811528,811396,132,0,utRho12
1664,yaiO,761946,761946,761684,262,24,utRho12
1665,yaiP,767970,767970,767870,100,0,utRho12
1666,yaiS,769660,769660,769232,428,0,utRho12
1667,yaiV,788922,788922,788922,0,0,utRho12
1668,yaiY,799094,799094,798666,428,176,utRho12
1669,yaiZ,798888,799186,798888,298,624,utRho12
1670,yajC,854410,854574,854410,164,1334,utRho12
1671,yajD,860938,861210,860938,272,812,utRho12
1672,yajI,866068,866068,865702,366,490,utRho12
1673,yajL,887496,887496,887282,214,908,utRho12
1674,yajQ,889316,889366,889316,50,122,utRho12
1675,yajR,893374,893374,893332,42,612,utRho12
1676,ybaB,987418,988152,987418,734,4188,utRho12
1677,ybaL,1006590,1006590,1006476,114,110,utRho12
1678,ybaM,980648,980648,980542,106,554,utRho12
1679,ybaN,981436,981764,981436,328,394,utRho12
1680,ybaO,936704,936766,936704,62,0,utRho12
1681,ybaP,1016568,1016568,1016160,408,570,utRho12
1682,ybaQ,1016348,1016436,1016348,88,54,utRho12
1683,ybaS,1023146,1023282,1023146,136,116,utRho12
1684,ybaV,927504,927874,927504,370,118,utRho12
1685,ybaY,950490,950758,950490,268,6,utRho12
1686,ybbB,1062724,1062724,1062452,272,0,utRho12
1687,ybbJ,1030154,1030154,1029718,436,534,utRho12
1688,ybbL,1031784,1031838,1031784,54,0,utRho12
1689,ybbN,1037136,1037136,1036558,578,1168,utRho12
1690,ybbO,1038658,1038658,1038298,360,956,utRho12
1691,ybbY,1080718,1081130,1080718,412,0,utRho12
1692,ybcH,1176140,1176140,1175962,178,226,utRho12
1693,ybcI,1113264,1113264,1113106,158,2732,utRho12
1694,ybcJ,1114050,1114050,1113746,304,146,utRho12
1695,ybcK,1137502,1137804,1137502,302,136,utRho12
1696,ybcL,1141690,1141786,1141690,96,0,utRho12
1697,ybcN,1144628,1144932,1144628,304,84,utRho12
1698,ybcQ,1147548,1147912,1147548,364,214,utRho12
1699,ybcW,1159610,1159760,1159610,150,0,utRho12
1700,ybdD,1263982,1264364,1263982,382,222,utRho12
1701,ybdF,1212106,1212106,1211772,334,112,utRho12
1702,ybdH,1267048,1267048,1266954,94,138,utRho12
1703,ybdJ,1212822,1212822,1212398,424,0,utRho12
1704,ybdK,1215122,1215122,1214766,356,1608,utRho12
1705,ybdL,1267114,1267172,1267114,58,90,utRho12
1706,ybdM,1271110,1271110,1270752,358,252,utRho12
1707,ybdN,1273372,1273372,1273138,234,58,utRho12
1708,ybdR,1283844,1284176,1283844,332,2018,utRho12
1709,ybeD,1325412,1325412,1325284,128,120,utRho12
1710,ybeF,1323090,1323090,1322756,334,1320,utRho12
1711,ybeL,1349986,1350036,1349986,50,132,utRho12
1712,ybeQ,1353412,1353412,1353094,318,0,utRho12
1713,ybeR,1353120,1353422,1353120,302,0,utRho12
1714,ybeT,1358832,1358832,1358812,20,0,utRho12
1715,ybeU,1358924,1359016,1358924,92,0,utRho12
1716,ybeZ,1386938,1386938,1386834,104,6522,utRho12
1717,ybfA,1458074,1458268,1458074,194,82,utRho12
1718,ybfE,1423878,1423878,1423796,82,308,utRho12
1719,ybfF,1425692,1425692,1425604,88,208,utRho12
1720,ybfH,1433282,1433282,1433194,88,34,utRho12
1721,ybgA,1477840,1478002,1477840,162,0,utRho12
1722,ybgC,1549288,1549504,1549288,216,26,utRho12
1723,ybgD,1505916,1505916,1505590,326,8920,utRho12
1724,ybgI,1485238,1485654,1485238,416,6,utRho12
1725,ybgO,1498370,1498370,1497964,406,28,utRho12
1726,ybgS,1570992,1570992,1570634,358,110,utRho12
1727,ybhA,1597184,1597184,1596862,322,174,utRho12
1728,ybhB,1616070,1616070,1615818,252,52,utRho12
1729,ybhC,1614642,1614642,1614562,80,666,utRho12
1730,ybhD,1601418,1601418,1601276,142,0,utRho12
1731,ybhH,1601104,1601518,1601104,414,0,utRho12
1732,ybhK,1633384,1633384,1633294,90,90,utRho12
1733,ybhM,1641556,1641586,1641556,30,66,utRho12
1734,ybhN,1645296,1645296,1644996,300,204,utRho12
1735,ybhQ,1649202,1649260,1649202,58,248,utRho12
1736,ybiA,1665920,1665920,1665900,20,0,utRho12
1737,ybiI,1676968,1676968,1676912,56,390,utRho12
1738,ybiO,1691328,1691328,1690960,368,478,utRho12
1739,ybiP,1705252,1705252,1705194,58,488,utRho12
1740,ybiS,1711572,1711572,1711488,84,746,utRho12
1741,ybiT,1711894,1711926,1711894,32,0,utRho12
1742,ybiU,1718212,1718212,1718122,90,18,utRho12
1743,ybiV,1720176,1720176,1720056,120,0,utRho12
1744,ybiW,1725566,1725566,1725212,354,1850,utRho12
1745,ybiX,1678548,1678548,1678414,134,198,utRho12
1746,ybjC,1781784,1781826,1781784,42,0,utRho12
1747,ybjE,1830154,1830154,1829714,440,436,utRho12
1748,ybjG,1767016,1767016,1766776,240,1986,utRho12
1749,ybjL,1779882,1779882,1779638,244,82,utRho12
1750,ybjM,1779770,1780178,1779770,408,276,utRho12
1751,ybjO,1795704,1795978,1795704,274,0,utRho12
1752,ybjP,1809046,1809046,1808934,112,0,utRho12
1753,ybjQ,1809034,1809186,1809034,152,0,utRho12
1754,ybjS,1813796,1813796,1813506,290,162,utRho12
1755,ybjX,1838206,1838206,1838168,38,0,utRho12
1756,ycaD,1891438,1891742,1891438,304,2,utRho12
1757,ycaI,1928210,1928640,1928210,430,296,utRho12
1758,ycaK,1899094,1899336,1899094,242,54,utRho12
1759,ycaL,1920264,1920528,1920264,264,2,utRho12
1760,ycaM,1894240,1894458,1894240,218,326,utRho12
1761,ycaR,1941284,1941346,1941284,62,2962,utRho12
1762,ycbB,1961862,1962094,1961862,232,128,utRho12
1763,ycbJ,1943344,1943504,1943344,160,52,utRho12
1764,ycbK,1966046,1966150,1966046,104,174,utRho12
1765,ycbZ,2036920,2036920,2036598,322,52,utRho12
1766,yccA,2062886,2062886,2062836,50,60,utRho12
1767,yccF,2048730,2048730,2048696,34,80,utRho12
1768,yccS,2047988,2047988,2047766,222,132,utRho12
1769,yccT,2055674,2055674,2055546,128,22,utRho12
1770,yccX,2059960,2060128,2059960,168,890,utRho12
1771,ycdT,2185682,2185752,2185682,70,0,utRho12
1772,ycdU,2191266,2191686,2191266,420,28,utRho12
1773,ycdZ,2200504,2200592,2200504,88,28,utRho12
1774,yceA,2233544,2233614,2233544,70,176,utRho12
1775,yceD,2293298,2293588,2293298,290,7926,utRho12
1776,yceF,2293522,2293522,2293190,332,5312,utRho12
1777,yceH,2252154,2252314,2252154,160,938,utRho12
1778,yceI,2237282,2237282,2236952,330,324,utRho12
1779,yceJ,2238142,2238142,2238092,50,324,utRho12
1780,yceM,2253208,2253612,2253208,404,188,utRho12
1781,yceO,2239264,2239264,2238894,370,652,utRho12
1782,yceQ,2288760,2289004,2288760,244,4398,utRho12
1783,ycfD,2376540,2376540,2376480,60,184,utRho12
1784,ycfJ,2334814,2335198,2334814,384,216,utRho12
1785,ycfS,2340834,2340834,2340748,86,4,utRho12
1786,ycfT,2350658,2350658,2350330,328,0,utRho12
1787,ycfZ,2362760,2362760,2362534,226,926,utRho12
1788,ycgB,2474570,2474570,2474482,88,74,utRho12
1789,ycgG,2434614,2434656,2434614,42,472,utRho12
1790,ycgJ,2452956,2453200,2452956,244,44,utRho12
1791,ycgL,2455218,2455362,2455218,144,0,utRho12
1792,ycgN,2457366,2457660,2457366,294,210,utRho12
1793,ycgR,2489112,2489112,2489054,58,0,utRho12
1794,ycgV,2512222,2512222,2511904,318,1700,utRho12
1795,ycgX,2426568,2426568,2426214,354,22336,utRho12
1796,ycgY,2490166,2490320,2490166,154,688,utRho12
1797,ycgZ,2431504,2431578,2431504,74,38,utRho12
1798,ychE,2596904,2597196,2596904,292,12,utRho12
1799,ychF,2515764,2515764,2515624,140,82,utRho12
1800,ychH,2517476,2517582,2517476,106,906,utRho12
1801,ychJ,2578354,2578354,2578264,90,0,utRho12
1802,ychN,2547310,2547310,2547198,112,54,utRho12
1803,ychO,2547520,2547850,2547520,330,54,utRho12
1804,ychQ,2533798,2533848,2533798,50,66,utRho12
1805,yciA,2624828,2624828,2624492,336,94,utRho12
1806,yciB,2626110,2626110,2625780,330,2042,utRho12
1807,yciC,2627396,2627396,2627326,70,0,utRho12
1808,yciE,2630794,2630794,2630448,346,302,utRho12
1809,yciG,5264368,5264368,5264140,228,0,utRho12
1810,yciI,2621784,2621784,2621730,54,90,utRho12
1811,yciN,2661606,2661606,2661336,270,38,utRho12
1812,yciS,2680270,2680486,2680270,216,24,utRho12
1813,yciT,2689088,2689088,2688692,396,1020,utRho12
1814,yciU,2614718,2614718,2614300,418,1566,utRho12
1815,yciV,2646376,2646440,2646376,64,0,utRho12
1816,yciW,2700472,2700472,2700214,258,1922,utRho12
1817,yciZ,2689276,2689276,2689218,58,888,utRho12
1818,ycjD,2703792,2703792,2703520,272,70,utRho12
1819,ycjG,2777748,2777860,2777748,112,148,utRho12
1820,ycjM,2740006,2740432,2740006,426,166,utRho12
1821,ycjW,2767982,2767982,2767922,60,42,utRho12
1822,ycjX,2768138,2768234,2768138,96,80,utRho12
1823,ycjY,5568288,5568288,5567460,828,528,utRho12
1824,ydaE,2836438,2836438,2836016,422,412,utRho12
1825,ydaN,2816048,2816100,2816048,52,58,utRho12
1826,ydaS,2840340,2840730,2840340,390,72,utRho12
1827,ydbC,2948376,2948442,2948376,66,0,utRho12
1828,ydbD,2950132,2950288,2950132,156,0,utRho12
1829,ydbH,2885800,2886102,2885800,302,58,utRho12
1830,ydbJ,2881712,2882116,2881712,404,220,utRho12
1831,ydbK,2881692,2881692,2881568,124,66,utRho12
1832,ydcA,2983294,2983354,2983294,60,116,utRho12
1833,ydcF,2974404,2974470,2974404,66,18,utRho12
1834,ydcI,2990268,2990268,2990142,126,0,utRho12
1835,ydcJ,2990266,2990576,2990266,310,0,utRho12
1836,ydcK,3001280,3001280,3000898,382,0,utRho12
1837,ydcL,3004646,3004914,3004646,268,0,utRho12
1838,ydcN,3012308,3012344,3012308,36,146,utRho12
1839,ydcP,3013508,3013562,3013508,54,0,utRho12
1840,ydcR,3019956,3020006,3019956,50,0,utRho12
1841,ydcS,3022906,3023308,3022906,402,148,utRho12
1842,ydcX,3034442,3034778,3034442,336,230,utRho12
1843,ydcY,3035220,3035296,3035220,76,0,utRho12
1844,ydcZ,3036750,3036750,3036662,88,456,utRho12
1845,yddB,3155332,3155332,3155238,94,0,utRho12
1846,yddE,3071738,3071738,3071716,22,0,utRho12
1847,yddG,3094410,3094410,3094338,72,0,utRho12
1848,yddJ,3089732,3089732,3089438,294,0,utRho12
1849,yddW,3137704,3137704,3137646,58,0,utRho12
1850,ydeA,3233910,3234056,3233910,146,50,utRho12
1851,ydeE,3242528,3242664,3242528,136,90,utRho12
1852,ydeI,3249118,3249118,3248994,124,18,utRho12
1853,ydeJ,3249376,3249546,3249376,170,0,utRho12
1854,ydeN,3165458,3165458,3165048,410,0,utRho12
1855,ydeP,3173328,3173328,3172972,356,52,utRho12
1856,ydeR,3176596,3176596,3176592,4,128,utRho12
1857,ydfA,3296872,3297016,3296872,144,0,utRho12
1858,ydfG,3254982,3255034,3254982,52,0,utRho12
1859,ydfH,3256652,3256704,3256652,52,2,utRho12
1860,ydfK,3265446,3266144,3265446,698,14020,utRho12
1861,ydgA,3379588,3379704,3379588,116,0,utRho12
1862,ydgC,3364124,3364124,3364060,64,60,utRho12
1863,ydgD,3343906,3343920,3343906,14,122,utRho12
1864,ydgH,3356754,3356854,3356754,100,0,utRho12
1865,ydgJ,3408798,3408798,3408616,182,166,utRho12
1866,ydgK,3410414,3410500,3410414,86,286,utRho12
1867,ydhB,3479618,3479618,3479596,22,0,utRho12
1868,ydhC,3479698,3479822,3479698,124,0,utRho12
1869,ydhF,3451310,3451310,3451264,46,0,utRho12
1870,ydhI,3441996,3442050,3441996,54,26,utRho12
1871,ydhL,3451864,3451864,3451840,24,0,utRho12
1872,ydhQ,3492404,3492404,3492254,150,0,utRho12
1873,ydhS,3494136,3494262,3494136,126,2200,utRho12
1874,ydhT,3499138,3499138,3499118,20,58,utRho12
1875,ydhY,3509284,3509284,3508954,330,154,utRho12
1876,ydhZ,3510418,3510418,3510282,136,0,utRho12
1877,ydiE,3579206,3579226,3579206,20,0,utRho12
1878,ydiH,3530582,3530582,3530406,176,30,utRho12
1879,ydiM,3541852,3542142,3541852,290,86,utRho12
1880,ydiN,3544818,3545024,3544818,206,0,utRho12
1881,ydiP,3558656,3558656,3558602,54,0,utRho12
1882,ydiU,3582508,3582508,3582488,20,404,utRho12
1883,ydiV,3584174,3584174,3584040,134,128,utRho12
1884,ydiY,3612500,3612500,3612166,334,16,utRho12
1885,ydjA,3697400,3697400,3697352,48,54,utRho12
1886,ydjE,3708082,3708082,3707958,124,0,utRho12
1887,ydjF,3709848,3709848,3709708,140,0,utRho12
1888,ydjM,3620340,3620422,3620340,82,0,utRho12
1889,ydjO,3626696,3626696,3626288,408,100,utRho12
1890,ydjX,3666434,3666802,3666434,368,1066,utRho12
1891,yeaE,3731448,3731448,3731272,176,80,utRho12
1892,yeaG,3733530,3733816,3733530,286,0,utRho12
1893,yeaI,3740486,3740770,3740486,284,26,utRho12
1894,yeaJ,3743874,3744082,3743874,208,156,utRho12
1895,yeaL,3748646,3748704,3748646,58,216,utRho12
1896,yeaM,3751296,3751296,3751152,144,0,utRho12
1897,yeaN,3750926,3751346,3750926,420,74,utRho12
1898,yeaO,3753554,3753818,3753554,264,82,utRho12
1899,yeaP,3755314,3755430,3755314,116,458,utRho12
1900,yeaQ,3758780,3758780,3758510,270,308,utRho12
1901,yeaR,3759988,3759988,3759896,92,120,utRho12
1902,yeaY,3781122,3781122,3781064,58,138,utRho12
1903,yebB,3892220,3892502,3892220,282,512,utRho12
1904,yebC,3896370,3896370,3896302,68,14,utRho12
1905,yebE,3859464,3859464,3859414,50,246,utRho12
1906,yebG,3861530,3861530,3861494,36,42,utRho12
1907,yebK,3873180,3873304,3873180,124,16,utRho12
1908,yebQ,3820314,3820552,3820314,238,8,utRho12
1909,yebS,3832238,3832516,3832238,278,14,utRho12
1910,yebV,3843430,3843560,3843430,130,0,utRho12
1911,yebW,3843914,3844242,3843914,328,1380,utRho12
1912,yecC,3995646,3995646,3995628,18,0,utRho12
1913,yecD,3901272,3901664,3901272,392,122,utRho12
1914,yecF,3991434,3991636,3991434,202,148,utRho12
1915,yecH,3979304,3979304,3978980,324,608,utRho12
1916,yecJ,3975604,3975604,3975516,88,0,utRho12
1917,yecM,3919968,3919968,3919692,276,72,utRho12
1918,yecR,3976400,3976444,3976400,44,20,utRho12
1919,yecT,3923862,3923944,3923862,82,204,utRho12
1920,yedD,4016522,4016522,4016180,342,74,utRho12
1921,yedE,4016310,4016554,4016310,244,54,utRho12
1922,yedI,4058922,4058922,4058732,190,46,utRho12
1923,yedJ,4066446,4066446,4066158,288,32,utRho12
1924,yedV,4076404,4076404,4076304,100,78,utRho12
1925,yedX,4077680,4077912,4077680,232,0,utRho12
1926,yedY,4078572,4078956,4078572,384,34,utRho12
1927,yeeA,4161322,4161322,4161182,140,0,utRho12
1928,yeeE,4171104,4171104,4171050,54,0,utRho12
1929,yeeJ,4089526,4089822,4089526,296,3724,utRho12
1930,yeeN,4113508,4113716,4113508,208,914,utRho12
1931,yeeO,4119444,4119444,4119692,248,0,utRho12
1932,yeeX,4158834,4158834,4158722,112,292,utRho12
1933,yeeZ,4178422,4178422,4178256,166,0,utRho12
1934,yefM,4179466,4179466,4179426,40,64,utRho12
1935,yegD,4295288,4295348,4295288,60,0,utRho12
1936,yegH,4275726,4275804,4275726,78,300,utRho12
1937,yegI,4302154,4302154,4301970,184,0,utRho12
1938,yegJ,4302032,4302370,4302032,338,88,utRho12
1939,yegQ,4331182,4331336,4331182,154,106,utRho12
1940,yegR,4336698,4336698,4336612,86,246,utRho12
1941,yegS,4337086,4337424,4337086,338,92,utRho12
1942,yegT,4357562,4357642,4357562,80,142,utRho12
1943,yegX,4367640,4367640,4367302,338,120,utRho12
1944,yehA,4376944,4376944,4376828,116,38,utRho12
1945,yehE,4385818,4385818,4385592,226,0,utRho12
1946,yehK,4407568,4407944,4407568,376,0,utRho12
1947,yehL,4408804,4409192,4408804,388,0,utRho12
1948,yeiB,4486146,4486146,4485934,212,0,utRho12
1949,yeiE,4499422,4499422,4499236,186,0,utRho12
1950,yeiG,4487776,4487820,4487776,44,308,utRho12
1951,yeiH,4499332,4499434,4499332,102,18,utRho12
1952,yeiI,4503306,4503400,4503306,94,4,utRho12
1953,yeiL,4510580,4510710,4510580,130,142,utRho12
1954,yeiP,4530834,4530900,4530834,66,638,utRho12
1955,yeiQ,4532328,4532490,4532328,162,554,utRho12
1956,yeiR,4535484,4535658,4535484,174,148,utRho12
1957,yeiW,4530840,4530840,4530590,250,842,utRho12
1958,yejA,4544624,4544728,4544624,104,0,utRho12
1959,yejG,4556892,4556892,4556474,418,3952,utRho12
1960,yejH,4561244,4561264,4561244,20,0,utRho12
1961,yejK,4568218,4568218,4567894,324,406,utRho12
1962,yejO,4578352,4578352,4577800,552,180,utRho12
1963,yfaD,4713380,4713808,4713380,428,410,utRho12
1964,yfaE,4696676,4697028,4696676,352,630,utRho12
1965,yfaL,4688568,4688568,4688338,230,0,utRho12
1966,yfaP,4656398,4656398,4656286,112,0,utRho12
1967,yfaU,4717892,4717892,4717690,202,4,utRho12
1968,yfaY,4727310,4727310,4727266,44,48,utRho12
1969,yfaZ,4728744,4728744,4728550,194,0,utRho12
1970,yfbK,4771810,4771810,4771444,366,252,utRho12
1971,yfbL,4771500,4771720,4771500,220,212,utRho12
1972,yfbN,4777174,4777174,4776852,322,248,utRho12
1973,yfbO,4776916,4777162,4776916,246,206,utRho12
1974,yfbP,4777990,4778232,4777990,242,5974,utRho12
1975,yfbR,4817662,4817724,4817662,62,24,utRho12
1976,yfcI,4847424,4847424,4847078,346,904,utRho12
1977,yfcJ,4880482,4880482,4880240,242,802,utRho12
1978,yfcL,4888502,4888502,4888338,164,62,utRho12
1979,yfcV,4911642,4911642,4911292,350,74,utRho12
1980,yfcZ,4921958,4921958,4921868,90,18,utRho12
1981,yfdF,4925604,4926024,4925604,420,10958,utRho12
1982,yfdG,4935474,4935710,4935474,236,0,utRho12
1983,yfdP,4946844,4947040,4946844,196,0,utRho12
1984,yfdX,4988866,4988866,4988804,62,24,utRho12
1985,yfdY,4990672,4990672,4990584,88,24,utRho12
1986,yfeA,5035784,5035784,5035664,120,26198,utRho12
1987,yfeC,5036668,5036934,5036668,266,272,utRho12
1988,yfeH,5053818,5053892,5053818,74,0,utRho12
1989,yfeK,5074630,5074684,5074630,54,0,utRho12
1990,yfeO,5018906,5019260,5018906,354,286,utRho12
1991,yfeR,5054078,5054078,5053712,366,56,utRho12
1992,yfeX,5101356,5101356,5101090,266,2,utRho12
1993,yfeY,5102486,5102486,5102432,54,0,utRho12
1994,yfeZ,5103842,5103842,5103452,390,86,utRho12
1995,yffO,5123804,5124222,5123804,418,32,utRho12
1996,yffQ,5126778,5127154,5126778,376,116,utRho12
1997,yffS,5128800,5128986,5128800,186,222,utRho12
1998,yfgC,5232052,5232188,5232052,136,48,utRho12
1999,yfgF,5258062,5258062,5257876,186,362,utRho12
2000,yfgG,5258170,5258580,5258170,410,920,utRho12
2001,yfgH,5259344,5259584,5259344,240,28,utRho12
2002,yfgM,5278866,5278866,5278566,300,360,utRho12
2003,yfhH,5397414,5397518,5397414,104,202,utRho12
2004,yfhM,5304648,5304648,5304574,74,176,utRho12
2005,yfhR,5328408,5328726,5328408,318,8366,utRho12
2006,yfiC,5425610,5425610,5425528,82,90,utRho12
2007,yfiE,5430688,5430688,5430640,48,468,utRho12
2008,yfiL,5482630,5482720,5482630,90,52,utRho12
2009,yfiM,5448066,5448358,5448066,292,15938,utRho12
2010,yfiR,5483354,5483750,5483354,396,238,utRho12
2011,yfjH,5517326,5517326,5517200,126,146,utRho12
2012,yfjI,5517710,5517970,5517710,260,56,utRho12
2013,yfjJ,5521014,5521094,5521014,80,124,utRho12
2014,yfjM,5531970,5531970,5531552,418,3004,utRho12
2015,yfjP,5535080,5535420,5535080,340,1214,utRho12
2016,yfjW,5546570,5546636,5546570,66,0,utRho12
2017,yfjX,5551776,5551838,5551776,62,0,utRho12
2018,ygaC,5601180,5601180,5599988,1192,294,utRho12
2019,ygaM,5600242,5600292,5600242,50,46,utRho12
2020,ygaU,5593628,5593628,5593572,56,66,utRho12
2021,ygaZ,5619190,5619234,5619190,44,298,utRho12
2022,ygbA,5713656,5713656,5713612,44,0,utRho12
2023,ygbE,5746784,5746784,5746674,110,48,utRho12
2024,ygbI,5722882,5722882,5722528,354,114,utRho12
2025,ygbK,5724394,5724670,5724394,276,32,utRho12
2026,ygbL,5727074,5727186,5727074,112,0,utRho12
2027,ygbN,5729814,5730202,5729814,388,428,utRho12
2028,ygcG,5811210,5811422,5811210,212,0,utRho12
2029,ygcN,5785144,5785314,5785144,170,36,utRho12
2030,ygcU,5799214,5799214,5798836,378,0,utRho12
2031,ygcW,5800942,5800942,5800546,396,0,utRho12
2032,ygdD,5883442,5883442,5883262,180,38,utRho12
2033,ygdG,5861746,5861930,5861746,184,566,utRho12
2034,ygdI,5886526,5886526,5886290,236,372,utRho12
2035,ygdQ,5940784,5940840,5940784,56,24,utRho12
2036,ygdR,5942494,5942542,5942494,48,0,utRho12
2037,ygeA,5961606,5961606,5961270,336,100,utRho12
2038,ygeH,5983758,5984188,5983758,430,124,utRho12
2039,ygeI,5987162,5987276,5987162,114,714,utRho12
2040,ygeR,6000078,6000078,5999782,296,622,utRho12
2041,ygeV,6011694,6011694,6011572,122,0,utRho12
2042,ygeW,6012234,6012524,6012234,290,474,utRho12
2043,ygfB,6110946,6110946,6110888,58,28,utRho12
2044,ygfK,6031984,6032120,6031984,136,94,utRho12
2045,ygfS,6058328,6058328,6058024,304,0,utRho12
2046,ygfZ,6082564,6082626,6082564,62,208,utRho12
2047,yggC,6149512,6149512,6149378,134,22,utRho12
2048,yggE,6136370,6136370,6136160,210,2,utRho12
2049,yggI,6179176,6179510,6179176,334,528,utRho12
2050,yggL,6204508,6204508,6204266,242,84,utRho12
2051,yggM,6199514,6199514,6199130,384,218,utRho12
2052,yggN,6203596,6203596,6203246,350,24,utRho12
2053,yggX,18623958,18624558,18623958,600,960,utRho12
2054,yghA,6298966,6299324,6298966,358,0,utRho12
2055,yghB,6307058,6307126,6307058,68,6,utRho12
2056,yghD,6222614,6222614,6222252,362,158,utRho12
2057,yghF,6225798,6225798,6225840,42,46,utRho12
2058,yghJ,6238640,6238640,6238224,416,98,utRho12
2059,yghQ,6265186,6265186,6264816,370,112,utRho12
2060,yghT,6267830,6268262,6267830,432,0,utRho12
2061,yghU,6277400,6277454,6277400,54,74,utRho12
2062,yghW,6293506,6293506,6293474,32,12,utRho12
2063,yghZ,6295562,6295794,6295562,232,312,utRho12
2064,ygiD,6365122,6365122,6364868,254,3946,utRho12
2065,ygiH,6409066,6409388,6409066,322,110,utRho12
2066,ygiL,6370622,6370828,6370622,206,344,utRho12
2067,ygiM,6402084,6402414,6402084,330,32,utRho12
2068,ygiN,6346156,6346284,6346156,128,832,utRho12
2069,ygiQ,6322620,6322620,6322292,328,1014,utRho12
2070,ygiS,6335462,6335462,6335436,26,62,utRho12
2071,ygiV,6338582,6338582,6338462,120,66,utRho12
2072,ygiW,6339774,6339774,6339352,422,152,utRho12
2073,ygiZ,6344506,6344506,6344422,84,0,utRho12
2074,ygjH,6442528,6442528,6442494,34,0,utRho12
2075,ygjI,6452140,6452468,6452140,328,72,utRho12
2076,ygjQ,6472730,6473080,6472730,350,810,utRho12
2077,ygjR,6474564,6474586,6474564,22,0,utRho12
2078,ygjV,6483638,6483638,6483488,150,0,utRho12
2079,yhaB,6535632,6535708,6535632,76,0,utRho12
2080,yhaH,6504498,6504608,6504498,110,258,utRho12
2081,yhaI,6505400,6505822,6505400,422,180,utRho12
2082,yhaJ,6508560,6508560,6508428,132,30,utRho12
2083,yhaK,6508538,6508638,6508538,100,76,utRho12
2084,yhbQ,6599878,6599932,6599878,54,384,utRho12
2085,yhbT,6602736,6602736,6602552,184,266,utRho12
2086,yhbU,6602558,6602970,6602558,412,266,utRho12
2087,yhbX,6643302,6643302,6643226,76,138,utRho12
2088,yhbY,6655518,6655580,6655518,62,920,utRho12
2089,yhcA,6723956,6724224,6723956,268,170,utRho12
2090,yhcB,6760364,6760382,6760364,18,0,utRho12
2091,yhcC,6708470,6708470,6708100,370,560,utRho12
2092,yhcF,6733440,6733852,6733440,412,368,utRho12
2093,yhcH,6739124,6739124,6738956,168,88,utRho12
2094,yhcM,6760312,6760312,6759994,318,170,utRho12
2095,yhcN,6770812,6771076,6770812,264,768,utRho12
2096,yhcO,6772606,6772606,6772258,348,0,utRho12
2097,yhdH,6806560,6806968,6806560,408,176,utRho12
2098,yhdJ,6823234,6823306,6823234,72,0,utRho12
2099,yhdN,6879092,6879092,6879018,74,2928,utRho12
2100,yhdT,6814702,6814750,6814702,48,514,utRho12
2101,yhdU,6824994,6825242,6824994,248,806,utRho12
2102,yhdV,6836392,6836780,6836392,388,66,utRho12
2103,yhdW,6837944,6838298,6837944,354,0,utRho12
2104,yheO,6953082,6953082,6952880,202,608,utRho12
2105,yheV,6957970,6957970,6957584,386,98,utRho12
2106,yhfA,6971902,6971902,6971636,266,666,utRho12
2107,yhfG,6983294,6983294,6983240,54,728,utRho12
2108,yhfL,6998622,6998896,6998622,274,206,utRho12
2109,yhfY,7023244,7023244,7022844,400,64,utRho12
2110,yhgA,7086294,7086334,7086294,40,0,utRho12
2111,yhgE,7065176,7065176,7064878,298,274,utRho12
2112,yhgF,7074352,7074770,7074352,418,2710,utRho12
2113,yhhA,7173458,7173886,7173458,428,336,utRho12
2114,yhhI,7248346,7248756,7248346,410,6,utRho12
2115,yhhJ,7253696,7253696,7253606,90,46,utRho12
2116,yhhM,7211588,7211588,7211220,368,372,utRho12
2117,yhhN,7211150,7211502,7211150,352,356,utRho12
2118,yhhQ,7218238,7218434,7218238,196,360,utRho12
2119,yhhT,7223682,7223730,7223682,48,104,utRho12
2120,yhhX,7162032,7162032,7161610,422,6,utRho12
2121,yhhY,7162222,7162276,7162222,54,0,utRho12
2122,yhhZ,7163516,7163726,7163516,210,102,utRho12
2123,yhiD,7312220,7312220,7311804,416,2680,utRho12
2124,yhiJ,7265190,7265190,7265180,10,0,utRho12
2125,yhiM,7269270,7269682,7269270,412,1266,utRho12
2126,yhiN,7275000,7275000,7274820,180,86,utRho12
2127,yhjA,7338522,7338522,7338376,146,80,utRho12
2128,yhjB,7344090,7344090,7343788,302,326,utRho12
2129,yhjC,7344272,7344684,7344272,412,60,utRho12
2130,yhjD,7346660,7346724,7346660,64,44,utRho12
2131,yhjE,7349274,7349572,7349274,298,224,utRho12
2132,yhjG,7356824,7356824,7356730,94,78,utRho12
2133,yhjH,7358458,7358458,7358374,84,436,utRho12
2134,yhjJ,7364032,7364032,7363880,152,370,utRho12
2135,yhjK,7371296,7371296,7371158,138,16,utRho12
2136,yhjR,7392750,7392750,7392370,380,38,utRho12
2137,yhjV,7400796,7401126,7400796,330,2204,utRho12
2138,yhjX,7424194,7424194,7424014,180,0,utRho12
2139,yhjY,7425966,7425966,7425868,98,0,utRho12
2140,yiaB,7455654,7455654,7455496,158,0,utRho12
2141,yiaD,7432712,7433094,7432712,382,378,utRho12
2142,yiaF,7438194,7438194,7438088,106,210,utRho12
2143,yiaG,7438862,7438956,7438862,94,178,utRho12
2144,yiaJ,7485236,7485236,7485064,172,54,utRho12
2145,yiaK,7485348,7485466,7485348,118,2,utRho12
2146,yiaT,7503924,7503924,7503736,188,0,utRho12
2147,yiaU,7503792,7503984,7503792,192,0,utRho12
2148,yiaY,7515856,7515856,7515654,202,124,utRho12
2149,yibF,7523950,7523950,7523910,40,34,utRho12
2150,yibG,7536128,7536354,7536128,226,62,utRho12
2151,yibL,7553194,7553330,7553194,136,12,utRho12
2152,yibN,7570112,7570112,7570030,82,218,utRho12
2153,yibT,7552848,7552848,7552760,88,822,utRho12
2154,yicC,7633290,7633352,7633290,62,10,utRho12
2155,yicH,7660862,7660914,7660862,52,62,utRho12
2156,yicJ,7673328,7673328,7671858,1470,10310,utRho12
2157,yicN,7685018,7685018,7684804,214,118,utRho12
2158,yicO,7687914,7687914,7687578,336,128,utRho12
2159,yicR,15250308,15250308,15250236,72,0,utRho12
2160,yidB,7755230,7755230,7754930,300,32,utRho12
2161,yidE,7732780,7732780,7732546,234,0,utRho12
2162,yidF,7711580,7711580,7711222,358,92,utRho12
2163,yidQ,7735088,7735456,7735088,368,810,utRho12
2164,yidR,7738824,7738824,7738618,206,106,utRho12
2165,yieE,7787658,7787738,7787658,80,158,utRho12
2166,yieH,7793314,7793548,7793314,234,4,utRho12
2167,yieK,7798928,7798928,7798786,142,0,utRho12
2168,yifB,7900350,7900350,7899998,352,82,utRho12
2169,yifL,7988984,7989044,7988984,60,2298,utRho12
2170,yigF,8005750,8005750,8005598,152,8172,utRho12
2171,yigI,8009448,8009448,8009394,54,0,utRho12
2172,yigM,8022100,8022152,8022100,52,0,utRho12
2173,yihA,8101970,8101970,8101458,512,112,utRho12
2174,yihD,8084098,8084138,8084098,40,48,utRho12
2175,yihF,8088110,8088398,8088110,288,32,utRho12
2176,yihG,8093304,8093304,8093204,100,76,utRho12
2177,yihI,8102616,8102694,8102616,78,36,utRho12
2178,yihL,8120506,8120894,8120506,388,44,utRho12
2179,yihN,8124332,8124494,8124332,162,0,utRho12
2180,yihO,8131942,8131942,8131532,410,0,utRho12
2181,yihQ,8138892,8138892,8138552,340,0,utRho12
2182,yihV,8147064,8147478,8147064,414,76,utRho12
2183,yihX,8151096,8151106,8151096,10,136,utRho12
2184,yiiE,8158192,8158582,8158192,390,472,utRho12
2185,yiiF,8159124,8159502,8159124,378,550,utRho12
2186,yiiG,8173762,8174004,8173762,242,0,utRho12
2187,yiiM,8205506,8205644,8205506,138,586,utRho12
2188,yiiQ,8224624,8224624,8224428,196,0,utRho12
2189,yiiS,8225738,8225934,8225738,196,144,utRho12
2190,yijE,8272178,8272216,8272178,38,10,utRho12
2191,yijF,8275728,8275728,8275314,414,106,utRho12
2192,yijO,8296858,8296858,8296634,224,230,utRho12
2193,yjaA,8426240,8426468,8426240,228,116472,utRho12
2194,yjaB,8428312,8428312,8428246,66,346,utRho12
2195,yjaG,8398746,8399008,8398746,262,1838,utRho12
2196,yjaH,8401022,8401132,8401022,110,262,utRho12
2197,yjaZ,8379506,8379572,8379506,66,58,utRho12
2198,yjbB,8455204,8455462,8455204,258,0,utRho12
2199,yjbE,16943432,16943624,16943432,192,56,utRho12
2200,yjbL,8520318,8520642,8520318,324,80,utRho12
2201,yjbQ,8540428,8540476,8540428,48,52,utRho12
2202,yjcB,8550328,8550328,8550082,246,256,utRho12
2203,yjcC,8550836,8550942,8550836,106,52,utRho12
2204,yjcD,8556628,8556958,8556628,330,22,utRho12
2205,yjcE,8559658,8559960,8559658,302,0,utRho12
2206,yjcF,8566212,8566212,8566150,62,0,utRho12
2207,yjcO,8594660,8594660,8594250,410,64,utRho12
2208,yjdA,8654128,8654270,8654128,142,0,utRho12
2209,yjdC,8726660,8726660,8726616,44,0,utRho12
2210,yjdK,8704780,8705168,8704780,388,318,utRho12
2211,yjdL,8713034,8713034,8712822,212,14,utRho12
2212,yjdM,8653672,8653672,8653468,204,68,utRho12
2213,yjeF,8787354,8788132,8787354,778,128090,utRho12
2214,yjeI,8745522,8745618,8745522,96,0,utRho12
2215,yjeJ,8748806,8748806,8748468,338,904,utRho12
2216,yjeV,8785472,8785784,8785472,312,5392,utRho12
2217,yjfP,8833512,8833904,8833512,392,100,utRho12
2218,yjfY,8849656,8849656,8849582,74,0,utRho12
2219,yjfZ,8855052,8855052,8854844,208,120,utRho12
2220,yjgA,8916162,8916162,8915730,432,138,utRho12
2221,yjgL,8950802,8950874,8950802,72,50,utRho12
2222,yjgM,8959342,8959342,8959074,268,178,utRho12
2223,yjgN,8959132,8959460,8959132,328,130,utRho12
2224,yjgR,8980170,8980170,8980126,44,46,utRho12
2225,yjgZ,9002116,9002520,9002116,404,2606,utRho12
2226,yjhB,9007764,9008116,9007764,352,4,utRho12
2227,yjhG,9048452,9048452,9048188,264,970,utRho12
2228,yjhU,9041080,9041080,9040648,432,318,utRho12
2229,yjiA,9178096,9178096,9177730,366,464,utRho12
2230,yjiJ,9125364,9125364,9125350,14,0,utRho12
2231,yjiK,9127270,9127270,9127422,152,142,utRho12
2232,yjiL,9129604,9129604,9129378,226,16,utRho12
2233,yjiS,9143410,9143502,9143410,92,90,utRho12
2234,yjiY,9182734,9182734,9182558,176,104,utRho12
2235,yjjA,9200674,9200674,9200378,296,112,utRho12
2236,yjjB,18408708,18408708,18407800,908,456,utRho12
2237,yjjJ,9243314,9243538,9243314,224,124,utRho12
2238,yjjK,9261132,9261132,9261044,88,70,utRho12
2239,yjjL,9189764,9189764,9189444,320,56,utRho12
2240,yjjM,9191894,9191894,9191702,192,68,utRho12
2241,yjjP,9206068,9206068,9205716,352,5722,utRho12
2242,yjjQ,9206638,9206954,9206638,316,6838,utRho12
2243,yjjX,9267798,9267798,9267490,308,1462,utRho12
2244,yjjY,9280716,9280804,9280716,88,300,utRho12
2245,yjjZ,9211554,9211608,9211554,54,61490,utRho12
2246,yjtD,9281676,9281884,9281676,208,136,utRho12
2247,ykfB,532454,532454,532174,280,3960,utRho12
2248,ykfI,527636,527636,527338,298,704,utRho12
2249,ykgB,637050,637050,636638,412,98,utRho12
2250,ykgC,640430,640430,640002,428,0,utRho12
2251,ykgD,640232,640454,640232,222,0,utRho12
2252,ykgE,642962,643216,642962,254,198,utRho12
2253,ykgJ,608524,608524,608364,160,48,utRho12
2254,ykgL,623878,624224,623878,346,316,utRho12
2255,ykgM,625610,625610,625554,56,0,utRho12
2256,ykgR,626570,626570,626484,86,0,utRho12
2257,ylaC,958576,958576,958502,74,2298,utRho12
2258,yliE,1745938,1745958,1745938,20,0,utRho12
2259,ymcE,2103660,2103694,2103660,34,4,utRho12
2260,ymdA,2210450,2210828,2210450,378,294,utRho12
2261,ymdB,2211428,2211640,2211428,212,2,utRho12
2262,ymfD,2395322,2395322,2395064,258,1208,utRho12
2263,ymfI,2402880,2402994,2402880,114,0,utRho12
2264,ymfJ,2404518,2404518,2404168,350,154,utRho12
2265,ymfK,2406176,2406176,2405866,310,200,utRho12
2266,ymfT,2405766,2406048,2405766,282,186,utRho12
2267,ymgE,2489110,2489456,2489110,346,724,utRho12
2268,ymgF,2437628,2437966,2437628,338,0,utRho12
2269,ymiA,2670112,2670320,2670112,208,294,utRho12
2270,ymjA,2715620,2715620,2715336,284,756,utRho12
2271,ynaI,2791946,2791946,2791844,102,62,utRho12
2272,ynaK,2850438,2850754,2850438,316,144,utRho12
2273,ynbA,2954924,2955242,2954924,318,0,utRho12
2274,yncD,3046552,3046552,3046130,422,142,utRho12
2275,yncE,3046454,3046614,3046454,160,0,utRho12
2276,yncG,3052456,3052494,3052456,38,72,utRho12
2277,yncL,3034492,3034492,3034388,104,62,utRho12
2278,yneE,3218364,3218364,3218044,320,0,utRho12
2279,yneF,3223748,3223748,3223708,40,0,utRho12
2280,yneJ,3229560,3229608,3229560,48,0,utRho12
2281,yneK,3231100,3231526,3231100,426,64,utRho12
2282,yneM,3245176,3245292,3245176,116,510,utRho12
2283,ynfA,3311398,3311398,3311346,52,0,utRho12
2284,ynfB,3311418,3311616,3311418,198,166,utRho12
2285,ynfC,3315094,3315094,3314914,180,0,utRho12
2286,ynfD,3314828,3315130,3314828,302,0,utRho12
2287,ynfE,3316006,3316138,3316006,132,138,utRho12
2288,ynfK,3334670,3334670,3334438,232,284,utRho12
2289,ynfL,3339304,3339304,3339184,120,0,utRho12
2290,ynfM,3339260,3339398,3339260,138,8,utRho12
2291,ynfN,3276598,3276598,3276218,380,226,utRho12
2292,ynfO,3273454,3273512,3273454,58,0,utRho12
2293,ynhG,3517890,3517890,3517450,440,74,utRho12
2294,yniA,3615158,3615592,3615158,434,406,utRho12
2295,yniB,3618526,3618526,3618466,60,28,utRho12
2296,yniC,3618652,3618760,3618652,108,126,utRho12
2297,yniD,3610202,3610330,3610202,128,188,utRho12
2298,ynjE,3678880,3678934,3678880,54,36,utRho12
2299,ynjF,3683222,3683222,3682806,416,110,utRho12
2300,ynjH,3684376,3684376,3684270,106,24,utRho12
2301,ynjI,3690022,3690022,3689742,280,90,utRho12
2302,yoaB,3786642,3786734,3786642,92,90,utRho12
2303,yoaC,3787932,3788146,3787932,214,692,utRho12
2304,yoaE,3803544,3803544,3803170,374,256,utRho12
2305,yoaF,3755444,3755444,3755064,380,740,utRho12
2306,yoaH,3789866,3789866,3789462,404,640,utRho12
2307,yobB,3850418,3850880,3850418,462,566,utRho12
2308,yobF,3815586,3815586,3815182,404,452,utRho12
2309,yobH,3817800,3817850,3817800,50,376,utRho12
2310,yodB,4084352,4084736,4084352,384,1218,utRho12
2311,yodC,4057008,4057008,4056740,268,42,utRho12
2312,yohC,4451358,4451358,4451262,96,74,utRho12
2313,yohD,4451526,4451602,4451526,76,46,utRho12
2314,yohJ,4460986,4461248,4460986,262,44,utRho12
2315,yohO,4431172,4431314,4431172,142,88,utRho12
2316,yojI,4617282,4617282,4617230,52,44,utRho12
2317,ypdI,4988988,4989396,4988988,408,86,utRho12
2318,ypfG,5165786,5165786,5165554,232,0,utRho12
2319,ypfM,5182140,5182140,5181732,408,200,utRho12
2320,yphB,5349590,5349590,5349376,214,0,utRho12
2321,ypjA,5565644,5565644,5565452,192,248,utRho12
2322,ypjB,5569636,5569636,5568858,778,0,utRho12
2323,ypjD,5495860,5495774,5495860,86,0,utRho12
2324,yqaE,5594170,5594170,5594056,114,26,utRho12
2325,yqcA,5846100,5846100,5845968,132,82,utRho12
2326,yqcE,5800944,5801184,5800944,240,0,utRho12
2327,yqeC,6030468,6030468,6030114,354,178,utRho12
2328,yqeF,5971618,5971618,5971184,434,42,utRho12
2329,yqeG,5971438,5971694,5971438,256,44,utRho12
2330,yqeH,5975016,5975072,5975016,56,70,utRho12
2331,yqeI,5976688,5977004,5976688,316,50,utRho12
2332,yqeK,5981140,5981140,5980720,420,1090,utRho12
2333,yqfA,6086728,6086728,6086296,432,380,utRho12
2334,yqgA,6219042,6219106,6219042,64,0,utRho12
2335,yqgB,6172500,6172500,6172102,398,4962,utRho12
2336,yqgE,6185768,6185874,6185768,106,344,utRho12
2337,yqhA,6299150,6299150,6298942,208,0,utRho12
2338,yqhC,6310768,6310768,6310436,332,80,utRho12
2339,yqhD,6310604,6310710,6310604,106,46,utRho12
2340,yqhH,6316842,6317254,6316842,412,1688,utRho12
2341,yqiC,6369662,6369680,6369662,18,128,utRho12
2342,yqiJ,6384108,6384416,6384108,308,46,utRho12
2343,yqjA,6495096,6495546,6495096,450,3784,utRho12
2344,yqjF,6500932,6501124,6500932,192,620,utRho12
2345,yqjG,6501948,6502048,6501948,100,0,utRho12
2346,yqjH,6433078,6433078,6432982,96,2,utRho12
2347,yqjI,6433506,6433558,6433506,52,0,utRho12
2348,yraH,6574552,6574852,6574552,300,120,utRho12
2349,yraP,6592144,6592818,6592144,674,366,utRho12
2350,yraQ,6596414,6596414,6596276,138,0,utRho12
2351,yraR,6598024,6598024,6597692,332,154,utRho12
2352,yrbG,13360844,13361100,13360844,256,0,utRho12
2353,yrbL,6696842,6696904,6696842,62,736,utRho12
2354,yrbN,6616172,6616172,6615866,306,14094,utRho12
2355,yrdB,6860176,6860176,6860046,130,52,utRho12
2356,yrfF,7052548,7052938,7052548,390,126,utRho12
2357,yrhB,7169440,7169518,7169440,78,0,utRho12
2358,ysaB,7451804,7451804,7451424,380,0,utRho12
2359,ysgA,8032686,8032686,8032338,348,206,utRho12
2360,ytfB,8857638,8857638,8857434,204,486,utRho12
2361,ytfE,8864018,8864018,8863966,52,22,utRho12
2362,ytfF,8866296,8866296,8866130,166,82,utRho12
2363,ytfH,8868164,8868226,8868164,62,0,utRho12
2364,ytfI,8875234,8875414,8875234,180,64,utRho12
2365,ytfJ,8878572,8878572,8878524,48,110,utRho12
2366,ytfK,8879022,8879174,8879022,152,388,utRho12
2367,ytfL,8882642,8882642,8882430,212,148,utRho12
2368,ytfQ,8899634,8899924,8899634,290,534,utRho12
2369,ytjB,9249598,9249598,9249578,20,22,utRho12
2370,yzfA,8896588,8896588,8896490,98,32,utRho12
2371,zapA,6111102,6111224,6111102,122,1804,utRho12
2372,zapB,8236772,8237030,8236772,258,262,utRho12
2373,zapC,2011700,2011904,2011700,204,34,utRho12
2374,zinT,4082692,4082750,4082692,58,304,utRho12
2375,zipA,5062814,5062814,5062466,348,88,utRho12
2376,zitB,1569716,1569716,1569646,70,108,utRho12
2377,zntA,7212844,7212902,7212844,58,64,utRho12
2378,zntR,6878336,6878336,6878260,76,12,utRho12
2379,znuA,3885322,3885322,3885166,156,102,utRho12
2380,znuC,3885268,3885324,3885268,56,102,utRho12
2381,zraP,8403424,8403424,8403376,48,28,utRho12
2382,zraS,8403810,8403852,8403810,42,16,utRho12
2383,zupT,6364866,6365100,6364866,234,3944,utRho12
2384,zur,8520282,8520282,8520006,276,286,utRho12
2385,zwf,3872752,3872752,3872628,124,106,utRho12
0,C0343,2818676,2818728,2818676,52,0,utRho13
1,aaeB,6776526,6776526,6776376,150,0,utRho13
2,aaeR,6778762,6779040,6778762,278,48,utRho13
3,aaeX,6778860,6778860,6778674,186,56,utRho13
4,aat,1854920,1854920,1854864,56,58,utRho13
5,accA,416822,417242,416822,420,3304,utRho13
6,accB,6810280,6810872,6810280,592,12062,utRho13
7,accD,4868030,4868030,4867852,178,650,utRho13
8,aceB,8430804,8430956,8430804,152,0,utRho13
9,aceE,245938,246034,245938,96,166,utRho13
10,ackA,4826918,4826940,4826918,22,1420,utRho13
11,acnA,2670848,2671662,2670848,814,924,utRho13
12,acnB,263038,263230,263038,192,1246,utRho13
13,acpP,2303148,2303230,2303148,82,816,utRho13
14,acpS,5402324,5402324,5401996,328,326,utRho13
15,acrA,971396,971396,971238,158,156,utRho13
16,acrB,969370,969370,968806,564,5102,utRho13
17,acrD,5174950,5175190,5174950,240,96,utRho13
18,acrE,6827404,6827728,6827404,324,0,utRho13
19,acrR,971398,971522,971398,124,44,utRho13
20,acrZ,1589502,1589546,1589502,44,0,utRho13
21,acs,8575190,8575190,8574742,448,82,utRho13
22,actP,8569870,8569870,8569804,66,0,utRho13
23,ada,4620854,4620854,4620810,44,0,utRho13
24,add,3404404,3404466,3404404,62,192,utRho13
25,ade,7687802,7687928,7687802,126,0,utRho13
26,adhE,2596826,2596826,2596242,584,104,utRho13
27,adhP,3107988,3107988,3107676,312,3794,utRho13
28,adiA,8681112,8681112,8681042,70,24,utRho13
29,adiC,8674404,8674404,8674062,342,104,utRho13
30,adiY,8676084,8676084,8675858,226,0,utRho13
31,adk,994278,994350,994278,72,208,utRho13
32,adrA,807374,807406,807374,32,0,utRho13
33,aer,6438240,6438240,6438152,88,94,utRho13
34,aes,1000102,1000102,999946,156,74,utRho13
35,agaR,6557406,6557406,6557330,76,0,utRho13
36,agaS,6563778,6563952,6563778,174,0,utRho13
37,agp,2131118,2131170,2131118,52,0,utRho13
38,agrA,7296126,7296126,7296126,0,0,utRho13
39,agrB,7296588,7296588,7296588,0,0,utRho13
40,ahpC,1277386,1277890,1277386,504,2140,utRho13
41,ahpF,1278004,1279506,1278004,1502,189834,utRho13
42,ahr,8992698,8992698,8992418,280,0,utRho13
43,aidB,8828494,8828550,8828494,56,0,utRho13
44,ais,4731512,4731512,4731240,272,0,utRho13
45,alaA,4814816,4815122,4814816,306,0,utRho13
46,alaC,4996798,4996798,4996590,208,0,utRho13
47,alaE,5598140,5598328,5598140,188,0,utRho13
48,alaS,5644180,5644180,5644022,158,7804,utRho13
49,alaW,5036612,5036612,5036462,150,0,utRho13
50,aldA,2976380,2976464,2976380,84,608,utRho13
51,aldB,7513070,7513070,7513022,48,0,utRho13
52,alkA,4295118,4295118,4295080,38,0,utRho13
53,alkB,4618890,4618890,4618682,208,0,utRho13
54,allA,1064780,1064902,1064780,122,0,utRho13
55,allD,1092822,1092822,1092726,96,0,utRho13
56,allE,1088112,1088112,1088092,20,42,utRho13
57,allS,1064600,1064600,1064442,158,0,utRho13
58,alr,8531178,8531564,8531178,386,1834,utRho13
59,alsE,8617334,8617334,8616956,378,110,utRho13
60,alsK,8615990,8615990,8615598,392,154,utRho13
61,alx,6476740,6477160,6476740,420,0,utRho13
62,amiA,5104482,5104704,5104482,222,48,utRho13
63,amiC,5898378,5898378,5898020,358,0,utRho13
64,amn,4110062,4110122,4110062,60,0,utRho13
65,ampC,8758006,8758006,8757888,118,66,utRho13
66,ampD,237362,237466,237362,104,64,utRho13
67,ampG,907372,907372,907090,282,1126,utRho13
68,ampH,792726,792726,792574,152,112,utRho13
69,amyA,4012230,4012312,4012230,82,56,utRho13
70,anmK,3439346,3439346,3439204,142,0,utRho13
71,ansB,6201580,6201580,6201456,124,0,utRho13
72,ansP,3052040,3052040,3051960,80,90,utRho13
73,apaG,104068,104068,103212,856,5254,utRho13
74,apaH,102586,102586,102444,142,3540,utRho13
75,apbE,4623188,4623188,4623068,120,0,utRho13
76,appA,2081198,2081234,2081198,36,50,utRho13
77,appC,2075420,2075480,2075420,60,48,utRho13
78,appY,1167134,1167362,1167134,228,0,utRho13
79,apt,982620,982824,982620,204,150,utRho13
80,aqpZ,1832424,1832424,1832094,330,0,utRho13
81,araB,140150,140150,140096,54,0,utRho13
82,araC,140482,140774,140482,292,526,utRho13
83,araE,5964416,5964416,5964364,52,0,utRho13
84,araF,3972476,3972476,3972256,220,0,utRho13
85,araH,3967120,3967120,3967086,34,0,utRho13
86,araJ,825058,825058,824962,96,28,utRho13
87,arcA,9281602,9281602,9280612,990,10726,utRho13
88,arcB,6706098,6706098,6706050,48,0,utRho13
89,arcZ,6701154,6701154,6701154,0,0,utRho13
90,arfA,6877346,6877346,6877298,48,0,utRho13
91,argA,5898312,5898484,5898312,172,0,utRho13
92,argC,8309770,8310002,8309770,232,120,utRho13
93,argD,6980442,6980442,6980360,82,0,utRho13
94,argE,8310156,8310156,8309694,462,300,utRho13
95,argF,580680,580680,580610,70,0,utRho13
96,argG,6637124,6637274,6637124,150,0,utRho13
97,argI,8956688,8956688,8956622,66,0,utRho13
98,argO,6137672,6137672,6137616,56,2,utRho13
99,argP,6119460,6119506,6119460,46,32,utRho13
100,argR,6769204,6769406,6769204,202,0,utRho13
101,argS,3920002,3920124,3920002,122,0,utRho13
102,argT,4855698,4855698,4855582,116,0,utRho13
103,argU,1129406,1129446,1129406,40,0,utRho13
104,argW,4932616,4932618,4932616,2,0,utRho13
105,argX,7964728,7964750,7964728,22,0,utRho13
106,aroF,5482402,5482402,5482300,102,0,utRho13
107,aroG,1571182,1571266,1571182,84,258,utRho13
108,aroH,3576636,3576870,3576636,234,1214,utRho13
109,aroK,7038760,7038760,7038128,632,1030,utRho13
110,aroL,812560,812810,812560,250,60,utRho13
111,aroP,243342,243342,243102,240,0,utRho13
112,arpA,8445382,8445382,8444974,408,0,utRho13
113,arrS,7316108,7316108,7316108,0,0,utRho13
114,arsR,7297024,7297056,7297024,32,0,utRho13
115,artJ,1801252,1801252,1801150,102,0,utRho13
116,artP,1807686,1807686,1807468,218,70,utRho13
117,ascF,5678858,5679048,5678858,190,0,utRho13
118,ascG,5678574,5678574,5678528,46,0,utRho13
119,aslB,7965562,7965916,7965562,354,292,utRho13
120,asnA,7854258,7854310,7854258,52,0,utRho13
121,asnB,1398444,1398444,1398354,90,70,utRho13
122,asnC,23562186,23562186,23562018,168,0,utRho13
123,asnS,1978088,1978088,1977970,118,16274,utRho13
124,asnT,4089082,4089098,4089082,16,312,utRho13
125,asnU,4119690,4119702,4119690,12,0,utRho13
126,asnV,4124504,4124520,4124504,16,14,utRho13
127,aspA,17473728,17473728,17473308,420,212,utRho13
128,aspC,1971486,1971486,1971418,68,144,utRho13
129,aspS,3901402,3901402,3901044,358,164,utRho13
130,aspT,7893560,7893744,7893560,184,147588,utRho13
131,aspV,473826,473862,473826,36,90,utRho13
132,asr,3342654,3342752,3342654,98,38,utRho13
133,astC,3664088,3664088,3663964,124,0,utRho13
134,astE,3654138,3654138,3653846,292,0,utRho13
135,atoD,4646824,4646894,4646824,70,0,utRho13
136,atpB,7844540,7844540,7844102,438,710,utRho13
137,atpC,7832118,7832118,7831944,174,3128,utRho13
138,atpI,7845050,7845050,7844880,170,46,utRho13
139,avtA,7479348,7479410,7479348,62,220,utRho13
140,azoR,2965982,2965982,2965720,262,90,utRho13
141,azuC,3976002,3976002,3975918,84,0,utRho13
142,bacA,6408350,6408350,6408262,88,0,utRho13
143,bamA,394052,395856,394052,1804,1140,utRho13
144,bamB,5277950,5277950,5277304,646,1920,utRho13
145,bamC,5198028,5198028,5197730,298,2698,utRho13
146,bamD,5471922,5472292,5471922,370,1474,utRho13
147,bamE,5506972,5507210,5506972,238,814,utRho13
148,basS,8666954,8666954,8666544,410,592,utRho13
149,bax,7474468,7474468,7474354,114,60,utRho13
150,bcp,5200874,5200956,5200874,82,4762,utRho13
151,bcsB,7385346,7385346,7385214,132,94,utRho13
152,bcsE,7392644,7392916,7392644,272,0,utRho13
153,bdcA,8948128,8948128,8948106,22,0,utRho13
154,bdcR,8948192,8948248,8948192,56,0,utRho13
155,bdm,3112680,3112680,3112560,120,0,utRho13
156,betA,654522,654522,654494,28,124,utRho13
157,betI,658722,658722,658668,54,0,utRho13
158,betT,658842,658926,658842,84,0,utRho13
159,bfr,6933498,6933498,6933450,48,0,utRho13
160,bglG,23440182,23440182,23439402,780,0,utRho13
161,bglX,4444240,4444240,4443978,262,0,utRho13
162,bhsA,2337962,2338146,2337962,184,0,utRho13
163,bioA,1618584,1618584,1618514,70,0,utRho13
164,bioB,1618604,1618688,1618604,84,0,utRho13
165,bioH,7089716,7089716,7089688,28,0,utRho13
166,bisC,7433026,7433026,7432788,238,0,utRho13
167,blc,8755490,8755490,8755444,46,0,utRho13
168,blr,3409024,3409102,3409024,78,0,utRho13
169,bluF,2431226,2431226,2430950,276,0,utRho13
170,bluR,2428226,2428226,2428118,108,0,utRho13
171,bolA,908698,908944,908698,246,116,utRho13
172,borD,1157842,1157842,1157786,56,2,utRho13
173,brnQ,838976,839182,838976,206,632,utRho13
174,bssR,1756492,1756496,1756492,4,0,utRho13
175,bssS,2242116,2242116,2241910,206,0,utRho13
176,btuB,8326798,8327278,8326798,480,4874,utRho13
177,cadB,8720212,8720212,8720062,150,0,utRho13
178,cadC,8723926,8723926,8723868,58,20,utRho13
179,caiE,70998,70998,70742,256,0,utRho13
180,caiF,68436,68600,68436,164,0,utRho13
181,caiT,84074,84074,83862,212,0,utRho13
182,can,285406,285406,285340,66,0,utRho13
183,carA,59102,59302,59102,200,0,utRho13
184,carB,61550,61634,61550,84,246,utRho13
185,cas2,5757830,5757830,5757706,124,0,utRho13
186,casA,5768638,5768638,5768276,362,0,utRho13
187,cbl,4121882,4121882,4121828,54,0,utRho13
188,cbpA,2128074,2128074,2127550,524,0,utRho13
189,cbrA,7738628,7738754,7738628,126,0,utRho13
190,cbrB,7794958,7795012,7794958,54,0,utRho13
191,ccmH,4585242,4585242,4584820,422,92,utRho13
192,cdaR,364894,364926,364894,32,0,utRho13
193,cdd,4463638,4463688,4463638,50,0,utRho13
194,cdh,8219814,8219860,8219814,46,0,utRho13
195,cdsA,391110,391354,391110,244,1570,utRho13
196,cedA,3627484,3627484,3627326,158,40,utRho13
197,cfa,3482402,3482826,3482402,424,368,utRho13
198,chaC,2544844,2544972,2544844,128,0,utRho13
199,chbB,3643452,3643452,3643238,214,0,utRho13
200,chbG,3634624,3634624,3634270,354,92,utRho13
201,cheW,3946924,3946924,3946678,246,1146,utRho13
202,chiA,6939792,6939792,6939706,86,0,utRho13
203,chiP,1416472,1416668,1416472,196,0,utRho13
204,cho,3646984,3647030,3646984,46,0,utRho13
205,chpS,8896804,8896894,8896804,90,18,utRho13
206,cirA,4493884,4493884,4493538,346,0,utRho13
207,citC,1304078,1304078,1303712,366,0,utRho13
208,citT,1293264,1293264,1293160,104,0,utRho13
209,clcA,350104,350214,350104,110,0,utRho13
210,clpA,1846160,1846528,1846160,368,102,utRho13
211,clpB,5468410,5468410,5468346,64,266,utRho13
212,clpP,913154,913354,913154,200,754,utRho13
213,clpS,1845500,1845826,1845500,326,28,utRho13
214,clpX,914404,914852,914404,448,2992,utRho13
215,clsA,2617346,2617346,2617290,56,0,utRho13
216,clsC,2212584,2212710,2212584,126,622,utRho13
217,cmk,1922330,1922402,1922330,72,0,utRho13
218,cnu,3409522,3409898,3409522,376,666,utRho13
219,coaA,8350214,8350214,8350052,162,338,utRho13
220,cobC,1340092,1340092,1339814,278,336,utRho13
221,cobT,4129202,4129202,4128934,268,0,utRho13
222,cobU,4131944,4131944,4131528,416,0,utRho13
223,codB,709768,709844,709768,76,0,utRho13
224,comR,2337726,2337726,2337664,62,130,utRho13
225,copA,1022822,1022822,1022758,64,28,utRho13
226,corA,8002388,8002852,8002388,464,6014,utRho13
227,cpdB,8873258,8873258,8873130,128,412,utRho13
228,cptB,6082198,6082198,6082140,58,0,utRho13
229,cpxA,8210202,8210202,8209950,252,732,utRho13
230,cpxP,8211570,8211640,8211570,70,90,utRho13
231,cpxR,8211372,8211372,8211340,32,58,utRho13
232,cra,175894,176056,175894,162,50,utRho13
233,crcB,1316016,1316016,1315876,140,0,utRho13
234,creA,9270486,9271042,9270486,556,364,utRho13
235,creD,9276320,9276356,9276320,36,0,utRho13
236,crl,515620,515658,515620,38,666,utRho13
237,crp,6971906,6972240,6971906,334,6878,utRho13
238,crr,5070960,5071668,5070960,708,4262,utRho13
239,csdA,5886414,5886674,5886414,260,0,utRho13
240,csgB,2207718,2207902,2207718,184,0,utRho13
241,csgD,2206688,2206688,2206392,296,0,utRho13
242,csgG,2203510,2203510,2203368,142,0,utRho13
243,csiD,5577854,5577970,5577854,116,128,utRho13
244,csiE,5330802,5330870,5330802,68,0,utRho13
245,csiR,5590942,5591348,5590942,406,0,utRho13
246,cspA,7439778,7440098,7439778,320,1718,utRho13
247,cspB,3283430,3283430,3283108,322,2,utRho13
248,cspC,3815018,3815018,3814870,148,976,utRho13
249,cspD,1845352,1845352,1845180,172,19414,utRho13
250,cspE,1314294,1314584,1314294,290,38,utRho13
251,cspF,3283380,3283710,3283380,330,0,utRho13
252,cspG,2102610,2102922,2102610,312,178,utRho13
253,cspH,2102746,2102746,2102350,396,2,utRho13
254,cspI,3277624,3277624,3277334,290,0,utRho13
255,csrA,5638746,5638746,5638292,454,2044,utRho13
256,csrB,5849048,5849048,5849048,0,0,utRho13
257,csrC,8102072,8102072,8102072,0,0,utRho13
258,csrD,6806850,6806850,6806664,186,0,utRho13
259,cstA,1259710,1259788,1259710,78,0,utRho13
260,cueO,274090,274166,274090,76,0,utRho13
261,cueR,1027948,1027986,1027948,38,50,utRho13
262,curA,3037784,3038054,3037784,270,0,utRho13
263,cusC,1191146,1191200,1191146,54,0,utRho13
264,cusR,1190924,1190924,1190886,38,0,utRho13
265,cutA,8730784,8730784,8730712,72,24,utRho13
266,cutC,3918534,3918534,3917920,614,434,utRho13
267,cvpA,4861600,4861600,4861526,74,20,utRho13
268,cvrA,2484328,2484328,2484142,186,16,utRho13
269,cyaA,7981548,7982306,7981548,758,462,utRho13
270,cyaR,4334228,4334224,4334228,4,0,utRho13
271,cyaY,7988166,7988166,7988118,48,0,utRho13
272,cybB,2981522,2981804,2981522,282,0,utRho13
273,cycA,8859560,8859728,8859560,168,614,utRho13
274,cydA,1542340,1542916,1542340,576,372,utRho13
275,cydC,1858800,1858800,1858390,410,340,utRho13
276,cydD,1862062,1862062,1861924,138,38,utRho13
277,cydX,1548300,1548392,1548300,92,650,utRho13
278,cynR,717418,717418,717380,38,0,utRho13
279,cynT,1435092,1435196,1435092,104,0,utRho13
280,cyoA,903306,903306,903220,86,4702,utRho13
281,cyoE,895540,895540,895410,130,732,utRho13
282,cysB,2667576,2667710,2667576,134,58,utRho13
283,cysC,5748056,5748056,5747984,72,0,utRho13
284,cysD,5752736,5752736,5752658,78,0,utRho13
285,cysE,7565362,7565362,7565124,238,3770,utRho13
286,cysG,6995508,6995656,6995508,148,26,utRho13
287,cysJ,5783928,5783928,5783796,132,136,utRho13
288,cysK,5064688,5064818,5064688,130,104,utRho13
289,cysP,5087114,5087114,5087056,58,0,utRho13
290,cysS,1109154,1109222,1109154,68,198,utRho13
291,cysT,3984100,3984100,3983974,126,210,utRho13
292,cysZ,5062766,5062926,5062766,160,102,utRho13
293,cytR,8249018,8249018,8248912,106,184,utRho13
294,dacA,1328002,1328002,1327926,76,216,utRho13
295,dacB,6657714,6657926,6657714,212,0,utRho13
296,dacC,1761306,1761454,1761306,148,0,utRho13
297,dadA,2475018,2475142,2475018,124,0,utRho13
298,dam,7032504,7032504,7031826,678,1192,utRho13
299,damX,7035200,7035200,7034612,588,326,utRho13
300,dapA,5199568,5199568,5199520,48,0,utRho13
301,dapB,56576,56748,56576,172,84,utRho13
302,dapD,371954,371954,371894,60,318,utRho13
303,dapE,5183120,5183214,5183120,94,1194,utRho13
304,dcp,3254844,3254844,3254760,84,48,utRho13
305,dcrB,7219534,7219910,7219534,376,0,utRho13
306,dctA,7366996,7366996,7366894,102,822,utRho13
307,dcuA,8733686,8733686,8733546,140,0,utRho13
308,dcuB,8698182,8698182,8697488,694,408,utRho13
309,dcuC,1312166,1312166,1311936,230,0,utRho13
310,dcuD,6749166,6749738,6749166,572,0,utRho13
311,dcuR,8701130,8701130,8700068,1062,670,utRho13
312,dcuS,8703370,8703370,8703324,46,0,utRho13
313,dcyD,3999016,3999016,3998960,56,0,utRho13
314,ddpX,3126498,3126498,3126152,346,0,utRho13
315,deaD,6615818,6615818,6615720,98,92,utRho13
316,dedA,4869880,4869880,4869482,398,5366,utRho13
317,dedD,4863750,4863750,4863368,382,158,utRho13
318,def,6867300,6867380,6867300,80,6,utRho13
319,degP,361690,361768,361690,78,0,utRho13
320,degQ,6761308,6761486,6761308,178,610,utRho13
321,deoB,9239134,9239206,9239134,72,0,utRho13
322,deoC,9233358,9234646,9233358,1288,480,utRho13
323,dfp,7625406,7625462,7625406,56,138,utRho13
324,dgcZ,3247758,3247758,3247700,58,0,utRho13
325,dgkA,8512914,8513274,8512914,360,942,utRho13
326,dgt,358392,358474,358392,82,0,utRho13
327,dhaK,2501888,2501888,2501676,212,490,utRho13
328,dhaR,2502006,2502132,2502006,126,44,utRho13
329,dicB,3299194,3299218,3299194,24,0,utRho13
330,dicC,3295752,3295752,3295700,52,0,utRho13
331,dinB,501760,501796,501760,36,0,utRho13
332,dinD,7635398,7635520,7635398,122,0,utRho13
333,dinG,1666146,1666140,1666146,6,0,utRho13
334,dinI,2243018,2243018,2242974,44,44,utRho13
335,dinJ,493230,493230,493004,226,0,utRho13
336,dinQ,7295964,7295964,7295576,388,824,utRho13
337,djlA,114536,114728,114536,192,130,utRho13
338,dkgA,6313142,6313246,6313142,104,764,utRho13
339,dkgB,458196,458334,458196,138,0,utRho13
340,dksA,321502,321502,321208,294,2394,utRho13
341,dld,4444164,4444370,4444164,206,126,utRho13
342,dmlA,3763424,3763824,3763424,400,112,utRho13
343,dmlR,3763710,3763710,3763618,92,108,utRho13
344,dmsA,1881646,1881918,1881646,272,0,utRho13
345,dnaA,7767922,7767922,7767458,464,942,utRho13
346,dnaB,8528566,8528628,8528566,62,0,utRho13
347,dnaK,24096,24326,24096,230,2476,utRho13
348,dnaN,7765466,7765466,7764642,824,628,utRho13
349,dnaQ,471868,472134,471868,266,1686,utRho13
350,dnaT,18406460,18406460,18406068,392,0,utRho13
351,dnaX,984112,984184,984112,72,258,utRho13
352,dosP,3131486,3131486,3131466,20,0,utRho13
353,dpiB,1303968,1304470,1303968,502,0,utRho13
354,dppA,7415740,7415740,7415410,330,3352,utRho13
355,dps,1697900,1697900,1697822,78,72,utRho13
356,dsbA,8086754,8086836,8086754,82,2516,utRho13
357,dsbB,2466294,2466294,2466060,234,0,utRho13
358,dsbC,6079266,6079266,6077644,1622,1160,utRho13
359,dsbG,1277600,1277600,1277146,454,392,utRho13
360,dsdA,4958242,4958404,4958242,162,1320,utRho13
361,dsdC,4955492,4955492,4955258,234,0,utRho13
362,dsdX,4955642,4955694,4955642,52,0,utRho13
363,dsrA,4050626,4050626,4050626,0,0,utRho13
364,dsrB,4049686,4049686,4049646,40,2,utRho13
365,dtpD,1485340,1485340,1485112,228,20,utRho13
366,dusA,8523200,8523338,8523200,138,1298,utRho13
367,dusB,6820492,6820560,6820492,68,0,utRho13
368,dusC,4460790,4460790,4460770,20,0,utRho13
369,dut,7627704,7627864,7627704,160,2176,utRho13
370,dxr,386670,387042,386670,372,1184,utRho13
371,ebgA,6445102,6445266,6445102,164,44,utRho13
372,ebgR,6442874,6442932,6442874,58,60,utRho13
373,ecnB,8753018,8753106,8753018,88,0,utRho13
374,eco,4607594,4607810,4607594,216,54,utRho13
375,ecpA,621594,621594,621342,252,0,utRho13
376,ecpB,620238,620238,620052,186,0,utRho13
377,ecpR,622964,622964,622672,292,0,utRho13
378,eda,3866218,3866218,3865512,706,308,utRho13
379,edd,3869426,3869426,3869208,218,186,utRho13
380,efeO,2164308,2164486,2164308,178,56,utRho13
381,efeU_1,2162614,2162712,2162614,98,0,utRho13
382,efp,8751134,8751398,8751134,264,4412,utRho13
383,elaA,4763372,4763372,4763086,286,224,utRho13
384,elaD,4765308,4765426,4765308,118,0,utRho13
385,elfA,1995530,1995736,1995530,206,0,utRho13
386,elfD,1996642,1996980,1996642,338,0,utRho13
387,emrD,7707690,7707844,7707690,154,8,utRho13
388,emrK,4966896,4966896,4966678,218,0,utRho13
389,emrY,4964668,4964668,4964352,316,0,utRho13
390,emtA,2486250,2486360,2486250,110,0,utRho13
391,endA,12361100,12361388,12361100,288,0,utRho13
392,eno,5817692,5817692,5815882,1810,3054,utRho13
393,entC,1249662,1249770,1249662,108,0,utRho13
394,entD,1220508,1220508,1220158,350,160,utRho13
395,entH,1258584,1258600,1258584,16,0,utRho13
396,entS,1244506,1244600,1244506,94,0,utRho13
397,envR,6827266,6827266,6826930,336,0,utRho13
398,epd,12295292,12295292,12294764,528,88,utRho13
399,epmA,8765236,8765286,8765236,50,0,utRho13
400,epmB,8751406,8751406,8751314,92,2162,utRho13
401,eptB,7421162,7421162,7420950,212,118,utRho13
402,eptC,8300622,8300622,8300530,92,0,utRho13
403,erfK,4126708,4126708,4126646,62,38,utRho13
404,erpA,353122,353220,353122,98,72,utRho13
405,esrE,8039956,8039956,8039956,0,0,utRho13
406,essD,1153746,1154796,1153746,1050,16,utRho13
407,etk,2088606,2088606,2088420,186,0,utRho13
408,evgA,4967262,4967510,4967262,248,0,utRho13
409,exbB,6304028,6304028,6303968,60,0,utRho13
410,exbD,6302780,6302780,6302486,294,142,utRho13
411,exuR,6493016,6493304,6493016,288,82,utRho13
412,exuT,6490004,6490208,6490004,204,0,utRho13
413,fabA,2032996,2032996,2032940,56,0,utRho13
414,fabB,4883282,4883282,4883210,72,0,utRho13
415,fabH,2297032,2297518,2297032,486,1294,utRho13
416,fabI,2702236,2702236,2702078,158,52,utRho13
417,fadB,8062026,8062026,8061942,84,0,utRho13
418,fadD,3779614,3779614,3779492,122,0,utRho13
419,fadE,486812,486812,486606,206,0,utRho13
420,fadH,6463248,6463330,6463248,82,0,utRho13
421,fadI,4921022,4921022,4920938,84,0,utRho13
422,fadL,4922410,4922600,4922410,190,172,utRho13
423,fadM,928720,928804,928720,84,4,utRho13
424,fadR,2469810,2469876,2469810,66,0,utRho13
425,fbaB,4357334,4357334,4357128,206,0,utRho13
426,fdhE,8162722,8162722,8162456,266,2014,utRho13
427,fdhF,8598814,8598814,8598732,82,0,utRho13
428,fdnG,3094744,3094802,3094744,58,0,utRho13
429,fdrA,1093012,1093360,1093012,348,0,utRho13
430,feaB,2894994,2895038,2894994,44,0,utRho13
431,feaR,2894734,2894734,2894566,168,68,utRho13
432,fecA,9033454,9033454,9033354,100,74,utRho13
433,fecE,9023288,9023288,9022914,374,4014,utRho13
434,fecI,9036564,9036564,9036470,94,0,utRho13
435,feoA,7080114,7080326,7080114,212,68,utRho13
436,fepA,1225334,1225334,1224988,346,0,utRho13
437,fepB,1249454,1249454,1249020,434,730,utRho13
438,fepD,1244468,1244468,1244378,90,0,utRho13
439,fes,1225374,1225630,1225374,256,16,utRho13
440,ffh,5495706,5495706,5495590,116,894,utRho13
441,ffs,952576,952848,952576,272,0,utRho13
442,fhuA,334884,334968,334884,84,48,utRho13
443,fhuE,2323294,2323294,2323102,192,42,utRho13
444,fhuF,9211504,9211504,9211326,178,198,utRho13
445,fic,6983296,6983296,6982926,370,316,utRho13
446,fieF,8212864,8212938,8212864,74,0,utRho13
447,fimA,9085388,9086230,9085388,842,660,utRho13
448,fimB,9081334,9081914,9081334,580,722,utRho13
449,fimE,9083742,9084074,9083742,332,0,utRho13
450,fimZ,1129214,1129214,1128960,254,0,utRho13
451,fiu,1683296,1683296,1683062,234,0,utRho13
452,fixA,84650,84806,84650,156,0,utRho13
453,fkpA,6955050,6955050,6954838,212,10048,utRho13
454,fldA,2846084,2846084,2845860,224,2988,utRho13
455,fldB,6079644,6079710,6079644,66,0,utRho13
456,flgA,2261770,2261770,2261726,44,0,utRho13
457,flgB,2261986,2262036,2261986,50,0,utRho13
458,flgK,2276702,2276756,2276702,54,386,utRho13
459,flgM,2260330,2260330,2260256,74,552,utRho13
460,flgN,2259828,2259828,2259660,168,166,utRho13
461,flhB,3932432,3932432,3932382,50,50,utRho13
462,flhC,3955864,3955864,3955688,176,104,utRho13
463,flhD,3957154,3957154,3956394,760,466,utRho13
464,fliA,4003638,4003638,4003578,60,0,utRho13
465,fliC,4007352,4007352,4007212,140,240,utRho13
466,fliD,4007634,4007744,4007634,110,316,utRho13
467,fliE,4026186,4026186,4026028,158,0,utRho13
468,fliF,4026292,4026458,4026292,166,346,utRho13
469,fliL,4039168,4039236,4039168,68,26,utRho13
470,flk,4875824,4875900,4875824,76,0,utRho13
471,flu,4142634,4143078,4142634,444,56,utRho13
472,flxA,3292776,3292810,3292776,34,0,utRho13
473,fnr,2799104,2799104,2799052,52,16,utRho13
474,fnrS,2818258,2818258,2818258,0,0,utRho13
475,focA,1909628,1909628,1908932,696,218,utRho13
476,folA,99598,99646,99598,48,0,utRho13
477,folB,6409296,6409296,6409178,118,0,utRho13
478,folD,1115562,1115562,1115482,80,212,utRho13
479,folE,4487696,4487696,4487304,392,3114,utRho13
480,fpr,8228998,8228998,8228944,54,0,utRho13
481,frc,4986878,4986878,4986508,370,0,utRho13
482,frdA,8764824,8764824,8764636,188,46,utRho13
483,frdD,8758948,8758948,8758732,216,2624,utRho13
484,fre,8052886,8053054,8052886,168,2306,utRho13
485,frlA,6999518,6999820,6999518,302,0,utRho13
486,frr,385624,385744,385624,120,2026,utRho13
487,frsA,513004,513054,513004,50,36,utRho13
488,fruB,4527194,4527194,4526990,204,82,utRho13
489,frvR,8179804,8179804,8179710,94,0,utRho13
490,fryA,5008986,5008986,5008970,16,0,utRho13
491,fsaA,1727060,1727284,1727060,224,0,utRho13
492,fsr,1009710,1009710,1009392,318,128,utRho13
493,ftnA,3977364,3977432,3977364,68,0,utRho13
494,ftnB,3973550,3973850,3973550,300,28,utRho13
495,ftsA,207122,207964,207122,842,602,utRho13
496,ftsB,5745802,5745802,5745640,162,10,utRho13
497,ftsH,6654204,6654204,6653870,334,1340,utRho13
498,ftsK,1865858,1866448,1865858,590,2074,utRho13
499,ftsL,181376,182064,181376,688,1838,utRho13
500,ftsP,6325732,6325732,6325338,394,194,utRho13
501,ftsQ,205484,206310,205484,826,266,utRho13
502,ftsX,7204512,7204512,7204172,340,420,utRho13
503,ftsZ,209272,210610,209272,1338,122,utRho13
504,fucA,5867708,5867708,5867376,332,70,utRho13
505,fucP,5868238,5868470,5868238,232,0,utRho13
506,fumA,6753760,6753760,6753508,252,13152,utRho13
507,fumB,8694696,8694696,8694652,44,12,utRho13
508,fumC,3373418,3373418,3373176,242,0,utRho13
509,fur,2842892,2842892,2842584,308,5668,utRho13
510,fusA,6947370,6947370,6947028,342,36468,utRho13
511,fxsA,8737206,8737328,8737206,122,792,utRho13
512,gabD,5581824,5582546,5581824,722,3082,utRho13
513,gadA,7335214,7335214,7335160,54,0,utRho13
514,gadB,3144144,3144144,3144090,54,0,utRho13
515,gadC,3141168,3141168,3140978,190,0,utRho13
516,gadE,7315600,7316732,7315600,1132,0,utRho13
517,gadW,7329562,7329562,7329236,326,0,utRho13
518,gadX,14663356,14663356,14663240,116,0,utRho13
519,gadY,7329728,7329728,7329728,0,0,utRho13
520,galE,1584354,1584354,1584110,244,0,utRho13
521,galF,4228702,4228702,4228654,48,0,utRho13
522,galM,1577796,1577796,1577674,122,1198,utRho13
523,galP,6176510,6176568,6176510,58,0,utRho13
524,galR,5953138,5953198,5953138,60,326,utRho13
525,galS,4483420,4483420,4483336,84,0,utRho13
526,galU,2582810,2582914,2582810,104,694,utRho13
527,gapA,3724480,3725542,3724480,1062,13684,utRho13
528,garP,6549868,6549868,6549814,54,22,utRho13
529,gatY,4354468,4354468,4354408,60,26,utRho13
530,gatZ,4352864,4352864,4352642,222,46452,utRho13
531,gcd,282558,282558,282450,108,0,utRho13
532,gcl,1067814,1067832,1067814,18,0,utRho13
533,gcvA,5885278,5885278,5885134,144,0,utRho13
534,gcvB,5885392,5885392,5885392,0,0,utRho13
535,gcvR,5199758,5199812,5199758,54,178,utRho13
536,gcvT,6101544,6101544,6101334,210,7082,utRho13
537,gdhA,3684616,3684742,3684616,126,0,utRho13
538,gfcA,2099668,2099668,2099488,180,24,utRho13
539,gfcD,2096236,2096236,2095890,346,0,utRho13
540,ghrA,2195648,2195772,2195648,124,110,utRho13
541,ghrB,7434378,7434620,7434378,242,1082,utRho13
542,glcA,6242728,6242728,6242558,170,104,utRho13
543,glcC,6256412,6256544,6256412,132,0,utRho13
544,glcD,6256152,6256152,6256042,110,276,utRho13
545,gldA,8278092,8278092,8278070,22,0,utRho13
546,glgA,7136784,7136784,7136066,718,656,utRho13
547,glgB,7147314,7147314,7147004,310,254,utRho13
548,glgC,7139142,7139142,7138656,486,450,utRho13
549,glgP,7133546,7133546,7133162,384,344,utRho13
550,glgS,6384024,6384024,6383878,146,0,utRho13
551,glgX,7142838,7142838,7142638,200,52,utRho13
552,glk,5018922,5018922,5018852,70,0,utRho13
553,glmS,7827622,7827622,7827336,286,5292,utRho13
554,glmU,7830652,7830652,7830400,252,2,utRho13
555,glmY,10765360,10765360,10765360,0,0,utRho13
556,glmZ,7972864,7972864,7972864,0,0,utRho13
557,glnA,16232888,16232888,16232136,752,1416,utRho13
558,glnB,5375052,5375052,5374816,236,4,utRho13
559,glnD,377310,377310,377300,10,0,utRho13
560,glnE,6399602,6399602,6399282,320,136,utRho13
561,glnH,1696396,1696396,1696008,388,526,utRho13
562,glnK,945112,945196,945112,84,0,utRho13
563,glnL,8112742,8112742,8112678,64,0,utRho13
564,glnQ,1693262,1693262,1692926,336,1228,utRho13
565,glnS,1411998,1412186,1411998,188,1194,utRho13
566,gloA,3455602,3455674,3455602,72,0,utRho13
567,gloB,469852,469852,469564,288,1350,utRho13
568,glpA,4705166,4705294,4705166,128,0,utRho13
569,glpD,7123942,7124026,7123942,84,66,utRho13
570,glpE,7123698,7123698,7123646,52,38,utRho13
571,glpF,8236322,8236322,8236180,142,616,utRho13
572,glpG,7122960,7122960,7122904,56,438,utRho13
573,glpR,7121782,7121782,7121210,572,140,utRho13
574,glpT,4704902,4704902,4704748,154,658,utRho13
575,glpX,8231212,8231212,8231158,54,7246,utRho13
576,glrK,5382246,5382246,5382196,50,40,utRho13
577,gltA,1509534,1509534,1508936,598,22366,utRho13
578,gltB,6709018,6709264,6709018,246,28,utRho13
579,gltI,1375792,1375792,1375494,298,2974,utRho13
580,gltP,8588536,8588962,8588536,426,1184,utRho13
581,gltS,7657382,7657382,7657330,52,622,utRho13
582,gltX,5041568,5041568,5041344,224,320,utRho13
583,gluQ,320286,320286,320224,62,606,utRho13
584,glyA,5371148,5371148,5371014,134,86,utRho13
585,glyQ,7450708,7450708,7450636,72,208,utRho13
586,glyS,7448990,7448990,7448794,196,2696,utRho13
587,glyU,5998128,5998128,5998114,14,26,utRho13
588,glyV,8784626,8784720,8784626,94,226,utRho13
589,glyW,3984360,3984360,3984234,126,0,utRho13
590,gmhB,445612,445666,445612,54,0,utRho13
591,gmk,7642776,7642856,7642776,80,14,utRho13
592,gmr,2693686,2693686,2693484,202,60,utRho13
593,gnd,4202648,4202648,4202536,112,556,utRho13
594,gnsB,3275692,3275692,3275564,128,0,utRho13
595,gntK,14310580,14310580,14310368,212,88,utRho13
596,gntP,9102668,9102668,9102592,76,46,utRho13
597,gntR,7157760,7157760,7157452,308,432,utRho13
598,gntT,7092810,7093118,7092810,308,88,utRho13
599,gntU,7154170,7154170,7154122,48,0,utRho13
600,gntX,7089334,7089764,7089334,430,0,utRho13
601,gor,7292224,7292598,7292224,374,380,utRho13
602,gpmA,1575340,1575340,1575190,150,56,utRho13
603,gpmM,7570374,7570520,7570374,146,36,utRho13
604,gpsA,7567620,7567620,7567322,298,25780,utRho13
605,gpt,511828,511954,511828,126,476,utRho13
606,grcA,5433046,5433046,5432898,148,0,utRho13
607,greA,6657728,6657728,6657430,298,952,utRho13
608,greB,7073488,7073624,7073488,136,112,utRho13
609,groL,8741566,8742050,8741566,484,9766,utRho13
610,groS,8741232,8741376,8741232,144,12484,utRho13
611,grpE,5501494,5501494,5501416,78,524,utRho13
612,grxA,1781552,1781552,1781506,46,0,utRho13
613,grxB,2248206,2248206,2248108,98,50,utRho13
614,grxC,7569152,7569152,7568884,268,11042,utRho13
615,grxD,3468324,3468324,3468202,122,6260,utRho13
616,gspA,6911268,6911268,6910796,472,0,utRho13
617,gspC,6910964,6911156,6910964,192,0,utRho13
618,gss,6277220,6277220,6277044,176,68,utRho13
619,gstA,3428654,3428754,3428654,100,0,utRho13
620,gstB,1761038,1761038,1760960,78,0,utRho13
621,guaB,5268214,5268214,5268140,74,350,utRho13
622,gudD,5839026,5839026,5838770,256,38,utRho13
623,gyrA,4678914,4678914,4678840,74,8,utRho13
624,gyrB,7760300,7760300,7760238,62,0,utRho13
625,hcaE,5337964,5338064,5337964,100,80,utRho13
626,hcaR,5337928,5337928,5337792,136,0,utRho13
627,hcaT,5336106,5336106,5335692,414,508,utRho13
628,hchA,4071260,4071670,4071260,410,0,utRho13
629,hcp,1828258,1828258,1827628,630,86,utRho13
630,hcr,1824400,1824400,1824300,100,106,utRho13
631,hdeA,7313582,7313582,7313480,102,0,utRho13
632,hdeD,7313920,7313990,7313920,70,0,utRho13
633,hdfR,7896320,7896320,7895934,386,340,utRho13
634,hdhA,3396244,3396244,3396080,164,0,utRho13
635,helD,2048876,2048942,2048876,66,0,utRho13
636,hemA,2527166,2527428,2527166,262,64,utRho13
637,hemB,779722,779722,779454,268,0,utRho13
638,hemF,5106410,5106450,5106410,40,0,utRho13
639,hemH,996062,996110,996062,48,4,utRho13
640,hemL,349882,349882,349764,118,258,utRho13
641,hemN,8103886,8104090,8103886,204,94,utRho13
642,hepA,127176,127176,126528,648,1240,utRho13
643,hflD,2385372,2385372,2385262,110,238,utRho13
644,hfq,8799602,8800576,8799602,974,11534,utRho13
645,hha,961006,961006,960616,390,52,utRho13
646,hicA,3018442,3018572,3018442,130,0,utRho13
647,higA,6468682,6468682,6468288,394,38,utRho13
648,higB,6468960,6468960,6468910,50,2,utRho13
649,hinT,2323642,2323770,2323642,128,156,utRho13
650,hipB,3184964,3184964,3184884,80,56,utRho13
651,hisB,4186720,4186936,4186720,216,1122,utRho13
652,hisJ,4853674,4853674,4853576,98,172,utRho13
653,hisL,8359856,8359984,8359856,128,32,utRho13
654,hisS,5281284,5281284,5281150,134,338,utRho13
655,hlpA,400910,400964,400910,54,450,utRho13
656,hlyE,2460932,2460932,2460788,144,0,utRho13
657,hmp,5371594,5371670,5371594,76,0,utRho13
658,hns,2585916,2585916,2585844,72,1030,utRho13
659,hofM,7045856,7045856,7045502,354,0,utRho13
660,hokA,7441620,7441620,7441200,420,46,utRho13
661,hokC,33902,33902,33806,96,296,utRho13
662,hokE,1215462,1215672,1215462,210,0,utRho13
663,holC,8968546,8968546,8968560,14,1242,utRho13
664,holD,9215562,9215606,9215562,44,0,utRho13
665,holE,3850040,3850216,3850040,176,118,utRho13
666,hpt,282720,282862,282720,142,330,utRho13
667,hrpB,324150,324210,324150,60,18,utRho13
668,hscB,5319048,5319048,5318934,114,5228,utRho13
669,hscC,1367188,1367188,1366786,402,2408,utRho13
670,hsdS,9163004,9163004,9162924,80,0,utRho13
671,hslJ,2883560,2883560,2883486,74,82,utRho13
672,hslO,7059344,7059548,7059344,204,10916,utRho13
673,hslR,7058220,7058696,7058220,476,1800,utRho13
674,hslV,8244708,8244708,8244574,134,170,utRho13
675,hsrA,7881412,7881412,7881224,188,58,utRho13
676,htgA,21286,21660,21286,374,0,utRho13
677,htpG,989634,990240,989634,606,1998,utRho13
678,htpX,3825236,3825236,3825152,84,0,utRho13
679,htrE,311036,311036,310852,184,0,utRho13
680,htrL,7587668,7587668,7587366,302,0,utRho13
681,hupA,8400352,8400562,8400352,210,422,utRho13
682,hupB,1845220,1845804,1845220,584,2244,utRho13
683,hyaA,2063968,2064278,2063968,310,0,utRho13
684,hybO,6292726,6292726,6292522,204,424,utRho13
685,hycA,5700922,5700922,5700870,52,0,utRho13
686,hycI,5686204,5686204,5686086,118,224,utRho13
687,hydN,5676264,5676264,5676210,54,0,utRho13
688,hyfA,5202342,5202402,5202342,60,0,utRho13
689,hypA,11402508,11402588,11402508,80,0,utRho13
690,hypB,11403356,11404004,11403356,648,380,utRho13
691,hypF,5676210,5676210,5674850,1360,156,utRho13
692,hypT,9116634,9116634,9116578,56,0,utRho13
693,hyuA,6019660,6020056,6019660,396,8,utRho13
694,iaaA,1733074,1733136,1733074,62,0,utRho13
695,iadA,9119074,9119074,9119052,22,88,utRho13
696,iap,5753072,5753162,5753072,90,44,utRho13
697,ibaG,6673966,6673966,6673606,360,306,utRho13
698,ibpA,7735036,7735036,7734844,192,1066,utRho13
699,ibpB,7733962,7733962,7733794,168,4530,utRho13
700,icd,2389922,2390246,2389922,324,340,utRho13
701,iclR,8447304,8447304,8447256,48,80,utRho13
702,idi,6065876,6066130,6065876,254,0,utRho13
703,idnD,8988870,8988870,8988812,58,0,utRho13
704,idnK,8989194,8989246,8989194,52,0,utRho13
705,ihfA,3591442,3591442,3591104,338,452,utRho13
706,ihfB,1927498,1927656,1927498,158,1124,utRho13
707,ileS,43666,44782,43666,1116,8418,utRho13
708,ileX,6431194,6431196,6431194,2,0,utRho13
709,ilvA,15820940,15821324,15820940,384,296,utRho13
710,ilvC,7915824,7915940,7915824,116,0,utRho13
711,ilvE,15809552,15809936,15809552,384,324,utRho13
712,ilvI,170840,171260,170840,420,0,utRho13
713,ilvL,23701308,23701932,23701308,624,6,utRho13
714,ilvY,7915734,7915734,7915640,94,0,utRho13
715,inaA,4698998,4698998,4698944,54,0,utRho13
716,infA,1853370,1853370,1852886,484,1266,utRho13
717,infC,3602692,3602692,3601276,1416,5474,utRho13
718,insA-5,3958452,3958452,3958430,22,0,utRho13
719,insA-7,9036758,9037054,9036758,296,0,utRho13
720,insC-5,6372080,6372284,6372080,204,40,utRho13
721,insEF-2,785238,785238,785820,582,224,utRho13
722,insEF-4,2190310,2190310,2190892,582,238,utRho13
723,insG,9007098,9007098,9006862,236,32,utRho13
724,insH-1,550596,550596,550234,362,168,utRho13
725,insH-11,7306538,7306538,7306396,142,166,utRho13
726,insH-2,1151548,1151548,1151506,42,474,utRho13
727,insH-3,1378444,1378444,1378026,418,218,utRho13
728,insH-4,2791942,2792152,2791942,210,210,utRho13
729,insH-5,2857852,2857852,2857452,400,0,utRho13
730,insH-6,4135022,4135022,4134642,380,68,utRho13
731,insH-7,4206186,4206186,4205822,364,2510,utRho13
732,insH-9,6260050,6260356,6260050,306,190,utRho13
733,insI-3,9017372,9017372,9017234,138,48,utRho13
734,insJ,7441188,7441360,7441188,172,42,utRho13
735,insK,7442130,7442308,7442130,178,0,utRho13
736,insL-1,30760,30890,30760,130,2656,utRho13
737,insL-2,1216112,1216130,1216112,18,8,utRho13
738,insL-3,5028644,5028662,5028644,18,32,utRho13
739,insN-1,540452,540484,540452,32,0,utRho13
740,intD,1132202,1132202,1131956,246,0,utRho13
741,intR,2826520,2826520,2826470,50,0,utRho13
742,intS,4933026,4933090,4933026,64,12,utRho13
743,intZ,5117386,5117542,5117386,156,48,utRho13
744,iraD,9113152,9113986,9113152,834,68,utRho13
745,iraM,2424246,2424246,2424006,240,38,utRho13
746,iraP,802638,802772,802638,134,0,utRho13
747,iscA,5319924,5319924,5319772,152,2674,utRho13
748,iscR,5324398,5324398,5324262,136,20176,utRho13
749,iscX,5313834,5313834,5313472,362,3156,utRho13
750,ispF,5743968,5743968,5743560,408,1354,utRho13
751,ispG,5283908,5283908,5283608,300,688,utRho13
752,ispU,389568,389806,389568,238,78,utRho13
753,isrA,2811502,2811502,2811618,116,0,utRho13
754,istr-1,7706384,7706384,7706384,0,0,utRho13
755,istr-2,7706514,7706514,7706514,0,0,utRho13
756,ivbL,15412092,15412092,15411952,140,1112,utRho13
757,ivy,480638,480686,480638,48,0,utRho13
758,katE,3627628,3627734,3627628,106,0,utRho13
759,katG,8267624,8267670,8267624,46,20,utRho13
760,kbaZ,6557732,6557828,6557732,96,0,utRho13
761,kbl,7585154,7585154,7585102,52,1046,utRho13
762,kch,2621046,2621046,2620538,508,58,utRho13
763,kdgR,3820506,3820506,3820198,308,0,utRho13
764,kdpE,1443788,1443788,1443466,322,102,utRho13
765,kdpF,1457698,1457698,1457642,56,0,utRho13
766,kdsA,2535708,2536330,2535708,622,1444,utRho13
767,kdsC,6683438,6684546,6683438,1108,3072,utRho13
768,kduI,5968388,5968388,5968248,140,0,utRho13
769,kefF,94160,94492,94160,332,78,utRho13
770,kgtP,5451624,5451624,5451492,132,106,utRho13
771,kup,7862206,7862632,7862206,426,32,utRho13
772,lacI,735076,735076,735020,56,48,utRho13
773,lacZ,1465508,1465508,1465220,288,124,utRho13
774,ldcA,2486394,2486394,2486160,234,0,utRho13
775,ldhA,2885830,2885830,2885686,144,0,utRho13
776,ldrA,2538954,2538954,2538550,404,276,utRho13
777,ldrB,2540024,2540024,2539620,404,32,utRho13
778,ldrC,2541092,2541092,2540690,402,64,utRho13
779,ldrD,7400544,7400544,7400174,370,372,utRho13
780,lepA,5414392,5414392,5414248,144,232,utRho13
781,lepB,5410928,5410928,5410618,310,956,utRho13
782,leuD,159188,159188,158906,282,64,utRho13
783,leuE,3761600,3761600,3761518,82,0,utRho13
784,leuL,168048,168048,167416,632,0,utRho13
785,leuO,168308,168736,168308,428,0,utRho13
786,leuQ,9212864,9212864,9212802,62,16,utRho13
787,leuU,6644556,6644556,6644316,240,3434,utRho13
788,leuV,9212546,9212546,9212330,216,1464,utRho13
789,leuX,8992772,8992810,8992772,38,18,utRho13
790,lexA,8514174,8514230,8514174,56,54,utRho13
791,lhr,3456706,3458174,3456706,1468,1704,utRho13
792,ligA,5060402,5060402,5060352,50,0,utRho13
793,ligB,7642576,7642576,7642340,236,0,utRho13
794,lipA,1320602,1320602,1320432,170,134,utRho13
795,lipB,1324802,1324802,1324556,246,2162,utRho13
796,lit,2397032,2397390,2397032,358,20,utRho13
797,livJ,7199524,7199524,7199316,208,4,utRho13
798,livK,7195510,7195510,7195120,390,0,utRho13
799,lldP,7554578,7554798,7554578,220,6182,utRho13
800,lnt,1381968,1381968,1381762,206,924,utRho13
801,loiP,6163784,6163826,6163784,42,68,utRho13
802,lolA,1874656,1874738,1874656,82,446,utRho13
803,lolB,2527112,2527112,2527000,112,64,utRho13
804,lolC,2350748,2350854,2350748,106,60,utRho13
805,lon,917630,917776,917630,146,574,utRho13
806,lpcA,486936,487086,486936,150,50,utRho13
807,lpd,255434,255824,255434,390,6722,utRho13
808,lplA,9248476,9248476,9248234,242,2206,utRho13
809,lplT,5947878,5947878,5947724,154,86,utRho13
810,lpoA,6586422,6586800,6586422,378,292,utRho13
811,lpp,3514592,3514842,3514592,250,230,utRho13
812,lptA,6686598,6686760,6686598,162,1190,utRho13
813,lptB,6686792,6687888,6686792,1096,2148,utRho13
814,lptD,114672,114672,114218,454,782,utRho13
815,lptF,8972244,8972436,8972244,192,0,utRho13
816,lpxC,213016,213114,213016,98,7768,utRho13
817,lpxD,401920,401942,401920,22,54,utRho13
818,lpxL,2233418,2233418,2233164,254,138,utRho13
819,lpxM,3880456,3880456,3880386,70,68,utRho13
820,lpxP,4991156,4991290,4991156,134,40,utRho13
821,lrhA,4813312,4813312,4813282,30,40,utRho13
822,lrp,1864656,1865190,1864656,534,1268,utRho13
823,lspA,50028,50414,50028,386,830,utRho13
824,lsrA,3202920,3202980,3202920,60,0,utRho13
825,lsrR,3202514,3202514,3202482,32,0,utRho13
826,ltaE,1818640,1818640,1818588,52,0,utRho13
827,luxS,5630130,5630130,5629466,664,1034,utRho13
828,lysA,5957902,5957902,5957798,104,0,utRho13
829,lysC,8467232,8467232,8466466,766,1070,utRho13
830,lysP,4497120,4497120,4497064,56,0,utRho13
831,lysR,5957900,5958042,5957900,142,0,utRho13
832,lysT,1561028,1561108,1561028,80,108,utRho13
833,lysU,8709610,8709610,8709434,176,62,utRho13
834,macB,1840188,1840694,1840188,506,468,utRho13
835,maeA,3111484,3111484,3111338,146,11084,utRho13
836,mak,820236,820288,820236,52,2,utRho13
837,malE,8492928,8492928,8492838,90,46,utRho13
838,malI,3398456,3398456,3398360,96,44,utRho13
839,malK,8493472,8493568,8493472,96,0,utRho13
840,malP,7105020,7105020,7104946,74,272,utRho13
841,malQ,7100798,7100798,7100140,658,1762,utRho13
842,malS,14949880,14949988,14949880,108,160,utRho13
843,malT,7106048,7106170,7106048,122,466,utRho13
844,malX,3398626,3398710,3398626,84,44,utRho13
845,malZ,1689980,1690072,1689980,92,156,utRho13
846,manA,3377102,3377152,3377102,50,0,utRho13
847,manX,3803866,3804096,3803866,230,0,utRho13
848,marC,3237882,3237882,3237816,66,0,utRho13
849,marR,3238186,3238240,3238186,54,0,utRho13
850,matP,2036918,2036970,2036918,52,0,utRho13
851,mazE,5822736,5822736,5822678,58,0,utRho13
852,mazG,5821720,5821720,5821370,350,1668,utRho13
853,mcbA,1684306,1684306,1684112,194,36,utRho13
854,mcbR,3040192,3040524,3040192,332,0,utRho13
855,mcrA,2420278,2420692,2420278,414,0,utRho13
856,mcrC,9156124,9156124,9155916,208,284,utRho13
857,mdaB,6344814,6345060,6344814,246,0,utRho13
858,mdfA,1767138,1767346,1767138,208,0,utRho13
859,mdh,6768940,6768940,6768536,404,512,utRho13
860,mdoB,9198988,9198988,9198882,106,1706,utRho13
861,mdoD,2993290,2993712,2993290,422,12,utRho13
862,mdoG,2218514,2218670,2218514,156,0,utRho13
863,mdtA,4307958,4308032,4307958,74,0,utRho13
864,mdtE,7318168,7318464,7318168,296,252,utRho13
865,mdtK,3486538,3486914,3486538,376,190,utRho13
866,mdtP,8602472,8602472,8602060,412,64,utRho13
867,melA,8683774,8683822,8683774,48,0,utRho13
868,melR,8683300,8683300,8683256,44,88,utRho13
869,menA,8240812,8240812,8240698,114,36,utRho13
870,menB,4753774,4753774,4753638,136,558,utRho13
871,mepH,3468714,3468870,3468714,156,0,utRho13
872,mepM,3883666,3883666,3883270,396,396,utRho13
873,mepS,4539840,4539958,4539840,118,298,utRho13
874,metA,8428318,8428560,8428318,242,2,utRho13
875,metB,8257272,8257344,8257272,72,1760,utRho13
876,metC,6304150,6304472,6304150,322,0,utRho13
877,metE,8025768,8026106,8025768,338,340,utRho13
878,metF,8265092,8265232,8265092,140,0,utRho13
879,metG,4388538,4388600,4388538,62,132,utRho13
880,metH,8447010,8447656,8447010,646,2402,utRho13
881,metJ,8257116,8257116,8256790,326,98,utRho13
882,metK,6173154,6173412,6173154,258,132,utRho13
883,metN,445428,445428,445290,138,72,utRho13
884,metR,8025710,8025710,8025632,78,36,utRho13
885,metT,1394326,1394326,1394266,60,118,utRho13
886,metY,19910250,19910250,19909734,516,132,utRho13
887,metZ,11789528,11789548,11789528,20,20,utRho13
888,mfd,2348056,2348056,2347928,128,262,utRho13
889,mglA,4478782,4478782,4478578,204,2458,utRho13
890,mglB,4481132,4481132,4480696,436,39874,utRho13
891,mglC,4475918,4475918,4475506,412,1240,utRho13
892,mgrB,3817584,3817584,3817532,52,0,utRho13
893,mgrR,3245828,3245828,3245828,0,0,utRho13
894,mgsA,2054082,2054082,2054030,52,152,utRho13
895,mgtL,8934560,8934862,8934560,302,0,utRho13
896,mhpA,737038,737222,737038,184,0,utRho13
897,mhpR,737072,737072,736840,232,0,utRho13
898,mhpT,750772,750918,750772,146,0,utRho13
899,miaA,8797964,8798504,8797964,540,554,utRho13
900,micA,5629604,5629604,5629604,0,0,utRho13
901,micC,2874242,2874238,2874242,4,0,utRho13
902,micF,4626168,4626168,4626168,0,0,utRho13
903,micM,1014408,1014408,1014408,0,0,utRho13
904,minE,2449422,2449422,2449090,332,3134,utRho13
905,mioC,7852950,7852950,7852910,40,0,utRho13
906,mipA,3733012,3733012,3732944,68,3182,utRho13
907,mlaA,4930270,4930270,4930014,256,0,utRho13
908,mlc,3337206,3337206,3337128,78,4,utRho13
909,mlrA,4429498,4429732,4429498,234,0,utRho13
910,mltA,5894546,5894546,5894356,190,48,utRho13
911,mltD,468050,468050,467910,140,0,utRho13
912,mltF,5391534,5391602,5391534,68,0,utRho13
913,mmuP,550238,550650,550238,412,168,utRho13
914,mngA,1531622,1531968,1531622,346,0,utRho13
915,mngR,1531852,1531852,1531750,102,0,utRho13
916,mnmG,7851348,7851348,7851266,82,808,utRho13
917,mntH,5025470,5025470,5025412,58,2,utRho13
918,mntP,3810918,3811376,3810918,458,212,utRho13
919,mntR,1706160,1706366,1706160,206,0,utRho13
920,mntS,1706128,1706128,1705994,134,0,utRho13
921,moaA,1633654,1634088,1633654,434,548,utRho13
922,moaB,1635954,1636110,1635954,156,2346,utRho13
923,mobA,8084242,8084242,8083998,244,198,utRho13
924,mocA,6030112,6030320,6030112,208,242,utRho13
925,modA,1589990,1590178,1589990,188,18,utRho13
926,moeA,1732788,1732788,1732728,60,374,utRho13
927,mokB,2984610,2984610,2984258,352,632,utRho13
928,molR_1,4392888,4392948,4392888,60,0,utRho13
929,motA,3954604,3954604,3954278,326,40,utRho13
930,mpaA,2781278,2781278,2781196,82,60,utRho13
931,mpl,8911456,8911570,8911456,114,0,utRho13
932,mppA,2786108,2786454,2786108,346,0,utRho13
933,mprA,5621494,5621540,5621494,46,672,utRho13
934,mqo,4613848,4613848,4613508,340,0,utRho13
935,mqsA,6336742,6336742,6336492,250,404,utRho13
936,mqsR,6337306,6337306,6337088,218,272,utRho13
937,mraZ,179192,179268,179192,76,146,utRho13
938,mrcA,7045652,7045742,7045652,90,0,utRho13
939,mrcB,329442,329460,329442,18,0,utRho13
940,mreB,13605424,13605424,13604348,1076,1792,utRho13
941,mreD,6798166,6798166,6797750,416,248,utRho13
942,mrp,4388360,4388360,4388336,24,0,utRho13
943,mscK,972984,973072,972984,88,0,utRho13
944,mscL,6876002,6876048,6876002,46,20,utRho13
945,mscS,6139742,6139742,6139614,128,0,utRho13
946,msrA,8884522,8884522,8884352,170,114,utRho13
947,msrB,3725168,3725168,3724858,310,0,utRho13
948,msyB,2228426,2228426,2228362,64,86,utRho13
949,mtfA,4087236,4087302,4087236,66,4682,utRho13
950,mtgA,6699662,6699662,6699618,44,204,utRho13
951,mtlA,30177504,30178248,30177504,744,1592,utRho13
952,mtn,358366,358366,358306,60,0,utRho13
953,mtr,6611864,6611864,6611634,230,88,utRho13
954,mug,6430992,6430992,6430946,46,2,utRho13
955,murQ,5091466,5091546,5091466,80,0,utRho13
956,murR,5091586,5091586,5091218,368,28,utRho13
957,mutH,5939164,5939324,5939164,160,164,utRho13
958,mutL,8794092,8794824,8794092,732,824,utRho13
959,mutM,7622554,7622554,7622304,250,1086,utRho13
960,mutS,5714038,5714186,5714038,148,1980,utRho13
961,mutY,18617466,18618078,18617466,612,78,utRho13
962,nac,4123956,4123956,4123866,90,0,utRho13
963,nadA,1564122,1564170,1564122,48,0,utRho13
964,nadB,5420714,5420840,5420714,126,0,utRho13
965,nadC,237326,237326,237290,36,30,utRho13
966,nadE,3644604,3644916,3644604,312,0,utRho13
967,nadK,5501526,5501662,5501526,136,102,utRho13
968,nagA,1406350,1406350,1405502,848,19798,utRho13
969,nagB,1407416,1407416,1407222,194,100,utRho13
970,nagC,1404016,1404016,1403188,828,578,utRho13
971,nagE,1407680,1407888,1407680,208,112,utRho13
972,nagK,2357080,2357186,2357080,106,0,utRho13
973,nanA,6747240,6747240,6747152,88,78,utRho13
974,nanC,9079856,9079856,9079002,854,4032,utRho13
975,nanR,6749406,6749406,6748978,428,54,utRho13
976,nanS,9075406,9075406,9075188,218,696,utRho13
977,napF,4607390,4607390,4606994,396,0,utRho13
978,narG,2559614,2559728,2559614,114,0,utRho13
979,narK,2555642,2555914,2555642,272,0,utRho13
980,narP,4580844,4581000,4580844,156,176,utRho13
981,narQ,5171154,5171462,5171154,308,0,utRho13
982,narU,3088326,3088326,3088120,206,0,utRho13
983,narW,3077374,3077374,3074618,2756,224,utRho13
984,narX,2555554,2555554,2555236,318,0,utRho13
985,narZ,3085380,3085380,3085180,200,0,utRho13
986,ndh,2331984,2332170,2331984,186,0,utRho13
987,ndk,5289920,5289920,5289728,192,204,utRho13
988,nemR,6904084,6904092,6904084,8,0,utRho13
989,nepI,7683542,7683542,7683478,64,0,utRho13
990,nfo,4501612,4501680,4501612,68,2,utRho13
991,nfsB,1210906,1210906,1210848,58,28,utRho13
992,nfuA,7090916,7091248,7090916,332,888,utRho13
993,nhaA,34634,34978,34634,344,56,utRho13
994,nhaB,2469534,2469534,2469434,100,0,utRho13
995,nhoA,3067926,3068048,3067926,122,0,utRho13
996,nikA,7226878,7227334,7226878,456,722,utRho13
997,nikR,7237074,7237176,7237074,102,350,utRho13
998,nirB,6987974,6988022,6987974,48,0,utRho13
999,nlpA,7680034,7680034,7679986,48,0,utRho13
1000,nlpC,3585654,3585654,3585462,192,0,utRho13
1001,nlpD,5737658,5737658,5737506,152,106,utRho13
1002,nlpI,6618080,6618080,6617848,232,0,utRho13
1003,nmpC,1153740,1153740,1153650,90,104,utRho13
1004,nohA,3273206,3273206,3272734,472,0,utRho13
1005,norR,5664614,5664614,5664578,36,0,utRho13
1006,norV,5664878,5664952,5664878,74,0,utRho13
1007,nrdA,4689510,4689730,4689510,220,15180,utRho13
1008,nrdD,8925676,8925676,8925320,356,3682,utRho13
1009,nrdH,5601312,5601446,5601312,134,776,utRho13
1010,nrdR,865954,866004,865954,50,0,utRho13
1011,nrfA,8575342,8575528,8575342,186,0,utRho13
1012,nsrR,8812088,8812380,8812088,292,296,utRho13
1013,nudB,3897348,3897348,3897264,84,0,utRho13
1014,nudC,8393428,8393806,8393428,378,180,utRho13
1015,nudE,7052658,7052658,7052298,360,784,utRho13
1016,nudG,3682876,3682980,3682876,104,0,utRho13
1017,nudI,4729050,4729108,4729050,58,0,utRho13
1018,nudJ,2388874,2388874,2388576,298,750,utRho13
1019,nuoA,4810670,4810670,4810144,526,9142,utRho13
1020,nuoN,4783434,4783434,4783010,424,2682,utRho13
1021,nupC,5026018,5026084,5026018,66,46,utRho13
1022,nupG,6211302,6211428,6211302,126,62,utRho13
1023,ogrK,4335096,4335096,4335040,56,0,utRho13
1024,ogt,2800568,2800568,2800472,96,40,utRho13
1025,ohsC,5401036,5401040,5401036,4,0,utRho13
1026,ompA,2040382,2040382,2040106,276,45330,utRho13
1027,ompC,4625774,4625774,4625498,276,480,utRho13
1028,ompF,1974184,1974184,1973964,220,588,utRho13
1029,ompL,8128958,8128958,8128590,368,0,utRho13
1030,ompN,2874158,2874158,2873786,372,0,utRho13
1031,ompR,7073510,7073510,7073168,342,180,utRho13
1032,ompT,1171330,1171330,1171266,64,110,utRho13
1033,ompW,2627982,2628040,2627982,58,0,utRho13
1034,ompX,1700418,1700900,1700418,482,610,utRho13
1035,omrA,5952378,5952378,5952378,0,0,utRho13
1036,omrB,5952770,5952770,5952770,0,0,utRho13
1037,oppA,2602170,2602364,2602170,194,6876,utRho13
1038,orn,8783168,8783208,8783168,40,0,utRho13
1039,osmB,2686952,2686952,2686656,296,2,utRho13
1040,osmC,3113192,3113250,3113192,58,174,utRho13
1041,osmE,3644566,3644566,3644512,54,0,utRho13
1042,osmF,4439046,4439046,4438962,84,746,utRho13
1043,osmY,9222306,9222792,9222306,486,6,utRho13
1044,otsA,3963302,3963302,3963224,78,0,utRho13
1045,otsB,3964930,3964930,3964774,156,0,utRho13
1046,oxc,4984288,4984288,4983900,388,0,utRho13
1047,oxyR,8316914,8316980,8316914,66,48,utRho13
1048,oxyS,8316788,8316788,8316788,0,0,utRho13
1049,paaA,2907730,2907854,2907730,124,0,utRho13
1050,paaX,2927018,2927078,2927018,60,0,utRho13
1051,paaZ,2907340,2907340,2907284,56,0,utRho13
1052,pabA,6981702,6981702,6981658,44,0,utRho13
1053,pabB,3789256,3789610,3789256,354,240,utRho13
1054,pabC,2306186,2306600,2306186,414,436,utRho13
1055,pagP,1313052,1313114,1313052,62,0,utRho13
1056,panB,299260,299260,299202,58,44,utRho13
1057,panC,297840,297840,297590,250,544,utRho13
1058,panD,293490,293490,293388,102,0,utRho13
1059,panZ,7195656,7195968,7195656,312,140,utRho13
1060,parC,6332060,6332060,6331946,114,698,utRho13
1061,patA,6438916,6438988,6438916,72,10,utRho13
1062,patD,3030830,3031156,3030830,326,0,utRho13
1063,pbpC,5294986,5294986,5294650,336,0,utRho13
1064,pbpG,4450132,4450132,4449740,392,304,utRho13
1065,pck,7065358,7065636,7065358,278,7422,utRho13
1066,pcnB,318782,318782,318252,530,790,utRho13
1067,pdhR,244068,244184,244068,116,0,utRho13
1068,pdxB,4875768,4875768,4875702,66,0,utRho13
1069,pdxH,3436068,3436068,3436014,54,156,utRho13
1070,pdxJ,5403626,5403626,5403458,168,0,utRho13
1071,pdxK,5074638,5074638,5074474,164,62,utRho13
1072,pepA,8972278,8972278,8971902,376,400,utRho13
1073,pepD,511618,511618,511432,186,11270,utRho13
1074,pepN,1981182,1981244,1981182,62,38,utRho13
1075,pepQ,8062294,8062322,8062294,28,38,utRho13
1076,pepT,2371646,2371688,2371646,42,0,utRho13
1077,pfkA,8214948,8215104,8214948,156,244,utRho13
1078,pfkB,3612646,3612740,3612646,94,0,utRho13
1079,pflA,1902456,1902456,1902160,296,0,utRho13
1080,pflB,1907850,1907850,1907108,742,1184,utRho13
1081,pflD,8287716,8287990,8287716,274,0,utRho13
1082,pgaA,2185046,2185046,2184578,468,0,utRho13
1083,pgi,8467444,8467516,8467444,72,0,utRho13
1084,pgk,12291428,12291428,12290488,940,6668,utRho13
1085,pgl,1597078,1597172,1597078,94,92,utRho13
1086,pgpB,2678324,2678660,2678324,336,72,utRho13
1087,pgpC,5397276,5397276,5397100,176,0,utRho13
1088,pgrR,2783744,2783982,2783744,238,0,utRho13
1089,pheL,5475158,5475198,5475158,40,0,utRho13
1090,pheM,7197204,7197204,7197080,124,68,utRho13
1091,pheP,1203858,1203918,1203858,60,0,utRho13
1092,pheU,8725254,8725254,8725252,2,80,utRho13
1093,pheV,6220730,6220732,6220730,2,0,utRho13
1094,phnC,8650412,8650412,8650330,82,32,utRho13
1095,phoA,803414,803494,803414,80,26,utRho13
1096,phoB,834202,834284,834202,82,0,utRho13
1097,phoE,520316,520316,520200,116,0,utRho13
1098,phoH,2169730,2169984,2169730,254,166,utRho13
1099,phoP,2381016,2381016,2380894,122,1600,utRho13
1100,phoQ,2379880,2379880,2379552,328,1188,utRho13
1101,phoU,7815330,7815330,7815156,174,166,utRho13
1102,phr,1478842,1479014,1478842,172,0,utRho13
1103,pinE,2419054,2419370,2419054,316,0,utRho13
1104,pinQ,3267168,3267244,3267168,76,0,utRho13
1105,pinR,2867424,2867424,2867348,76,0,utRho13
1106,pitA,7275224,7275284,7275224,60,64,utRho13
1107,pitB,6272806,6272806,6272742,64,0,utRho13
1108,pka,5439862,5439906,5439862,44,0,utRho13
1109,plaP,4174476,4174476,4174124,352,218,utRho13
1110,pldA,8009628,8009724,8009628,96,10,utRho13
1111,pldB,8018028,8018340,8018028,312,176,utRho13
1112,plsB,8513196,8513196,8512932,264,660,utRho13
1113,pmbA,8915890,8915918,8915890,28,0,utRho13
1114,pmrD,4747148,4747148,4747076,72,0,utRho13
1115,pncB,1980828,1980828,1980712,116,2,utRho13
1116,pncC,5648788,5648788,5648692,96,0,utRho13
1117,pnp,6622652,6622652,6622336,316,178,utRho13
1118,pntA,3355950,3355950,3355806,144,58,utRho13
1119,pntB,3353096,3353096,3352720,376,0,utRho13
1120,polA,8093880,8093932,8093880,52,52,utRho13
1121,polB,131606,131606,131560,46,0,utRho13
1122,potD,2365700,2365700,2365658,42,0,utRho13
1123,potE,1436688,1436688,1436530,158,0,utRho13
1124,potF,1787268,1787568,1787268,300,0,utRho13
1125,poxB,1822152,1822152,1822098,54,0,utRho13
1126,ppa,8899372,8899372,8899304,68,124,utRho13
1127,ppc,8306380,8306380,8306196,184,1204,utRho13
1128,ppdA,5928440,5928440,5928354,86,2,utRho13
1129,ppdD,235410,235410,235098,312,44,utRho13
1130,pphA,3846770,3846770,3845938,832,3030,utRho13
1131,pphB,5719474,5719520,5719474,46,38,utRho13
1132,ppiA,6984898,6984898,6984594,304,74,utRho13
1133,ppiC,7919682,7919682,7919626,56,0,utRho13
1134,ppiD,923638,923830,923638,192,568,utRho13
1135,ppk,5245748,5246088,5245748,340,418,utRho13
1136,pppA,6228958,6228958,6228704,254,62,utRho13
1137,ppsA,3574322,3574322,3574224,98,8,utRho13
1138,ppsR,3574678,3574890,3574678,212,0,utRho13
1139,pptA,3065716,3066104,3065716,388,0,utRho13
1140,pqiA,2023318,2024002,2023318,684,72,utRho13
1141,prc,3830054,3830054,3829632,422,25512,utRho13
1142,preT,4467978,4468066,4467978,88,0,utRho13
1143,prfC,9218688,9218828,9218688,140,786,utRho13
1144,prkB,6968622,6968980,6968622,358,948,utRho13
1145,prlC,7290476,7290476,7290364,112,396,utRho13
1146,prlF,6553944,6554004,6553944,60,168,utRho13
1147,proB,520432,520776,520432,344,28,utRho13
1148,proC,811372,811372,811288,84,0,utRho13
1149,proK,7417388,7417388,7417384,4,0,utRho13
1150,proL,4572414,4572422,4572414,8,0,utRho13
1151,proP,8660640,8661004,8660640,364,588,utRho13
1152,proS,437674,437674,437550,124,1688,utRho13
1153,proV,5609126,5609630,5609126,504,68,utRho13
1154,prpB,697292,697364,697292,72,0,utRho13
1155,prpR,696942,696942,696886,56,0,utRho13
1156,prs,2524354,2524354,2523750,604,101002,utRho13
1157,psd,8781276,8781276,8780720,556,2214,utRho13
1158,psiE,8480600,8480650,8480600,50,0,utRho13
1159,pspA,2736076,2736158,2736076,82,0,utRho13
1160,pspF,2736080,2736080,2735824,256,0,utRho13
1161,pspG,8525632,8525680,8525632,48,0,utRho13
1162,pssA,5445156,5445454,5445156,298,6504,utRho13
1163,pstB,7817112,7817112,7816732,380,2,utRho13
1164,pstC,7821084,7821084,7820796,288,92,utRho13
1165,pstS,23469408,23469408,23469150,258,246,utRho13
1166,psuG,4517114,4517114,4516734,380,2590,utRho13
1167,psuT,4514992,4514992,4514670,322,0,utRho13
1168,pth,2517084,2517084,2517026,58,48,utRho13
1169,ptrA,5918022,5918022,5917768,254,12,utRho13
1170,ptrB,3857730,3857730,3857678,52,414,utRho13
1171,ptsG,2315252,2315738,2315252,486,2254,utRho13
1172,ptsH,5066996,5067528,5066996,532,6684,utRho13
1173,purA,8809328,8809374,8809328,46,8,utRho13
1174,purC,5195562,5195562,5195236,326,190,utRho13
1175,purD,8411972,8411972,8411862,110,160,utRho13
1176,purE,1106284,1106284,1106200,84,272,utRho13
1177,purH,8415254,8415254,8415064,190,70,utRho13
1178,purL,5391178,5391178,5391086,92,666,utRho13
1179,purM,5242306,5242394,5242306,88,222,utRho13
1180,purR,3475378,3475688,3475378,310,672,utRho13
1181,purT,3861438,3861762,3861438,324,0,utRho13
1182,purU,2577512,2577512,2577248,264,432,utRho13
1183,putA,2157850,2157850,2157764,86,0,utRho13
1184,putP,2158336,2158610,2158336,274,2250,utRho13
1185,puuA,2721936,2721936,2721816,120,0,utRho13
1186,puuC,2725456,2725486,2725456,30,0,utRho13
1187,puuD,2722104,2722240,2722104,136,0,utRho13
1188,puuP,2718746,2718746,2718374,372,126,utRho13
1189,pykA,3874988,3875298,3874988,310,628,utRho13
1190,pykF,3510934,3511396,3510934,462,746,utRho13
1191,pyrC,2245286,2245286,2245214,72,276,utRho13
1192,pyrD,2009464,2009536,2009464,72,0,utRho13
1193,pyrE,7631970,7631970,7631536,434,0,utRho13
1194,pyrF,2683740,2683842,2683740,102,158,utRho13
1195,pyrG,5819594,5819594,5819332,262,158,utRho13
1196,pyrH,383624,383710,383624,86,1312,utRho13
1197,pyrL,8945490,8945490,8945066,424,50,utRho13
1198,qmcA,1031646,1031646,1031546,100,0,utRho13
1199,qor,8528608,8528608,8528462,146,0,utRho13
1200,qseB,6339502,6339656,6339502,154,4,utRho13
1201,queA,849970,850022,849970,52,200,utRho13
1202,queE,5811212,5811212,5810836,376,0,utRho13
1203,queF,5850642,5850696,5850642,54,0,utRho13
1204,queG,8788184,8788184,8788134,50,1394,utRho13
1205,racC,2835630,2835630,2835526,104,0,utRho13
1206,racR,2840898,2840898,2840482,416,0,utRho13
1207,raiA,5474208,5474308,5474208,100,104,utRho13
1208,rarD,8008594,8008594,8008356,238,78,utRho13
1209,ravA,7862256,7862256,7862186,70,0,utRho13
1210,rayT,495088,495274,495088,186,0,utRho13
1211,rbn,4763162,4763216,4763162,54,0,utRho13
1212,rbsD,7866644,7866702,7866644,58,68,utRho13
1213,rcnA,4371654,4371834,4371654,180,0,utRho13
1214,rcnB,4373768,4373920,4373768,152,26,utRho13
1215,rcnR,4371806,4371806,4371592,214,0,utRho13
1216,rcsA,4047672,4047936,4047672,264,4,utRho13
1217,rcsB,4631390,4632354,4631390,964,930,utRho13
1218,rcsC,4640162,4640162,4639656,506,642,utRho13
1219,rcsD,4626904,4626976,4626904,72,78,utRho13
1220,rdgB,6193240,6193362,6193240,122,624,utRho13
1221,rdlA,2538646,2538646,2538646,0,0,utRho13
1222,rdlB,2539712,2539716,2539712,4,0,utRho13
1223,rdlC,2540782,2540786,2540782,4,0,utRho13
1224,rdlD,7400272,7400272,7400272,0,0,utRho13
1225,rdoA,8084782,8084830,8084782,48,28,utRho13
1226,recA,11295276,11295276,11295076,200,840,utRho13
1227,recC,5925014,5925014,5924856,158,96,utRho13
1228,recF,7763722,7763722,7762442,1280,6958,utRho13
1229,recN,5503518,5503590,5503518,72,32,utRho13
1230,recQ,8011666,8011728,8011666,62,0,utRho13
1231,relA,5828554,5828554,5827302,1252,776,utRho13
1232,relB,3291806,3291806,3291744,62,0,utRho13
1233,rem,3289950,3289950,3289804,146,0,utRho13
1234,rep,7921294,7921354,7921294,60,52,utRho13
1235,rfaD,7587730,7587974,7587730,244,0,utRho13
1236,rfaE,6393852,6393852,6393506,346,160,utRho13
1237,rfaH,8049930,8049930,8049642,288,610,utRho13
1238,rfbX,4219436,4219436,4219168,268,1430,utRho13
1239,rfe,7935600,7935832,7935600,232,0,utRho13
1240,rhaB,8194944,8194944,8194896,48,0,utRho13
1241,rhaD,8188770,8188770,8188544,226,0,utRho13
1242,rhaS,8195422,8195472,8195422,50,0,utRho13
1243,rhaT,8201132,8201132,8201050,82,38,utRho13
1244,rhlE,1661566,1661744,1661566,178,68,utRho13
1245,rhoL,47593944,47594772,47593944,828,30924,utRho13
1246,rhsB,7238006,7238384,7238006,378,0,utRho13
1247,rhsC,1458758,1459166,1458758,408,0,utRho13
1248,rhsD,1046132,1046522,1046132,390,0,utRho13
1249,rhtA,1700608,1700608,1700194,414,0,utRho13
1250,rhtC,8015478,8015514,8015478,36,576,utRho13
1251,ribA,2678468,2678468,2678320,148,72,utRho13
1252,ribC,3486916,3486916,3486484,432,190,utRho13
1253,ribE,869008,869294,869008,286,11960,utRho13
1254,ribF,42766,42814,42766,48,0,utRho13
1255,ridA,8941892,8941892,8941826,66,34,utRho13
1256,rihA,1369204,1369204,1368824,380,184,utRho13
1257,rihB,4510504,4510504,4510372,132,0,utRho13
1258,rimJ,2251044,2251124,2251044,80,0,utRho13
1259,rimK,1783752,1783934,1783752,182,838,utRho13
1260,rimL,2997486,2997876,2997486,390,148,utRho13
1261,rimO,1756140,1756140,1756070,70,0,utRho13
1262,rimP,6636350,6636350,6636012,338,340,utRho13
1263,rlmA,3814172,3814172,3814120,52,684,utRho13
1264,rlmD,5830086,5830086,5830000,86,0,utRho13
1265,rlmE,6655520,6655520,6655328,192,516,utRho13
1266,rlmF,1684384,1684664,1684384,280,36,utRho13
1267,rlmG,6471784,6471784,6471750,34,0,utRho13
1268,rlmI,2060002,2060002,2059938,64,0,utRho13
1269,rlmJ,7290700,7290770,7290700,70,10,utRho13
1270,rlmL,2015344,2015688,2015344,344,1226,utRho13
1271,rlpA,1330444,1330444,1330380,64,40,utRho13
1272,rluA,120900,120900,120692,208,0,utRho13
1273,rluF,8460324,8460708,8460324,384,0,utRho13
1274,rmf,2031006,2031430,2031006,424,0,utRho13
1275,rna,1290068,1290068,1290006,62,26,utRho13
1276,rnb,2698258,2698258,2697824,434,2764,utRho13
1277,rnc,10816892,10816892,10816252,640,5144,utRho13
1278,rnd,3776122,3776122,3775982,140,46,utRho13
1279,rne,2289746,2289746,2288734,1012,8966,utRho13
1280,rnhA,472082,472082,472004,78,522,utRho13
1281,rnk,1288360,1288360,1287934,426,182,utRho13
1282,rnlA,5531788,5531836,5531788,48,0,utRho13
1283,rnlB,5533414,5533968,5533414,554,698,utRho13
1284,rnpB,19623552,19623552,19623552,0,0,utRho13
1285,rob,9270706,9270706,9270620,86,96,utRho13
1286,rodZ,5285868,5285868,5285688,180,12,utRho13
1287,rpe,7030306,7030306,7030118,188,146,utRho13
1288,rph,15266320,15266320,15266196,124,80,utRho13
1289,rpiA,6118706,6118706,6118650,56,0,utRho13
1290,rpiB,8626514,8626700,8626514,186,0,utRho13
1291,rpiR,8626274,8626274,8625982,292,0,utRho13
1292,rplJ,8359246,8359992,8359246,746,8140,utRho13
1293,rplK,8356708,8356894,8356708,186,712,utRho13
1294,rplM,6757344,6757344,6757302,42,11992,utRho13
1295,rplN,6896444,6896444,6896298,146,7496,utRho13
1296,rplS,5489284,5489284,5489060,224,10902,utRho13
1297,rplT,7199052,7199052,7198996,56,1228,utRho13
1298,rplU,6667036,6667036,6666902,134,180,utRho13
1299,rplY,4564866,4565034,4564866,168,158,utRho13
1300,rpmA,6666450,6666450,6666238,212,532,utRho13
1301,rpmB,15247980,15247980,15246696,1284,98072,utRho13
1302,rpmE,8253816,8254026,8253816,210,438,utRho13
1303,rpmF,2294676,2294734,2294676,58,50054,utRho13
1304,rpmH,7768130,7768672,7768130,542,5348,utRho13
1305,rpmI,3600854,3600854,3599998,856,15384,utRho13
1306,rpoB,8362126,8362490,8362126,364,346,utRho13
1307,rpoD,6424946,6426094,6424946,1148,24026,utRho13
1308,rpoE,5420372,5420372,5420024,348,0,utRho13
1309,rpoH,7202006,7202006,7201566,440,2026,utRho13
1310,rpoN,6689324,6689434,6689324,110,108,utRho13
1311,rpoS,5736236,5736236,5735102,1134,6042,utRho13
1312,rpoZ,7644154,7644212,7644154,58,548,utRho13
1313,rppH,5937986,5937986,5937954,32,0,utRho13
1314,rprA,3540744,3540744,3540744,0,0,utRho13
1315,rpsA,1923434,1923990,1923434,556,140090,utRho13
1316,rpsF,8850050,8850236,8850050,186,38642,utRho13
1317,rpsI,6756580,6756580,6756414,166,10904,utRho13
1318,rpsJ,6906884,6906884,6906540,344,9394,utRho13
1319,rpsL,6949242,6949242,6949104,138,404,utRho13
1320,rpsM,6885130,6885130,6884942,188,1616,utRho13
1321,rpsO,13247144,13247144,13246736,408,1060,utRho13
1322,rpsP,5492508,5492508,5492370,138,374,utRho13
1323,rpsT,42420,42420,42156,264,640,utRho13
1324,rpsU,12842584,12843124,12842584,540,2112,utRho13
1325,rraA,8238716,8238716,8238660,56,228,utRho13
1326,rraB,8956768,8956946,8956768,178,0,utRho13
1327,rrsA,8070478,8071062,8070478,584,9714,utRho13
1328,rrsB,16665468,16666636,16665468,1168,22668,utRho13
1329,rrsC,7883032,7883616,7883032,584,8092,utRho13
1330,rrsD,6858094,6858094,6857524,570,400,utRho13
1331,rrsE,8415726,8416294,8415726,568,1634,utRho13
1332,rrsG,5462896,5462896,5462314,582,8840,utRho13
1333,rrsH,446970,447542,446970,572,1030,utRho13
1334,rsd,8393908,8393908,8393616,292,264,utRho13
1335,rseA,5419264,5419264,5418808,456,720,utRho13
1336,rseP,392940,393092,392940,152,0,utRho13
1337,rseX,4067298,4067298,4067298,0,0,utRho13
1338,rsfS,1338144,1338144,1338072,72,434,utRho13
1339,rsgA,8783132,8783132,8783018,114,112,utRho13
1340,rsmA,105176,105176,104860,316,3468,utRho13
1341,rsmB,6869982,6870414,6869982,432,826,utRho13
1342,rsmC,9215736,9215736,9215400,336,448,utRho13
1343,rsmD,7208594,7208786,7208594,192,0,utRho13
1344,rsmE,6182036,6182268,6182036,232,802,utRho13
1345,rsmG,7847512,7847512,7847360,152,364,utRho13
1346,rsmH,180020,180188,180020,168,332,utRho13
1347,rsmI,6587106,6587106,6586670,436,2184,utRho13
1348,rssA,2578212,2578412,2578212,200,216,utRho13
1349,rssB,2580440,2580484,2580440,44,314,utRho13
1350,rstA,3364276,3364300,3364276,24,0,utRho13
1351,rsuA,4561096,4561096,4560966,130,282,utRho13
1352,rsxA,3411510,3411534,3411510,24,0,utRho13
1353,rtcA,7114004,7114004,7113698,306,0,utRho13
1354,rtcB,7116214,7116214,7116158,56,0,utRho13
1355,rtn,4541356,4541452,4541356,96,0,utRho13
1356,rutA,2148052,2148052,2148022,30,0,utRho13
1357,rutG,2140090,2140090,2139678,412,0,utRho13
1358,rutR,2148226,2148484,2148226,258,0,utRho13
1359,ruvA,7784096,7784096,7783904,192,0,utRho13
1360,ruvB,7782176,7782176,7781424,752,876,utRho13
1361,ruvC,3894878,3894878,3894752,126,144,utRho13
1362,rybB,1776114,1776114,1776114,0,0,utRho13
1363,rydB,3529860,3529860,3529322,538,268,utRho13
1364,rydC,2983012,2983012,2983012,0,0,utRho13
1365,ryfA,5307398,5307710,5307398,312,0,utRho13
1366,ryfD,5468590,5468590,5468590,0,0,utRho13
1367,ryhB,7162032,7162032,7162032,0,0,utRho13
1368,ryjA,8556132,8556132,8556132,0,0,utRho13
1369,ryjB,9055954,9055954,9055954,0,0,utRho13
1370,sad,3229598,3229598,3229406,192,0,utRho13
1371,safA,3168056,3168056,3167918,138,0,utRho13
1372,sanA,4465368,4465756,4465368,388,104,utRho13
1373,sapF,2705314,2705314,2705268,46,34,utRho13
1374,sbcB,4165456,4165512,4165456,56,0,utRho13
1375,sbcC,831694,831694,831506,188,192,utRho13
1376,sbcD,833954,833954,833904,50,0,utRho13
1377,sbmA,793106,793278,793106,172,0,utRho13
1378,sbmC,4162650,4162650,4162524,126,0,utRho13
1379,sdaA,3793618,3793864,3793618,246,56,utRho13
1380,sdaC,5856070,5856458,5856070,388,2544,utRho13
1381,sdhC,1509916,1510354,1509916,438,94756,utRho13
1382,sdhD,1510808,1511120,1510808,312,24690,utRho13
1383,sdiA,3993834,3993834,3993664,170,172,utRho13
1384,secE,8354354,8354716,8354354,362,132,utRho13
1385,secG,6645180,6645180,6645010,170,1224,utRho13
1386,selA,7522594,7522594,7522498,96,152,utRho13
1387,selB,7519850,7519850,7519722,128,268,utRho13
1388,selC,7672396,7672444,7672396,48,48,utRho13
1389,selD,3696058,3696058,3696016,42,1610,utRho13
1390,seqA,1425884,1425974,1425884,90,774,utRho13
1391,serA,6117098,6117098,6116820,278,64,utRho13
1392,serB,9249712,9249790,9249712,78,0,utRho13
1393,serC,3830380,3830612,3830380,232,0,utRho13
1394,serS,1878730,1878856,1878730,126,910,utRho13
1395,serT,2063438,2063438,2063424,14,0,utRho13
1396,serU,4087124,4087124,4087114,10,584,utRho13
1397,serV,5637394,5637394,5637290,104,120,utRho13
1398,serW,1852014,1852014,1851942,72,76,utRho13
1399,serX,2195352,2195352,2195304,48,16,utRho13
1400,setB,4527426,4527726,4527426,300,0,utRho13
1401,setC,7673488,7673906,7673488,418,8,utRho13
1402,sfmA,1116124,1116424,1116124,300,0,utRho13
1403,sfmC,1117606,1117948,1117606,342,0,utRho13
1404,sfsA,323030,323030,322972,58,1054,utRho13
1405,sfsB,6669592,6669818,6669592,226,72,utRho13
1406,sgrR,154676,154676,154598,78,0,utRho13
1407,sgrS,154734,154734,154734,0,0,utRho13
1408,shiA,4107068,4107286,4107068,218,0,utRho13
1409,sibA,4306622,4306622,4306622,0,0,utRho13
1410,sibB,4307292,4307292,4307292,0,0,utRho13
1411,sibC,6113702,6113702,6113702,0,0,utRho13
1412,sibD,6389730,6389730,6389730,0,0,utRho13
1413,sibE,6390480,6390480,6390480,0,0,utRho13
1414,sixA,4913998,4913998,4913624,374,44,utRho13
1415,slp,7307872,7307922,7307872,50,0,utRho13
1416,slt,9261400,9261466,9261400,66,0,utRho13
1417,slyA,3442028,3442028,3441648,380,130,utRho13
1418,slyB,3439496,3439752,3439496,256,112,utRho13
1419,slyD,6957398,6957398,6956994,404,498,utRho13
1420,slyX,6954862,6955280,6954862,418,9524,utRho13
1421,smf,6867372,6867372,6867120,252,6,utRho13
1422,smpB,5509534,5509792,5509534,258,680,utRho13
1423,smrA,2811872,2811958,2811872,86,188,utRho13
1424,smrB,4896872,4897212,4896872,340,114,utRho13
1425,smtA,1946808,1947074,1946808,266,54,utRho13
1426,sodA,8201518,8201620,8201518,102,16114,utRho13
1427,sodB,3470646,3470756,3470646,110,144,utRho13
1428,sodC,3449358,3449358,3449310,48,0,utRho13
1429,sohB,2658568,2658664,2658568,96,0,utRho13
1430,sokB,2984232,2984238,2984232,6,28,utRho13
1431,solA,2241218,2241218,2241172,46,0,utRho13
1432,soxR,8554894,8554938,8554894,44,0,utRho13
1433,soxS,8554846,8554846,8554766,80,0,utRho13
1434,speA,6172096,6172096,6171822,274,312,utRho13
1435,speB,6167892,6167892,6167594,298,258,utRho13
1436,speC,6218350,6218350,6218310,40,6,utRho13
1437,spf,8099798,8099798,8099798,0,0,utRho13
1438,sppA,3697422,3697674,3697422,252,0,utRho13
1439,spy,3651376,3651376,3651250,126,0,utRho13
1440,sra,3112092,3112092,3111926,166,0,utRho13
1441,sraB,2293178,2293178,2293178,0,0,utRho13
1442,sraC,3846132,3846132,3846132,0,0,utRho13
1443,srlA,5651582,5651664,5651582,82,0,utRho13
1444,srlR,5657720,5658094,5657720,374,3458,utRho13
1445,srmB,5425752,5425792,5425752,40,434,utRho13
1446,sroA,151216,151216,151216,0,0,utRho13
1447,sroG,6369436,6369436,6369436,0,0,utRho13
1448,sroH,8380974,8380974,8380974,0,0,utRho13
1449,ssb,8548022,8548250,8548022,228,2,utRho13
1450,sseA,5304782,5304988,5304782,206,25084,utRho13
1451,sspA,6755138,6755138,6754840,298,942,utRho13
1452,ssrA,5511014,5511186,5511014,172,80,utRho13
1453,ssrS,12223036,12223932,12223036,896,2588,utRho13
1454,sstT,6479726,6479888,6479726,162,0,utRho13
1455,ssuB,1988282,1988282,1988088,194,48,utRho13
1456,ssuE,1995126,1995126,1995024,102,0,utRho13
1457,sthA,8321604,8321604,8321580,24,4362,utRho13
1458,stpA,5597156,5597156,5596990,166,0,utRho13
1459,sucA,3034344,3034824,3034344,480,11316,utRho13
1460,sufA,3528836,3528836,3528772,64,0,utRho13
1461,sufE,3518962,3518962,3518580,382,0,utRho13
1462,sugE,8753588,8753750,8753588,162,292,utRho13
1463,sulA,2041894,2041894,2041838,56,132,utRho13
1464,syd,5850738,5850738,5850560,178,132,utRho13
1465,symE,9159834,9159834,9159680,154,0,utRho13
1466,symR,9159670,9159670,9159670,0,0,utRho13
1467,tabA,8949566,8949724,8949566,158,0,utRho13
1468,talA,5157140,5157332,5157140,192,46,utRho13
1469,talB,16382,16476,16382,94,14632,utRho13
1470,tam,3214442,3214692,3214442,250,40,utRho13
1471,tamA,8884540,8884764,8884540,224,26,utRho13
1472,tar,3945432,3945432,3945382,50,0,utRho13
1473,tas,5943138,5943194,5943138,56,102,utRho13
1474,tatA,16087636,16087780,16087636,144,488,utRho13
1475,tatE,1317742,1317894,1317742,152,0,utRho13
1476,tauA,770410,770464,770410,54,0,utRho13
1477,tdcA,6534186,6534186,6534130,56,0,utRho13
1478,tdcG,6519652,6519652,6519298,354,530,utRho13
1479,tdcR,6534380,6534760,6534380,380,44,utRho13
1480,tdk,2586986,2587054,2586986,68,0,utRho13
1481,tehA,3001072,3001146,3001072,74,0,utRho13
1482,tesA,1039898,1039898,1039530,368,428,utRho13
1483,tesB,950402,950402,950322,80,0,utRho13
1484,tfaE,2418532,2418532,2418238,294,0,utRho13
1485,tfaQ,3269912,3269912,3269770,142,0,utRho13
1486,tff,379424,379256,379424,168,144,utRho13
1487,tgt,852110,852274,852110,164,70,utRho13
1488,thiD,4369346,4369346,4369032,314,0,utRho13
1489,thiI,882936,883098,882936,162,498,utRho13
1490,thiM,4370902,4370902,4370602,300,96,utRho13
1491,thiQ,146170,146170,145854,316,312,utRho13
1492,thrL,592,760,592,168,460,utRho13
1493,thrS,7210932,7210932,7210280,652,1248,utRho13
1494,thrU,8350762,8350776,8350762,14,0,utRho13
1495,thrV,6847414,6847414,6847310,104,201684,utRho13
1496,thrW,525682,525742,525682,60,158,utRho13
1497,thyA,5930696,5930696,5930310,386,3304,utRho13
1498,tig,909986,910266,909986,280,1826,utRho13
1499,tisB,7706674,7707106,7706674,432,618,utRho13
1500,tktA,6163414,6163414,6163270,144,244,utRho13
1501,tktB,5158616,5159272,5158616,656,1004,utRho13
1502,tldD,6784368,6784368,6784056,312,0,utRho13
1503,tmcA,5191876,5191876,5191718,158,0,utRho13
1504,tnaC,15553644,15553740,15553644,96,5488,utRho13
1505,tolB,1555074,1555480,1555074,406,404,utRho13
1506,tolC,6356008,6356230,6356008,222,428,utRho13
1507,tomB,961588,961588,961416,172,130,utRho13
1508,tonB,2622108,2622178,2622108,70,0,utRho13
1509,topA,2661578,2662096,2661578,518,252,utRho13
1510,torC,2116112,2116168,2116112,56,204,utRho13
1511,torR,2115968,2115968,2115908,60,388,utRho13
1512,torS,2112364,2112364,2112356,8,0,utRho13
1513,torT,2112414,2112522,2112414,108,0,utRho13
1514,tpiA,8223138,8223138,8223014,124,342,utRho13
1515,tppB,3425342,3425538,3425342,196,4674,utRho13
1516,tpr,2574376,2574376,2574376,0,0,utRho13
1517,tpx,2777688,2777688,2777622,66,324,utRho13
1518,tqsA,3347780,3347826,3347780,46,0,utRho13
1519,treA,2494850,2494850,2494752,98,72,utRho13
1520,treB,8932420,8932420,8932360,60,246,utRho13
1521,treF,7339102,7339184,7339102,82,0,utRho13
1522,treR,8934694,8934694,8934492,202,0,utRho13
1523,trg,2984878,2984940,2984878,62,0,utRho13
1524,trkG,2847342,2847564,2847342,222,38,utRho13
1525,trmA,8326590,8326590,8326540,50,0,utRho13
1526,trpA,2634678,2634678,2634444,234,590,utRho13
1527,trpC,2639888,2639888,2639570,318,0,utRho13
1528,trpL,5292432,5292432,5292328,104,0,utRho13
1529,trpR,9265408,9265520,9265408,112,220,utRho13
1530,trpS,7027394,7027394,7027276,118,2072,utRho13
1531,trpT,7893560,7893914,7893560,354,148954,utRho13
1532,trxA,7931294,7931522,7931294,228,720,utRho13
1533,trxB,1864156,1864156,1864100,56,0,utRho13
1534,trxC,5437350,5437470,5437350,120,114,utRho13
1535,tsaD,6421256,6421256,6421086,170,0,utRho13
1536,tsgA,6985038,6985136,6985038,98,0,utRho13
1537,tsr,9182824,9183314,9182824,490,132,utRho13
1538,tsx,864490,864490,864026,464,2166,utRho13
1539,ttcA,2823970,2823970,2823896,74,2684,utRho13
1540,ttdA,6412848,6412926,6412848,78,0,utRho13
1541,ttdR,6412760,6412760,6412512,248,0,utRho13
1542,tufA,6943448,6943448,6942658,790,290268,utRho13
1543,tus,3368346,3368518,3368346,172,146,utRho13
1544,tusA,7218040,7218040,7217992,48,188,utRho13
1545,tusB,6950218,6950218,6949930,288,432,utRho13
1546,tynA,2902996,2902996,2902698,298,0,utRho13
1547,typA,8116460,8116814,8116460,354,4898,utRho13
1548,tyrB,8534164,8534228,8534164,64,3802,utRho13
1549,tyrP,3979004,3979362,3979004,358,4,utRho13
1550,tyrR,2773384,2773440,2773384,56,0,utRho13
1551,tyrS,3434566,3434566,3434444,122,0,utRho13
1552,tyrT,2575330,2575330,2575244,86,244,utRho13
1553,uacT,6062378,6062734,6062378,356,0,utRho13
1554,ubiC,8504886,8505012,8504886,126,0,utRho13
1555,ubiD,8049618,8049976,8049618,358,682,utRho13
1556,ubiE,8037494,8037710,8037494,216,298,utRho13
1557,ubiG,4679078,4679134,4679078,56,0,utRho13
1558,ucpA,5089342,5089342,5089246,96,22,utRho13
1559,udp,8032782,8032862,8032782,80,84,utRho13
1560,ugd,4199470,4199470,4199226,244,0,utRho13
1561,ugpB,7184852,7184852,7184650,202,398,utRho13
1562,ugpQ,7176600,7176600,7176226,374,102,utRho13
1563,uhpT,7694396,7694396,7694334,62,0,utRho13
1564,uidA,3392304,3392304,3392142,162,0,utRho13
1565,uidC,3386012,3386012,3385702,310,0,utRho13
1566,uidR,3394150,3394150,3394104,46,42,utRho13
1567,ulaA,8839854,8839960,8839854,106,40,utRho13
1568,ulaG,8839350,8839350,8839250,100,0,utRho13
1569,ulaR,8837124,8837124,8836906,218,0,utRho13
1570,umpG,5741372,5741372,5740548,824,1056,utRho13
1571,umpH,1400704,1400704,1400652,52,180,utRho13
1572,umuD,2461476,2461534,2461476,58,0,utRho13
1573,ung,5433476,5433508,5433476,32,0,utRho13
1574,uof,2843316,2843316,2842900,416,5772,utRho13
1575,upp,5241818,5241818,5241744,74,830,utRho13
1576,usg,4873780,4873780,4873298,482,370,utRho13
1577,ushA,1009772,1009828,1009772,56,0,utRho13
1578,uspA,7279966,7280222,7279966,256,1054,utRho13
1579,uspB,7279696,7279696,7279440,256,6,utRho13
1580,uspC,3959172,3959506,3959172,334,0,utRho13
1581,uspE,2797318,2797318,2797244,74,82,utRho13
1582,uspF,2871282,2871282,2871238,44,0,utRho13
1583,uspG,1283806,1283806,1283734,72,310,utRho13
1584,uvrA,8547872,8547872,8547742,130,12,utRho13
1585,uvrB,1626304,1627052,1626304,748,1172,utRho13
1586,uvrC,3989758,3989758,3989412,346,172,utRho13
1587,uvrD,7995814,7995966,7995814,152,104,utRho13
1588,uvrY,3990812,3990812,3990718,94,30,utRho13
1589,uxaB,3221474,3221474,3221360,114,0,utRho13
1590,uxaC,6489714,6489714,6489482,232,0,utRho13
1591,uxuA,9103036,9103272,9103036,236,1034,utRho13
1592,uxuR,9108916,9109152,9108916,236,84,utRho13
1593,valS,8967854,8967854,8967674,180,834,utRho13
1594,valU,5041848,5041862,5041848,14,2,utRho13
1595,valV,3492830,3492870,3492830,40,10,utRho13
1596,ves,3649968,3649968,3649874,94,0,utRho13
1597,waaA,7616512,7617080,7616512,568,104,utRho13
1598,waaH,7580298,7580298,7580162,136,0,utRho13
1599,waaQ,7616476,7616476,7616196,280,0,utRho13
1600,waaU,7598996,7598996,7598624,372,154,utRho13
1601,waaY,7602272,7602272,7601930,342,4318,utRho13
1602,wbbH,4214888,4214888,4214452,436,1418,utRho13
1603,wbbK,4209212,4209212,4209018,194,226,utRho13
1604,wcaM,4231868,4231868,4231792,76,0,utRho13
1605,wrbA,2135516,2135516,2135416,100,0,utRho13
1606,wza,4275166,4275166,4274486,680,0,utRho13
1607,wzxC,4240674,4240674,4240316,358,0,utRho13
1608,wzzB,4196950,4196950,4196602,348,0,utRho13
1609,xanP,7657642,7657890,7657642,248,24,utRho13
1610,xanQ,6048520,6048702,6048520,182,0,utRho13
1611,xapA,5049820,5049820,5049756,64,42,utRho13
1612,xapR,10090252,10090252,10089908,344,0,utRho13
1613,xdhA,6000514,6000690,6000514,176,0,utRho13
1614,xerD,6079702,6079702,6079486,216,0,utRho13
1615,xseA,5268394,5268464,5268394,70,0,utRho13
1616,xseB,882746,882746,882686,60,602,utRho13
1617,xthA,3664798,3664856,3664798,58,0,utRho13
1618,xylA,7461614,7461614,7461530,84,914,utRho13
1619,xylE,8484540,8484540,8484508,32,0,utRho13
1620,xylF,7462138,7462262,7462138,124,10,utRho13
1621,xylR,7469812,7469958,7469812,146,0,utRho13
1622,yaaA,13230,13230,12918,312,14,utRho13
1623,yaaI,23876,23876,23572,304,44,utRho13
1624,yaaJ,16034,16034,15918,116,50,utRho13
1625,yaaU,91184,91614,91184,430,0,utRho13
1626,yaaW,23084,23084,22712,372,0,utRho13
1627,yaaX,10060,10468,10060,408,46,utRho13
1628,yabI,142542,142702,142542,160,102,utRho13
1629,yacC,273880,273880,273834,46,268,utRho13
1630,yacH,262932,262932,262520,412,0,utRho13
1631,yacL,268678,268776,268678,98,28,utRho13
1632,yadD,293796,293936,293796,140,0,utRho13
1633,yadE,289930,290162,289930,232,0,utRho13
1634,yadN,314110,314110,313766,344,0,utRho13
1635,yadS,355572,355572,355248,324,154,utRho13
1636,yadV,312470,312470,312402,68,60,utRho13
1637,yaeF,434270,434270,434006,264,0,utRho13
1638,yaeP,428374,428374,428250,124,0,utRho13
1639,yaeQ,428176,428582,428176,406,0,utRho13
1640,yaeR,423716,423754,423716,38,0,utRho13
1641,yafC,462166,462166,461762,404,210,utRho13
1642,yafD,462128,462244,462128,116,232,utRho13
1643,yafK,491986,491986,491610,376,540,utRho13
1644,yafL,493282,493424,493282,142,0,utRho13
1645,yafN,503938,504010,503938,72,0,utRho13
1646,yafS,469568,469632,469568,64,490,utRho13
1647,yafT,474470,474670,474470,200,0,utRho13
1648,yafV,480432,480432,480378,54,38,utRho13
1649,yafZ,536052,536052,536010,42,42,utRho13
1650,yagE,564446,564556,564446,110,0,utRho13
1651,yagG,570414,570790,570414,376,0,utRho13
1652,yagI,578384,578384,578324,60,0,utRho13
1653,yagK,586236,586236,585896,340,38,utRho13
1654,yagL,588062,588062,587836,226,0,utRho13
1655,yagN,591342,591342,591158,184,602,utRho13
1656,yahA,663746,664742,663746,996,34,utRho13
1657,yahC,670136,670136,670044,92,0,utRho13
1658,yahE,671478,671850,671478,372,0,utRho13
1659,yahM,690504,690808,690504,304,50,utRho13
1660,yahN,692872,692872,692674,198,0,utRho13
1661,yahO,692864,692968,692864,104,0,utRho13
1662,yaiE,816296,816354,816296,58,30,utRho13
1663,yaiI,811396,811528,811396,132,0,utRho13
1664,yaiO,761946,761946,761684,262,0,utRho13
1665,yaiP,767970,767970,767870,100,0,utRho13
1666,yaiS,769660,769660,769232,428,0,utRho13
1667,yaiV,788922,788922,788922,0,0,utRho13
1668,yaiY,799094,799094,798666,428,0,utRho13
1669,yaiZ,798888,799186,798888,298,0,utRho13
1670,yajC,854410,854574,854410,164,1008,utRho13
1671,yajD,860938,861210,860938,272,278,utRho13
1672,yajI,866068,866068,865702,366,252,utRho13
1673,yajL,887496,887496,887282,214,542,utRho13
1674,yajQ,889316,889366,889316,50,0,utRho13
1675,yajR,893374,893374,893332,42,0,utRho13
1676,ybaB,987418,988152,987418,734,2934,utRho13
1677,ybaL,1006590,1006590,1006476,114,82,utRho13
1678,ybaM,980648,980648,980542,106,130,utRho13
1679,ybaN,981436,981764,981436,328,518,utRho13
1680,ybaO,936704,936766,936704,62,0,utRho13
1681,ybaP,1016568,1016568,1016160,408,1252,utRho13
1682,ybaQ,1016348,1016436,1016348,88,0,utRho13
1683,ybaS,1023146,1023282,1023146,136,16,utRho13
1684,ybaV,927504,927874,927504,370,106,utRho13
1685,ybaY,950490,950758,950490,268,170,utRho13
1686,ybbB,1062724,1062724,1062452,272,0,utRho13
1687,ybbJ,1030154,1030154,1029718,436,472,utRho13
1688,ybbL,1031784,1031838,1031784,54,0,utRho13
1689,ybbN,1037136,1037136,1036558,578,1678,utRho13
1690,ybbO,1038658,1038658,1038298,360,1052,utRho13
1691,ybbY,1080718,1081130,1080718,412,0,utRho13
1692,ybcH,1176140,1176140,1175962,178,0,utRho13
1693,ybcI,1113264,1113264,1113106,158,200,utRho13
1694,ybcJ,1114050,1114050,1113746,304,836,utRho13
1695,ybcK,1137502,1137804,1137502,302,0,utRho13
1696,ybcL,1141690,1141786,1141690,96,0,utRho13
1697,ybcN,1144628,1144932,1144628,304,0,utRho13
1698,ybcQ,1147548,1147912,1147548,364,0,utRho13
1699,ybcW,1159610,1159760,1159610,150,0,utRho13
1700,ybdD,1263982,1264364,1263982,382,248,utRho13
1701,ybdF,1212106,1212106,1211772,334,56,utRho13
1702,ybdH,1267048,1267048,1266954,94,18,utRho13
1703,ybdJ,1212822,1212822,1212398,424,84,utRho13
1704,ybdK,1215122,1215122,1214766,356,0,utRho13
1705,ybdL,1267114,1267172,1267114,58,0,utRho13
1706,ybdM,1271110,1271110,1270752,358,182,utRho13
1707,ybdN,1273372,1273372,1273138,234,0,utRho13
1708,ybdR,1283844,1284176,1283844,332,378,utRho13
1709,ybeD,1325412,1325412,1325284,128,390,utRho13
1710,ybeF,1323090,1323090,1322756,334,4,utRho13
1711,ybeL,1349986,1350036,1349986,50,276,utRho13
1712,ybeQ,1353412,1353412,1353094,318,0,utRho13
1713,ybeR,1353120,1353422,1353120,302,0,utRho13
1714,ybeT,1358832,1358832,1358812,20,0,utRho13
1715,ybeU,1358924,1359016,1358924,92,0,utRho13
1716,ybeZ,1386938,1386938,1386834,104,1252,utRho13
1717,ybfA,1458074,1458268,1458074,194,0,utRho13
1718,ybfE,1423878,1423878,1423796,82,0,utRho13
1719,ybfF,1425692,1425692,1425604,88,280,utRho13
1720,ybfH,1433282,1433282,1433194,88,0,utRho13
1721,ybgA,1477840,1478002,1477840,162,0,utRho13
1722,ybgC,1549288,1549504,1549288,216,0,utRho13
1723,ybgD,1505916,1505916,1505590,326,248,utRho13
1724,ybgI,1485238,1485654,1485238,416,0,utRho13
1725,ybgO,1498370,1498370,1497964,406,0,utRho13
1726,ybgS,1570992,1570992,1570634,358,0,utRho13
1727,ybhA,1597184,1597184,1596862,322,92,utRho13
1728,ybhB,1616070,1616070,1615818,252,264,utRho13
1729,ybhC,1614642,1614642,1614562,80,2420,utRho13
1730,ybhD,1601418,1601418,1601276,142,0,utRho13
1731,ybhH,1601104,1601518,1601104,414,0,utRho13
1732,ybhK,1633384,1633384,1633294,90,16,utRho13
1733,ybhM,1641556,1641586,1641556,30,0,utRho13
1734,ybhN,1645296,1645296,1644996,300,0,utRho13
1735,ybhQ,1649202,1649260,1649202,58,0,utRho13
1736,ybiA,1665920,1665920,1665900,20,0,utRho13
1737,ybiI,1676968,1676968,1676912,56,0,utRho13
1738,ybiO,1691328,1691328,1690960,368,586,utRho13
1739,ybiP,1705252,1705252,1705194,58,84,utRho13
1740,ybiS,1711572,1711572,1711488,84,196,utRho13
1741,ybiT,1711894,1711926,1711894,32,0,utRho13
1742,ybiU,1718212,1718212,1718122,90,76,utRho13
1743,ybiV,1720176,1720176,1720056,120,0,utRho13
1744,ybiW,1725566,1725566,1725212,354,280,utRho13
1745,ybiX,1678548,1678548,1678414,134,252,utRho13
1746,ybjC,1781784,1781826,1781784,42,0,utRho13
1747,ybjE,1830154,1830154,1829714,440,70,utRho13
1748,ybjG,1767016,1767016,1766776,240,848,utRho13
1749,ybjL,1779882,1779882,1779638,244,0,utRho13
1750,ybjM,1779770,1780178,1779770,408,0,utRho13
1751,ybjO,1795704,1795978,1795704,274,0,utRho13
1752,ybjP,1809046,1809046,1808934,112,60,utRho13
1753,ybjQ,1809034,1809186,1809034,152,0,utRho13
1754,ybjS,1813796,1813796,1813506,290,54,utRho13
1755,ybjX,1838206,1838206,1838168,38,66,utRho13
1756,ycaD,1891438,1891742,1891438,304,0,utRho13
1757,ycaI,1928210,1928640,1928210,430,62,utRho13
1758,ycaK,1899094,1899336,1899094,242,14,utRho13
1759,ycaL,1920264,1920528,1920264,264,56,utRho13
1760,ycaM,1894240,1894458,1894240,218,222,utRho13
1761,ycaR,1941284,1941346,1941284,62,384,utRho13
1762,ycbB,1961862,1962094,1961862,232,40,utRho13
1763,ycbJ,1943344,1943504,1943344,160,0,utRho13
1764,ycbK,1966046,1966150,1966046,104,754,utRho13
1765,ycbZ,2036920,2036920,2036598,322,0,utRho13
1766,yccA,2062886,2062886,2062836,50,46,utRho13
1767,yccF,2048730,2048730,2048696,34,0,utRho13
1768,yccS,2047988,2047988,2047766,222,0,utRho13
1769,yccT,2055674,2055674,2055546,128,144,utRho13
1770,yccX,2059960,2060128,2059960,168,0,utRho13
1771,ycdT,2185682,2185752,2185682,70,0,utRho13
1772,ycdU,2191266,2191686,2191266,420,0,utRho13
1773,ycdZ,2200504,2200592,2200504,88,288,utRho13
1774,yceA,2233544,2233614,2233544,70,0,utRho13
1775,yceD,2293298,2293588,2293298,290,6832,utRho13
1776,yceF,2293522,2293522,2293190,332,4534,utRho13
1777,yceH,2252154,2252314,2252154,160,3996,utRho13
1778,yceI,2237282,2237282,2236952,330,308,utRho13
1779,yceJ,2238142,2238142,2238092,50,30,utRho13
1780,yceM,2253208,2253612,2253208,404,164,utRho13
1781,yceO,2239264,2239264,2238894,370,778,utRho13
1782,yceQ,2288760,2289004,2288760,244,6296,utRho13
1783,ycfD,2376540,2376540,2376480,60,76,utRho13
1784,ycfJ,2334814,2335198,2334814,384,0,utRho13
1785,ycfS,2340834,2340834,2340748,86,0,utRho13
1786,ycfT,2350658,2350658,2350330,328,0,utRho13
1787,ycfZ,2362760,2362760,2362534,226,4,utRho13
1788,ycgB,2474570,2474570,2474482,88,0,utRho13
1789,ycgG,2434614,2434656,2434614,42,0,utRho13
1790,ycgJ,2452956,2453200,2452956,244,0,utRho13
1791,ycgL,2455218,2455362,2455218,144,0,utRho13
1792,ycgN,2457366,2457660,2457366,294,254,utRho13
1793,ycgR,2489112,2489112,2489054,58,0,utRho13
1794,ycgV,2512222,2512222,2511904,318,98,utRho13
1795,ycgX,2426568,2426568,2426214,354,490,utRho13
1796,ycgY,2490166,2490320,2490166,154,0,utRho13
1797,ycgZ,2431504,2431578,2431504,74,0,utRho13
1798,ychE,2596904,2597196,2596904,292,0,utRho13
1799,ychF,2515764,2515764,2515624,140,76,utRho13
1800,ychH,2517476,2517582,2517476,106,204,utRho13
1801,ychJ,2578354,2578354,2578264,90,54,utRho13
1802,ychN,2547310,2547310,2547198,112,0,utRho13
1803,ychO,2547520,2547850,2547520,330,184,utRho13
1804,ychQ,2533798,2533848,2533798,50,0,utRho13
1805,yciA,2624828,2624828,2624492,336,252,utRho13
1806,yciB,2626110,2626110,2625780,330,2136,utRho13
1807,yciC,2627396,2627396,2627326,70,28,utRho13
1808,yciE,2630794,2630794,2630448,346,0,utRho13
1809,yciG,5264368,5264368,5264140,228,0,utRho13
1810,yciI,2621784,2621784,2621730,54,0,utRho13
1811,yciN,2661606,2661606,2661336,270,186,utRho13
1812,yciS,2680270,2680486,2680270,216,54,utRho13
1813,yciT,2689088,2689088,2688692,396,718,utRho13
1814,yciU,2614718,2614718,2614300,418,424,utRho13
1815,yciV,2646376,2646440,2646376,64,0,utRho13
1816,yciW,2700472,2700472,2700214,258,98,utRho13
1817,yciZ,2689276,2689276,2689218,58,214,utRho13
1818,ycjD,2703792,2703792,2703520,272,44,utRho13
1819,ycjG,2777748,2777860,2777748,112,294,utRho13
1820,ycjM,2740006,2740432,2740006,426,228,utRho13
1821,ycjW,2767982,2767982,2767922,60,8,utRho13
1822,ycjX,2768138,2768234,2768138,96,48,utRho13
1823,ycjY,5568288,5568288,5567460,828,0,utRho13
1824,ydaE,2836438,2836438,2836016,422,0,utRho13
1825,ydaN,2816048,2816100,2816048,52,0,utRho13
1826,ydaS,2840340,2840730,2840340,390,168,utRho13
1827,ydbC,2948376,2948442,2948376,66,0,utRho13
1828,ydbD,2950132,2950288,2950132,156,0,utRho13
1829,ydbH,2885800,2886102,2885800,302,152,utRho13
1830,ydbJ,2881712,2882116,2881712,404,80,utRho13
1831,ydbK,2881692,2881692,2881568,124,40,utRho13
1832,ydcA,2983294,2983354,2983294,60,0,utRho13
1833,ydcF,2974404,2974470,2974404,66,0,utRho13
1834,ydcI,2990268,2990268,2990142,126,14,utRho13
1835,ydcJ,2990266,2990576,2990266,310,0,utRho13
1836,ydcK,3001280,3001280,3000898,382,0,utRho13
1837,ydcL,3004646,3004914,3004646,268,0,utRho13
1838,ydcN,3012308,3012344,3012308,36,0,utRho13
1839,ydcP,3013508,3013562,3013508,54,70,utRho13
1840,ydcR,3019956,3020006,3019956,50,0,utRho13
1841,ydcS,3022906,3023308,3022906,402,0,utRho13
1842,ydcX,3034442,3034778,3034442,336,100,utRho13
1843,ydcY,3035220,3035296,3035220,76,2,utRho13
1844,ydcZ,3036750,3036750,3036662,88,0,utRho13
1845,yddB,3155332,3155332,3155238,94,24,utRho13
1846,yddE,3071738,3071738,3071716,22,0,utRho13
1847,yddG,3094410,3094410,3094338,72,0,utRho13
1848,yddJ,3089732,3089732,3089438,294,0,utRho13
1849,yddW,3137704,3137704,3137646,58,0,utRho13
1850,ydeA,3233910,3234056,3233910,146,0,utRho13
1851,ydeE,3242528,3242664,3242528,136,0,utRho13
1852,ydeI,3249118,3249118,3248994,124,0,utRho13
1853,ydeJ,3249376,3249546,3249376,170,0,utRho13
1854,ydeN,3165458,3165458,3165048,410,0,utRho13
1855,ydeP,3173328,3173328,3172972,356,0,utRho13
1856,ydeR,3176596,3176596,3176592,4,0,utRho13
1857,ydfA,3296872,3297016,3296872,144,0,utRho13
1858,ydfG,3254982,3255034,3254982,52,0,utRho13
1859,ydfH,3256652,3256704,3256652,52,32,utRho13
1860,ydfK,3265446,3266144,3265446,698,26,utRho13
1861,ydgA,3379588,3379704,3379588,116,154,utRho13
1862,ydgC,3364124,3364124,3364060,64,0,utRho13
1863,ydgD,3343906,3343920,3343906,14,0,utRho13
1864,ydgH,3356754,3356854,3356754,100,0,utRho13
1865,ydgJ,3408798,3408798,3408616,182,0,utRho13
1866,ydgK,3410414,3410500,3410414,86,202,utRho13
1867,ydhB,3479618,3479618,3479596,22,0,utRho13
1868,ydhC,3479698,3479822,3479698,124,0,utRho13
1869,ydhF,3451310,3451310,3451264,46,46,utRho13
1870,ydhI,3441996,3442050,3441996,54,0,utRho13
1871,ydhL,3451864,3451864,3451840,24,0,utRho13
1872,ydhQ,3492404,3492404,3492254,150,118,utRho13
1873,ydhS,3494136,3494262,3494136,126,30,utRho13
1874,ydhT,3499138,3499138,3499118,20,0,utRho13
1875,ydhY,3509284,3509284,3508954,330,0,utRho13
1876,ydhZ,3510418,3510418,3510282,136,0,utRho13
1877,ydiE,3579206,3579226,3579206,20,0,utRho13
1878,ydiH,3530582,3530582,3530406,176,44,utRho13
1879,ydiM,3541852,3542142,3541852,290,30,utRho13
1880,ydiN,3544818,3545024,3544818,206,0,utRho13
1881,ydiP,3558656,3558656,3558602,54,0,utRho13
1882,ydiU,3582508,3582508,3582488,20,0,utRho13
1883,ydiV,3584174,3584174,3584040,134,264,utRho13
1884,ydiY,3612500,3612500,3612166,334,0,utRho13
1885,ydjA,3697400,3697400,3697352,48,0,utRho13
1886,ydjE,3708082,3708082,3707958,124,0,utRho13
1887,ydjF,3709848,3709848,3709708,140,0,utRho13
1888,ydjM,3620340,3620422,3620340,82,0,utRho13
1889,ydjO,3626696,3626696,3626288,408,0,utRho13
1890,ydjX,3666434,3666802,3666434,368,424,utRho13
1891,yeaE,3731448,3731448,3731272,176,212,utRho13
1892,yeaG,3733530,3733816,3733530,286,0,utRho13
1893,yeaI,3740486,3740770,3740486,284,0,utRho13
1894,yeaJ,3743874,3744082,3743874,208,92,utRho13
1895,yeaL,3748646,3748704,3748646,58,166,utRho13
1896,yeaM,3751296,3751296,3751152,144,0,utRho13
1897,yeaN,3750926,3751346,3750926,420,0,utRho13
1898,yeaO,3753554,3753818,3753554,264,6,utRho13
1899,yeaP,3755314,3755430,3755314,116,262,utRho13
1900,yeaQ,3758780,3758780,3758510,270,44,utRho13
1901,yeaR,3759988,3759988,3759896,92,0,utRho13
1902,yeaY,3781122,3781122,3781064,58,74,utRho13
1903,yebB,3892220,3892502,3892220,282,4,utRho13
1904,yebC,3896370,3896370,3896302,68,80,utRho13
1905,yebE,3859464,3859464,3859414,50,0,utRho13
1906,yebG,3861530,3861530,3861494,36,0,utRho13
1907,yebK,3873180,3873304,3873180,124,388,utRho13
1908,yebQ,3820314,3820552,3820314,238,0,utRho13
1909,yebS,3832238,3832516,3832238,278,52,utRho13
1910,yebV,3843430,3843560,3843430,130,0,utRho13
1911,yebW,3843914,3844242,3843914,328,404,utRho13
1912,yecC,3995646,3995646,3995628,18,0,utRho13
1913,yecD,3901272,3901664,3901272,392,218,utRho13
1914,yecF,3991434,3991636,3991434,202,74,utRho13
1915,yecH,3979304,3979304,3978980,324,8,utRho13
1916,yecJ,3975604,3975604,3975516,88,0,utRho13
1917,yecM,3919968,3919968,3919692,276,0,utRho13
1918,yecR,3976400,3976444,3976400,44,0,utRho13
1919,yecT,3923862,3923944,3923862,82,0,utRho13
1920,yedD,4016522,4016522,4016180,342,126,utRho13
1921,yedE,4016310,4016554,4016310,244,68,utRho13
1922,yedI,4058922,4058922,4058732,190,0,utRho13
1923,yedJ,4066446,4066446,4066158,288,0,utRho13
1924,yedV,4076404,4076404,4076304,100,0,utRho13
1925,yedX,4077680,4077912,4077680,232,0,utRho13
1926,yedY,4078572,4078956,4078572,384,0,utRho13
1927,yeeA,4161322,4161322,4161182,140,84,utRho13
1928,yeeE,4171104,4171104,4171050,54,0,utRho13
1929,yeeJ,4089526,4089822,4089526,296,0,utRho13
1930,yeeN,4113508,4113716,4113508,208,0,utRho13
1931,yeeO,4119444,4119444,4119692,248,0,utRho13
1932,yeeX,4158834,4158834,4158722,112,362,utRho13
1933,yeeZ,4178422,4178422,4178256,166,0,utRho13
1934,yefM,4179466,4179466,4179426,40,0,utRho13
1935,yegD,4295288,4295348,4295288,60,0,utRho13
1936,yegH,4275726,4275804,4275726,78,0,utRho13
1937,yegI,4302154,4302154,4301970,184,0,utRho13
1938,yegJ,4302032,4302370,4302032,338,0,utRho13
1939,yegQ,4331182,4331336,4331182,154,54,utRho13
1940,yegR,4336698,4336698,4336612,86,0,utRho13
1941,yegS,4337086,4337424,4337086,338,0,utRho13
1942,yegT,4357562,4357642,4357562,80,0,utRho13
1943,yegX,4367640,4367640,4367302,338,0,utRho13
1944,yehA,4376944,4376944,4376828,116,0,utRho13
1945,yehE,4385818,4385818,4385592,226,0,utRho13
1946,yehK,4407568,4407944,4407568,376,0,utRho13
1947,yehL,4408804,4409192,4408804,388,0,utRho13
1948,yeiB,4486146,4486146,4485934,212,244,utRho13
1949,yeiE,4499422,4499422,4499236,186,0,utRho13
1950,yeiG,4487776,4487820,4487776,44,178,utRho13
1951,yeiH,4499332,4499434,4499332,102,0,utRho13
1952,yeiI,4503306,4503400,4503306,94,64,utRho13
1953,yeiL,4510580,4510710,4510580,130,0,utRho13
1954,yeiP,4530834,4530900,4530834,66,580,utRho13
1955,yeiQ,4532328,4532490,4532328,162,0,utRho13
1956,yeiR,4535484,4535658,4535484,174,112,utRho13
1957,yeiW,4530840,4530840,4530590,250,694,utRho13
1958,yejA,4544624,4544728,4544624,104,0,utRho13
1959,yejG,4556892,4556892,4556474,418,68,utRho13
1960,yejH,4561244,4561264,4561244,20,0,utRho13
1961,yejK,4568218,4568218,4567894,324,168,utRho13
1962,yejO,4578352,4578352,4577800,552,152,utRho13
1963,yfaD,4713380,4713808,4713380,428,856,utRho13
1964,yfaE,4696676,4697028,4696676,352,1328,utRho13
1965,yfaL,4688568,4688568,4688338,230,0,utRho13
1966,yfaP,4656398,4656398,4656286,112,0,utRho13
1967,yfaU,4717892,4717892,4717690,202,0,utRho13
1968,yfaY,4727310,4727310,4727266,44,0,utRho13
1969,yfaZ,4728744,4728744,4728550,194,0,utRho13
1970,yfbK,4771810,4771810,4771444,366,0,utRho13
1971,yfbL,4771500,4771720,4771500,220,0,utRho13
1972,yfbN,4777174,4777174,4776852,322,0,utRho13
1973,yfbO,4776916,4777162,4776916,246,0,utRho13
1974,yfbP,4777990,4778232,4777990,242,50,utRho13
1975,yfbR,4817662,4817724,4817662,62,0,utRho13
1976,yfcI,4847424,4847424,4847078,346,84,utRho13
1977,yfcJ,4880482,4880482,4880240,242,32,utRho13
1978,yfcL,4888502,4888502,4888338,164,52,utRho13
1979,yfcV,4911642,4911642,4911292,350,0,utRho13
1980,yfcZ,4921958,4921958,4921868,90,32,utRho13
1981,yfdF,4925604,4926024,4925604,420,0,utRho13
1982,yfdG,4935474,4935710,4935474,236,70,utRho13
1983,yfdP,4946844,4947040,4946844,196,0,utRho13
1984,yfdX,4988866,4988866,4988804,62,0,utRho13
1985,yfdY,4990672,4990672,4990584,88,0,utRho13
1986,yfeA,5035784,5035784,5035664,120,3234,utRho13
1987,yfeC,5036668,5036934,5036668,266,344,utRho13
1988,yfeH,5053818,5053892,5053818,74,0,utRho13
1989,yfeK,5074630,5074684,5074630,54,0,utRho13
1990,yfeO,5018906,5019260,5018906,354,0,utRho13
1991,yfeR,5054078,5054078,5053712,366,48,utRho13
1992,yfeX,5101356,5101356,5101090,266,0,utRho13
1993,yfeY,5102486,5102486,5102432,54,0,utRho13
1994,yfeZ,5103842,5103842,5103452,390,40,utRho13
1995,yffO,5123804,5124222,5123804,418,0,utRho13
1996,yffQ,5126778,5127154,5126778,376,0,utRho13
1997,yffS,5128800,5128986,5128800,186,44,utRho13
1998,yfgC,5232052,5232188,5232052,136,44,utRho13
1999,yfgF,5258062,5258062,5257876,186,0,utRho13
2000,yfgG,5258170,5258580,5258170,410,4,utRho13
2001,yfgH,5259344,5259584,5259344,240,0,utRho13
2002,yfgM,5278866,5278866,5278566,300,832,utRho13
2003,yfhH,5397414,5397518,5397414,104,24,utRho13
2004,yfhM,5304648,5304648,5304574,74,18,utRho13
2005,yfhR,5328408,5328726,5328408,318,6,utRho13
2006,yfiC,5425610,5425610,5425528,82,0,utRho13
2007,yfiE,5430688,5430688,5430640,48,0,utRho13
2008,yfiL,5482630,5482720,5482630,90,0,utRho13
2009,yfiM,5448066,5448358,5448066,292,1362,utRho13
2010,yfiR,5483354,5483750,5483354,396,0,utRho13
2011,yfjH,5517326,5517326,5517200,126,0,utRho13
2012,yfjI,5517710,5517970,5517710,260,0,utRho13
2013,yfjJ,5521014,5521094,5521014,80,0,utRho13
2014,yfjM,5531970,5531970,5531552,418,218,utRho13
2015,yfjP,5535080,5535420,5535080,340,48,utRho13
2016,yfjW,5546570,5546636,5546570,66,0,utRho13
2017,yfjX,5551776,5551838,5551776,62,0,utRho13
2018,ygaC,5601180,5601180,5599988,1192,4,utRho13
2019,ygaM,5600242,5600292,5600242,50,0,utRho13
2020,ygaU,5593628,5593628,5593572,56,22,utRho13
2021,ygaZ,5619190,5619234,5619190,44,32,utRho13
2022,ygbA,5713656,5713656,5713612,44,0,utRho13
2023,ygbE,5746784,5746784,5746674,110,90,utRho13
2024,ygbI,5722882,5722882,5722528,354,0,utRho13
2025,ygbK,5724394,5724670,5724394,276,4,utRho13
2026,ygbL,5727074,5727186,5727074,112,0,utRho13
2027,ygbN,5729814,5730202,5729814,388,172,utRho13
2028,ygcG,5811210,5811422,5811210,212,0,utRho13
2029,ygcN,5785144,5785314,5785144,170,0,utRho13
2030,ygcU,5799214,5799214,5798836,378,0,utRho13
2031,ygcW,5800942,5800942,5800546,396,0,utRho13
2032,ygdD,5883442,5883442,5883262,180,124,utRho13
2033,ygdG,5861746,5861930,5861746,184,1148,utRho13
2034,ygdI,5886526,5886526,5886290,236,0,utRho13
2035,ygdQ,5940784,5940840,5940784,56,62,utRho13
2036,ygdR,5942494,5942542,5942494,48,0,utRho13
2037,ygeA,5961606,5961606,5961270,336,0,utRho13
2038,ygeH,5983758,5984188,5983758,430,0,utRho13
2039,ygeI,5987162,5987276,5987162,114,0,utRho13
2040,ygeR,6000078,6000078,5999782,296,0,utRho13
2041,ygeV,6011694,6011694,6011572,122,0,utRho13
2042,ygeW,6012234,6012524,6012234,290,16,utRho13
2043,ygfB,6110946,6110946,6110888,58,40,utRho13
2044,ygfK,6031984,6032120,6031984,136,0,utRho13
2045,ygfS,6058328,6058328,6058024,304,0,utRho13
2046,ygfZ,6082564,6082626,6082564,62,184,utRho13
2047,yggC,6149512,6149512,6149378,134,0,utRho13
2048,yggE,6136370,6136370,6136160,210,210,utRho13
2049,yggI,6179176,6179510,6179176,334,152,utRho13
2050,yggL,6204508,6204508,6204266,242,188,utRho13
2051,yggM,6199514,6199514,6199130,384,0,utRho13
2052,yggN,6203596,6203596,6203246,350,68,utRho13
2053,yggX,18623958,18624558,18623958,600,582,utRho13
2054,yghA,6298966,6299324,6298966,358,0,utRho13
2055,yghB,6307058,6307126,6307058,68,62,utRho13
2056,yghD,6222614,6222614,6222252,362,98,utRho13
2057,yghF,6225798,6225798,6225840,42,0,utRho13
2058,yghJ,6238640,6238640,6238224,416,16,utRho13
2059,yghQ,6265186,6265186,6264816,370,48,utRho13
2060,yghT,6267830,6268262,6267830,432,0,utRho13
2061,yghU,6277400,6277454,6277400,54,96,utRho13
2062,yghW,6293506,6293506,6293474,32,0,utRho13
2063,yghZ,6295562,6295794,6295562,232,0,utRho13
2064,ygiD,6365122,6365122,6364868,254,460,utRho13
2065,ygiH,6409066,6409388,6409066,322,0,utRho13
2066,ygiL,6370622,6370828,6370622,206,38,utRho13
2067,ygiM,6402084,6402414,6402084,330,282,utRho13
2068,ygiN,6346156,6346284,6346156,128,2786,utRho13
2069,ygiQ,6322620,6322620,6322292,328,248,utRho13
2070,ygiS,6335462,6335462,6335436,26,64,utRho13
2071,ygiV,6338582,6338582,6338462,120,252,utRho13
2072,ygiW,6339774,6339774,6339352,422,4,utRho13
2073,ygiZ,6344506,6344506,6344422,84,0,utRho13
2074,ygjH,6442528,6442528,6442494,34,0,utRho13
2075,ygjI,6452140,6452468,6452140,328,28,utRho13
2076,ygjQ,6472730,6473080,6472730,350,160,utRho13
2077,ygjR,6474564,6474586,6474564,22,22,utRho13
2078,ygjV,6483638,6483638,6483488,150,0,utRho13
2079,yhaB,6535632,6535708,6535632,76,34,utRho13
2080,yhaH,6504498,6504608,6504498,110,0,utRho13
2081,yhaI,6505400,6505822,6505400,422,212,utRho13
2082,yhaJ,6508560,6508560,6508428,132,4,utRho13
2083,yhaK,6508538,6508638,6508538,100,0,utRho13
2084,yhbQ,6599878,6599932,6599878,54,138,utRho13
2085,yhbT,6602736,6602736,6602552,184,44,utRho13
2086,yhbU,6602558,6602970,6602558,412,44,utRho13
2087,yhbX,6643302,6643302,6643226,76,0,utRho13
2088,yhbY,6655518,6655580,6655518,62,268,utRho13
2089,yhcA,6723956,6724224,6723956,268,0,utRho13
2090,yhcB,6760364,6760382,6760364,18,42,utRho13
2091,yhcC,6708470,6708470,6708100,370,0,utRho13
2092,yhcF,6733440,6733852,6733440,412,348,utRho13
2093,yhcH,6739124,6739124,6738956,168,546,utRho13
2094,yhcM,6760312,6760312,6759994,318,8,utRho13
2095,yhcN,6770812,6771076,6770812,264,128,utRho13
2096,yhcO,6772606,6772606,6772258,348,0,utRho13
2097,yhdH,6806560,6806968,6806560,408,0,utRho13
2098,yhdJ,6823234,6823306,6823234,72,0,utRho13
2099,yhdN,6879092,6879092,6879018,74,720,utRho13
2100,yhdT,6814702,6814750,6814702,48,54,utRho13
2101,yhdU,6824994,6825242,6824994,248,114,utRho13
2102,yhdV,6836392,6836780,6836392,388,0,utRho13
2103,yhdW,6837944,6838298,6837944,354,0,utRho13
2104,yheO,6953082,6953082,6952880,202,1116,utRho13
2105,yheV,6957970,6957970,6957584,386,294,utRho13
2106,yhfA,6971902,6971902,6971636,266,0,utRho13
2107,yhfG,6983294,6983294,6983240,54,314,utRho13
2108,yhfL,6998622,6998896,6998622,274,0,utRho13
2109,yhfY,7023244,7023244,7022844,400,56,utRho13
2110,yhgA,7086294,7086334,7086294,40,44,utRho13
2111,yhgE,7065176,7065176,7064878,298,44,utRho13
2112,yhgF,7074352,7074770,7074352,418,4250,utRho13
2113,yhhA,7173458,7173886,7173458,428,30,utRho13
2114,yhhI,7248346,7248756,7248346,410,0,utRho13
2115,yhhJ,7253696,7253696,7253606,90,0,utRho13
2116,yhhM,7211588,7211588,7211220,368,16,utRho13
2117,yhhN,7211150,7211502,7211150,352,0,utRho13
2118,yhhQ,7218238,7218434,7218238,196,72,utRho13
2119,yhhT,7223682,7223730,7223682,48,0,utRho13
2120,yhhX,7162032,7162032,7161610,422,16,utRho13
2121,yhhY,7162222,7162276,7162222,54,0,utRho13
2122,yhhZ,7163516,7163726,7163516,210,0,utRho13
2123,yhiD,7312220,7312220,7311804,416,5050,utRho13
2124,yhiJ,7265190,7265190,7265180,10,0,utRho13
2125,yhiM,7269270,7269682,7269270,412,2,utRho13
2126,yhiN,7275000,7275000,7274820,180,114,utRho13
2127,yhjA,7338522,7338522,7338376,146,48,utRho13
2128,yhjB,7344090,7344090,7343788,302,50,utRho13
2129,yhjC,7344272,7344684,7344272,412,112,utRho13
2130,yhjD,7346660,7346724,7346660,64,4,utRho13
2131,yhjE,7349274,7349572,7349274,298,0,utRho13
2132,yhjG,7356824,7356824,7356730,94,44,utRho13
2133,yhjH,7358458,7358458,7358374,84,292,utRho13
2134,yhjJ,7364032,7364032,7363880,152,60,utRho13
2135,yhjK,7371296,7371296,7371158,138,0,utRho13
2136,yhjR,7392750,7392750,7392370,380,0,utRho13
2137,yhjV,7400796,7401126,7400796,330,444,utRho13
2138,yhjX,7424194,7424194,7424014,180,0,utRho13
2139,yhjY,7425966,7425966,7425868,98,0,utRho13
2140,yiaB,7455654,7455654,7455496,158,0,utRho13
2141,yiaD,7432712,7433094,7432712,382,24,utRho13
2142,yiaF,7438194,7438194,7438088,106,0,utRho13
2143,yiaG,7438862,7438956,7438862,94,136,utRho13
2144,yiaJ,7485236,7485236,7485064,172,0,utRho13
2145,yiaK,7485348,7485466,7485348,118,74,utRho13
2146,yiaT,7503924,7503924,7503736,188,0,utRho13
2147,yiaU,7503792,7503984,7503792,192,0,utRho13
2148,yiaY,7515856,7515856,7515654,202,0,utRho13
2149,yibF,7523950,7523950,7523910,40,0,utRho13
2150,yibG,7536128,7536354,7536128,226,34,utRho13
2151,yibL,7553194,7553330,7553194,136,94,utRho13
2152,yibN,7570112,7570112,7570030,82,372,utRho13
2153,yibT,7552848,7552848,7552760,88,130,utRho13
2154,yicC,7633290,7633352,7633290,62,74,utRho13
2155,yicH,7660862,7660914,7660862,52,40,utRho13
2156,yicJ,7673328,7673328,7671858,1470,1192,utRho13
2157,yicN,7685018,7685018,7684804,214,30,utRho13
2158,yicO,7687914,7687914,7687578,336,0,utRho13
2159,yicR,15250308,15250308,15250236,72,0,utRho13
2160,yidB,7755230,7755230,7754930,300,0,utRho13
2161,yidE,7732780,7732780,7732546,234,34,utRho13
2162,yidF,7711580,7711580,7711222,358,266,utRho13
2163,yidQ,7735088,7735456,7735088,368,1466,utRho13
2164,yidR,7738824,7738824,7738618,206,0,utRho13
2165,yieE,7787658,7787738,7787658,80,34,utRho13
2166,yieH,7793314,7793548,7793314,234,0,utRho13
2167,yieK,7798928,7798928,7798786,142,0,utRho13
2168,yifB,7900350,7900350,7899998,352,2,utRho13
2169,yifL,7988984,7989044,7988984,60,132,utRho13
2170,yigF,8005750,8005750,8005598,152,224,utRho13
2171,yigI,8009448,8009448,8009394,54,0,utRho13
2172,yigM,8022100,8022152,8022100,52,0,utRho13
2173,yihA,8101970,8101970,8101458,512,4,utRho13
2174,yihD,8084098,8084138,8084098,40,80,utRho13
2175,yihF,8088110,8088398,8088110,288,36,utRho13
2176,yihG,8093304,8093304,8093204,100,0,utRho13
2177,yihI,8102616,8102694,8102616,78,36,utRho13
2178,yihL,8120506,8120894,8120506,388,40,utRho13
2179,yihN,8124332,8124494,8124332,162,58,utRho13
2180,yihO,8131942,8131942,8131532,410,0,utRho13
2181,yihQ,8138892,8138892,8138552,340,0,utRho13
2182,yihV,8147064,8147478,8147064,414,0,utRho13
2183,yihX,8151096,8151106,8151096,10,194,utRho13
2184,yiiE,8158192,8158582,8158192,390,0,utRho13
2185,yiiF,8159124,8159502,8159124,378,0,utRho13
2186,yiiG,8173762,8174004,8173762,242,0,utRho13
2187,yiiM,8205506,8205644,8205506,138,0,utRho13
2188,yiiQ,8224624,8224624,8224428,196,0,utRho13
2189,yiiS,8225738,8225934,8225738,196,0,utRho13
2190,yijE,8272178,8272216,8272178,38,74,utRho13
2191,yijF,8275728,8275728,8275314,414,130,utRho13
2192,yijO,8296858,8296858,8296634,224,68,utRho13
2193,yjaA,8426240,8426468,8426240,228,142522,utRho13
2194,yjaB,8428312,8428312,8428246,66,2,utRho13
2195,yjaG,8398746,8399008,8398746,262,364,utRho13
2196,yjaH,8401022,8401132,8401022,110,1504,utRho13
2197,yjaZ,8379506,8379572,8379506,66,0,utRho13
2198,yjbB,8455204,8455462,8455204,258,0,utRho13
2199,yjbE,16943432,16943624,16943432,192,172,utRho13
2200,yjbL,8520318,8520642,8520318,324,0,utRho13
2201,yjbQ,8540428,8540476,8540428,48,0,utRho13
2202,yjcB,8550328,8550328,8550082,246,4,utRho13
2203,yjcC,8550836,8550942,8550836,106,0,utRho13
2204,yjcD,8556628,8556958,8556628,330,232,utRho13
2205,yjcE,8559658,8559960,8559658,302,206,utRho13
2206,yjcF,8566212,8566212,8566150,62,0,utRho13
2207,yjcO,8594660,8594660,8594250,410,272,utRho13
2208,yjdA,8654128,8654270,8654128,142,0,utRho13
2209,yjdC,8726660,8726660,8726616,44,0,utRho13
2210,yjdK,8704780,8705168,8704780,388,24,utRho13
2211,yjdL,8713034,8713034,8712822,212,0,utRho13
2212,yjdM,8653672,8653672,8653468,204,208,utRho13
2213,yjeF,8787354,8788132,8787354,778,3632,utRho13
2214,yjeI,8745522,8745618,8745522,96,0,utRho13
2215,yjeJ,8748806,8748806,8748468,338,0,utRho13
2216,yjeV,8785472,8785784,8785472,312,128,utRho13
2217,yjfP,8833512,8833904,8833512,392,66,utRho13
2218,yjfY,8849656,8849656,8849582,74,0,utRho13
2219,yjfZ,8855052,8855052,8854844,208,0,utRho13
2220,yjgA,8916162,8916162,8915730,432,18,utRho13
2221,yjgL,8950802,8950874,8950802,72,0,utRho13
2222,yjgM,8959342,8959342,8959074,268,0,utRho13
2223,yjgN,8959132,8959460,8959132,328,0,utRho13
2224,yjgR,8980170,8980170,8980126,44,0,utRho13
2225,yjgZ,9002116,9002520,9002116,404,80,utRho13
2226,yjhB,9007764,9008116,9007764,352,212,utRho13
2227,yjhG,9048452,9048452,9048188,264,1404,utRho13
2228,yjhU,9041080,9041080,9040648,432,852,utRho13
2229,yjiA,9178096,9178096,9177730,366,10968,utRho13
2230,yjiJ,9125364,9125364,9125350,14,0,utRho13
2231,yjiK,9127270,9127270,9127422,152,84,utRho13
2232,yjiL,9129604,9129604,9129378,226,0,utRho13
2233,yjiS,9143410,9143502,9143410,92,0,utRho13
2234,yjiY,9182734,9182734,9182558,176,7534,utRho13
2235,yjjA,9200674,9200674,9200378,296,328,utRho13
2236,yjjB,18408708,18408708,18407800,908,0,utRho13
2237,yjjJ,9243314,9243538,9243314,224,0,utRho13
2238,yjjK,9261132,9261132,9261044,88,0,utRho13
2239,yjjL,9189764,9189764,9189444,320,164,utRho13
2240,yjjM,9191894,9191894,9191702,192,0,utRho13
2241,yjjP,9206068,9206068,9205716,352,4,utRho13
2242,yjjQ,9206638,9206954,9206638,316,0,utRho13
2243,yjjX,9267798,9267798,9267490,308,1214,utRho13
2244,yjjY,9280716,9280804,9280716,88,502,utRho13
2245,yjjZ,9211554,9211608,9211554,54,76,utRho13
2246,yjtD,9281676,9281884,9281676,208,0,utRho13
2247,ykfB,532454,532454,532174,280,384,utRho13
2248,ykfI,527636,527636,527338,298,0,utRho13
2249,ykgB,637050,637050,636638,412,0,utRho13
2250,ykgC,640430,640430,640002,428,0,utRho13
2251,ykgD,640232,640454,640232,222,0,utRho13
2252,ykgE,642962,643216,642962,254,22,utRho13
2253,ykgJ,608524,608524,608364,160,202,utRho13
2254,ykgL,623878,624224,623878,346,52,utRho13
2255,ykgM,625610,625610,625554,56,0,utRho13
2256,ykgR,626570,626570,626484,86,0,utRho13
2257,ylaC,958576,958576,958502,74,682,utRho13
2258,yliE,1745938,1745958,1745938,20,0,utRho13
2259,ymcE,2103660,2103694,2103660,34,0,utRho13
2260,ymdA,2210450,2210828,2210450,378,66,utRho13
2261,ymdB,2211428,2211640,2211428,212,96,utRho13
2262,ymfD,2395322,2395322,2395064,258,338,utRho13
2263,ymfI,2402880,2402994,2402880,114,32,utRho13
2264,ymfJ,2404518,2404518,2404168,350,90,utRho13
2265,ymfK,2406176,2406176,2405866,310,0,utRho13
2266,ymfT,2405766,2406048,2405766,282,92,utRho13
2267,ymgE,2489110,2489456,2489110,346,0,utRho13
2268,ymgF,2437628,2437966,2437628,338,32,utRho13
2269,ymiA,2670112,2670320,2670112,208,106,utRho13
2270,ymjA,2715620,2715620,2715336,284,244,utRho13
2271,ynaI,2791946,2791946,2791844,102,0,utRho13
2272,ynaK,2850438,2850754,2850438,316,0,utRho13
2273,ynbA,2954924,2955242,2954924,318,0,utRho13
2274,yncD,3046552,3046552,3046130,422,48,utRho13
2275,yncE,3046454,3046614,3046454,160,28,utRho13
2276,yncG,3052456,3052494,3052456,38,0,utRho13
2277,yncL,3034492,3034492,3034388,104,0,utRho13
2278,yneE,3218364,3218364,3218044,320,0,utRho13
2279,yneF,3223748,3223748,3223708,40,0,utRho13
2280,yneJ,3229560,3229608,3229560,48,0,utRho13
2281,yneK,3231100,3231526,3231100,426,0,utRho13
2282,yneM,3245176,3245292,3245176,116,0,utRho13
2283,ynfA,3311398,3311398,3311346,52,0,utRho13
2284,ynfB,3311418,3311616,3311418,198,242,utRho13
2285,ynfC,3315094,3315094,3314914,180,54,utRho13
2286,ynfD,3314828,3315130,3314828,302,54,utRho13
2287,ynfE,3316006,3316138,3316006,132,0,utRho13
2288,ynfK,3334670,3334670,3334438,232,200,utRho13
2289,ynfL,3339304,3339304,3339184,120,0,utRho13
2290,ynfM,3339260,3339398,3339260,138,0,utRho13
2291,ynfN,3276598,3276598,3276218,380,0,utRho13
2292,ynfO,3273454,3273512,3273454,58,0,utRho13
2293,ynhG,3517890,3517890,3517450,440,326,utRho13
2294,yniA,3615158,3615592,3615158,434,0,utRho13
2295,yniB,3618526,3618526,3618466,60,0,utRho13
2296,yniC,3618652,3618760,3618652,108,0,utRho13
2297,yniD,3610202,3610330,3610202,128,0,utRho13
2298,ynjE,3678880,3678934,3678880,54,0,utRho13
2299,ynjF,3683222,3683222,3682806,416,114,utRho13
2300,ynjH,3684376,3684376,3684270,106,0,utRho13
2301,ynjI,3690022,3690022,3689742,280,80,utRho13
2302,yoaB,3786642,3786734,3786642,92,92,utRho13
2303,yoaC,3787932,3788146,3787932,214,162,utRho13
2304,yoaE,3803544,3803544,3803170,374,292,utRho13
2305,yoaF,3755444,3755444,3755064,380,316,utRho13
2306,yoaH,3789866,3789866,3789462,404,774,utRho13
2307,yobB,3850418,3850880,3850418,462,780,utRho13
2308,yobF,3815586,3815586,3815182,404,36,utRho13
2309,yobH,3817800,3817850,3817800,50,0,utRho13
2310,yodB,4084352,4084736,4084352,384,0,utRho13
2311,yodC,4057008,4057008,4056740,268,0,utRho13
2312,yohC,4451358,4451358,4451262,96,0,utRho13
2313,yohD,4451526,4451602,4451526,76,0,utRho13
2314,yohJ,4460986,4461248,4460986,262,0,utRho13
2315,yohO,4431172,4431314,4431172,142,40,utRho13
2316,yojI,4617282,4617282,4617230,52,0,utRho13
2317,ypdI,4988988,4989396,4988988,408,0,utRho13
2318,ypfG,5165786,5165786,5165554,232,0,utRho13
2319,ypfM,5182140,5182140,5181732,408,2518,utRho13
2320,yphB,5349590,5349590,5349376,214,68,utRho13
2321,ypjA,5565644,5565644,5565452,192,0,utRho13
2322,ypjB,5569636,5569636,5568858,778,0,utRho13
2323,ypjD,5495860,5495774,5495860,86,0,utRho13
2324,yqaE,5594170,5594170,5594056,114,0,utRho13
2325,yqcA,5846100,5846100,5845968,132,0,utRho13
2326,yqcE,5800944,5801184,5800944,240,0,utRho13
2327,yqeC,6030468,6030468,6030114,354,480,utRho13
2328,yqeF,5971618,5971618,5971184,434,60,utRho13
2329,yqeG,5971438,5971694,5971438,256,144,utRho13
2330,yqeH,5975016,5975072,5975016,56,0,utRho13
2331,yqeI,5976688,5977004,5976688,316,0,utRho13
2332,yqeK,5981140,5981140,5980720,420,0,utRho13
2333,yqfA,6086728,6086728,6086296,432,306,utRho13
2334,yqgA,6219042,6219106,6219042,64,0,utRho13
2335,yqgB,6172500,6172500,6172102,398,1398,utRho13
2336,yqgE,6185768,6185874,6185768,106,980,utRho13
2337,yqhA,6299150,6299150,6298942,208,0,utRho13
2338,yqhC,6310768,6310768,6310436,332,246,utRho13
2339,yqhD,6310604,6310710,6310604,106,118,utRho13
2340,yqhH,6316842,6317254,6316842,412,136,utRho13
2341,yqiC,6369662,6369680,6369662,18,0,utRho13
2342,yqiJ,6384108,6384416,6384108,308,6,utRho13
2343,yqjA,6495096,6495546,6495096,450,798,utRho13
2344,yqjF,6500932,6501124,6500932,192,64,utRho13
2345,yqjG,6501948,6502048,6501948,100,0,utRho13
2346,yqjH,6433078,6433078,6432982,96,0,utRho13
2347,yqjI,6433506,6433558,6433506,52,0,utRho13
2348,yraH,6574552,6574852,6574552,300,0,utRho13
2349,yraP,6592144,6592818,6592144,674,868,utRho13
2350,yraQ,6596414,6596414,6596276,138,0,utRho13
2351,yraR,6598024,6598024,6597692,332,0,utRho13
2352,yrbG,13360844,13361100,13360844,256,0,utRho13
2353,yrbL,6696842,6696904,6696842,62,100,utRho13
2354,yrbN,6616172,6616172,6615866,306,502,utRho13
2355,yrdB,6860176,6860176,6860046,130,0,utRho13
2356,yrfF,7052548,7052938,7052548,390,304,utRho13
2357,yrhB,7169440,7169518,7169440,78,0,utRho13
2358,ysaB,7451804,7451804,7451424,380,48,utRho13
2359,ysgA,8032686,8032686,8032338,348,202,utRho13
2360,ytfB,8857638,8857638,8857434,204,54,utRho13
2361,ytfE,8864018,8864018,8863966,52,0,utRho13
2362,ytfF,8866296,8866296,8866130,166,0,utRho13
2363,ytfH,8868164,8868226,8868164,62,0,utRho13
2364,ytfI,8875234,8875414,8875234,180,0,utRho13
2365,ytfJ,8878572,8878572,8878524,48,226,utRho13
2366,ytfK,8879022,8879174,8879022,152,2596,utRho13
2367,ytfL,8882642,8882642,8882430,212,0,utRho13
2368,ytfQ,8899634,8899924,8899634,290,110,utRho13
2369,ytjB,9249598,9249598,9249578,20,68,utRho13
2370,yzfA,8896588,8896588,8896490,98,0,utRho13
2371,zapA,6111102,6111224,6111102,122,4052,utRho13
2372,zapB,8236772,8237030,8236772,258,138,utRho13
2373,zapC,2011700,2011904,2011700,204,0,utRho13
2374,zinT,4082692,4082750,4082692,58,0,utRho13
2375,zipA,5062814,5062814,5062466,348,0,utRho13
2376,zitB,1569716,1569716,1569646,70,0,utRho13
2377,zntA,7212844,7212902,7212844,58,0,utRho13
2378,zntR,6878336,6878336,6878260,76,66,utRho13
2379,znuA,3885322,3885322,3885166,156,2,utRho13
2380,znuC,3885268,3885324,3885268,56,2,utRho13
2381,zraP,8403424,8403424,8403376,48,0,utRho13
2382,zraS,8403810,8403852,8403810,42,0,utRho13
2383,zupT,6364866,6365100,6364866,234,460,utRho13
2384,zur,8520282,8520282,8520006,276,650,utRho13
2385,zwf,3872752,3872752,3872628,124,62,utRho13
0,C0343,2818676,2818728,2818676,52,0,utRho14
1,aaeB,6776526,6776526,6776376,150,0,utRho14
2,aaeR,6778762,6779040,6778762,278,54,utRho14
3,aaeX,6778860,6778860,6778674,186,160,utRho14
4,aat,1854920,1854920,1854864,56,0,utRho14
5,accA,416822,417242,416822,420,2900,utRho14
6,accB,6810280,6810872,6810280,592,11460,utRho14
7,accD,4868030,4868030,4867852,178,286,utRho14
8,aceB,8430804,8430956,8430804,152,48,utRho14
9,aceE,245938,246034,245938,96,128,utRho14
10,ackA,4826918,4826940,4826918,22,2098,utRho14
11,acnA,2670848,2671662,2670848,814,926,utRho14
12,acnB,263038,263230,263038,192,1398,utRho14
13,acpP,2303148,2303230,2303148,82,956,utRho14
14,acpS,5402324,5402324,5401996,328,446,utRho14
15,acrA,971396,971396,971238,158,64,utRho14
16,acrB,969370,969370,968806,564,4716,utRho14
17,acrD,5174950,5175190,5174950,240,0,utRho14
18,acrE,6827404,6827728,6827404,324,0,utRho14
19,acrR,971398,971522,971398,124,270,utRho14
20,acrZ,1589502,1589546,1589502,44,50,utRho14
21,acs,8575190,8575190,8574742,448,314,utRho14
22,actP,8569870,8569870,8569804,66,0,utRho14
23,ada,4620854,4620854,4620810,44,0,utRho14
24,add,3404404,3404466,3404404,62,262,utRho14
25,ade,7687802,7687928,7687802,126,0,utRho14
26,adhE,2596826,2596826,2596242,584,52,utRho14
27,adhP,3107988,3107988,3107676,312,3514,utRho14
28,adiA,8681112,8681112,8681042,70,0,utRho14
29,adiC,8674404,8674404,8674062,342,0,utRho14
30,adiY,8676084,8676084,8675858,226,0,utRho14
31,adk,994278,994350,994278,72,156,utRho14
32,adrA,807374,807406,807374,32,0,utRho14
33,aer,6438240,6438240,6438152,88,76,utRho14
34,aes,1000102,1000102,999946,156,200,utRho14
35,agaR,6557406,6557406,6557330,76,0,utRho14
36,agaS,6563778,6563952,6563778,174,0,utRho14
37,agp,2131118,2131170,2131118,52,108,utRho14
38,agrA,7296126,7296126,7296126,0,0,utRho14
39,agrB,7296588,7296588,7296588,0,0,utRho14
40,ahpC,1277386,1277890,1277386,504,2866,utRho14
41,ahpF,1278004,1279506,1278004,1502,200352,utRho14
42,ahr,8992698,8992698,8992418,280,0,utRho14
43,aidB,8828494,8828550,8828494,56,0,utRho14
44,ais,4731512,4731512,4731240,272,0,utRho14
45,alaA,4814816,4815122,4814816,306,0,utRho14
46,alaC,4996798,4996798,4996590,208,86,utRho14
47,alaE,5598140,5598328,5598140,188,430,utRho14
48,alaS,5644180,5644180,5644022,158,8150,utRho14
49,alaW,5036612,5036612,5036462,150,0,utRho14
50,aldA,2976380,2976464,2976380,84,1042,utRho14
51,aldB,7513070,7513070,7513022,48,0,utRho14
52,alkA,4295118,4295118,4295080,38,0,utRho14
53,alkB,4618890,4618890,4618682,208,2,utRho14
54,allA,1064780,1064902,1064780,122,0,utRho14
55,allD,1092822,1092822,1092726,96,0,utRho14
56,allE,1088112,1088112,1088092,20,0,utRho14
57,allS,1064600,1064600,1064442,158,0,utRho14
58,alr,8531178,8531564,8531178,386,2042,utRho14
59,alsE,8617334,8617334,8616956,378,174,utRho14
60,alsK,8615990,8615990,8615598,392,56,utRho14
61,alx,6476740,6477160,6476740,420,88,utRho14
62,amiA,5104482,5104704,5104482,222,0,utRho14
63,amiC,5898378,5898378,5898020,358,2,utRho14
64,amn,4110062,4110122,4110062,60,0,utRho14
65,ampC,8758006,8758006,8757888,118,122,utRho14
66,ampD,237362,237466,237362,104,194,utRho14
67,ampG,907372,907372,907090,282,1140,utRho14
68,ampH,792726,792726,792574,152,178,utRho14
69,amyA,4012230,4012312,4012230,82,0,utRho14
70,anmK,3439346,3439346,3439204,142,0,utRho14
71,ansB,6201580,6201580,6201456,124,0,utRho14
72,ansP,3052040,3052040,3051960,80,58,utRho14
73,apaG,104068,104068,103212,856,6356,utRho14
74,apaH,102586,102586,102444,142,3130,utRho14
75,apbE,4623188,4623188,4623068,120,0,utRho14
76,appA,2081198,2081234,2081198,36,0,utRho14
77,appC,2075420,2075480,2075420,60,0,utRho14
78,appY,1167134,1167362,1167134,228,0,utRho14
79,apt,982620,982824,982620,204,142,utRho14
80,aqpZ,1832424,1832424,1832094,330,28,utRho14
81,araB,140150,140150,140096,54,0,utRho14
82,araC,140482,140774,140482,292,1876,utRho14
83,araE,5964416,5964416,5964364,52,0,utRho14
84,araF,3972476,3972476,3972256,220,0,utRho14
85,araH,3967120,3967120,3967086,34,0,utRho14
86,araJ,825058,825058,824962,96,24,utRho14
87,arcA,9281602,9281602,9280612,990,14848,utRho14
88,arcB,6706098,6706098,6706050,48,0,utRho14
89,arcZ,6701154,6701154,6701154,0,0,utRho14
90,arfA,6877346,6877346,6877298,48,0,utRho14
91,argA,5898312,5898484,5898312,172,0,utRho14
92,argC,8309770,8310002,8309770,232,0,utRho14
93,argD,6980442,6980442,6980360,82,0,utRho14
94,argE,8310156,8310156,8309694,462,18,utRho14
95,argF,580680,580680,580610,70,0,utRho14
96,argG,6637124,6637274,6637124,150,228,utRho14
97,argI,8956688,8956688,8956622,66,0,utRho14
98,argO,6137672,6137672,6137616,56,4,utRho14
99,argP,6119460,6119506,6119460,46,0,utRho14
100,argR,6769204,6769406,6769204,202,72,utRho14
101,argS,3920002,3920124,3920002,122,0,utRho14
102,argT,4855698,4855698,4855582,116,110,utRho14
103,argU,1129406,1129446,1129406,40,0,utRho14
104,argW,4932616,4932618,4932616,2,0,utRho14
105,argX,7964728,7964750,7964728,22,0,utRho14
106,aroF,5482402,5482402,5482300,102,0,utRho14
107,aroG,1571182,1571266,1571182,84,512,utRho14
108,aroH,3576636,3576870,3576636,234,1204,utRho14
109,aroK,7038760,7038760,7038128,632,1130,utRho14
110,aroL,812560,812810,812560,250,112,utRho14
111,aroP,243342,243342,243102,240,0,utRho14
112,arpA,8445382,8445382,8444974,408,0,utRho14
113,arrS,7316108,7316108,7316108,0,0,utRho14
114,arsR,7297024,7297056,7297024,32,0,utRho14
115,artJ,1801252,1801252,1801150,102,0,utRho14
116,artP,1807686,1807686,1807468,218,10,utRho14
117,ascF,5678858,5679048,5678858,190,0,utRho14
118,ascG,5678574,5678574,5678528,46,0,utRho14
119,aslB,7965562,7965916,7965562,354,484,utRho14
120,asnA,7854258,7854310,7854258,52,88,utRho14
121,asnB,1398444,1398444,1398354,90,44,utRho14
122,asnC,23562186,23562186,23562018,168,0,utRho14
123,asnS,1978088,1978088,1977970,118,17084,utRho14
124,asnT,4089082,4089098,4089082,16,518,utRho14
125,asnU,4119690,4119702,4119690,12,20,utRho14
126,asnV,4124504,4124520,4124504,16,24,utRho14
127,aspA,17473728,17473728,17473308,420,260,utRho14
128,aspC,1971486,1971486,1971418,68,284,utRho14
129,aspS,3901402,3901402,3901044,358,504,utRho14
130,aspT,7893560,7893744,7893560,184,132840,utRho14
131,aspV,473826,473862,473826,36,20,utRho14
132,asr,3342654,3342752,3342654,98,0,utRho14
133,astC,3664088,3664088,3663964,124,0,utRho14
134,astE,3654138,3654138,3653846,292,0,utRho14
135,atoD,4646824,4646894,4646824,70,4,utRho14
136,atpB,7844540,7844540,7844102,438,926,utRho14
137,atpC,7832118,7832118,7831944,174,1884,utRho14
138,atpI,7845050,7845050,7844880,170,140,utRho14
139,avtA,7479348,7479410,7479348,62,56,utRho14
140,azoR,2965982,2965982,2965720,262,2,utRho14
141,azuC,3976002,3976002,3975918,84,2,utRho14
142,bacA,6408350,6408350,6408262,88,4,utRho14
143,bamA,394052,395856,394052,1804,1894,utRho14
144,bamB,5277950,5277950,5277304,646,1648,utRho14
145,bamC,5198028,5198028,5197730,298,1922,utRho14
146,bamD,5471922,5472292,5471922,370,2468,utRho14
147,bamE,5506972,5507210,5506972,238,1032,utRho14
148,basS,8666954,8666954,8666544,410,840,utRho14
149,bax,7474468,7474468,7474354,114,4,utRho14
150,bcp,5200874,5200956,5200874,82,6812,utRho14
151,bcsB,7385346,7385346,7385214,132,0,utRho14
152,bcsE,7392644,7392916,7392644,272,0,utRho14
153,bdcA,8948128,8948128,8948106,22,2,utRho14
154,bdcR,8948192,8948248,8948192,56,0,utRho14
155,bdm,3112680,3112680,3112560,120,0,utRho14
156,betA,654522,654522,654494,28,204,utRho14
157,betI,658722,658722,658668,54,0,utRho14
158,betT,658842,658926,658842,84,0,utRho14
159,bfr,6933498,6933498,6933450,48,0,utRho14
160,bglG,23440182,23440182,23439402,780,552,utRho14
161,bglX,4444240,4444240,4443978,262,0,utRho14
162,bhsA,2337962,2338146,2337962,184,0,utRho14
163,bioA,1618584,1618584,1618514,70,0,utRho14
164,bioB,1618604,1618688,1618604,84,44,utRho14
165,bioH,7089716,7089716,7089688,28,0,utRho14
166,bisC,7433026,7433026,7432788,238,32,utRho14
167,blc,8755490,8755490,8755444,46,0,utRho14
168,blr,3409024,3409102,3409024,78,82,utRho14
169,bluF,2431226,2431226,2430950,276,0,utRho14
170,bluR,2428226,2428226,2428118,108,0,utRho14
171,bolA,908698,908944,908698,246,0,utRho14
172,borD,1157842,1157842,1157786,56,84,utRho14
173,brnQ,838976,839182,838976,206,708,utRho14
174,bssR,1756492,1756496,1756492,4,0,utRho14
175,bssS,2242116,2242116,2241910,206,0,utRho14
176,btuB,8326798,8327278,8326798,480,5226,utRho14
177,cadB,8720212,8720212,8720062,150,0,utRho14
178,cadC,8723926,8723926,8723868,58,0,utRho14
179,caiE,70998,70998,70742,256,0,utRho14
180,caiF,68436,68600,68436,164,2,utRho14
181,caiT,84074,84074,83862,212,0,utRho14
182,can,285406,285406,285340,66,0,utRho14
183,carA,59102,59302,59102,200,0,utRho14
184,carB,61550,61634,61550,84,228,utRho14
185,cas2,5757830,5757830,5757706,124,0,utRho14
186,casA,5768638,5768638,5768276,362,0,utRho14
187,cbl,4121882,4121882,4121828,54,0,utRho14
188,cbpA,2128074,2128074,2127550,524,0,utRho14
189,cbrA,7738628,7738754,7738628,126,0,utRho14
190,cbrB,7794958,7795012,7794958,54,0,utRho14
191,ccmH,4585242,4585242,4584820,422,4,utRho14
192,cdaR,364894,364926,364894,32,4,utRho14
193,cdd,4463638,4463688,4463638,50,0,utRho14
194,cdh,8219814,8219860,8219814,46,0,utRho14
195,cdsA,391110,391354,391110,244,1148,utRho14
196,cedA,3627484,3627484,3627326,158,0,utRho14
197,cfa,3482402,3482826,3482402,424,120,utRho14
198,chaC,2544844,2544972,2544844,128,0,utRho14
199,chbB,3643452,3643452,3643238,214,0,utRho14
200,chbG,3634624,3634624,3634270,354,0,utRho14
201,cheW,3946924,3946924,3946678,246,722,utRho14
202,chiA,6939792,6939792,6939706,86,0,utRho14
203,chiP,1416472,1416668,1416472,196,8,utRho14
204,cho,3646984,3647030,3646984,46,0,utRho14
205,chpS,8896804,8896894,8896804,90,2,utRho14
206,cirA,4493884,4493884,4493538,346,2,utRho14
207,citC,1304078,1304078,1303712,366,0,utRho14
208,citT,1293264,1293264,1293160,104,0,utRho14
209,clcA,350104,350214,350104,110,0,utRho14
210,clpA,1846160,1846528,1846160,368,334,utRho14
211,clpB,5468410,5468410,5468346,64,24,utRho14
212,clpP,913154,913354,913154,200,1634,utRho14
213,clpS,1845500,1845826,1845500,326,0,utRho14
214,clpX,914404,914852,914404,448,4396,utRho14
215,clsA,2617346,2617346,2617290,56,0,utRho14
216,clsC,2212584,2212710,2212584,126,794,utRho14
217,cmk,1922330,1922402,1922330,72,0,utRho14
218,cnu,3409522,3409898,3409522,376,770,utRho14
219,coaA,8350214,8350214,8350052,162,588,utRho14
220,cobC,1340092,1340092,1339814,278,152,utRho14
221,cobT,4129202,4129202,4128934,268,38,utRho14
222,cobU,4131944,4131944,4131528,416,0,utRho14
223,codB,709768,709844,709768,76,0,utRho14
224,comR,2337726,2337726,2337664,62,0,utRho14
225,copA,1022822,1022822,1022758,64,0,utRho14
226,corA,8002388,8002852,8002388,464,6632,utRho14
227,cpdB,8873258,8873258,8873130,128,368,utRho14
228,cptB,6082198,6082198,6082140,58,0,utRho14
229,cpxA,8210202,8210202,8209950,252,356,utRho14
230,cpxP,8211570,8211640,8211570,70,0,utRho14
231,cpxR,8211372,8211372,8211340,32,0,utRho14
232,cra,175894,176056,175894,162,0,utRho14
233,crcB,1316016,1316016,1315876,140,0,utRho14
234,creA,9270486,9271042,9270486,556,670,utRho14
235,creD,9276320,9276356,9276320,36,0,utRho14
236,crl,515620,515658,515620,38,430,utRho14
237,crp,6971906,6972240,6971906,334,8960,utRho14
238,crr,5070960,5071668,5070960,708,6010,utRho14
239,csdA,5886414,5886674,5886414,260,0,utRho14
240,csgB,2207718,2207902,2207718,184,0,utRho14
241,csgD,2206688,2206688,2206392,296,0,utRho14
242,csgG,2203510,2203510,2203368,142,0,utRho14
243,csiD,5577854,5577970,5577854,116,134,utRho14
244,csiE,5330802,5330870,5330802,68,0,utRho14
245,csiR,5590942,5591348,5590942,406,0,utRho14
246,cspA,7439778,7440098,7439778,320,2378,utRho14
247,cspB,3283430,3283430,3283108,322,0,utRho14
248,cspC,3815018,3815018,3814870,148,2086,utRho14
249,cspD,1845352,1845352,1845180,172,21790,utRho14
250,cspE,1314294,1314584,1314294,290,2,utRho14
251,cspF,3283380,3283710,3283380,330,2,utRho14
252,cspG,2102610,2102922,2102610,312,282,utRho14
253,cspH,2102746,2102746,2102350,396,0,utRho14
254,cspI,3277624,3277624,3277334,290,0,utRho14
255,csrA,5638746,5638746,5638292,454,2592,utRho14
256,csrB,5849048,5849048,5849048,0,0,utRho14
257,csrC,8102072,8102072,8102072,0,0,utRho14
258,csrD,6806850,6806850,6806664,186,100,utRho14
259,cstA,1259710,1259788,1259710,78,0,utRho14
260,cueO,274090,274166,274090,76,0,utRho14
261,cueR,1027948,1027986,1027948,38,0,utRho14
262,curA,3037784,3038054,3037784,270,0,utRho14
263,cusC,1191146,1191200,1191146,54,0,utRho14
264,cusR,1190924,1190924,1190886,38,12,utRho14
265,cutA,8730784,8730784,8730712,72,0,utRho14
266,cutC,3918534,3918534,3917920,614,410,utRho14
267,cvpA,4861600,4861600,4861526,74,72,utRho14
268,cvrA,2484328,2484328,2484142,186,0,utRho14
269,cyaA,7981548,7982306,7981548,758,1716,utRho14
270,cyaR,4334228,4334224,4334228,4,0,utRho14
271,cyaY,7988166,7988166,7988118,48,120,utRho14
272,cybB,2981522,2981804,2981522,282,0,utRho14
273,cycA,8859560,8859728,8859560,168,924,utRho14
274,cydA,1542340,1542916,1542340,576,118,utRho14
275,cydC,1858800,1858800,1858390,410,380,utRho14
276,cydD,1862062,1862062,1861924,138,0,utRho14
277,cydX,1548300,1548392,1548300,92,330,utRho14
278,cynR,717418,717418,717380,38,0,utRho14
279,cynT,1435092,1435196,1435092,104,0,utRho14
280,cyoA,903306,903306,903220,86,6468,utRho14
281,cyoE,895540,895540,895410,130,970,utRho14
282,cysB,2667576,2667710,2667576,134,316,utRho14
283,cysC,5748056,5748056,5747984,72,0,utRho14
284,cysD,5752736,5752736,5752658,78,0,utRho14
285,cysE,7565362,7565362,7565124,238,3896,utRho14
286,cysG,6995508,6995656,6995508,148,4,utRho14
287,cysJ,5783928,5783928,5783796,132,280,utRho14
288,cysK,5064688,5064818,5064688,130,568,utRho14
289,cysP,5087114,5087114,5087056,58,0,utRho14
290,cysS,1109154,1109222,1109154,68,172,utRho14
291,cysT,3984100,3984100,3983974,126,162,utRho14
292,cysZ,5062766,5062926,5062766,160,162,utRho14
293,cytR,8249018,8249018,8248912,106,60,utRho14
294,dacA,1328002,1328002,1327926,76,492,utRho14
295,dacB,6657714,6657926,6657714,212,0,utRho14
296,dacC,1761306,1761454,1761306,148,0,utRho14
297,dadA,2475018,2475142,2475018,124,22,utRho14
298,dam,7032504,7032504,7031826,678,1606,utRho14
299,damX,7035200,7035200,7034612,588,738,utRho14
300,dapA,5199568,5199568,5199520,48,0,utRho14
301,dapB,56576,56748,56576,172,2,utRho14
302,dapD,371954,371954,371894,60,218,utRho14
303,dapE,5183120,5183214,5183120,94,1652,utRho14
304,dcp,3254844,3254844,3254760,84,220,utRho14
305,dcrB,7219534,7219910,7219534,376,150,utRho14
306,dctA,7366996,7366996,7366894,102,794,utRho14
307,dcuA,8733686,8733686,8733546,140,0,utRho14
308,dcuB,8698182,8698182,8697488,694,184,utRho14
309,dcuC,1312166,1312166,1311936,230,0,utRho14
310,dcuD,6749166,6749738,6749166,572,0,utRho14
311,dcuR,8701130,8701130,8700068,1062,566,utRho14
312,dcuS,8703370,8703370,8703324,46,2,utRho14
313,dcyD,3999016,3999016,3998960,56,0,utRho14
314,ddpX,3126498,3126498,3126152,346,0,utRho14
315,deaD,6615818,6615818,6615720,98,160,utRho14
316,dedA,4869880,4869880,4869482,398,5816,utRho14
317,dedD,4863750,4863750,4863368,382,158,utRho14
318,def,6867300,6867380,6867300,80,0,utRho14
319,degP,361690,361768,361690,78,0,utRho14
320,degQ,6761308,6761486,6761308,178,556,utRho14
321,deoB,9239134,9239206,9239134,72,0,utRho14
322,deoC,9233358,9234646,9233358,1288,964,utRho14
323,dfp,7625406,7625462,7625406,56,66,utRho14
324,dgcZ,3247758,3247758,3247700,58,0,utRho14
325,dgkA,8512914,8513274,8512914,360,1028,utRho14
326,dgt,358392,358474,358392,82,0,utRho14
327,dhaK,2501888,2501888,2501676,212,1158,utRho14
328,dhaR,2502006,2502132,2502006,126,0,utRho14
329,dicB,3299194,3299218,3299194,24,0,utRho14
330,dicC,3295752,3295752,3295700,52,0,utRho14
331,dinB,501760,501796,501760,36,0,utRho14
332,dinD,7635398,7635520,7635398,122,0,utRho14
333,dinG,1666146,1666140,1666146,6,0,utRho14
334,dinI,2243018,2243018,2242974,44,0,utRho14
335,dinJ,493230,493230,493004,226,72,utRho14
336,dinQ,7295964,7295964,7295576,388,738,utRho14
337,djlA,114536,114728,114536,192,0,utRho14
338,dkgA,6313142,6313246,6313142,104,422,utRho14
339,dkgB,458196,458334,458196,138,0,utRho14
340,dksA,321502,321502,321208,294,1830,utRho14
341,dld,4444164,4444370,4444164,206,38,utRho14
342,dmlA,3763424,3763824,3763424,400,194,utRho14
343,dmlR,3763710,3763710,3763618,92,26,utRho14
344,dmsA,1881646,1881918,1881646,272,0,utRho14
345,dnaA,7767922,7767922,7767458,464,620,utRho14
346,dnaB,8528566,8528628,8528566,62,36,utRho14
347,dnaK,24096,24326,24096,230,3572,utRho14
348,dnaN,7765466,7765466,7764642,824,540,utRho14
349,dnaQ,471868,472134,471868,266,1032,utRho14
350,dnaT,18406460,18406460,18406068,392,8,utRho14
351,dnaX,984112,984184,984112,72,80,utRho14
352,dosP,3131486,3131486,3131466,20,0,utRho14
353,dpiB,1303968,1304470,1303968,502,0,utRho14
354,dppA,7415740,7415740,7415410,330,4686,utRho14
355,dps,1697900,1697900,1697822,78,0,utRho14
356,dsbA,8086754,8086836,8086754,82,2404,utRho14
357,dsbB,2466294,2466294,2466060,234,0,utRho14
358,dsbC,6079266,6079266,6077644,1622,618,utRho14
359,dsbG,1277600,1277600,1277146,454,956,utRho14
360,dsdA,4958242,4958404,4958242,162,2534,utRho14
361,dsdC,4955492,4955492,4955258,234,0,utRho14
362,dsdX,4955642,4955694,4955642,52,0,utRho14
363,dsrA,4050626,4050626,4050626,0,0,utRho14
364,dsrB,4049686,4049686,4049646,40,0,utRho14
365,dtpD,1485340,1485340,1485112,228,0,utRho14
366,dusA,8523200,8523338,8523200,138,1406,utRho14
367,dusB,6820492,6820560,6820492,68,2,utRho14
368,dusC,4460790,4460790,4460770,20,0,utRho14
369,dut,7627704,7627864,7627704,160,2460,utRho14
370,dxr,386670,387042,386670,372,1832,utRho14
371,ebgA,6445102,6445266,6445102,164,0,utRho14
372,ebgR,6442874,6442932,6442874,58,372,utRho14
373,ecnB,8753018,8753106,8753018,88,148,utRho14
374,eco,4607594,4607810,4607594,216,0,utRho14
375,ecpA,621594,621594,621342,252,0,utRho14
376,ecpB,620238,620238,620052,186,0,utRho14
377,ecpR,622964,622964,622672,292,0,utRho14
378,eda,3866218,3866218,3865512,706,184,utRho14
379,edd,3869426,3869426,3869208,218,66,utRho14
380,efeO,2164308,2164486,2164308,178,48,utRho14
381,efeU_1,2162614,2162712,2162614,98,0,utRho14
382,efp,8751134,8751398,8751134,264,3322,utRho14
383,elaA,4763372,4763372,4763086,286,108,utRho14
384,elaD,4765308,4765426,4765308,118,0,utRho14
385,elfA,1995530,1995736,1995530,206,0,utRho14
386,elfD,1996642,1996980,1996642,338,0,utRho14
387,emrD,7707690,7707844,7707690,154,0,utRho14
388,emrK,4966896,4966896,4966678,218,0,utRho14
389,emrY,4964668,4964668,4964352,316,0,utRho14
390,emtA,2486250,2486360,2486250,110,0,utRho14
391,endA,12361100,12361388,12361100,288,0,utRho14
392,eno,5817692,5817692,5815882,1810,3984,utRho14
393,entC,1249662,1249770,1249662,108,12,utRho14
394,entD,1220508,1220508,1220158,350,0,utRho14
395,entH,1258584,1258600,1258584,16,84,utRho14
396,entS,1244506,1244600,1244506,94,0,utRho14
397,envR,6827266,6827266,6826930,336,0,utRho14
398,epd,12295292,12295292,12294764,528,0,utRho14
399,epmA,8765236,8765286,8765236,50,0,utRho14
400,epmB,8751406,8751406,8751314,92,2152,utRho14
401,eptB,7421162,7421162,7420950,212,204,utRho14
402,eptC,8300622,8300622,8300530,92,48,utRho14
403,erfK,4126708,4126708,4126646,62,42,utRho14
404,erpA,353122,353220,353122,98,0,utRho14
405,esrE,8039956,8039956,8039956,0,0,utRho14
406,essD,1153746,1154796,1153746,1050,2,utRho14
407,etk,2088606,2088606,2088420,186,126,utRho14
408,evgA,4967262,4967510,4967262,248,0,utRho14
409,exbB,6304028,6304028,6303968,60,0,utRho14
410,exbD,6302780,6302780,6302486,294,166,utRho14
411,exuR,6493016,6493304,6493016,288,160,utRho14
412,exuT,6490004,6490208,6490004,204,0,utRho14
413,fabA,2032996,2032996,2032940,56,0,utRho14
414,fabB,4883282,4883282,4883210,72,0,utRho14
415,fabH,2297032,2297518,2297032,486,1976,utRho14
416,fabI,2702236,2702236,2702078,158,34,utRho14
417,fadB,8062026,8062026,8061942,84,0,utRho14
418,fadD,3779614,3779614,3779492,122,0,utRho14
419,fadE,486812,486812,486606,206,0,utRho14
420,fadH,6463248,6463330,6463248,82,0,utRho14
421,fadI,4921022,4921022,4920938,84,0,utRho14
422,fadL,4922410,4922600,4922410,190,362,utRho14
423,fadM,928720,928804,928720,84,2,utRho14
424,fadR,2469810,2469876,2469810,66,0,utRho14
425,fbaB,4357334,4357334,4357128,206,0,utRho14
426,fdhE,8162722,8162722,8162456,266,2736,utRho14
427,fdhF,8598814,8598814,8598732,82,0,utRho14
428,fdnG,3094744,3094802,3094744,58,0,utRho14
429,fdrA,1093012,1093360,1093012,348,0,utRho14
430,feaB,2894994,2895038,2894994,44,0,utRho14
431,feaR,2894734,2894734,2894566,168,300,utRho14
432,fecA,9033454,9033454,9033354,100,0,utRho14
433,fecE,9023288,9023288,9022914,374,3008,utRho14
434,fecI,9036564,9036564,9036470,94,0,utRho14
435,feoA,7080114,7080326,7080114,212,58,utRho14
436,fepA,1225334,1225334,1224988,346,0,utRho14
437,fepB,1249454,1249454,1249020,434,724,utRho14
438,fepD,1244468,1244468,1244378,90,0,utRho14
439,fes,1225374,1225630,1225374,256,72,utRho14
440,ffh,5495706,5495706,5495590,116,792,utRho14
441,ffs,952576,952848,952576,272,0,utRho14
442,fhuA,334884,334968,334884,84,0,utRho14
443,fhuE,2323294,2323294,2323102,192,56,utRho14
444,fhuF,9211504,9211504,9211326,178,230,utRho14
445,fic,6983296,6983296,6982926,370,120,utRho14
446,fieF,8212864,8212938,8212864,74,0,utRho14
447,fimA,9085388,9086230,9085388,842,618,utRho14
448,fimB,9081334,9081914,9081334,580,1038,utRho14
449,fimE,9083742,9084074,9083742,332,44,utRho14
450,fimZ,1129214,1129214,1128960,254,0,utRho14
451,fiu,1683296,1683296,1683062,234,0,utRho14
452,fixA,84650,84806,84650,156,0,utRho14
453,fkpA,6955050,6955050,6954838,212,11198,utRho14
454,fldA,2846084,2846084,2845860,224,4072,utRho14
455,fldB,6079644,6079710,6079644,66,0,utRho14
456,flgA,2261770,2261770,2261726,44,2,utRho14
457,flgB,2261986,2262036,2261986,50,0,utRho14
458,flgK,2276702,2276756,2276702,54,664,utRho14
459,flgM,2260330,2260330,2260256,74,1168,utRho14
460,flgN,2259828,2259828,2259660,168,98,utRho14
461,flhB,3932432,3932432,3932382,50,394,utRho14
462,flhC,3955864,3955864,3955688,176,120,utRho14
463,flhD,3957154,3957154,3956394,760,582,utRho14
464,fliA,4003638,4003638,4003578,60,2,utRho14
465,fliC,4007352,4007352,4007212,140,90,utRho14
466,fliD,4007634,4007744,4007634,110,194,utRho14
467,fliE,4026186,4026186,4026028,158,0,utRho14
468,fliF,4026292,4026458,4026292,166,288,utRho14
469,fliL,4039168,4039236,4039168,68,184,utRho14
470,flk,4875824,4875900,4875824,76,0,utRho14
471,flu,4142634,4143078,4142634,444,32,utRho14
472,flxA,3292776,3292810,3292776,34,16,utRho14
473,fnr,2799104,2799104,2799052,52,0,utRho14
474,fnrS,2818258,2818258,2818258,0,0,utRho14
475,focA,1909628,1909628,1908932,696,0,utRho14
476,folA,99598,99646,99598,48,0,utRho14
477,folB,6409296,6409296,6409178,118,0,utRho14
478,folD,1115562,1115562,1115482,80,180,utRho14
479,folE,4487696,4487696,4487304,392,4010,utRho14
480,fpr,8228998,8228998,8228944,54,0,utRho14
481,frc,4986878,4986878,4986508,370,0,utRho14
482,frdA,8764824,8764824,8764636,188,24,utRho14
483,frdD,8758948,8758948,8758732,216,2828,utRho14
484,fre,8052886,8053054,8052886,168,2728,utRho14
485,frlA,6999518,6999820,6999518,302,2,utRho14
486,frr,385624,385744,385624,120,2398,utRho14
487,frsA,513004,513054,513004,50,18,utRho14
488,fruB,4527194,4527194,4526990,204,0,utRho14
489,frvR,8179804,8179804,8179710,94,0,utRho14
490,fryA,5008986,5008986,5008970,16,0,utRho14
491,fsaA,1727060,1727284,1727060,224,2,utRho14
492,fsr,1009710,1009710,1009392,318,214,utRho14
493,ftnA,3977364,3977432,3977364,68,116,utRho14
494,ftnB,3973550,3973850,3973550,300,110,utRho14
495,ftsA,207122,207964,207122,842,1068,utRho14
496,ftsB,5745802,5745802,5745640,162,36,utRho14
497,ftsH,6654204,6654204,6653870,334,1094,utRho14
498,ftsK,1865858,1866448,1865858,590,1342,utRho14
499,ftsL,181376,182064,181376,688,2588,utRho14
500,ftsP,6325732,6325732,6325338,394,74,utRho14
501,ftsQ,205484,206310,205484,826,226,utRho14
502,ftsX,7204512,7204512,7204172,340,1692,utRho14
503,ftsZ,209272,210610,209272,1338,312,utRho14
504,fucA,5867708,5867708,5867376,332,8,utRho14
505,fucP,5868238,5868470,5868238,232,4,utRho14
506,fumA,6753760,6753760,6753508,252,16524,utRho14
507,fumB,8694696,8694696,8694652,44,0,utRho14
508,fumC,3373418,3373418,3373176,242,0,utRho14
509,fur,2842892,2842892,2842584,308,6356,utRho14
510,fusA,6947370,6947370,6947028,342,26422,utRho14
511,fxsA,8737206,8737328,8737206,122,224,utRho14
512,gabD,5581824,5582546,5581824,722,4820,utRho14
513,gadA,7335214,7335214,7335160,54,0,utRho14
514,gadB,3144144,3144144,3144090,54,0,utRho14
515,gadC,3141168,3141168,3140978,190,2,utRho14
516,gadE,7315600,7316732,7315600,1132,2,utRho14
517,gadW,7329562,7329562,7329236,326,0,utRho14
518,gadX,14663356,14663356,14663240,116,8,utRho14
519,gadY,7329728,7329728,7329728,0,0,utRho14
520,galE,1584354,1584354,1584110,244,2,utRho14
521,galF,4228702,4228702,4228654,48,2,utRho14
522,galM,1577796,1577796,1577674,122,1964,utRho14
523,galP,6176510,6176568,6176510,58,0,utRho14
524,galR,5953138,5953198,5953138,60,306,utRho14
525,galS,4483420,4483420,4483336,84,0,utRho14
526,galU,2582810,2582914,2582810,104,844,utRho14
527,gapA,3724480,3725542,3724480,1062,14852,utRho14
528,garP,6549868,6549868,6549814,54,88,utRho14
529,gatY,4354468,4354468,4354408,60,0,utRho14
530,gatZ,4352864,4352864,4352642,222,58740,utRho14
531,gcd,282558,282558,282450,108,0,utRho14
532,gcl,1067814,1067832,1067814,18,0,utRho14
533,gcvA,5885278,5885278,5885134,144,0,utRho14
534,gcvB,5885392,5885392,5885392,0,0,utRho14
535,gcvR,5199758,5199812,5199758,54,26,utRho14
536,gcvT,6101544,6101544,6101334,210,8920,utRho14
537,gdhA,3684616,3684742,3684616,126,68,utRho14
538,gfcA,2099668,2099668,2099488,180,8,utRho14
539,gfcD,2096236,2096236,2095890,346,26,utRho14
540,ghrA,2195648,2195772,2195648,124,128,utRho14
541,ghrB,7434378,7434620,7434378,242,964,utRho14
542,glcA,6242728,6242728,6242558,170,136,utRho14
543,glcC,6256412,6256544,6256412,132,30,utRho14
544,glcD,6256152,6256152,6256042,110,0,utRho14
545,gldA,8278092,8278092,8278070,22,58,utRho14
546,glgA,7136784,7136784,7136066,718,1826,utRho14
547,glgB,7147314,7147314,7147004,310,494,utRho14
548,glgC,7139142,7139142,7138656,486,968,utRho14
549,glgP,7133546,7133546,7133162,384,220,utRho14
550,glgS,6384024,6384024,6383878,146,0,utRho14
551,glgX,7142838,7142838,7142638,200,158,utRho14
552,glk,5018922,5018922,5018852,70,0,utRho14
553,glmS,7827622,7827622,7827336,286,6702,utRho14
554,glmU,7830652,7830652,7830400,252,0,utRho14
555,glmY,10765360,10765360,10765360,0,0,utRho14
556,glmZ,7972864,7972864,7972864,0,0,utRho14
557,glnA,16232888,16232888,16232136,752,1328,utRho14
558,glnB,5375052,5375052,5374816,236,404,utRho14
559,glnD,377310,377310,377300,10,0,utRho14
560,glnE,6399602,6399602,6399282,320,336,utRho14
561,glnH,1696396,1696396,1696008,388,1158,utRho14
562,glnK,945112,945196,945112,84,0,utRho14
563,glnL,8112742,8112742,8112678,64,0,utRho14
564,glnQ,1693262,1693262,1692926,336,3042,utRho14
565,glnS,1411998,1412186,1411998,188,1318,utRho14
566,gloA,3455602,3455674,3455602,72,0,utRho14
567,gloB,469852,469852,469564,288,1868,utRho14
568,glpA,4705166,4705294,4705166,128,68,utRho14
569,glpD,7123942,7124026,7123942,84,48,utRho14
570,glpE,7123698,7123698,7123646,52,218,utRho14
571,glpF,8236322,8236322,8236180,142,622,utRho14
572,glpG,7122960,7122960,7122904,56,34,utRho14
573,glpR,7121782,7121782,7121210,572,494,utRho14
574,glpT,4704902,4704902,4704748,154,1022,utRho14
575,glpX,8231212,8231212,8231158,54,7338,utRho14
576,glrK,5382246,5382246,5382196,50,0,utRho14
577,gltA,1509534,1509534,1508936,598,28656,utRho14
578,gltB,6709018,6709264,6709018,246,74,utRho14
579,gltI,1375792,1375792,1375494,298,3108,utRho14
580,gltP,8588536,8588962,8588536,426,1398,utRho14
581,gltS,7657382,7657382,7657330,52,0,utRho14
582,gltX,5041568,5041568,5041344,224,56,utRho14
583,gluQ,320286,320286,320224,62,378,utRho14
584,glyA,5371148,5371148,5371014,134,0,utRho14
585,glyQ,7450708,7450708,7450636,72,678,utRho14
586,glyS,7448990,7448990,7448794,196,2566,utRho14
587,glyU,5998128,5998128,5998114,14,0,utRho14
588,glyV,8784626,8784720,8784626,94,70,utRho14
589,glyW,3984360,3984360,3984234,126,0,utRho14
590,gmhB,445612,445666,445612,54,0,utRho14
591,gmk,7642776,7642856,7642776,80,0,utRho14
592,gmr,2693686,2693686,2693484,202,0,utRho14
593,gnd,4202648,4202648,4202536,112,726,utRho14
594,gnsB,3275692,3275692,3275564,128,0,utRho14
595,gntK,14310580,14310580,14310368,212,304,utRho14
596,gntP,9102668,9102668,9102592,76,86,utRho14
597,gntR,7157760,7157760,7157452,308,466,utRho14
598,gntT,7092810,7093118,7092810,308,168,utRho14
599,gntU,7154170,7154170,7154122,48,0,utRho14
600,gntX,7089334,7089764,7089334,430,0,utRho14
601,gor,7292224,7292598,7292224,374,432,utRho14
602,gpmA,1575340,1575340,1575190,150,0,utRho14
603,gpmM,7570374,7570520,7570374,146,156,utRho14
604,gpsA,7567620,7567620,7567322,298,30274,utRho14
605,gpt,511828,511954,511828,126,382,utRho14
606,grcA,5433046,5433046,5432898,148,184,utRho14
607,greA,6657728,6657728,6657430,298,994,utRho14
608,greB,7073488,7073624,7073488,136,0,utRho14
609,groL,8741566,8742050,8741566,484,10974,utRho14
610,groS,8741232,8741376,8741232,144,15218,utRho14
611,grpE,5501494,5501494,5501416,78,436,utRho14
612,grxA,1781552,1781552,1781506,46,0,utRho14
613,grxB,2248206,2248206,2248108,98,60,utRho14
614,grxC,7569152,7569152,7568884,268,13482,utRho14
615,grxD,3468324,3468324,3468202,122,7916,utRho14
616,gspA,6911268,6911268,6910796,472,0,utRho14
617,gspC,6910964,6911156,6910964,192,0,utRho14
618,gss,6277220,6277220,6277044,176,0,utRho14
619,gstA,3428654,3428754,3428654,100,0,utRho14
620,gstB,1761038,1761038,1760960,78,0,utRho14
621,guaB,5268214,5268214,5268140,74,266,utRho14
622,gudD,5839026,5839026,5838770,256,0,utRho14
623,gyrA,4678914,4678914,4678840,74,0,utRho14
624,gyrB,7760300,7760300,7760238,62,308,utRho14
625,hcaE,5337964,5338064,5337964,100,0,utRho14
626,hcaR,5337928,5337928,5337792,136,12,utRho14
627,hcaT,5336106,5336106,5335692,414,608,utRho14
628,hchA,4071260,4071670,4071260,410,0,utRho14
629,hcp,1828258,1828258,1827628,630,0,utRho14
630,hcr,1824400,1824400,1824300,100,42,utRho14
631,hdeA,7313582,7313582,7313480,102,0,utRho14
632,hdeD,7313920,7313990,7313920,70,6,utRho14
633,hdfR,7896320,7896320,7895934,386,320,utRho14
634,hdhA,3396244,3396244,3396080,164,0,utRho14
635,helD,2048876,2048942,2048876,66,0,utRho14
636,hemA,2527166,2527428,2527166,262,0,utRho14
637,hemB,779722,779722,779454,268,0,utRho14
638,hemF,5106410,5106450,5106410,40,58,utRho14
639,hemH,996062,996110,996062,48,0,utRho14
640,hemL,349882,349882,349764,118,468,utRho14
641,hemN,8103886,8104090,8103886,204,76,utRho14
642,hepA,127176,127176,126528,648,1190,utRho14
643,hflD,2385372,2385372,2385262,110,398,utRho14
644,hfq,8799602,8800576,8799602,974,11316,utRho14
645,hha,961006,961006,960616,390,0,utRho14
646,hicA,3018442,3018572,3018442,130,0,utRho14
647,higA,6468682,6468682,6468288,394,138,utRho14
648,higB,6468960,6468960,6468910,50,0,utRho14
649,hinT,2323642,2323770,2323642,128,50,utRho14
650,hipB,3184964,3184964,3184884,80,0,utRho14
651,hisB,4186720,4186936,4186720,216,1190,utRho14
652,hisJ,4853674,4853674,4853576,98,140,utRho14
653,hisL,8359856,8359984,8359856,128,0,utRho14
654,hisS,5281284,5281284,5281150,134,526,utRho14
655,hlpA,400910,400964,400910,54,318,utRho14
656,hlyE,2460932,2460932,2460788,144,0,utRho14
657,hmp,5371594,5371670,5371594,76,0,utRho14
658,hns,2585916,2585916,2585844,72,1342,utRho14
659,hofM,7045856,7045856,7045502,354,0,utRho14
660,hokA,7441620,7441620,7441200,420,14,utRho14
661,hokC,33902,33902,33806,96,306,utRho14
662,hokE,1215462,1215672,1215462,210,0,utRho14
663,holC,8968546,8968546,8968560,14,1340,utRho14
664,holD,9215562,9215606,9215562,44,78,utRho14
665,holE,3850040,3850216,3850040,176,100,utRho14
666,hpt,282720,282862,282720,142,182,utRho14
667,hrpB,324150,324210,324150,60,90,utRho14
668,hscB,5319048,5319048,5318934,114,3442,utRho14
669,hscC,1367188,1367188,1366786,402,3670,utRho14
670,hsdS,9163004,9163004,9162924,80,0,utRho14
671,hslJ,2883560,2883560,2883486,74,0,utRho14
672,hslO,7059344,7059548,7059344,204,16056,utRho14
673,hslR,7058220,7058696,7058220,476,2952,utRho14
674,hslV,8244708,8244708,8244574,134,288,utRho14
675,hsrA,7881412,7881412,7881224,188,96,utRho14
676,htgA,21286,21660,21286,374,242,utRho14
677,htpG,989634,990240,989634,606,2272,utRho14
678,htpX,3825236,3825236,3825152,84,0,utRho14
679,htrE,311036,311036,310852,184,2,utRho14
680,htrL,7587668,7587668,7587366,302,0,utRho14
681,hupA,8400352,8400562,8400352,210,200,utRho14
682,hupB,1845220,1845804,1845220,584,2284,utRho14
683,hyaA,2063968,2064278,2063968,310,0,utRho14
684,hybO,6292726,6292726,6292522,204,954,utRho14
685,hycA,5700922,5700922,5700870,52,0,utRho14
686,hycI,5686204,5686204,5686086,118,124,utRho14
687,hydN,5676264,5676264,5676210,54,0,utRho14
688,hyfA,5202342,5202402,5202342,60,0,utRho14
689,hypA,11402508,11402588,11402508,80,0,utRho14
690,hypB,11403356,11404004,11403356,648,656,utRho14
691,hypF,5676210,5676210,5674850,1360,78,utRho14
692,hypT,9116634,9116634,9116578,56,0,utRho14
693,hyuA,6019660,6020056,6019660,396,2,utRho14
694,iaaA,1733074,1733136,1733074,62,4,utRho14
695,iadA,9119074,9119074,9119052,22,46,utRho14
696,iap,5753072,5753162,5753072,90,0,utRho14
697,ibaG,6673966,6673966,6673606,360,4,utRho14
698,ibpA,7735036,7735036,7734844,192,2712,utRho14
699,ibpB,7733962,7733962,7733794,168,8784,utRho14
700,icd,2389922,2390246,2389922,324,122,utRho14
701,iclR,8447304,8447304,8447256,48,40,utRho14
702,idi,6065876,6066130,6065876,254,0,utRho14
703,idnD,8988870,8988870,8988812,58,0,utRho14
704,idnK,8989194,8989246,8989194,52,0,utRho14
705,ihfA,3591442,3591442,3591104,338,988,utRho14
706,ihfB,1927498,1927656,1927498,158,1348,utRho14
707,ileS,43666,44782,43666,1116,12862,utRho14
708,ileX,6431194,6431196,6431194,2,60,utRho14
709,ilvA,15820940,15821324,15820940,384,0,utRho14
710,ilvC,7915824,7915940,7915824,116,138,utRho14
711,ilvE,15809552,15809936,15809552,384,528,utRho14
712,ilvI,170840,171260,170840,420,0,utRho14
713,ilvL,23701308,23701932,23701308,624,360,utRho14
714,ilvY,7915734,7915734,7915640,94,0,utRho14
715,inaA,4698998,4698998,4698944,54,0,utRho14
716,infA,1853370,1853370,1852886,484,1570,utRho14
717,infC,3602692,3602692,3601276,1416,5832,utRho14
718,insA-5,3958452,3958452,3958430,22,0,utRho14
719,insA-7,9036758,9037054,9036758,296,22,utRho14
720,insC-5,6372080,6372284,6372080,204,140,utRho14
721,insEF-2,785238,785238,785820,582,380,utRho14
722,insEF-4,2190310,2190310,2190892,582,516,utRho14
723,insG,9007098,9007098,9006862,236,44,utRho14
724,insH-1,550596,550596,550234,362,254,utRho14
725,insH-11,7306538,7306538,7306396,142,262,utRho14
726,insH-2,1151548,1151548,1151506,42,594,utRho14
727,insH-3,1378444,1378444,1378026,418,594,utRho14
728,insH-4,2791942,2792152,2791942,210,184,utRho14
729,insH-5,2857852,2857852,2857452,400,0,utRho14
730,insH-6,4135022,4135022,4134642,380,22,utRho14
731,insH-7,4206186,4206186,4205822,364,6030,utRho14
732,insH-9,6260050,6260356,6260050,306,172,utRho14
733,insI-3,9017372,9017372,9017234,138,0,utRho14
734,insJ,7441188,7441360,7441188,172,12,utRho14
735,insK,7442130,7442308,7442130,178,0,utRho14
736,insL-1,30760,30890,30760,130,3348,utRho14
737,insL-2,1216112,1216130,1216112,18,62,utRho14
738,insL-3,5028644,5028662,5028644,18,98,utRho14
739,insN-1,540452,540484,540452,32,12,utRho14
740,intD,1132202,1132202,1131956,246,0,utRho14
741,intR,2826520,2826520,2826470,50,0,utRho14
742,intS,4933026,4933090,4933026,64,110,utRho14
743,intZ,5117386,5117542,5117386,156,2,utRho14
744,iraD,9113152,9113986,9113152,834,0,utRho14
745,iraM,2424246,2424246,2424006,240,0,utRho14
746,iraP,802638,802772,802638,134,0,utRho14
747,iscA,5319924,5319924,5319772,152,1930,utRho14
748,iscR,5324398,5324398,5324262,136,23578,utRho14
749,iscX,5313834,5313834,5313472,362,2714,utRho14
750,ispF,5743968,5743968,5743560,408,2054,utRho14
751,ispG,5283908,5283908,5283608,300,796,utRho14
752,ispU,389568,389806,389568,238,156,utRho14
753,isrA,2811502,2811502,2811618,116,0,utRho14
754,istr-1,7706384,7706384,7706384,0,0,utRho14
755,istr-2,7706514,7706514,7706514,0,0,utRho14
756,ivbL,15412092,15412092,15411952,140,676,utRho14
757,ivy,480638,480686,480638,48,0,utRho14
758,katE,3627628,3627734,3627628,106,0,utRho14
759,katG,8267624,8267670,8267624,46,256,utRho14
760,kbaZ,6557732,6557828,6557732,96,0,utRho14
761,kbl,7585154,7585154,7585102,52,954,utRho14
762,kch,2621046,2621046,2620538,508,142,utRho14
763,kdgR,3820506,3820506,3820198,308,0,utRho14
764,kdpE,1443788,1443788,1443466,322,14,utRho14
765,kdpF,1457698,1457698,1457642,56,0,utRho14
766,kdsA,2535708,2536330,2535708,622,2002,utRho14
767,kdsC,6683438,6684546,6683438,1108,2912,utRho14
768,kduI,5968388,5968388,5968248,140,458,utRho14
769,kefF,94160,94492,94160,332,84,utRho14
770,kgtP,5451624,5451624,5451492,132,0,utRho14
771,kup,7862206,7862632,7862206,426,0,utRho14
772,lacI,735076,735076,735020,56,62,utRho14
773,lacZ,1465508,1465508,1465220,288,92,utRho14
774,ldcA,2486394,2486394,2486160,234,0,utRho14
775,ldhA,2885830,2885830,2885686,144,0,utRho14
776,ldrA,2538954,2538954,2538550,404,230,utRho14
777,ldrB,2540024,2540024,2539620,404,4,utRho14
778,ldrC,2541092,2541092,2540690,402,36,utRho14
779,ldrD,7400544,7400544,7400174,370,258,utRho14
780,lepA,5414392,5414392,5414248,144,224,utRho14
781,lepB,5410928,5410928,5410618,310,720,utRho14
782,leuD,159188,159188,158906,282,56,utRho14
783,leuE,3761600,3761600,3761518,82,0,utRho14
784,leuL,168048,168048,167416,632,92,utRho14
785,leuO,168308,168736,168308,428,0,utRho14
786,leuQ,9212864,9212864,9212802,62,0,utRho14
787,leuU,6644556,6644556,6644316,240,2074,utRho14
788,leuV,9212546,9212546,9212330,216,1760,utRho14
789,leuX,8992772,8992810,8992772,38,0,utRho14
790,lexA,8514174,8514230,8514174,56,94,utRho14
791,lhr,3456706,3458174,3456706,1468,1058,utRho14
792,ligA,5060402,5060402,5060352,50,54,utRho14
793,ligB,7642576,7642576,7642340,236,0,utRho14
794,lipA,1320602,1320602,1320432,170,42,utRho14
795,lipB,1324802,1324802,1324556,246,3848,utRho14
796,lit,2397032,2397390,2397032,358,36,utRho14
797,livJ,7199524,7199524,7199316,208,148,utRho14
798,livK,7195510,7195510,7195120,390,100,utRho14
799,lldP,7554578,7554798,7554578,220,8122,utRho14
800,lnt,1381968,1381968,1381762,206,920,utRho14
801,loiP,6163784,6163826,6163784,42,0,utRho14
802,lolA,1874656,1874738,1874656,82,422,utRho14
803,lolB,2527112,2527112,2527000,112,0,utRho14
804,lolC,2350748,2350854,2350748,106,0,utRho14
805,lon,917630,917776,917630,146,164,utRho14
806,lpcA,486936,487086,486936,150,0,utRho14
807,lpd,255434,255824,255434,390,7570,utRho14
808,lplA,9248476,9248476,9248234,242,2576,utRho14
809,lplT,5947878,5947878,5947724,154,64,utRho14
810,lpoA,6586422,6586800,6586422,378,268,utRho14
811,lpp,3514592,3514842,3514592,250,384,utRho14
812,lptA,6686598,6686760,6686598,162,410,utRho14
813,lptB,6686792,6687888,6686792,1096,1828,utRho14
814,lptD,114672,114672,114218,454,1642,utRho14
815,lptF,8972244,8972436,8972244,192,0,utRho14
816,lpxC,213016,213114,213016,98,8190,utRho14
817,lpxD,401920,401942,401920,22,54,utRho14
818,lpxL,2233418,2233418,2233164,254,16,utRho14
819,lpxM,3880456,3880456,3880386,70,0,utRho14
820,lpxP,4991156,4991290,4991156,134,0,utRho14
821,lrhA,4813312,4813312,4813282,30,0,utRho14
822,lrp,1864656,1865190,1864656,534,532,utRho14
823,lspA,50028,50414,50028,386,2294,utRho14
824,lsrA,3202920,3202980,3202920,60,0,utRho14
825,lsrR,3202514,3202514,3202482,32,0,utRho14
826,ltaE,1818640,1818640,1818588,52,0,utRho14
827,luxS,5630130,5630130,5629466,664,1958,utRho14
828,lysA,5957902,5957902,5957798,104,0,utRho14
829,lysC,8467232,8467232,8466466,766,1142,utRho14
830,lysP,4497120,4497120,4497064,56,0,utRho14
831,lysR,5957900,5958042,5957900,142,0,utRho14
832,lysT,1561028,1561108,1561028,80,174,utRho14
833,lysU,8709610,8709610,8709434,176,44,utRho14
834,macB,1840188,1840694,1840188,506,786,utRho14
835,maeA,3111484,3111484,3111338,146,13578,utRho14
836,mak,820236,820288,820236,52,42,utRho14
837,malE,8492928,8492928,8492838,90,2,utRho14
838,malI,3398456,3398456,3398360,96,0,utRho14
839,malK,8493472,8493568,8493472,96,0,utRho14
840,malP,7105020,7105020,7104946,74,496,utRho14
841,malQ,7100798,7100798,7100140,658,1492,utRho14
842,malS,14949880,14949988,14949880,108,0,utRho14
843,malT,7106048,7106170,7106048,122,174,utRho14
844,malX,3398626,3398710,3398626,84,70,utRho14
845,malZ,1689980,1690072,1689980,92,168,utRho14
846,manA,3377102,3377152,3377102,50,0,utRho14
847,manX,3803866,3804096,3803866,230,108,utRho14
848,marC,3237882,3237882,3237816,66,0,utRho14
849,marR,3238186,3238240,3238186,54,0,utRho14
850,matP,2036918,2036970,2036918,52,2,utRho14
851,mazE,5822736,5822736,5822678,58,0,utRho14
852,mazG,5821720,5821720,5821370,350,1910,utRho14
853,mcbA,1684306,1684306,1684112,194,0,utRho14
854,mcbR,3040192,3040524,3040192,332,0,utRho14
855,mcrA,2420278,2420692,2420278,414,0,utRho14
856,mcrC,9156124,9156124,9155916,208,292,utRho14
857,mdaB,6344814,6345060,6344814,246,0,utRho14
858,mdfA,1767138,1767346,1767138,208,0,utRho14
859,mdh,6768940,6768940,6768536,404,306,utRho14
860,mdoB,9198988,9198988,9198882,106,1806,utRho14
861,mdoD,2993290,2993712,2993290,422,76,utRho14
862,mdoG,2218514,2218670,2218514,156,0,utRho14
863,mdtA,4307958,4308032,4307958,74,0,utRho14
864,mdtE,7318168,7318464,7318168,296,60,utRho14
865,mdtK,3486538,3486914,3486538,376,154,utRho14
866,mdtP,8602472,8602472,8602060,412,6,utRho14
867,melA,8683774,8683822,8683774,48,0,utRho14
868,melR,8683300,8683300,8683256,44,172,utRho14
869,menA,8240812,8240812,8240698,114,46,utRho14
870,menB,4753774,4753774,4753638,136,590,utRho14
871,mepH,3468714,3468870,3468714,156,0,utRho14
872,mepM,3883666,3883666,3883270,396,332,utRho14
873,mepS,4539840,4539958,4539840,118,336,utRho14
874,metA,8428318,8428560,8428318,242,0,utRho14
875,metB,8257272,8257344,8257272,72,1852,utRho14
876,metC,6304150,6304472,6304150,322,28,utRho14
877,metE,8025768,8026106,8025768,338,596,utRho14
878,metF,8265092,8265232,8265092,140,36,utRho14
879,metG,4388538,4388600,4388538,62,84,utRho14
880,metH,8447010,8447656,8447010,646,3892,utRho14
881,metJ,8257116,8257116,8256790,326,168,utRho14
882,metK,6173154,6173412,6173154,258,452,utRho14
883,metN,445428,445428,445290,138,0,utRho14
884,metR,8025710,8025710,8025632,78,0,utRho14
885,metT,1394326,1394326,1394266,60,158,utRho14
886,metY,19910250,19910250,19909734,516,246,utRho14
887,metZ,11789528,11789548,11789528,20,0,utRho14
888,mfd,2348056,2348056,2347928,128,162,utRho14
889,mglA,4478782,4478782,4478578,204,2286,utRho14
890,mglB,4481132,4481132,4480696,436,47788,utRho14
891,mglC,4475918,4475918,4475506,412,1354,utRho14
892,mgrB,3817584,3817584,3817532,52,0,utRho14
893,mgrR,3245828,3245828,3245828,0,0,utRho14
894,mgsA,2054082,2054082,2054030,52,248,utRho14
895,mgtL,8934560,8934862,8934560,302,0,utRho14
896,mhpA,737038,737222,737038,184,0,utRho14
897,mhpR,737072,737072,736840,232,84,utRho14
898,mhpT,750772,750918,750772,146,0,utRho14
899,miaA,8797964,8798504,8797964,540,930,utRho14
900,micA,5629604,5629604,5629604,0,0,utRho14
901,micC,2874242,2874238,2874242,4,0,utRho14
902,micF,4626168,4626168,4626168,0,0,utRho14
903,micM,1014408,1014408,1014408,0,0,utRho14
904,minE,2449422,2449422,2449090,332,3116,utRho14
905,mioC,7852950,7852950,7852910,40,0,utRho14
906,mipA,3733012,3733012,3732944,68,4500,utRho14
907,mlaA,4930270,4930270,4930014,256,0,utRho14
908,mlc,3337206,3337206,3337128,78,0,utRho14
909,mlrA,4429498,4429732,4429498,234,0,utRho14
910,mltA,5894546,5894546,5894356,190,246,utRho14
911,mltD,468050,468050,467910,140,0,utRho14
912,mltF,5391534,5391602,5391534,68,0,utRho14
913,mmuP,550238,550650,550238,412,258,utRho14
914,mngA,1531622,1531968,1531622,346,0,utRho14
915,mngR,1531852,1531852,1531750,102,0,utRho14
916,mnmG,7851348,7851348,7851266,82,1098,utRho14
917,mntH,5025470,5025470,5025412,58,0,utRho14
918,mntP,3810918,3811376,3810918,458,462,utRho14
919,mntR,1706160,1706366,1706160,206,0,utRho14
920,mntS,1706128,1706128,1705994,134,0,utRho14
921,moaA,1633654,1634088,1633654,434,1326,utRho14
922,moaB,1635954,1636110,1635954,156,1820,utRho14
923,mobA,8084242,8084242,8083998,244,0,utRho14
924,mocA,6030112,6030320,6030112,208,434,utRho14
925,modA,1589990,1590178,1589990,188,0,utRho14
926,moeA,1732788,1732788,1732728,60,242,utRho14
927,mokB,2984610,2984610,2984258,352,694,utRho14
928,molR_1,4392888,4392948,4392888,60,0,utRho14
929,motA,3954604,3954604,3954278,326,244,utRho14
930,mpaA,2781278,2781278,2781196,82,110,utRho14
931,mpl,8911456,8911570,8911456,114,0,utRho14
932,mppA,2786108,2786454,2786108,346,0,utRho14
933,mprA,5621494,5621540,5621494,46,810,utRho14
934,mqo,4613848,4613848,4613508,340,94,utRho14
935,mqsA,6336742,6336742,6336492,250,436,utRho14
936,mqsR,6337306,6337306,6337088,218,756,utRho14
937,mraZ,179192,179268,179192,76,58,utRho14
938,mrcA,7045652,7045742,7045652,90,0,utRho14
939,mrcB,329442,329460,329442,18,0,utRho14
940,mreB,13605424,13605424,13604348,1076,1632,utRho14
941,mreD,6798166,6798166,6797750,416,266,utRho14
942,mrp,4388360,4388360,4388336,24,0,utRho14
943,mscK,972984,973072,972984,88,0,utRho14
944,mscL,6876002,6876048,6876002,46,2,utRho14
945,mscS,6139742,6139742,6139614,128,0,utRho14
946,msrA,8884522,8884522,8884352,170,648,utRho14
947,msrB,3725168,3725168,3724858,310,0,utRho14
948,msyB,2228426,2228426,2228362,64,0,utRho14
949,mtfA,4087236,4087302,4087236,66,5422,utRho14
950,mtgA,6699662,6699662,6699618,44,2,utRho14
951,mtlA,30177504,30178248,30177504,744,2312,utRho14
952,mtn,358366,358366,358306,60,0,utRho14
953,mtr,6611864,6611864,6611634,230,14,utRho14
954,mug,6430992,6430992,6430946,46,2,utRho14
955,murQ,5091466,5091546,5091466,80,0,utRho14
956,murR,5091586,5091586,5091218,368,0,utRho14
957,mutH,5939164,5939324,5939164,160,120,utRho14
958,mutL,8794092,8794824,8794092,732,912,utRho14
959,mutM,7622554,7622554,7622304,250,1076,utRho14
960,mutS,5714038,5714186,5714038,148,1562,utRho14
961,mutY,18617466,18618078,18617466,612,0,utRho14
962,nac,4123956,4123956,4123866,90,0,utRho14
963,nadA,1564122,1564170,1564122,48,0,utRho14
964,nadB,5420714,5420840,5420714,126,0,utRho14
965,nadC,237326,237326,237290,36,16,utRho14
966,nadE,3644604,3644916,3644604,312,108,utRho14
967,nadK,5501526,5501662,5501526,136,52,utRho14
968,nagA,1406350,1406350,1405502,848,23998,utRho14
969,nagB,1407416,1407416,1407222,194,214,utRho14
970,nagC,1404016,1404016,1403188,828,224,utRho14
971,nagE,1407680,1407888,1407680,208,0,utRho14
972,nagK,2357080,2357186,2357080,106,2,utRho14
973,nanA,6747240,6747240,6747152,88,604,utRho14
974,nanC,9079856,9079856,9079002,854,4406,utRho14
975,nanR,6749406,6749406,6748978,428,0,utRho14
976,nanS,9075406,9075406,9075188,218,840,utRho14
977,napF,4607390,4607390,4606994,396,0,utRho14
978,narG,2559614,2559728,2559614,114,134,utRho14
979,narK,2555642,2555914,2555642,272,0,utRho14
980,narP,4580844,4581000,4580844,156,36,utRho14
981,narQ,5171154,5171462,5171154,308,324,utRho14
982,narU,3088326,3088326,3088120,206,0,utRho14
983,narW,3077374,3077374,3074618,2756,168,utRho14
984,narX,2555554,2555554,2555236,318,0,utRho14
985,narZ,3085380,3085380,3085180,200,0,utRho14
986,ndh,2331984,2332170,2331984,186,0,utRho14
987,ndk,5289920,5289920,5289728,192,284,utRho14
988,nemR,6904084,6904092,6904084,8,0,utRho14
989,nepI,7683542,7683542,7683478,64,4,utRho14
990,nfo,4501612,4501680,4501612,68,108,utRho14
991,nfsB,1210906,1210906,1210848,58,0,utRho14
992,nfuA,7090916,7091248,7090916,332,1566,utRho14
993,nhaA,34634,34978,34634,344,164,utRho14
994,nhaB,2469534,2469534,2469434,100,4,utRho14
995,nhoA,3067926,3068048,3067926,122,0,utRho14
996,nikA,7226878,7227334,7226878,456,596,utRho14
997,nikR,7237074,7237176,7237074,102,634,utRho14
998,nirB,6987974,6988022,6987974,48,0,utRho14
999,nlpA,7680034,7680034,7679986,48,0,utRho14
1000,nlpC,3585654,3585654,3585462,192,0,utRho14
1001,nlpD,5737658,5737658,5737506,152,30,utRho14
1002,nlpI,6618080,6618080,6617848,232,132,utRho14
1003,nmpC,1153740,1153740,1153650,90,272,utRho14
1004,nohA,3273206,3273206,3272734,472,2,utRho14
1005,norR,5664614,5664614,5664578,36,0,utRho14
1006,norV,5664878,5664952,5664878,74,0,utRho14
1007,nrdA,4689510,4689730,4689510,220,17142,utRho14
1008,nrdD,8925676,8925676,8925320,356,4634,utRho14
1009,nrdH,5601312,5601446,5601312,134,630,utRho14
1010,nrdR,865954,866004,865954,50,0,utRho14
1011,nrfA,8575342,8575528,8575342,186,22,utRho14
1012,nsrR,8812088,8812380,8812088,292,200,utRho14
1013,nudB,3897348,3897348,3897264,84,0,utRho14
1014,nudC,8393428,8393806,8393428,378,0,utRho14
1015,nudE,7052658,7052658,7052298,360,346,utRho14
1016,nudG,3682876,3682980,3682876,104,0,utRho14
1017,nudI,4729050,4729108,4729050,58,0,utRho14
1018,nudJ,2388874,2388874,2388576,298,1174,utRho14
1019,nuoA,4810670,4810670,4810144,526,8354,utRho14
1020,nuoN,4783434,4783434,4783010,424,3362,utRho14
1021,nupC,5026018,5026084,5026018,66,0,utRho14
1022,nupG,6211302,6211428,6211302,126,0,utRho14
1023,ogrK,4335096,4335096,4335040,56,0,utRho14
1024,ogt,2800568,2800568,2800472,96,0,utRho14
1025,ohsC,5401036,5401040,5401036,4,0,utRho14
1026,ompA,2040382,2040382,2040106,276,49126,utRho14
1027,ompC,4625774,4625774,4625498,276,564,utRho14
1028,ompF,1974184,1974184,1973964,220,1066,utRho14
1029,ompL,8128958,8128958,8128590,368,0,utRho14
1030,ompN,2874158,2874158,2873786,372,0,utRho14
1031,ompR,7073510,7073510,7073168,342,0,utRho14
1032,ompT,1171330,1171330,1171266,64,166,utRho14
1033,ompW,2627982,2628040,2627982,58,2,utRho14
1034,ompX,1700418,1700900,1700418,482,1508,utRho14
1035,omrA,5952378,5952378,5952378,0,0,utRho14
1036,omrB,5952770,5952770,5952770,0,0,utRho14
1037,oppA,2602170,2602364,2602170,194,6814,utRho14
1038,orn,8783168,8783208,8783168,40,0,utRho14
1039,osmB,2686952,2686952,2686656,296,0,utRho14
1040,osmC,3113192,3113250,3113192,58,392,utRho14
1041,osmE,3644566,3644566,3644512,54,0,utRho14
1042,osmF,4439046,4439046,4438962,84,758,utRho14
1043,osmY,9222306,9222792,9222306,486,2,utRho14
1044,otsA,3963302,3963302,3963224,78,0,utRho14
1045,otsB,3964930,3964930,3964774,156,106,utRho14
1046,oxc,4984288,4984288,4983900,388,52,utRho14
1047,oxyR,8316914,8316980,8316914,66,2,utRho14
1048,oxyS,8316788,8316788,8316788,0,0,utRho14
1049,paaA,2907730,2907854,2907730,124,0,utRho14
1050,paaX,2927018,2927078,2927018,60,86,utRho14
1051,paaZ,2907340,2907340,2907284,56,0,utRho14
1052,pabA,6981702,6981702,6981658,44,2,utRho14
1053,pabB,3789256,3789610,3789256,354,198,utRho14
1054,pabC,2306186,2306600,2306186,414,398,utRho14
1055,pagP,1313052,1313114,1313052,62,0,utRho14
1056,panB,299260,299260,299202,58,0,utRho14
1057,panC,297840,297840,297590,250,384,utRho14
1058,panD,293490,293490,293388,102,134,utRho14
1059,panZ,7195656,7195968,7195656,312,92,utRho14
1060,parC,6332060,6332060,6331946,114,462,utRho14
1061,patA,6438916,6438988,6438916,72,0,utRho14
1062,patD,3030830,3031156,3030830,326,0,utRho14
1063,pbpC,5294986,5294986,5294650,336,150,utRho14
1064,pbpG,4450132,4450132,4449740,392,318,utRho14
1065,pck,7065358,7065636,7065358,278,7228,utRho14
1066,pcnB,318782,318782,318252,530,948,utRho14
1067,pdhR,244068,244184,244068,116,2,utRho14
1068,pdxB,4875768,4875768,4875702,66,0,utRho14
1069,pdxH,3436068,3436068,3436014,54,450,utRho14
1070,pdxJ,5403626,5403626,5403458,168,4,utRho14
1071,pdxK,5074638,5074638,5074474,164,0,utRho14
1072,pepA,8972278,8972278,8971902,376,126,utRho14
1073,pepD,511618,511618,511432,186,14074,utRho14
1074,pepN,1981182,1981244,1981182,62,0,utRho14
1075,pepQ,8062294,8062322,8062294,28,0,utRho14
1076,pepT,2371646,2371688,2371646,42,68,utRho14
1077,pfkA,8214948,8215104,8214948,156,396,utRho14
1078,pfkB,3612646,3612740,3612646,94,0,utRho14
1079,pflA,1902456,1902456,1902160,296,228,utRho14
1080,pflB,1907850,1907850,1907108,742,1234,utRho14
1081,pflD,8287716,8287990,8287716,274,0,utRho14
1082,pgaA,2185046,2185046,2184578,468,0,utRho14
1083,pgi,8467444,8467516,8467444,72,58,utRho14
1084,pgk,12291428,12291428,12290488,940,5480,utRho14
1085,pgl,1597078,1597172,1597078,94,156,utRho14
1086,pgpB,2678324,2678660,2678324,336,0,utRho14
1087,pgpC,5397276,5397276,5397100,176,0,utRho14
1088,pgrR,2783744,2783982,2783744,238,0,utRho14
1089,pheL,5475158,5475198,5475158,40,0,utRho14
1090,pheM,7197204,7197204,7197080,124,0,utRho14
1091,pheP,1203858,1203918,1203858,60,0,utRho14
1092,pheU,8725254,8725254,8725252,2,0,utRho14
1093,pheV,6220730,6220732,6220730,2,0,utRho14
1094,phnC,8650412,8650412,8650330,82,0,utRho14
1095,phoA,803414,803494,803414,80,264,utRho14
1096,phoB,834202,834284,834202,82,0,utRho14
1097,phoE,520316,520316,520200,116,0,utRho14
1098,phoH,2169730,2169984,2169730,254,198,utRho14
1099,phoP,2381016,2381016,2380894,122,3054,utRho14
1100,phoQ,2379880,2379880,2379552,328,872,utRho14
1101,phoU,7815330,7815330,7815156,174,172,utRho14
1102,phr,1478842,1479014,1478842,172,0,utRho14
1103,pinE,2419054,2419370,2419054,316,182,utRho14
1104,pinQ,3267168,3267244,3267168,76,2,utRho14
1105,pinR,2867424,2867424,2867348,76,4,utRho14
1106,pitA,7275224,7275284,7275224,60,0,utRho14
1107,pitB,6272806,6272806,6272742,64,0,utRho14
1108,pka,5439862,5439906,5439862,44,0,utRho14
1109,plaP,4174476,4174476,4174124,352,0,utRho14
1110,pldA,8009628,8009724,8009628,96,2,utRho14
1111,pldB,8018028,8018340,8018028,312,62,utRho14
1112,plsB,8513196,8513196,8512932,264,806,utRho14
1113,pmbA,8915890,8915918,8915890,28,0,utRho14
1114,pmrD,4747148,4747148,4747076,72,0,utRho14
1115,pncB,1980828,1980828,1980712,116,2,utRho14
1116,pncC,5648788,5648788,5648692,96,0,utRho14
1117,pnp,6622652,6622652,6622336,316,42,utRho14
1118,pntA,3355950,3355950,3355806,144,0,utRho14
1119,pntB,3353096,3353096,3352720,376,400,utRho14
1120,polA,8093880,8093932,8093880,52,2,utRho14
1121,polB,131606,131606,131560,46,0,utRho14
1122,potD,2365700,2365700,2365658,42,82,utRho14
1123,potE,1436688,1436688,1436530,158,0,utRho14
1124,potF,1787268,1787568,1787268,300,2,utRho14
1125,poxB,1822152,1822152,1822098,54,0,utRho14
1126,ppa,8899372,8899372,8899304,68,134,utRho14
1127,ppc,8306380,8306380,8306196,184,634,utRho14
1128,ppdA,5928440,5928440,5928354,86,74,utRho14
1129,ppdD,235410,235410,235098,312,0,utRho14
1130,pphA,3846770,3846770,3845938,832,2350,utRho14
1131,pphB,5719474,5719520,5719474,46,0,utRho14
1132,ppiA,6984898,6984898,6984594,304,100,utRho14
1133,ppiC,7919682,7919682,7919626,56,0,utRho14
1134,ppiD,923638,923830,923638,192,66,utRho14
1135,ppk,5245748,5246088,5245748,340,210,utRho14
1136,pppA,6228958,6228958,6228704,254,0,utRho14
1137,ppsA,3574322,3574322,3574224,98,0,utRho14
1138,ppsR,3574678,3574890,3574678,212,0,utRho14
1139,pptA,3065716,3066104,3065716,388,0,utRho14
1140,pqiA,2023318,2024002,2023318,684,16,utRho14
1141,prc,3830054,3830054,3829632,422,27662,utRho14
1142,preT,4467978,4468066,4467978,88,0,utRho14
1143,prfC,9218688,9218828,9218688,140,914,utRho14
1144,prkB,6968622,6968980,6968622,358,1066,utRho14
1145,prlC,7290476,7290476,7290364,112,164,utRho14
1146,prlF,6553944,6554004,6553944,60,0,utRho14
1147,proB,520432,520776,520432,344,134,utRho14
1148,proC,811372,811372,811288,84,0,utRho14
1149,proK,7417388,7417388,7417384,4,0,utRho14
1150,proL,4572414,4572422,4572414,8,0,utRho14
1151,proP,8660640,8661004,8660640,364,216,utRho14
1152,proS,437674,437674,437550,124,912,utRho14
1153,proV,5609126,5609630,5609126,504,66,utRho14
1154,prpB,697292,697364,697292,72,0,utRho14
1155,prpR,696942,696942,696886,56,132,utRho14
1156,prs,2524354,2524354,2523750,604,115304,utRho14
1157,psd,8781276,8781276,8780720,556,2750,utRho14
1158,psiE,8480600,8480650,8480600,50,0,utRho14
1159,pspA,2736076,2736158,2736076,82,0,utRho14
1160,pspF,2736080,2736080,2735824,256,0,utRho14
1161,pspG,8525632,8525680,8525632,48,0,utRho14
1162,pssA,5445156,5445454,5445156,298,7328,utRho14
1163,pstB,7817112,7817112,7816732,380,160,utRho14
1164,pstC,7821084,7821084,7820796,288,244,utRho14
1165,pstS,23469408,23469408,23469150,258,6,utRho14
1166,psuG,4517114,4517114,4516734,380,2978,utRho14
1167,psuT,4514992,4514992,4514670,322,0,utRho14
1168,pth,2517084,2517084,2517026,58,0,utRho14
1169,ptrA,5918022,5918022,5917768,254,0,utRho14
1170,ptrB,3857730,3857730,3857678,52,388,utRho14
1171,ptsG,2315252,2315738,2315252,486,1938,utRho14
1172,ptsH,5066996,5067528,5066996,532,7868,utRho14
1173,purA,8809328,8809374,8809328,46,0,utRho14
1174,purC,5195562,5195562,5195236,326,0,utRho14
1175,purD,8411972,8411972,8411862,110,0,utRho14
1176,purE,1106284,1106284,1106200,84,212,utRho14
1177,purH,8415254,8415254,8415064,190,0,utRho14
1178,purL,5391178,5391178,5391086,92,1740,utRho14
1179,purM,5242306,5242394,5242306,88,42,utRho14
1180,purR,3475378,3475688,3475378,310,724,utRho14
1181,purT,3861438,3861762,3861438,324,46,utRho14
1182,purU,2577512,2577512,2577248,264,362,utRho14
1183,putA,2157850,2157850,2157764,86,0,utRho14
1184,putP,2158336,2158610,2158336,274,1520,utRho14
1185,puuA,2721936,2721936,2721816,120,0,utRho14
1186,puuC,2725456,2725486,2725456,30,0,utRho14
1187,puuD,2722104,2722240,2722104,136,0,utRho14
1188,puuP,2718746,2718746,2718374,372,548,utRho14
1189,pykA,3874988,3875298,3874988,310,566,utRho14
1190,pykF,3510934,3511396,3510934,462,930,utRho14
1191,pyrC,2245286,2245286,2245214,72,98,utRho14
1192,pyrD,2009464,2009536,2009464,72,104,utRho14
1193,pyrE,7631970,7631970,7631536,434,0,utRho14
1194,pyrF,2683740,2683842,2683740,102,396,utRho14
1195,pyrG,5819594,5819594,5819332,262,476,utRho14
1196,pyrH,383624,383710,383624,86,1294,utRho14
1197,pyrL,8945490,8945490,8945066,424,78,utRho14
1198,qmcA,1031646,1031646,1031546,100,0,utRho14
1199,qor,8528608,8528608,8528462,146,82,utRho14
1200,qseB,6339502,6339656,6339502,154,2,utRho14
1201,queA,849970,850022,849970,52,132,utRho14
1202,queE,5811212,5811212,5810836,376,0,utRho14
1203,queF,5850642,5850696,5850642,54,0,utRho14
1204,queG,8788184,8788184,8788134,50,2300,utRho14
1205,racC,2835630,2835630,2835526,104,0,utRho14
1206,racR,2840898,2840898,2840482,416,0,utRho14
1207,raiA,5474208,5474308,5474208,100,12,utRho14
1208,rarD,8008594,8008594,8008356,238,194,utRho14
1209,ravA,7862256,7862256,7862186,70,0,utRho14
1210,rayT,495088,495274,495088,186,4,utRho14
1211,rbn,4763162,4763216,4763162,54,0,utRho14
1212,rbsD,7866644,7866702,7866644,58,138,utRho14
1213,rcnA,4371654,4371834,4371654,180,0,utRho14
1214,rcnB,4373768,4373920,4373768,152,108,utRho14
1215,rcnR,4371806,4371806,4371592,214,0,utRho14
1216,rcsA,4047672,4047936,4047672,264,0,utRho14
1217,rcsB,4631390,4632354,4631390,964,2116,utRho14
1218,rcsC,4640162,4640162,4639656,506,972,utRho14
1219,rcsD,4626904,4626976,4626904,72,0,utRho14
1220,rdgB,6193240,6193362,6193240,122,850,utRho14
1221,rdlA,2538646,2538646,2538646,0,0,utRho14
1222,rdlB,2539712,2539716,2539712,4,0,utRho14
1223,rdlC,2540782,2540786,2540782,4,0,utRho14
1224,rdlD,7400272,7400272,7400272,0,0,utRho14
1225,rdoA,8084782,8084830,8084782,48,212,utRho14
1226,recA,11295276,11295276,11295076,200,352,utRho14
1227,recC,5925014,5925014,5924856,158,120,utRho14
1228,recF,7763722,7763722,7762442,1280,5544,utRho14
1229,recN,5503518,5503590,5503518,72,0,utRho14
1230,recQ,8011666,8011728,8011666,62,0,utRho14
1231,relA,5828554,5828554,5827302,1252,330,utRho14
1232,relB,3291806,3291806,3291744,62,2,utRho14
1233,rem,3289950,3289950,3289804,146,0,utRho14
1234,rep,7921294,7921354,7921294,60,196,utRho14
1235,rfaD,7587730,7587974,7587730,244,66,utRho14
1236,rfaE,6393852,6393852,6393506,346,0,utRho14
1237,rfaH,8049930,8049930,8049642,288,964,utRho14
1238,rfbX,4219436,4219436,4219168,268,1192,utRho14
1239,rfe,7935600,7935832,7935600,232,2,utRho14
1240,rhaB,8194944,8194944,8194896,48,0,utRho14
1241,rhaD,8188770,8188770,8188544,226,0,utRho14
1242,rhaS,8195422,8195472,8195422,50,0,utRho14
1243,rhaT,8201132,8201132,8201050,82,0,utRho14
1244,rhlE,1661566,1661744,1661566,178,6,utRho14
1245,rhoL,47593944,47594772,47593944,828,36756,utRho14
1246,rhsB,7238006,7238384,7238006,378,110,utRho14
1247,rhsC,1458758,1459166,1458758,408,0,utRho14
1248,rhsD,1046132,1046522,1046132,390,0,utRho14
1249,rhtA,1700608,1700608,1700194,414,0,utRho14
1250,rhtC,8015478,8015514,8015478,36,1594,utRho14
1251,ribA,2678468,2678468,2678320,148,0,utRho14
1252,ribC,3486916,3486916,3486484,432,154,utRho14
1253,ribE,869008,869294,869008,286,12812,utRho14
1254,ribF,42766,42814,42766,48,144,utRho14
1255,ridA,8941892,8941892,8941826,66,132,utRho14
1256,rihA,1369204,1369204,1368824,380,2,utRho14
1257,rihB,4510504,4510504,4510372,132,0,utRho14
1258,rimJ,2251044,2251124,2251044,80,0,utRho14
1259,rimK,1783752,1783934,1783752,182,1172,utRho14
1260,rimL,2997486,2997876,2997486,390,438,utRho14
1261,rimO,1756140,1756140,1756070,70,0,utRho14
1262,rimP,6636350,6636350,6636012,338,550,utRho14
1263,rlmA,3814172,3814172,3814120,52,350,utRho14
1264,rlmD,5830086,5830086,5830000,86,26,utRho14
1265,rlmE,6655520,6655520,6655328,192,706,utRho14
1266,rlmF,1684384,1684664,1684384,280,0,utRho14
1267,rlmG,6471784,6471784,6471750,34,0,utRho14
1268,rlmI,2060002,2060002,2059938,64,188,utRho14
1269,rlmJ,7290700,7290770,7290700,70,2,utRho14
1270,rlmL,2015344,2015688,2015344,344,1434,utRho14
1271,rlpA,1330444,1330444,1330380,64,166,utRho14
1272,rluA,120900,120900,120692,208,64,utRho14
1273,rluF,8460324,8460708,8460324,384,0,utRho14
1274,rmf,2031006,2031430,2031006,424,4,utRho14
1275,rna,1290068,1290068,1290006,62,0,utRho14
1276,rnb,2698258,2698258,2697824,434,3306,utRho14
1277,rnc,10816892,10816892,10816252,640,5720,utRho14
1278,rnd,3776122,3776122,3775982,140,178,utRho14
1279,rne,2289746,2289746,2288734,1012,13394,utRho14
1280,rnhA,472082,472082,472004,78,398,utRho14
1281,rnk,1288360,1288360,1287934,426,204,utRho14
1282,rnlA,5531788,5531836,5531788,48,104,utRho14
1283,rnlB,5533414,5533968,5533414,554,332,utRho14
1284,rnpB,19623552,19623552,19623552,0,0,utRho14
1285,rob,9270706,9270706,9270620,86,0,utRho14
1286,rodZ,5285868,5285868,5285688,180,6,utRho14
1287,rpe,7030306,7030306,7030118,188,422,utRho14
1288,rph,15266320,15266320,15266196,124,192,utRho14
1289,rpiA,6118706,6118706,6118650,56,0,utRho14
1290,rpiB,8626514,8626700,8626514,186,0,utRho14
1291,rpiR,8626274,8626274,8625982,292,0,utRho14
1292,rplJ,8359246,8359992,8359246,746,9116,utRho14
1293,rplK,8356708,8356894,8356708,186,1024,utRho14
1294,rplM,6757344,6757344,6757302,42,12876,utRho14
1295,rplN,6896444,6896444,6896298,146,8622,utRho14
1296,rplS,5489284,5489284,5489060,224,12012,utRho14
1297,rplT,7199052,7199052,7198996,56,1652,utRho14
1298,rplU,6667036,6667036,6666902,134,90,utRho14
1299,rplY,4564866,4565034,4564866,168,28,utRho14
1300,rpmA,6666450,6666450,6666238,212,772,utRho14
1301,rpmB,15247980,15247980,15246696,1284,109900,utRho14
1302,rpmE,8253816,8254026,8253816,210,340,utRho14
1303,rpmF,2294676,2294734,2294676,58,46420,utRho14
1304,rpmH,7768130,7768672,7768130,542,6114,utRho14
1305,rpmI,3600854,3600854,3599998,856,15364,utRho14
1306,rpoB,8362126,8362490,8362126,364,64,utRho14
1307,rpoD,6424946,6426094,6424946,1148,24774,utRho14
1308,rpoE,5420372,5420372,5420024,348,4,utRho14
1309,rpoH,7202006,7202006,7201566,440,3138,utRho14
1310,rpoN,6689324,6689434,6689324,110,216,utRho14
1311,rpoS,5736236,5736236,5735102,1134,7232,utRho14
1312,rpoZ,7644154,7644212,7644154,58,754,utRho14
1313,rppH,5937986,5937986,5937954,32,0,utRho14
1314,rprA,3540744,3540744,3540744,0,0,utRho14
1315,rpsA,1923434,1923990,1923434,556,150478,utRho14
1316,rpsF,8850050,8850236,8850050,186,30536,utRho14
1317,rpsI,6756580,6756580,6756414,166,9800,utRho14
1318,rpsJ,6906884,6906884,6906540,344,10054,utRho14
1319,rpsL,6949242,6949242,6949104,138,964,utRho14
1320,rpsM,6885130,6885130,6884942,188,1428,utRho14
1321,rpsO,13247144,13247144,13246736,408,1004,utRho14
1322,rpsP,5492508,5492508,5492370,138,320,utRho14
1323,rpsT,42420,42420,42156,264,732,utRho14
1324,rpsU,12842584,12843124,12842584,540,3192,utRho14
1325,rraA,8238716,8238716,8238660,56,148,utRho14
1326,rraB,8956768,8956946,8956768,178,0,utRho14
1327,rrsA,8070478,8071062,8070478,584,11684,utRho14
1328,rrsB,16665468,16666636,16665468,1168,24848,utRho14
1329,rrsC,7883032,7883616,7883032,584,10594,utRho14
1330,rrsD,6858094,6858094,6857524,570,752,utRho14
1331,rrsE,8415726,8416294,8415726,568,1932,utRho14
1332,rrsG,5462896,5462896,5462314,582,10350,utRho14
1333,rrsH,446970,447542,446970,572,1742,utRho14
1334,rsd,8393908,8393908,8393616,292,0,utRho14
1335,rseA,5419264,5419264,5418808,456,90,utRho14
1336,rseP,392940,393092,392940,152,132,utRho14
1337,rseX,4067298,4067298,4067298,0,0,utRho14
1338,rsfS,1338144,1338144,1338072,72,336,utRho14
1339,rsgA,8783132,8783132,8783018,114,82,utRho14
1340,rsmA,105176,105176,104860,316,3324,utRho14
1341,rsmB,6869982,6870414,6869982,432,1328,utRho14
1342,rsmC,9215736,9215736,9215400,336,366,utRho14
1343,rsmD,7208594,7208786,7208594,192,232,utRho14
1344,rsmE,6182036,6182268,6182036,232,700,utRho14
1345,rsmG,7847512,7847512,7847360,152,156,utRho14
1346,rsmH,180020,180188,180020,168,210,utRho14
1347,rsmI,6587106,6587106,6586670,436,1768,utRho14
1348,rssA,2578212,2578412,2578212,200,520,utRho14
1349,rssB,2580440,2580484,2580440,44,88,utRho14
1350,rstA,3364276,3364300,3364276,24,0,utRho14
1351,rsuA,4561096,4561096,4560966,130,86,utRho14
1352,rsxA,3411510,3411534,3411510,24,46,utRho14
1353,rtcA,7114004,7114004,7113698,306,6,utRho14
1354,rtcB,7116214,7116214,7116158,56,0,utRho14
1355,rtn,4541356,4541452,4541356,96,0,utRho14
1356,rutA,2148052,2148052,2148022,30,0,utRho14
1357,rutG,2140090,2140090,2139678,412,0,utRho14
1358,rutR,2148226,2148484,2148226,258,4,utRho14
1359,ruvA,7784096,7784096,7783904,192,0,utRho14
1360,ruvB,7782176,7782176,7781424,752,1604,utRho14
1361,ruvC,3894878,3894878,3894752,126,0,utRho14
1362,rybB,1776114,1776114,1776114,0,0,utRho14
1363,rydB,3529860,3529860,3529322,538,116,utRho14
1364,rydC,2983012,2983012,2983012,0,0,utRho14
1365,ryfA,5307398,5307710,5307398,312,0,utRho14
1366,ryfD,5468590,5468590,5468590,0,0,utRho14
1367,ryhB,7162032,7162032,7162032,0,0,utRho14
1368,ryjA,8556132,8556132,8556132,0,0,utRho14
1369,ryjB,9055954,9055954,9055954,0,0,utRho14
1370,sad,3229598,3229598,3229406,192,0,utRho14
1371,safA,3168056,3168056,3167918,138,2,utRho14
1372,sanA,4465368,4465756,4465368,388,384,utRho14
1373,sapF,2705314,2705314,2705268,46,0,utRho14
1374,sbcB,4165456,4165512,4165456,56,62,utRho14
1375,sbcC,831694,831694,831506,188,330,utRho14
1376,sbcD,833954,833954,833904,50,6,utRho14
1377,sbmA,793106,793278,793106,172,4,utRho14
1378,sbmC,4162650,4162650,4162524,126,0,utRho14
1379,sdaA,3793618,3793864,3793618,246,308,utRho14
1380,sdaC,5856070,5856458,5856070,388,1720,utRho14
1381,sdhC,1509916,1510354,1509916,438,124558,utRho14
1382,sdhD,1510808,1511120,1510808,312,35108,utRho14
1383,sdiA,3993834,3993834,3993664,170,208,utRho14
1384,secE,8354354,8354716,8354354,362,4,utRho14
1385,secG,6645180,6645180,6645010,170,1176,utRho14
1386,selA,7522594,7522594,7522498,96,546,utRho14
1387,selB,7519850,7519850,7519722,128,82,utRho14
1388,selC,7672396,7672444,7672396,48,110,utRho14
1389,selD,3696058,3696058,3696016,42,2438,utRho14
1390,seqA,1425884,1425974,1425884,90,1188,utRho14
1391,serA,6117098,6117098,6116820,278,0,utRho14
1392,serB,9249712,9249790,9249712,78,152,utRho14
1393,serC,3830380,3830612,3830380,232,0,utRho14
1394,serS,1878730,1878856,1878730,126,930,utRho14
1395,serT,2063438,2063438,2063424,14,0,utRho14
1396,serU,4087124,4087124,4087114,10,656,utRho14
1397,serV,5637394,5637394,5637290,104,2,utRho14
1398,serW,1852014,1852014,1851942,72,192,utRho14
1399,serX,2195352,2195352,2195304,48,0,utRho14
1400,setB,4527426,4527726,4527426,300,0,utRho14
1401,setC,7673488,7673906,7673488,418,0,utRho14
1402,sfmA,1116124,1116424,1116124,300,0,utRho14
1403,sfmC,1117606,1117948,1117606,342,0,utRho14
1404,sfsA,323030,323030,322972,58,1290,utRho14
1405,sfsB,6669592,6669818,6669592,226,70,utRho14
1406,sgrR,154676,154676,154598,78,12,utRho14
1407,sgrS,154734,154734,154734,0,0,utRho14
1408,shiA,4107068,4107286,4107068,218,0,utRho14
1409,sibA,4306622,4306622,4306622,0,0,utRho14
1410,sibB,4307292,4307292,4307292,0,0,utRho14
1411,sibC,6113702,6113702,6113702,0,0,utRho14
1412,sibD,6389730,6389730,6389730,0,0,utRho14
1413,sibE,6390480,6390480,6390480,0,0,utRho14
1414,sixA,4913998,4913998,4913624,374,424,utRho14
1415,slp,7307872,7307922,7307872,50,0,utRho14
1416,slt,9261400,9261466,9261400,66,0,utRho14
1417,slyA,3442028,3442028,3441648,380,146,utRho14
1418,slyB,3439496,3439752,3439496,256,0,utRho14
1419,slyD,6957398,6957398,6956994,404,982,utRho14
1420,slyX,6954862,6955280,6954862,418,11148,utRho14
1421,smf,6867372,6867372,6867120,252,138,utRho14
1422,smpB,5509534,5509792,5509534,258,756,utRho14
1423,smrA,2811872,2811958,2811872,86,2,utRho14
1424,smrB,4896872,4897212,4896872,340,316,utRho14
1425,smtA,1946808,1947074,1946808,266,64,utRho14
1426,sodA,8201518,8201620,8201518,102,20394,utRho14
1427,sodB,3470646,3470756,3470646,110,0,utRho14
1428,sodC,3449358,3449358,3449310,48,128,utRho14
1429,sohB,2658568,2658664,2658568,96,0,utRho14
1430,sokB,2984232,2984238,2984232,6,274,utRho14
1431,solA,2241218,2241218,2241172,46,0,utRho14
1432,soxR,8554894,8554938,8554894,44,60,utRho14
1433,soxS,8554846,8554846,8554766,80,0,utRho14
1434,speA,6172096,6172096,6171822,274,54,utRho14
1435,speB,6167892,6167892,6167594,298,212,utRho14
1436,speC,6218350,6218350,6218310,40,0,utRho14
1437,spf,8099798,8099798,8099798,0,0,utRho14
1438,sppA,3697422,3697674,3697422,252,2,utRho14
1439,spy,3651376,3651376,3651250,126,0,utRho14
1440,sra,3112092,3112092,3111926,166,2,utRho14
1441,sraB,2293178,2293178,2293178,0,0,utRho14
1442,sraC,3846132,3846132,3846132,0,0,utRho14
1443,srlA,5651582,5651664,5651582,82,0,utRho14
1444,srlR,5657720,5658094,5657720,374,5510,utRho14
1445,srmB,5425752,5425792,5425752,40,286,utRho14
1446,sroA,151216,151216,151216,0,0,utRho14
1447,sroG,6369436,6369436,6369436,0,0,utRho14
1448,sroH,8380974,8380974,8380974,0,0,utRho14
1449,ssb,8548022,8548250,8548022,228,0,utRho14
1450,sseA,5304782,5304988,5304782,206,30334,utRho14
1451,sspA,6755138,6755138,6754840,298,1546,utRho14
1452,ssrA,5511014,5511186,5511014,172,10,utRho14
1453,ssrS,12223036,12223932,12223036,896,2256,utRho14
1454,sstT,6479726,6479888,6479726,162,0,utRho14
1455,ssuB,1988282,1988282,1988088,194,2,utRho14
1456,ssuE,1995126,1995126,1995024,102,0,utRho14
1457,sthA,8321604,8321604,8321580,24,6328,utRho14
1458,stpA,5597156,5597156,5596990,166,0,utRho14
1459,sucA,3034344,3034824,3034344,480,13184,utRho14
1460,sufA,3528836,3528836,3528772,64,54,utRho14
1461,sufE,3518962,3518962,3518580,382,110,utRho14
1462,sugE,8753588,8753750,8753588,162,216,utRho14
1463,sulA,2041894,2041894,2041838,56,84,utRho14
1464,syd,5850738,5850738,5850560,178,88,utRho14
1465,symE,9159834,9159834,9159680,154,70,utRho14
1466,symR,9159670,9159670,9159670,0,0,utRho14
1467,tabA,8949566,8949724,8949566,158,0,utRho14
1468,talA,5157140,5157332,5157140,192,0,utRho14
1469,talB,16382,16476,16382,94,19482,utRho14
1470,tam,3214442,3214692,3214442,250,180,utRho14
1471,tamA,8884540,8884764,8884540,224,100,utRho14
1472,tar,3945432,3945432,3945382,50,0,utRho14
1473,tas,5943138,5943194,5943138,56,368,utRho14
1474,tatA,16087636,16087780,16087636,144,336,utRho14
1475,tatE,1317742,1317894,1317742,152,0,utRho14
1476,tauA,770410,770464,770410,54,0,utRho14
1477,tdcA,6534186,6534186,6534130,56,0,utRho14
1478,tdcG,6519652,6519652,6519298,354,460,utRho14
1479,tdcR,6534380,6534760,6534380,380,0,utRho14
1480,tdk,2586986,2587054,2586986,68,0,utRho14
1481,tehA,3001072,3001146,3001072,74,76,utRho14
1482,tesA,1039898,1039898,1039530,368,852,utRho14
1483,tesB,950402,950402,950322,80,0,utRho14
1484,tfaE,2418532,2418532,2418238,294,0,utRho14
1485,tfaQ,3269912,3269912,3269770,142,0,utRho14
1486,tff,379424,379256,379424,168,0,utRho14
1487,tgt,852110,852274,852110,164,0,utRho14
1488,thiD,4369346,4369346,4369032,314,0,utRho14
1489,thiI,882936,883098,882936,162,142,utRho14
1490,thiM,4370902,4370902,4370602,300,410,utRho14
1491,thiQ,146170,146170,145854,316,184,utRho14
1492,thrL,592,760,592,168,192,utRho14
1493,thrS,7210932,7210932,7210280,652,1188,utRho14
1494,thrU,8350762,8350776,8350762,14,68,utRho14
1495,thrV,6847414,6847414,6847310,104,211290,utRho14
1496,thrW,525682,525742,525682,60,2,utRho14
1497,thyA,5930696,5930696,5930310,386,3126,utRho14
1498,tig,909986,910266,909986,280,1664,utRho14
1499,tisB,7706674,7707106,7706674,432,612,utRho14
1500,tktA,6163414,6163414,6163270,144,820,utRho14
1501,tktB,5158616,5159272,5158616,656,2556,utRho14
1502,tldD,6784368,6784368,6784056,312,0,utRho14
1503,tmcA,5191876,5191876,5191718,158,0,utRho14
1504,tnaC,15553644,15553740,15553644,96,10368,utRho14
1505,tolB,1555074,1555480,1555074,406,2,utRho14
1506,tolC,6356008,6356230,6356008,222,454,utRho14
1507,tomB,961588,961588,961416,172,224,utRho14
1508,tonB,2622108,2622178,2622108,70,0,utRho14
1509,topA,2661578,2662096,2661578,518,124,utRho14
1510,torC,2116112,2116168,2116112,56,152,utRho14
1511,torR,2115968,2115968,2115908,60,158,utRho14
1512,torS,2112364,2112364,2112356,8,0,utRho14
1513,torT,2112414,2112522,2112414,108,0,utRho14
1514,tpiA,8223138,8223138,8223014,124,456,utRho14
1515,tppB,3425342,3425538,3425342,196,6088,utRho14
1516,tpr,2574376,2574376,2574376,0,0,utRho14
1517,tpx,2777688,2777688,2777622,66,144,utRho14
1518,tqsA,3347780,3347826,3347780,46,0,utRho14
1519,treA,2494850,2494850,2494752,98,148,utRho14
1520,treB,8932420,8932420,8932360,60,230,utRho14
1521,treF,7339102,7339184,7339102,82,304,utRho14
1522,treR,8934694,8934694,8934492,202,0,utRho14
1523,trg,2984878,2984940,2984878,62,0,utRho14
1524,trkG,2847342,2847564,2847342,222,4,utRho14
1525,trmA,8326590,8326590,8326540,50,0,utRho14
1526,trpA,2634678,2634678,2634444,234,1024,utRho14
1527,trpC,2639888,2639888,2639570,318,0,utRho14
1528,trpL,5292432,5292432,5292328,104,0,utRho14
1529,trpR,9265408,9265520,9265408,112,310,utRho14
1530,trpS,7027394,7027394,7027276,118,2978,utRho14
1531,trpT,7893560,7893914,7893560,354,134358,utRho14
1532,trxA,7931294,7931522,7931294,228,264,utRho14
1533,trxB,1864156,1864156,1864100,56,0,utRho14
1534,trxC,5437350,5437470,5437350,120,340,utRho14
1535,tsaD,6421256,6421256,6421086,170,0,utRho14
1536,tsgA,6985038,6985136,6985038,98,0,utRho14
1537,tsr,9182824,9183314,9182824,490,280,utRho14
1538,tsx,864490,864490,864026,464,1862,utRho14
1539,ttcA,2823970,2823970,2823896,74,3374,utRho14
1540,ttdA,6412848,6412926,6412848,78,0,utRho14
1541,ttdR,6412760,6412760,6412512,248,0,utRho14
1542,tufA,6943448,6943448,6942658,790,275124,utRho14
1543,tus,3368346,3368518,3368346,172,128,utRho14
1544,tusA,7218040,7218040,7217992,48,106,utRho14
1545,tusB,6950218,6950218,6949930,288,852,utRho14
1546,tynA,2902996,2902996,2902698,298,0,utRho14
1547,typA,8116460,8116814,8116460,354,4886,utRho14
1548,tyrB,8534164,8534228,8534164,64,5238,utRho14
1549,tyrP,3979004,3979362,3979004,358,0,utRho14
1550,tyrR,2773384,2773440,2773384,56,0,utRho14
1551,tyrS,3434566,3434566,3434444,122,0,utRho14
1552,tyrT,2575330,2575330,2575244,86,136,utRho14
1553,uacT,6062378,6062734,6062378,356,132,utRho14
1554,ubiC,8504886,8505012,8504886,126,0,utRho14
1555,ubiD,8049618,8049976,8049618,358,1058,utRho14
1556,ubiE,8037494,8037710,8037494,216,460,utRho14
1557,ubiG,4679078,4679134,4679078,56,0,utRho14
1558,ucpA,5089342,5089342,5089246,96,76,utRho14
1559,udp,8032782,8032862,8032782,80,0,utRho14
1560,ugd,4199470,4199470,4199226,244,0,utRho14
1561,ugpB,7184852,7184852,7184650,202,272,utRho14
1562,ugpQ,7176600,7176600,7176226,374,36,utRho14
1563,uhpT,7694396,7694396,7694334,62,0,utRho14
1564,uidA,3392304,3392304,3392142,162,0,utRho14
1565,uidC,3386012,3386012,3385702,310,0,utRho14
1566,uidR,3394150,3394150,3394104,46,108,utRho14
1567,ulaA,8839854,8839960,8839854,106,0,utRho14
1568,ulaG,8839350,8839350,8839250,100,0,utRho14
1569,ulaR,8837124,8837124,8836906,218,74,utRho14
1570,umpG,5741372,5741372,5740548,824,528,utRho14
1571,umpH,1400704,1400704,1400652,52,84,utRho14
1572,umuD,2461476,2461534,2461476,58,0,utRho14
1573,ung,5433476,5433508,5433476,32,0,utRho14
1574,uof,2843316,2843316,2842900,416,6472,utRho14
1575,upp,5241818,5241818,5241744,74,736,utRho14
1576,usg,4873780,4873780,4873298,482,580,utRho14
1577,ushA,1009772,1009828,1009772,56,0,utRho14
1578,uspA,7279966,7280222,7279966,256,1826,utRho14
1579,uspB,7279696,7279696,7279440,256,70,utRho14
1580,uspC,3959172,3959506,3959172,334,0,utRho14
1581,uspE,2797318,2797318,2797244,74,0,utRho14
1582,uspF,2871282,2871282,2871238,44,0,utRho14
1583,uspG,1283806,1283806,1283734,72,154,utRho14
1584,uvrA,8547872,8547872,8547742,130,16,utRho14
1585,uvrB,1626304,1627052,1626304,748,1888,utRho14
1586,uvrC,3989758,3989758,3989412,346,126,utRho14
1587,uvrD,7995814,7995966,7995814,152,208,utRho14
1588,uvrY,3990812,3990812,3990718,94,0,utRho14
1589,uxaB,3221474,3221474,3221360,114,0,utRho14
1590,uxaC,6489714,6489714,6489482,232,0,utRho14
1591,uxuA,9103036,9103272,9103036,236,1230,utRho14
1592,uxuR,9108916,9109152,9108916,236,96,utRho14
1593,valS,8967854,8967854,8967674,180,1276,utRho14
1594,valU,5041848,5041862,5041848,14,0,utRho14
1595,valV,3492830,3492870,3492830,40,0,utRho14
1596,ves,3649968,3649968,3649874,94,0,utRho14
1597,waaA,7616512,7617080,7616512,568,346,utRho14
1598,waaH,7580298,7580298,7580162,136,0,utRho14
1599,waaQ,7616476,7616476,7616196,280,108,utRho14
1600,waaU,7598996,7598996,7598624,372,42,utRho14
1601,waaY,7602272,7602272,7601930,342,3426,utRho14
1602,wbbH,4214888,4214888,4214452,436,1686,utRho14
1603,wbbK,4209212,4209212,4209018,194,318,utRho14
1604,wcaM,4231868,4231868,4231792,76,0,utRho14
1605,wrbA,2135516,2135516,2135416,100,0,utRho14
1606,wza,4275166,4275166,4274486,680,0,utRho14
1607,wzxC,4240674,4240674,4240316,358,0,utRho14
1608,wzzB,4196950,4196950,4196602,348,0,utRho14
1609,xanP,7657642,7657890,7657642,248,0,utRho14
1610,xanQ,6048520,6048702,6048520,182,0,utRho14
1611,xapA,5049820,5049820,5049756,64,0,utRho14
1612,xapR,10090252,10090252,10089908,344,0,utRho14
1613,xdhA,6000514,6000690,6000514,176,68,utRho14
1614,xerD,6079702,6079702,6079486,216,0,utRho14
1615,xseA,5268394,5268464,5268394,70,0,utRho14
1616,xseB,882746,882746,882686,60,522,utRho14
1617,xthA,3664798,3664856,3664798,58,0,utRho14
1618,xylA,7461614,7461614,7461530,84,1218,utRho14
1619,xylE,8484540,8484540,8484508,32,0,utRho14
1620,xylF,7462138,7462262,7462138,124,292,utRho14
1621,xylR,7469812,7469958,7469812,146,0,utRho14
1622,yaaA,13230,13230,12918,312,62,utRho14
1623,yaaI,23876,23876,23572,304,0,utRho14
1624,yaaJ,16034,16034,15918,116,0,utRho14
1625,yaaU,91184,91614,91184,430,0,utRho14
1626,yaaW,23084,23084,22712,372,0,utRho14
1627,yaaX,10060,10468,10060,408,72,utRho14
1628,yabI,142542,142702,142542,160,292,utRho14
1629,yacC,273880,273880,273834,46,1096,utRho14
1630,yacH,262932,262932,262520,412,0,utRho14
1631,yacL,268678,268776,268678,98,0,utRho14
1632,yadD,293796,293936,293796,140,0,utRho14
1633,yadE,289930,290162,289930,232,322,utRho14
1634,yadN,314110,314110,313766,344,0,utRho14
1635,yadS,355572,355572,355248,324,348,utRho14
1636,yadV,312470,312470,312402,68,54,utRho14
1637,yaeF,434270,434270,434006,264,0,utRho14
1638,yaeP,428374,428374,428250,124,0,utRho14
1639,yaeQ,428176,428582,428176,406,0,utRho14
1640,yaeR,423716,423754,423716,38,42,utRho14
1641,yafC,462166,462166,461762,404,50,utRho14
1642,yafD,462128,462244,462128,116,50,utRho14
1643,yafK,491986,491986,491610,376,502,utRho14
1644,yafL,493282,493424,493282,142,72,utRho14
1645,yafN,503938,504010,503938,72,0,utRho14
1646,yafS,469568,469632,469568,64,936,utRho14
1647,yafT,474470,474670,474470,200,0,utRho14
1648,yafV,480432,480432,480378,54,0,utRho14
1649,yafZ,536052,536052,536010,42,0,utRho14
1650,yagE,564446,564556,564446,110,0,utRho14
1651,yagG,570414,570790,570414,376,0,utRho14
1652,yagI,578384,578384,578324,60,0,utRho14
1653,yagK,586236,586236,585896,340,0,utRho14
1654,yagL,588062,588062,587836,226,0,utRho14
1655,yagN,591342,591342,591158,184,882,utRho14
1656,yahA,663746,664742,663746,996,2,utRho14
1657,yahC,670136,670136,670044,92,0,utRho14
1658,yahE,671478,671850,671478,372,0,utRho14
1659,yahM,690504,690808,690504,304,0,utRho14
1660,yahN,692872,692872,692674,198,2,utRho14
1661,yahO,692864,692968,692864,104,0,utRho14
1662,yaiE,816296,816354,816296,58,46,utRho14
1663,yaiI,811396,811528,811396,132,0,utRho14
1664,yaiO,761946,761946,761684,262,0,utRho14
1665,yaiP,767970,767970,767870,100,0,utRho14
1666,yaiS,769660,769660,769232,428,0,utRho14
1667,yaiV,788922,788922,788922,0,0,utRho14
1668,yaiY,799094,799094,798666,428,2,utRho14
1669,yaiZ,798888,799186,798888,298,2,utRho14
1670,yajC,854410,854574,854410,164,1206,utRho14
1671,yajD,860938,861210,860938,272,768,utRho14
1672,yajI,866068,866068,865702,366,324,utRho14
1673,yajL,887496,887496,887282,214,802,utRho14
1674,yajQ,889316,889366,889316,50,0,utRho14
1675,yajR,893374,893374,893332,42,0,utRho14
1676,ybaB,987418,988152,987418,734,2740,utRho14
1677,ybaL,1006590,1006590,1006476,114,2,utRho14
1678,ybaM,980648,980648,980542,106,238,utRho14
1679,ybaN,981436,981764,981436,328,1208,utRho14
1680,ybaO,936704,936766,936704,62,0,utRho14
1681,ybaP,1016568,1016568,1016160,408,1100,utRho14
1682,ybaQ,1016348,1016436,1016348,88,0,utRho14
1683,ybaS,1023146,1023282,1023146,136,0,utRho14
1684,ybaV,927504,927874,927504,370,60,utRho14
1685,ybaY,950490,950758,950490,268,184,utRho14
1686,ybbB,1062724,1062724,1062452,272,0,utRho14
1687,ybbJ,1030154,1030154,1029718,436,274,utRho14
1688,ybbL,1031784,1031838,1031784,54,0,utRho14
1689,ybbN,1037136,1037136,1036558,578,2306,utRho14
1690,ybbO,1038658,1038658,1038298,360,2240,utRho14
1691,ybbY,1080718,1081130,1080718,412,66,utRho14
1692,ybcH,1176140,1176140,1175962,178,0,utRho14
1693,ybcI,1113264,1113264,1113106,158,16,utRho14
1694,ybcJ,1114050,1114050,1113746,304,640,utRho14
1695,ybcK,1137502,1137804,1137502,302,0,utRho14
1696,ybcL,1141690,1141786,1141690,96,0,utRho14
1697,ybcN,1144628,1144932,1144628,304,0,utRho14
1698,ybcQ,1147548,1147912,1147548,364,68,utRho14
1699,ybcW,1159610,1159760,1159610,150,0,utRho14
1700,ybdD,1263982,1264364,1263982,382,182,utRho14
1701,ybdF,1212106,1212106,1211772,334,344,utRho14
1702,ybdH,1267048,1267048,1266954,94,0,utRho14
1703,ybdJ,1212822,1212822,1212398,424,0,utRho14
1704,ybdK,1215122,1215122,1214766,356,44,utRho14
1705,ybdL,1267114,1267172,1267114,58,0,utRho14
1706,ybdM,1271110,1271110,1270752,358,8,utRho14
1707,ybdN,1273372,1273372,1273138,234,0,utRho14
1708,ybdR,1283844,1284176,1283844,332,118,utRho14
1709,ybeD,1325412,1325412,1325284,128,440,utRho14
1710,ybeF,1323090,1323090,1322756,334,0,utRho14
1711,ybeL,1349986,1350036,1349986,50,218,utRho14
1712,ybeQ,1353412,1353412,1353094,318,2,utRho14
1713,ybeR,1353120,1353422,1353120,302,2,utRho14
1714,ybeT,1358832,1358832,1358812,20,0,utRho14
1715,ybeU,1358924,1359016,1358924,92,0,utRho14
1716,ybeZ,1386938,1386938,1386834,104,1506,utRho14
1717,ybfA,1458074,1458268,1458074,194,2,utRho14
1718,ybfE,1423878,1423878,1423796,82,166,utRho14
1719,ybfF,1425692,1425692,1425604,88,470,utRho14
1720,ybfH,1433282,1433282,1433194,88,0,utRho14
1721,ybgA,1477840,1478002,1477840,162,0,utRho14
1722,ybgC,1549288,1549504,1549288,216,28,utRho14
1723,ybgD,1505916,1505916,1505590,326,204,utRho14
1724,ybgI,1485238,1485654,1485238,416,0,utRho14
1725,ybgO,1498370,1498370,1497964,406,0,utRho14
1726,ybgS,1570992,1570992,1570634,358,0,utRho14
1727,ybhA,1597184,1597184,1596862,322,156,utRho14
1728,ybhB,1616070,1616070,1615818,252,244,utRho14
1729,ybhC,1614642,1614642,1614562,80,3652,utRho14
1730,ybhD,1601418,1601418,1601276,142,0,utRho14
1731,ybhH,1601104,1601518,1601104,414,0,utRho14
1732,ybhK,1633384,1633384,1633294,90,0,utRho14
1733,ybhM,1641556,1641586,1641556,30,0,utRho14
1734,ybhN,1645296,1645296,1644996,300,68,utRho14
1735,ybhQ,1649202,1649260,1649202,58,0,utRho14
1736,ybiA,1665920,1665920,1665900,20,0,utRho14
1737,ybiI,1676968,1676968,1676912,56,0,utRho14
1738,ybiO,1691328,1691328,1690960,368,864,utRho14
1739,ybiP,1705252,1705252,1705194,58,4,utRho14
1740,ybiS,1711572,1711572,1711488,84,128,utRho14
1741,ybiT,1711894,1711926,1711894,32,0,utRho14
1742,ybiU,1718212,1718212,1718122,90,0,utRho14
1743,ybiV,1720176,1720176,1720056,120,0,utRho14
1744,ybiW,1725566,1725566,1725212,354,298,utRho14
1745,ybiX,1678548,1678548,1678414,134,362,utRho14
1746,ybjC,1781784,1781826,1781784,42,0,utRho14
1747,ybjE,1830154,1830154,1829714,440,0,utRho14
1748,ybjG,1767016,1767016,1766776,240,960,utRho14
1749,ybjL,1779882,1779882,1779638,244,44,utRho14
1750,ybjM,1779770,1780178,1779770,408,22,utRho14
1751,ybjO,1795704,1795978,1795704,274,0,utRho14
1752,ybjP,1809046,1809046,1808934,112,2,utRho14
1753,ybjQ,1809034,1809186,1809034,152,0,utRho14
1754,ybjS,1813796,1813796,1813506,290,152,utRho14
1755,ybjX,1838206,1838206,1838168,38,0,utRho14
1756,ycaD,1891438,1891742,1891438,304,0,utRho14
1757,ycaI,1928210,1928640,1928210,430,136,utRho14
1758,ycaK,1899094,1899336,1899094,242,0,utRho14
1759,ycaL,1920264,1920528,1920264,264,0,utRho14
1760,ycaM,1894240,1894458,1894240,218,8,utRho14
1761,ycaR,1941284,1941346,1941284,62,976,utRho14
1762,ycbB,1961862,1962094,1961862,232,0,utRho14
1763,ycbJ,1943344,1943504,1943344,160,2,utRho14
1764,ycbK,1966046,1966150,1966046,104,736,utRho14
1765,ycbZ,2036920,2036920,2036598,322,2,utRho14
1766,yccA,2062886,2062886,2062836,50,90,utRho14
1767,yccF,2048730,2048730,2048696,34,0,utRho14
1768,yccS,2047988,2047988,2047766,222,86,utRho14
1769,yccT,2055674,2055674,2055546,128,0,utRho14
1770,yccX,2059960,2060128,2059960,168,188,utRho14
1771,ycdT,2185682,2185752,2185682,70,0,utRho14
1772,ycdU,2191266,2191686,2191266,420,0,utRho14
1773,ycdZ,2200504,2200592,2200504,88,286,utRho14
1774,yceA,2233544,2233614,2233544,70,0,utRho14
1775,yceD,2293298,2293588,2293298,290,7154,utRho14
1776,yceF,2293522,2293522,2293190,332,4310,utRho14
1777,yceH,2252154,2252314,2252154,160,3712,utRho14
1778,yceI,2237282,2237282,2236952,330,806,utRho14
1779,yceJ,2238142,2238142,2238092,50,0,utRho14
1780,yceM,2253208,2253612,2253208,404,168,utRho14
1781,yceO,2239264,2239264,2238894,370,608,utRho14
1782,yceQ,2288760,2289004,2288760,244,8802,utRho14
1783,ycfD,2376540,2376540,2376480,60,220,utRho14
1784,ycfJ,2334814,2335198,2334814,384,0,utRho14
1785,ycfS,2340834,2340834,2340748,86,0,utRho14
1786,ycfT,2350658,2350658,2350330,328,52,utRho14
1787,ycfZ,2362760,2362760,2362534,226,6,utRho14
1788,ycgB,2474570,2474570,2474482,88,0,utRho14
1789,ycgG,2434614,2434656,2434614,42,0,utRho14
1790,ycgJ,2452956,2453200,2452956,244,0,utRho14
1791,ycgL,2455218,2455362,2455218,144,0,utRho14
1792,ycgN,2457366,2457660,2457366,294,184,utRho14
1793,ycgR,2489112,2489112,2489054,58,0,utRho14
1794,ycgV,2512222,2512222,2511904,318,4,utRho14
1795,ycgX,2426568,2426568,2426214,354,444,utRho14
1796,ycgY,2490166,2490320,2490166,154,0,utRho14
1797,ycgZ,2431504,2431578,2431504,74,0,utRho14
1798,ychE,2596904,2597196,2596904,292,8,utRho14
1799,ychF,2515764,2515764,2515624,140,42,utRho14
1800,ychH,2517476,2517582,2517476,106,4,utRho14
1801,ychJ,2578354,2578354,2578264,90,0,utRho14
1802,ychN,2547310,2547310,2547198,112,44,utRho14
1803,ychO,2547520,2547850,2547520,330,152,utRho14
1804,ychQ,2533798,2533848,2533798,50,0,utRho14
1805,yciA,2624828,2624828,2624492,336,182,utRho14
1806,yciB,2626110,2626110,2625780,330,2252,utRho14
1807,yciC,2627396,2627396,2627326,70,0,utRho14
1808,yciE,2630794,2630794,2630448,346,4,utRho14
1809,yciG,5264368,5264368,5264140,228,0,utRho14
1810,yciI,2621784,2621784,2621730,54,8,utRho14
1811,yciN,2661606,2661606,2661336,270,32,utRho14
1812,yciS,2680270,2680486,2680270,216,148,utRho14
1813,yciT,2689088,2689088,2688692,396,454,utRho14
1814,yciU,2614718,2614718,2614300,418,258,utRho14
1815,yciV,2646376,2646440,2646376,64,0,utRho14
1816,yciW,2700472,2700472,2700214,258,322,utRho14
1817,yciZ,2689276,2689276,2689218,58,342,utRho14
1818,ycjD,2703792,2703792,2703520,272,124,utRho14
1819,ycjG,2777748,2777860,2777748,112,150,utRho14
1820,ycjM,2740006,2740432,2740006,426,524,utRho14
1821,ycjW,2767982,2767982,2767922,60,0,utRho14
1822,ycjX,2768138,2768234,2768138,96,120,utRho14
1823,ycjY,5568288,5568288,5567460,828,0,utRho14
1824,ydaE,2836438,2836438,2836016,422,0,utRho14
1825,ydaN,2816048,2816100,2816048,52,0,utRho14
1826,ydaS,2840340,2840730,2840340,390,54,utRho14
1827,ydbC,2948376,2948442,2948376,66,0,utRho14
1828,ydbD,2950132,2950288,2950132,156,0,utRho14
1829,ydbH,2885800,2886102,2885800,302,74,utRho14
1830,ydbJ,2881712,2882116,2881712,404,0,utRho14
1831,ydbK,2881692,2881692,2881568,124,134,utRho14
1832,ydcA,2983294,2983354,2983294,60,50,utRho14
1833,ydcF,2974404,2974470,2974404,66,36,utRho14
1834,ydcI,2990268,2990268,2990142,126,0,utRho14
1835,ydcJ,2990266,2990576,2990266,310,0,utRho14
1836,ydcK,3001280,3001280,3000898,382,152,utRho14
1837,ydcL,3004646,3004914,3004646,268,54,utRho14
1838,ydcN,3012308,3012344,3012308,36,0,utRho14
1839,ydcP,3013508,3013562,3013508,54,0,utRho14
1840,ydcR,3019956,3020006,3019956,50,0,utRho14
1841,ydcS,3022906,3023308,3022906,402,0,utRho14
1842,ydcX,3034442,3034778,3034442,336,0,utRho14
1843,ydcY,3035220,3035296,3035220,76,104,utRho14
1844,ydcZ,3036750,3036750,3036662,88,140,utRho14
1845,yddB,3155332,3155332,3155238,94,2,utRho14
1846,yddE,3071738,3071738,3071716,22,0,utRho14
1847,yddG,3094410,3094410,3094338,72,0,utRho14
1848,yddJ,3089732,3089732,3089438,294,0,utRho14
1849,yddW,3137704,3137704,3137646,58,2,utRho14
1850,ydeA,3233910,3234056,3233910,146,2,utRho14
1851,ydeE,3242528,3242664,3242528,136,32,utRho14
1852,ydeI,3249118,3249118,3248994,124,0,utRho14
1853,ydeJ,3249376,3249546,3249376,170,0,utRho14
1854,ydeN,3165458,3165458,3165048,410,0,utRho14
1855,ydeP,3173328,3173328,3172972,356,0,utRho14
1856,ydeR,3176596,3176596,3176592,4,2,utRho14
1857,ydfA,3296872,3297016,3296872,144,0,utRho14
1858,ydfG,3254982,3255034,3254982,52,0,utRho14
1859,ydfH,3256652,3256704,3256652,52,244,utRho14
1860,ydfK,3265446,3266144,3265446,698,194,utRho14
1861,ydgA,3379588,3379704,3379588,116,64,utRho14
1862,ydgC,3364124,3364124,3364060,64,0,utRho14
1863,ydgD,3343906,3343920,3343906,14,0,utRho14
1864,ydgH,3356754,3356854,3356754,100,136,utRho14
1865,ydgJ,3408798,3408798,3408616,182,74,utRho14
1866,ydgK,3410414,3410500,3410414,86,300,utRho14
1867,ydhB,3479618,3479618,3479596,22,0,utRho14
1868,ydhC,3479698,3479822,3479698,124,0,utRho14
1869,ydhF,3451310,3451310,3451264,46,0,utRho14
1870,ydhI,3441996,3442050,3441996,54,0,utRho14
1871,ydhL,3451864,3451864,3451840,24,0,utRho14
1872,ydhQ,3492404,3492404,3492254,150,0,utRho14
1873,ydhS,3494136,3494262,3494136,126,4,utRho14
1874,ydhT,3499138,3499138,3499118,20,0,utRho14
1875,ydhY,3509284,3509284,3508954,330,0,utRho14
1876,ydhZ,3510418,3510418,3510282,136,0,utRho14
1877,ydiE,3579206,3579226,3579206,20,0,utRho14
1878,ydiH,3530582,3530582,3530406,176,0,utRho14
1879,ydiM,3541852,3542142,3541852,290,0,utRho14
1880,ydiN,3544818,3545024,3544818,206,0,utRho14
1881,ydiP,3558656,3558656,3558602,54,0,utRho14
1882,ydiU,3582508,3582508,3582488,20,240,utRho14
1883,ydiV,3584174,3584174,3584040,134,390,utRho14
1884,ydiY,3612500,3612500,3612166,334,0,utRho14
1885,ydjA,3697400,3697400,3697352,48,0,utRho14
1886,ydjE,3708082,3708082,3707958,124,0,utRho14
1887,ydjF,3709848,3709848,3709708,140,0,utRho14
1888,ydjM,3620340,3620422,3620340,82,0,utRho14
1889,ydjO,3626696,3626696,3626288,408,0,utRho14
1890,ydjX,3666434,3666802,3666434,368,596,utRho14
1891,yeaE,3731448,3731448,3731272,176,156,utRho14
1892,yeaG,3733530,3733816,3733530,286,0,utRho14
1893,yeaI,3740486,3740770,3740486,284,0,utRho14
1894,yeaJ,3743874,3744082,3743874,208,0,utRho14
1895,yeaL,3748646,3748704,3748646,58,420,utRho14
1896,yeaM,3751296,3751296,3751152,144,0,utRho14
1897,yeaN,3750926,3751346,3750926,420,124,utRho14
1898,yeaO,3753554,3753818,3753554,264,2,utRho14
1899,yeaP,3755314,3755430,3755314,116,300,utRho14
1900,yeaQ,3758780,3758780,3758510,270,0,utRho14
1901,yeaR,3759988,3759988,3759896,92,0,utRho14
1902,yeaY,3781122,3781122,3781064,58,0,utRho14
1903,yebB,3892220,3892502,3892220,282,0,utRho14
1904,yebC,3896370,3896370,3896302,68,2,utRho14
1905,yebE,3859464,3859464,3859414,50,10,utRho14
1906,yebG,3861530,3861530,3861494,36,44,utRho14
1907,yebK,3873180,3873304,3873180,124,104,utRho14
1908,yebQ,3820314,3820552,3820314,238,0,utRho14
1909,yebS,3832238,3832516,3832238,278,0,utRho14
1910,yebV,3843430,3843560,3843430,130,0,utRho14
1911,yebW,3843914,3844242,3843914,328,716,utRho14
1912,yecC,3995646,3995646,3995628,18,0,utRho14
1913,yecD,3901272,3901664,3901272,392,366,utRho14
1914,yecF,3991434,3991636,3991434,202,0,utRho14
1915,yecH,3979304,3979304,3978980,324,0,utRho14
1916,yecJ,3975604,3975604,3975516,88,0,utRho14
1917,yecM,3919968,3919968,3919692,276,0,utRho14
1918,yecR,3976400,3976444,3976400,44,0,utRho14
1919,yecT,3923862,3923944,3923862,82,2,utRho14
1920,yedD,4016522,4016522,4016180,342,40,utRho14
1921,yedE,4016310,4016554,4016310,244,84,utRho14
1922,yedI,4058922,4058922,4058732,190,0,utRho14
1923,yedJ,4066446,4066446,4066158,288,0,utRho14
1924,yedV,4076404,4076404,4076304,100,114,utRho14
1925,yedX,4077680,4077912,4077680,232,0,utRho14
1926,yedY,4078572,4078956,4078572,384,0,utRho14
1927,yeeA,4161322,4161322,4161182,140,334,utRho14
1928,yeeE,4171104,4171104,4171050,54,0,utRho14
1929,yeeJ,4089526,4089822,4089526,296,0,utRho14
1930,yeeN,4113508,4113716,4113508,208,0,utRho14
1931,yeeO,4119444,4119444,4119692,248,0,utRho14
1932,yeeX,4158834,4158834,4158722,112,372,utRho14
1933,yeeZ,4178422,4178422,4178256,166,76,utRho14
1934,yefM,4179466,4179466,4179426,40,0,utRho14
1935,yegD,4295288,4295348,4295288,60,0,utRho14
1936,yegH,4275726,4275804,4275726,78,0,utRho14
1937,yegI,4302154,4302154,4301970,184,0,utRho14
1938,yegJ,4302032,4302370,4302032,338,0,utRho14
1939,yegQ,4331182,4331336,4331182,154,4,utRho14
1940,yegR,4336698,4336698,4336612,86,0,utRho14
1941,yegS,4337086,4337424,4337086,338,0,utRho14
1942,yegT,4357562,4357642,4357562,80,0,utRho14
1943,yegX,4367640,4367640,4367302,338,0,utRho14
1944,yehA,4376944,4376944,4376828,116,0,utRho14
1945,yehE,4385818,4385818,4385592,226,0,utRho14
1946,yehK,4407568,4407944,4407568,376,0,utRho14
1947,yehL,4408804,4409192,4408804,388,0,utRho14
1948,yeiB,4486146,4486146,4485934,212,300,utRho14
1949,yeiE,4499422,4499422,4499236,186,54,utRho14
1950,yeiG,4487776,4487820,4487776,44,490,utRho14
1951,yeiH,4499332,4499434,4499332,102,56,utRho14
1952,yeiI,4503306,4503400,4503306,94,308,utRho14
1953,yeiL,4510580,4510710,4510580,130,0,utRho14
1954,yeiP,4530834,4530900,4530834,66,338,utRho14
1955,yeiQ,4532328,4532490,4532328,162,2,utRho14
1956,yeiR,4535484,4535658,4535484,174,180,utRho14
1957,yeiW,4530840,4530840,4530590,250,494,utRho14
1958,yejA,4544624,4544728,4544624,104,62,utRho14
1959,yejG,4556892,4556892,4556474,418,434,utRho14
1960,yejH,4561244,4561264,4561244,20,66,utRho14
1961,yejK,4568218,4568218,4567894,324,182,utRho14
1962,yejO,4578352,4578352,4577800,552,118,utRho14
1963,yfaD,4713380,4713808,4713380,428,776,utRho14
1964,yfaE,4696676,4697028,4696676,352,1582,utRho14
1965,yfaL,4688568,4688568,4688338,230,2,utRho14
1966,yfaP,4656398,4656398,4656286,112,0,utRho14
1967,yfaU,4717892,4717892,4717690,202,0,utRho14
1968,yfaY,4727310,4727310,4727266,44,0,utRho14
1969,yfaZ,4728744,4728744,4728550,194,0,utRho14
1970,yfbK,4771810,4771810,4771444,366,0,utRho14
1971,yfbL,4771500,4771720,4771500,220,0,utRho14
1972,yfbN,4777174,4777174,4776852,322,2,utRho14
1973,yfbO,4776916,4777162,4776916,246,2,utRho14
1974,yfbP,4777990,4778232,4777990,242,60,utRho14
1975,yfbR,4817662,4817724,4817662,62,64,utRho14
1976,yfcI,4847424,4847424,4847078,346,2,utRho14
1977,yfcJ,4880482,4880482,4880240,242,0,utRho14
1978,yfcL,4888502,4888502,4888338,164,0,utRho14
1979,yfcV,4911642,4911642,4911292,350,26,utRho14
1980,yfcZ,4921958,4921958,4921868,90,102,utRho14
1981,yfdF,4925604,4926024,4925604,420,6,utRho14
1982,yfdG,4935474,4935710,4935474,236,0,utRho14
1983,yfdP,4946844,4947040,4946844,196,0,utRho14
1984,yfdX,4988866,4988866,4988804,62,0,utRho14
1985,yfdY,4990672,4990672,4990584,88,0,utRho14
1986,yfeA,5035784,5035784,5035664,120,5376,utRho14
1987,yfeC,5036668,5036934,5036668,266,678,utRho14
1988,yfeH,5053818,5053892,5053818,74,0,utRho14
1989,yfeK,5074630,5074684,5074630,54,0,utRho14
1990,yfeO,5018906,5019260,5018906,354,0,utRho14
1991,yfeR,5054078,5054078,5053712,366,118,utRho14
1992,yfeX,5101356,5101356,5101090,266,0,utRho14
1993,yfeY,5102486,5102486,5102432,54,0,utRho14
1994,yfeZ,5103842,5103842,5103452,390,264,utRho14
1995,yffO,5123804,5124222,5123804,418,4,utRho14
1996,yffQ,5126778,5127154,5126778,376,4,utRho14
1997,yffS,5128800,5128986,5128800,186,30,utRho14
1998,yfgC,5232052,5232188,5232052,136,0,utRho14
1999,yfgF,5258062,5258062,5257876,186,4,utRho14
2000,yfgG,5258170,5258580,5258170,410,196,utRho14
2001,yfgH,5259344,5259584,5259344,240,0,utRho14
2002,yfgM,5278866,5278866,5278566,300,740,utRho14
2003,yfhH,5397414,5397518,5397414,104,0,utRho14
2004,yfhM,5304648,5304648,5304574,74,0,utRho14
2005,yfhR,5328408,5328726,5328408,318,148,utRho14
2006,yfiC,5425610,5425610,5425528,82,0,utRho14
2007,yfiE,5430688,5430688,5430640,48,0,utRho14
2008,yfiL,5482630,5482720,5482630,90,0,utRho14
2009,yfiM,5448066,5448358,5448066,292,1400,utRho14
2010,yfiR,5483354,5483750,5483354,396,118,utRho14
2011,yfjH,5517326,5517326,5517200,126,0,utRho14
2012,yfjI,5517710,5517970,5517710,260,0,utRho14
2013,yfjJ,5521014,5521094,5521014,80,0,utRho14
2014,yfjM,5531970,5531970,5531552,418,538,utRho14
2015,yfjP,5535080,5535420,5535080,340,4,utRho14
2016,yfjW,5546570,5546636,5546570,66,0,utRho14
2017,yfjX,5551776,5551838,5551776,62,0,utRho14
2018,ygaC,5601180,5601180,5599988,1192,218,utRho14
2019,ygaM,5600242,5600292,5600242,50,2,utRho14
2020,ygaU,5593628,5593628,5593572,56,2,utRho14
2021,ygaZ,5619190,5619234,5619190,44,98,utRho14
2022,ygbA,5713656,5713656,5713612,44,0,utRho14
2023,ygbE,5746784,5746784,5746674,110,82,utRho14
2024,ygbI,5722882,5722882,5722528,354,4,utRho14
2025,ygbK,5724394,5724670,5724394,276,234,utRho14
2026,ygbL,5727074,5727186,5727074,112,102,utRho14
2027,ygbN,5729814,5730202,5729814,388,282,utRho14
2028,ygcG,5811210,5811422,5811210,212,0,utRho14
2029,ygcN,5785144,5785314,5785144,170,144,utRho14
2030,ygcU,5799214,5799214,5798836,378,0,utRho14
2031,ygcW,5800942,5800942,5800546,396,0,utRho14
2032,ygdD,5883442,5883442,5883262,180,194,utRho14
2033,ygdG,5861746,5861930,5861746,184,612,utRho14
2034,ygdI,5886526,5886526,5886290,236,0,utRho14
2035,ygdQ,5940784,5940840,5940784,56,74,utRho14
2036,ygdR,5942494,5942542,5942494,48,108,utRho14
2037,ygeA,5961606,5961606,5961270,336,0,utRho14
2038,ygeH,5983758,5984188,5983758,430,2,utRho14
2039,ygeI,5987162,5987276,5987162,114,0,utRho14
2040,ygeR,6000078,6000078,5999782,296,0,utRho14
2041,ygeV,6011694,6011694,6011572,122,0,utRho14
2042,ygeW,6012234,6012524,6012234,290,0,utRho14
2043,ygfB,6110946,6110946,6110888,58,210,utRho14
2044,ygfK,6031984,6032120,6031984,136,144,utRho14
2045,ygfS,6058328,6058328,6058024,304,0,utRho14
2046,ygfZ,6082564,6082626,6082564,62,124,utRho14
2047,yggC,6149512,6149512,6149378,134,0,utRho14
2048,yggE,6136370,6136370,6136160,210,86,utRho14
2049,yggI,6179176,6179510,6179176,334,166,utRho14
2050,yggL,6204508,6204508,6204266,242,288,utRho14
2051,yggM,6199514,6199514,6199130,384,174,utRho14
2052,yggN,6203596,6203596,6203246,350,264,utRho14
2053,yggX,18623958,18624558,18623958,600,1302,utRho14
2054,yghA,6298966,6299324,6298966,358,62,utRho14
2055,yghB,6307058,6307126,6307058,68,0,utRho14
2056,yghD,6222614,6222614,6222252,362,120,utRho14
2057,yghF,6225798,6225798,6225840,42,0,utRho14
2058,yghJ,6238640,6238640,6238224,416,0,utRho14
2059,yghQ,6265186,6265186,6264816,370,0,utRho14
2060,yghT,6267830,6268262,6267830,432,0,utRho14
2061,yghU,6277400,6277454,6277400,54,4,utRho14
2062,yghW,6293506,6293506,6293474,32,0,utRho14
2063,yghZ,6295562,6295794,6295562,232,0,utRho14
2064,ygiD,6365122,6365122,6364868,254,416,utRho14
2065,ygiH,6409066,6409388,6409066,322,0,utRho14
2066,ygiL,6370622,6370828,6370622,206,0,utRho14
2067,ygiM,6402084,6402414,6402084,330,102,utRho14
2068,ygiN,6346156,6346284,6346156,128,5194,utRho14
2069,ygiQ,6322620,6322620,6322292,328,98,utRho14
2070,ygiS,6335462,6335462,6335436,26,76,utRho14
2071,ygiV,6338582,6338582,6338462,120,92,utRho14
2072,ygiW,6339774,6339774,6339352,422,4,utRho14
2073,ygiZ,6344506,6344506,6344422,84,0,utRho14
2074,ygjH,6442528,6442528,6442494,34,0,utRho14
2075,ygjI,6452140,6452468,6452140,328,8,utRho14
2076,ygjQ,6472730,6473080,6472730,350,32,utRho14
2077,ygjR,6474564,6474586,6474564,22,58,utRho14
2078,ygjV,6483638,6483638,6483488,150,0,utRho14
2079,yhaB,6535632,6535708,6535632,76,0,utRho14
2080,yhaH,6504498,6504608,6504498,110,2,utRho14
2081,yhaI,6505400,6505822,6505400,422,0,utRho14
2082,yhaJ,6508560,6508560,6508428,132,44,utRho14
2083,yhaK,6508538,6508638,6508538,100,116,utRho14
2084,yhbQ,6599878,6599932,6599878,54,0,utRho14
2085,yhbT,6602736,6602736,6602552,184,136,utRho14
2086,yhbU,6602558,6602970,6602558,412,136,utRho14
2087,yhbX,6643302,6643302,6643226,76,0,utRho14
2088,yhbY,6655518,6655580,6655518,62,240,utRho14
2089,yhcA,6723956,6724224,6723956,268,0,utRho14
2090,yhcB,6760364,6760382,6760364,18,62,utRho14
2091,yhcC,6708470,6708470,6708100,370,86,utRho14
2092,yhcF,6733440,6733852,6733440,412,200,utRho14
2093,yhcH,6739124,6739124,6738956,168,550,utRho14
2094,yhcM,6760312,6760312,6759994,318,44,utRho14
2095,yhcN,6770812,6771076,6770812,264,40,utRho14
2096,yhcO,6772606,6772606,6772258,348,0,utRho14
2097,yhdH,6806560,6806968,6806560,408,122,utRho14
2098,yhdJ,6823234,6823306,6823234,72,0,utRho14
2099,yhdN,6879092,6879092,6879018,74,744,utRho14
2100,yhdT,6814702,6814750,6814702,48,50,utRho14
2101,yhdU,6824994,6825242,6824994,248,0,utRho14
2102,yhdV,6836392,6836780,6836392,388,4,utRho14
2103,yhdW,6837944,6838298,6837944,354,0,utRho14
2104,yheO,6953082,6953082,6952880,202,2386,utRho14
2105,yheV,6957970,6957970,6957584,386,494,utRho14
2106,yhfA,6971902,6971902,6971636,266,0,utRho14
2107,yhfG,6983294,6983294,6983240,54,2,utRho14
2108,yhfL,6998622,6998896,6998622,274,86,utRho14
2109,yhfY,7023244,7023244,7022844,400,26,utRho14
2110,yhgA,7086294,7086334,7086294,40,0,utRho14
2111,yhgE,7065176,7065176,7064878,298,86,utRho14
2112,yhgF,7074352,7074770,7074352,418,4264,utRho14
2113,yhhA,7173458,7173886,7173458,428,24,utRho14
2114,yhhI,7248346,7248756,7248346,410,0,utRho14
2115,yhhJ,7253696,7253696,7253606,90,194,utRho14
2116,yhhM,7211588,7211588,7211220,368,0,utRho14
2117,yhhN,7211150,7211502,7211150,352,0,utRho14
2118,yhhQ,7218238,7218434,7218238,196,112,utRho14
2119,yhhT,7223682,7223730,7223682,48,0,utRho14
2120,yhhX,7162032,7162032,7161610,422,66,utRho14
2121,yhhY,7162222,7162276,7162222,54,0,utRho14
2122,yhhZ,7163516,7163726,7163516,210,0,utRho14
2123,yhiD,7312220,7312220,7311804,416,7912,utRho14
2124,yhiJ,7265190,7265190,7265180,10,0,utRho14
2125,yhiM,7269270,7269682,7269270,412,4,utRho14
2126,yhiN,7275000,7275000,7274820,180,172,utRho14
2127,yhjA,7338522,7338522,7338376,146,0,utRho14
2128,yhjB,7344090,7344090,7343788,302,2,utRho14
2129,yhjC,7344272,7344684,7344272,412,0,utRho14
2130,yhjD,7346660,7346724,7346660,64,124,utRho14
2131,yhjE,7349274,7349572,7349274,298,0,utRho14
2132,yhjG,7356824,7356824,7356730,94,0,utRho14
2133,yhjH,7358458,7358458,7358374,84,390,utRho14
2134,yhjJ,7364032,7364032,7363880,152,56,utRho14
2135,yhjK,7371296,7371296,7371158,138,0,utRho14
2136,yhjR,7392750,7392750,7392370,380,26,utRho14
2137,yhjV,7400796,7401126,7400796,330,68,utRho14
2138,yhjX,7424194,7424194,7424014,180,0,utRho14
2139,yhjY,7425966,7425966,7425868,98,0,utRho14
2140,yiaB,7455654,7455654,7455496,158,0,utRho14
2141,yiaD,7432712,7433094,7432712,382,32,utRho14
2142,yiaF,7438194,7438194,7438088,106,0,utRho14
2143,yiaG,7438862,7438956,7438862,94,150,utRho14
2144,yiaJ,7485236,7485236,7485064,172,0,utRho14
2145,yiaK,7485348,7485466,7485348,118,2,utRho14
2146,yiaT,7503924,7503924,7503736,188,0,utRho14
2147,yiaU,7503792,7503984,7503792,192,0,utRho14
2148,yiaY,7515856,7515856,7515654,202,2,utRho14
2149,yibF,7523950,7523950,7523910,40,96,utRho14
2150,yibG,7536128,7536354,7536128,226,0,utRho14
2151,yibL,7553194,7553330,7553194,136,188,utRho14
2152,yibN,7570112,7570112,7570030,82,156,utRho14
2153,yibT,7552848,7552848,7552760,88,0,utRho14
2154,yicC,7633290,7633352,7633290,62,0,utRho14
2155,yicH,7660862,7660914,7660862,52,0,utRho14
2156,yicJ,7673328,7673328,7671858,1470,886,utRho14
2157,yicN,7685018,7685018,7684804,214,104,utRho14
2158,yicO,7687914,7687914,7687578,336,0,utRho14
2159,yicR,15250308,15250308,15250236,72,0,utRho14
2160,yidB,7755230,7755230,7754930,300,0,utRho14
2161,yidE,7732780,7732780,7732546,234,32,utRho14
2162,yidF,7711580,7711580,7711222,358,10,utRho14
2163,yidQ,7735088,7735456,7735088,368,2576,utRho14
2164,yidR,7738824,7738824,7738618,206,0,utRho14
2165,yieE,7787658,7787738,7787658,80,4,utRho14
2166,yieH,7793314,7793548,7793314,234,0,utRho14
2167,yieK,7798928,7798928,7798786,142,0,utRho14
2168,yifB,7900350,7900350,7899998,352,0,utRho14
2169,yifL,7988984,7989044,7988984,60,170,utRho14
2170,yigF,8005750,8005750,8005598,152,230,utRho14
2171,yigI,8009448,8009448,8009394,54,0,utRho14
2172,yigM,8022100,8022152,8022100,52,0,utRho14
2173,yihA,8101970,8101970,8101458,512,90,utRho14
2174,yihD,8084098,8084138,8084098,40,0,utRho14
2175,yihF,8088110,8088398,8088110,288,0,utRho14
2176,yihG,8093304,8093304,8093204,100,0,utRho14
2177,yihI,8102616,8102694,8102616,78,0,utRho14
2178,yihL,8120506,8120894,8120506,388,0,utRho14
2179,yihN,8124332,8124494,8124332,162,2,utRho14
2180,yihO,8131942,8131942,8131532,410,0,utRho14
2181,yihQ,8138892,8138892,8138552,340,0,utRho14
2182,yihV,8147064,8147478,8147064,414,0,utRho14
2183,yihX,8151096,8151106,8151096,10,40,utRho14
2184,yiiE,8158192,8158582,8158192,390,0,utRho14
2185,yiiF,8159124,8159502,8159124,378,82,utRho14
2186,yiiG,8173762,8174004,8173762,242,0,utRho14
2187,yiiM,8205506,8205644,8205506,138,4,utRho14
2188,yiiQ,8224624,8224624,8224428,196,64,utRho14
2189,yiiS,8225738,8225934,8225738,196,0,utRho14
2190,yijE,8272178,8272216,8272178,38,16,utRho14
2191,yijF,8275728,8275728,8275314,414,0,utRho14
2192,yijO,8296858,8296858,8296634,224,76,utRho14
2193,yjaA,8426240,8426468,8426240,228,129058,utRho14
2194,yjaB,8428312,8428312,8428246,66,0,utRho14
2195,yjaG,8398746,8399008,8398746,262,1392,utRho14
2196,yjaH,8401022,8401132,8401022,110,1354,utRho14
2197,yjaZ,8379506,8379572,8379506,66,96,utRho14
2198,yjbB,8455204,8455462,8455204,258,0,utRho14
2199,yjbE,16943432,16943624,16943432,192,0,utRho14
2200,yjbL,8520318,8520642,8520318,324,0,utRho14
2201,yjbQ,8540428,8540476,8540428,48,256,utRho14
2202,yjcB,8550328,8550328,8550082,246,96,utRho14
2203,yjcC,8550836,8550942,8550836,106,2,utRho14
2204,yjcD,8556628,8556958,8556628,330,240,utRho14
2205,yjcE,8559658,8559960,8559658,302,0,utRho14
2206,yjcF,8566212,8566212,8566150,62,0,utRho14
2207,yjcO,8594660,8594660,8594250,410,0,utRho14
2208,yjdA,8654128,8654270,8654128,142,0,utRho14
2209,yjdC,8726660,8726660,8726616,44,96,utRho14
2210,yjdK,8704780,8705168,8704780,388,6,utRho14
2211,yjdL,8713034,8713034,8712822,212,4,utRho14
2212,yjdM,8653672,8653672,8653468,204,356,utRho14
2213,yjeF,8787354,8788132,8787354,778,5676,utRho14
2214,yjeI,8745522,8745618,8745522,96,0,utRho14
2215,yjeJ,8748806,8748806,8748468,338,420,utRho14
2216,yjeV,8785472,8785784,8785472,312,2,utRho14
2217,yjfP,8833512,8833904,8833512,392,142,utRho14
2218,yjfY,8849656,8849656,8849582,74,0,utRho14
2219,yjfZ,8855052,8855052,8854844,208,0,utRho14
2220,yjgA,8916162,8916162,8915730,432,104,utRho14
2221,yjgL,8950802,8950874,8950802,72,0,utRho14
2222,yjgM,8959342,8959342,8959074,268,0,utRho14
2223,yjgN,8959132,8959460,8959132,328,0,utRho14
2224,yjgR,8980170,8980170,8980126,44,26,utRho14
2225,yjgZ,9002116,9002520,9002116,404,78,utRho14
2226,yjhB,9007764,9008116,9007764,352,246,utRho14
2227,yjhG,9048452,9048452,9048188,264,1386,utRho14
2228,yjhU,9041080,9041080,9040648,432,422,utRho14
2229,yjiA,9178096,9178096,9177730,366,13834,utRho14
2230,yjiJ,9125364,9125364,9125350,14,0,utRho14
2231,yjiK,9127270,9127270,9127422,152,286,utRho14
2232,yjiL,9129604,9129604,9129378,226,0,utRho14
2233,yjiS,9143410,9143502,9143410,92,0,utRho14
2234,yjiY,9182734,9182734,9182558,176,8674,utRho14
2235,yjjA,9200674,9200674,9200378,296,76,utRho14
2236,yjjB,18408708,18408708,18407800,908,16,utRho14
2237,yjjJ,9243314,9243538,9243314,224,0,utRho14
2238,yjjK,9261132,9261132,9261044,88,8,utRho14
2239,yjjL,9189764,9189764,9189444,320,134,utRho14
2240,yjjM,9191894,9191894,9191702,192,0,utRho14
2241,yjjP,9206068,9206068,9205716,352,10,utRho14
2242,yjjQ,9206638,9206954,9206638,316,8,utRho14
2243,yjjX,9267798,9267798,9267490,308,1348,utRho14
2244,yjjY,9280716,9280804,9280716,88,1074,utRho14
2245,yjjZ,9211554,9211608,9211554,54,128,utRho14
2246,yjtD,9281676,9281884,9281676,208,154,utRho14
2247,ykfB,532454,532454,532174,280,484,utRho14
2248,ykfI,527636,527636,527338,298,180,utRho14
2249,ykgB,637050,637050,636638,412,112,utRho14
2250,ykgC,640430,640430,640002,428,0,utRho14
2251,ykgD,640232,640454,640232,222,0,utRho14
2252,ykgE,642962,643216,642962,254,50,utRho14
2253,ykgJ,608524,608524,608364,160,140,utRho14
2254,ykgL,623878,624224,623878,346,0,utRho14
2255,ykgM,625610,625610,625554,56,2,utRho14
2256,ykgR,626570,626570,626484,86,0,utRho14
2257,ylaC,958576,958576,958502,74,950,utRho14
2258,yliE,1745938,1745958,1745938,20,0,utRho14
2259,ymcE,2103660,2103694,2103660,34,0,utRho14
2260,ymdA,2210450,2210828,2210450,378,578,utRho14
2261,ymdB,2211428,2211640,2211428,212,0,utRho14
2262,ymfD,2395322,2395322,2395064,258,1186,utRho14
2263,ymfI,2402880,2402994,2402880,114,0,utRho14
2264,ymfJ,2404518,2404518,2404168,350,164,utRho14
2265,ymfK,2406176,2406176,2405866,310,0,utRho14
2266,ymfT,2405766,2406048,2405766,282,2,utRho14
2267,ymgE,2489110,2489456,2489110,346,6,utRho14
2268,ymgF,2437628,2437966,2437628,338,0,utRho14
2269,ymiA,2670112,2670320,2670112,208,0,utRho14
2270,ymjA,2715620,2715620,2715336,284,142,utRho14
2271,ynaI,2791946,2791946,2791844,102,0,utRho14
2272,ynaK,2850438,2850754,2850438,316,102,utRho14
2273,ynbA,2954924,2955242,2954924,318,0,utRho14
2274,yncD,3046552,3046552,3046130,422,34,utRho14
2275,yncE,3046454,3046614,3046454,160,0,utRho14
2276,yncG,3052456,3052494,3052456,38,0,utRho14
2277,yncL,3034492,3034492,3034388,104,0,utRho14
2278,yneE,3218364,3218364,3218044,320,0,utRho14
2279,yneF,3223748,3223748,3223708,40,0,utRho14
2280,yneJ,3229560,3229608,3229560,48,0,utRho14
2281,yneK,3231100,3231526,3231100,426,0,utRho14
2282,yneM,3245176,3245292,3245176,116,0,utRho14
2283,ynfA,3311398,3311398,3311346,52,0,utRho14
2284,ynfB,3311418,3311616,3311418,198,0,utRho14
2285,ynfC,3315094,3315094,3314914,180,178,utRho14
2286,ynfD,3314828,3315130,3314828,302,178,utRho14
2287,ynfE,3316006,3316138,3316006,132,4,utRho14
2288,ynfK,3334670,3334670,3334438,232,508,utRho14
2289,ynfL,3339304,3339304,3339184,120,0,utRho14
2290,ynfM,3339260,3339398,3339260,138,0,utRho14
2291,ynfN,3276598,3276598,3276218,380,8,utRho14
2292,ynfO,3273454,3273512,3273454,58,0,utRho14
2293,ynhG,3517890,3517890,3517450,440,274,utRho14
2294,yniA,3615158,3615592,3615158,434,0,utRho14
2295,yniB,3618526,3618526,3618466,60,46,utRho14
2296,yniC,3618652,3618760,3618652,108,0,utRho14
2297,yniD,3610202,3610330,3610202,128,0,utRho14
2298,ynjE,3678880,3678934,3678880,54,0,utRho14
2299,ynjF,3683222,3683222,3682806,416,288,utRho14
2300,ynjH,3684376,3684376,3684270,106,2,utRho14
2301,ynjI,3690022,3690022,3689742,280,40,utRho14
2302,yoaB,3786642,3786734,3786642,92,210,utRho14
2303,yoaC,3787932,3788146,3787932,214,4,utRho14
2304,yoaE,3803544,3803544,3803170,374,1140,utRho14
2305,yoaF,3755444,3755444,3755064,380,300,utRho14
2306,yoaH,3789866,3789866,3789462,404,502,utRho14
2307,yobB,3850418,3850880,3850418,462,808,utRho14
2308,yobF,3815586,3815586,3815182,404,2,utRho14
2309,yobH,3817800,3817850,3817800,50,4,utRho14
2310,yodB,4084352,4084736,4084352,384,0,utRho14
2311,yodC,4057008,4057008,4056740,268,0,utRho14
2312,yohC,4451358,4451358,4451262,96,0,utRho14
2313,yohD,4451526,4451602,4451526,76,0,utRho14
2314,yohJ,4460986,4461248,4460986,262,0,utRho14
2315,yohO,4431172,4431314,4431172,142,0,utRho14
2316,yojI,4617282,4617282,4617230,52,0,utRho14
2317,ypdI,4988988,4989396,4988988,408,2,utRho14
2318,ypfG,5165786,5165786,5165554,232,68,utRho14
2319,ypfM,5182140,5182140,5181732,408,2634,utRho14
2320,yphB,5349590,5349590,5349376,214,0,utRho14
2321,ypjA,5565644,5565644,5565452,192,0,utRho14
2322,ypjB,5569636,5569636,5568858,778,0,utRho14
2323,ypjD,5495860,5495774,5495860,86,0,utRho14
2324,yqaE,5594170,5594170,5594056,114,0,utRho14
2325,yqcA,5846100,5846100,5845968,132,0,utRho14
2326,yqcE,5800944,5801184,5800944,240,0,utRho14
2327,yqeC,6030468,6030468,6030114,354,738,utRho14
2328,yqeF,5971618,5971618,5971184,434,0,utRho14
2329,yqeG,5971438,5971694,5971438,256,0,utRho14
2330,yqeH,5975016,5975072,5975016,56,2,utRho14
2331,yqeI,5976688,5977004,5976688,316,0,utRho14
2332,yqeK,5981140,5981140,5980720,420,0,utRho14
2333,yqfA,6086728,6086728,6086296,432,654,utRho14
2334,yqgA,6219042,6219106,6219042,64,0,utRho14
2335,yqgB,6172500,6172500,6172102,398,906,utRho14
2336,yqgE,6185768,6185874,6185768,106,696,utRho14
2337,yqhA,6299150,6299150,6298942,208,62,utRho14
2338,yqhC,6310768,6310768,6310436,332,282,utRho14
2339,yqhD,6310604,6310710,6310604,106,104,utRho14
2340,yqhH,6316842,6317254,6316842,412,0,utRho14
2341,yqiC,6369662,6369680,6369662,18,0,utRho14
2342,yqiJ,6384108,6384416,6384108,308,108,utRho14
2343,yqjA,6495096,6495546,6495096,450,738,utRho14
2344,yqjF,6500932,6501124,6500932,192,314,utRho14
2345,yqjG,6501948,6502048,6501948,100,0,utRho14
2346,yqjH,6433078,6433078,6432982,96,0,utRho14
2347,yqjI,6433506,6433558,6433506,52,56,utRho14
2348,yraH,6574552,6574852,6574552,300,0,utRho14
2349,yraP,6592144,6592818,6592144,674,1060,utRho14
2350,yraQ,6596414,6596414,6596276,138,0,utRho14
2351,yraR,6598024,6598024,6597692,332,0,utRho14
2352,yrbG,13360844,13361100,13360844,256,104,utRho14
2353,yrbL,6696842,6696904,6696842,62,8,utRho14
2354,yrbN,6616172,6616172,6615866,306,596,utRho14
2355,yrdB,6860176,6860176,6860046,130,0,utRho14
2356,yrfF,7052548,7052938,7052548,390,378,utRho14
2357,yrhB,7169440,7169518,7169440,78,0,utRho14
2358,ysaB,7451804,7451804,7451424,380,0,utRho14
2359,ysgA,8032686,8032686,8032338,348,100,utRho14
2360,ytfB,8857638,8857638,8857434,204,890,utRho14
2361,ytfE,8864018,8864018,8863966,52,0,utRho14
2362,ytfF,8866296,8866296,8866130,166,0,utRho14
2363,ytfH,8868164,8868226,8868164,62,2,utRho14
2364,ytfI,8875234,8875414,8875234,180,0,utRho14
2365,ytfJ,8878572,8878572,8878524,48,14,utRho14
2366,ytfK,8879022,8879174,8879022,152,1870,utRho14
2367,ytfL,8882642,8882642,8882430,212,0,utRho14
2368,ytfQ,8899634,8899924,8899634,290,572,utRho14
2369,ytjB,9249598,9249598,9249578,20,166,utRho14
2370,yzfA,8896588,8896588,8896490,98,116,utRho14
2371,zapA,6111102,6111224,6111102,122,5526,utRho14
2372,zapB,8236772,8237030,8236772,258,506,utRho14
2373,zapC,2011700,2011904,2011700,204,0,utRho14
2374,zinT,4082692,4082750,4082692,58,0,utRho14
2375,zipA,5062814,5062814,5062466,348,204,utRho14
2376,zitB,1569716,1569716,1569646,70,2,utRho14
2377,zntA,7212844,7212902,7212844,58,66,utRho14
2378,zntR,6878336,6878336,6878260,76,0,utRho14
2379,znuA,3885322,3885322,3885166,156,0,utRho14
2380,znuC,3885268,3885324,3885268,56,0,utRho14
2381,zraP,8403424,8403424,8403376,48,0,utRho14
2382,zraS,8403810,8403852,8403810,42,0,utRho14
2383,zupT,6364866,6365100,6364866,234,416,utRho14
2384,zur,8520282,8520282,8520006,276,550,utRho14
2385,zwf,3872752,3872752,3872628,124,626,utRho14
0,C0343,2818676,2818728,2818676,52,0,utRho15
1,aaeB,6776526,6776526,6776376,150,0,utRho15
2,aaeR,6778762,6779040,6778762,278,20,utRho15
3,aaeX,6778860,6778860,6778674,186,36,utRho15
4,aat,1854920,1854920,1854864,56,0,utRho15
5,accA,416822,417242,416822,420,1784,utRho15
6,accB,6810280,6810872,6810280,592,6300,utRho15
7,accD,4868030,4868030,4867852,178,404,utRho15
8,aceB,8430804,8430956,8430804,152,20,utRho15
9,aceE,245938,246034,245938,96,64,utRho15
10,ackA,4826918,4826940,4826918,22,654,utRho15
11,acnA,2670848,2671662,2670848,814,726,utRho15
12,acnB,263038,263230,263038,192,912,utRho15
13,acpP,2303148,2303230,2303148,82,254,utRho15
14,acpS,5402324,5402324,5401996,328,304,utRho15
15,acrA,971396,971396,971238,158,126,utRho15
16,acrB,969370,969370,968806,564,1986,utRho15
17,acrD,5174950,5175190,5174950,240,0,utRho15
18,acrE,6827404,6827728,6827404,324,4,utRho15
19,acrR,971398,971522,971398,124,30,utRho15
20,acrZ,1589502,1589546,1589502,44,0,utRho15
21,acs,8575190,8575190,8574742,448,12,utRho15
22,actP,8569870,8569870,8569804,66,12,utRho15
23,ada,4620854,4620854,4620810,44,0,utRho15
24,add,3404404,3404466,3404404,62,14,utRho15
25,ade,7687802,7687928,7687802,126,4,utRho15
26,adhE,2596826,2596826,2596242,584,160,utRho15
27,adhP,3107988,3107988,3107676,312,1762,utRho15
28,adiA,8681112,8681112,8681042,70,0,utRho15
29,adiC,8674404,8674404,8674062,342,12,utRho15
30,adiY,8676084,8676084,8675858,226,0,utRho15
31,adk,994278,994350,994278,72,40,utRho15
32,adrA,807374,807406,807374,32,0,utRho15
33,aer,6438240,6438240,6438152,88,14,utRho15
34,aes,1000102,1000102,999946,156,8,utRho15
35,agaR,6557406,6557406,6557330,76,0,utRho15
36,agaS,6563778,6563952,6563778,174,0,utRho15
37,agp,2131118,2131170,2131118,52,16,utRho15
38,agrA,7296126,7296126,7296126,0,0,utRho15
39,agrB,7296588,7296588,7296588,0,0,utRho15
40,ahpC,1277386,1277890,1277386,504,792,utRho15
41,ahpF,1278004,1279506,1278004,1502,92234,utRho15
42,ahr,8992698,8992698,8992418,280,0,utRho15
43,aidB,8828494,8828550,8828494,56,0,utRho15
44,ais,4731512,4731512,4731240,272,0,utRho15
45,alaA,4814816,4815122,4814816,306,0,utRho15
46,alaC,4996798,4996798,4996590,208,30,utRho15
47,alaE,5598140,5598328,5598140,188,0,utRho15
48,alaS,5644180,5644180,5644022,158,3812,utRho15
49,alaW,5036612,5036612,5036462,150,0,utRho15
50,aldA,2976380,2976464,2976380,84,748,utRho15
51,aldB,7513070,7513070,7513022,48,2,utRho15
52,alkA,4295118,4295118,4295080,38,56,utRho15
53,alkB,4618890,4618890,4618682,208,0,utRho15
54,allA,1064780,1064902,1064780,122,12,utRho15
55,allD,1092822,1092822,1092726,96,0,utRho15
56,allE,1088112,1088112,1088092,20,2,utRho15
57,allS,1064600,1064600,1064442,158,2,utRho15
58,alr,8531178,8531564,8531178,386,1470,utRho15
59,alsE,8617334,8617334,8616956,378,106,utRho15
60,alsK,8615990,8615990,8615598,392,26,utRho15
61,alx,6476740,6477160,6476740,420,0,utRho15
62,amiA,5104482,5104704,5104482,222,0,utRho15
63,amiC,5898378,5898378,5898020,358,62,utRho15
64,amn,4110062,4110122,4110062,60,0,utRho15
65,ampC,8758006,8758006,8757888,118,2,utRho15
66,ampD,237362,237466,237362,104,78,utRho15
67,ampG,907372,907372,907090,282,612,utRho15
68,ampH,792726,792726,792574,152,8,utRho15
69,amyA,4012230,4012312,4012230,82,0,utRho15
70,anmK,3439346,3439346,3439204,142,0,utRho15
71,ansB,6201580,6201580,6201456,124,2,utRho15
72,ansP,3052040,3052040,3051960,80,16,utRho15
73,apaG,104068,104068,103212,856,2744,utRho15
74,apaH,102586,102586,102444,142,1810,utRho15
75,apbE,4623188,4623188,4623068,120,28,utRho15
76,appA,2081198,2081234,2081198,36,32,utRho15
77,appC,2075420,2075480,2075420,60,0,utRho15
78,appY,1167134,1167362,1167134,228,6,utRho15
79,apt,982620,982824,982620,204,12,utRho15
80,aqpZ,1832424,1832424,1832094,330,2,utRho15
81,araB,140150,140150,140096,54,0,utRho15
82,araC,140482,140774,140482,292,326,utRho15
83,araE,5964416,5964416,5964364,52,0,utRho15
84,araF,3972476,3972476,3972256,220,64,utRho15
85,araH,3967120,3967120,3967086,34,2,utRho15
86,araJ,825058,825058,824962,96,4,utRho15
87,arcA,9281602,9281602,9280612,990,6526,utRho15
88,arcB,6706098,6706098,6706050,48,0,utRho15
89,arcZ,6701154,6701154,6701154,0,0,utRho15
90,arfA,6877346,6877346,6877298,48,50,utRho15
91,argA,5898312,5898484,5898312,172,0,utRho15
92,argC,8309770,8310002,8309770,232,48,utRho15
93,argD,6980442,6980442,6980360,82,4,utRho15
94,argE,8310156,8310156,8309694,462,124,utRho15
95,argF,580680,580680,580610,70,2,utRho15
96,argG,6637124,6637274,6637124,150,82,utRho15
97,argI,8956688,8956688,8956622,66,4,utRho15
98,argO,6137672,6137672,6137616,56,6,utRho15
99,argP,6119460,6119506,6119460,46,14,utRho15
100,argR,6769204,6769406,6769204,202,0,utRho15
101,argS,3920002,3920124,3920002,122,30,utRho15
102,argT,4855698,4855698,4855582,116,88,utRho15
103,argU,1129406,1129446,1129406,40,38,utRho15
104,argW,4932616,4932618,4932616,2,0,utRho15
105,argX,7964728,7964750,7964728,22,66,utRho15
106,aroF,5482402,5482402,5482300,102,0,utRho15
107,aroG,1571182,1571266,1571182,84,134,utRho15
108,aroH,3576636,3576870,3576636,234,348,utRho15
109,aroK,7038760,7038760,7038128,632,736,utRho15
110,aroL,812560,812810,812560,250,4,utRho15
111,aroP,243342,243342,243102,240,0,utRho15
112,arpA,8445382,8445382,8444974,408,34,utRho15
113,arrS,7316108,7316108,7316108,0,0,utRho15
114,arsR,7297024,7297056,7297024,32,4,utRho15
115,artJ,1801252,1801252,1801150,102,0,utRho15
116,artP,1807686,1807686,1807468,218,40,utRho15
117,ascF,5678858,5679048,5678858,190,0,utRho15
118,ascG,5678574,5678574,5678528,46,0,utRho15
119,aslB,7965562,7965916,7965562,354,510,utRho15
120,asnA,7854258,7854310,7854258,52,2,utRho15
121,asnB,1398444,1398444,1398354,90,14,utRho15
122,asnC,23562186,23562186,23562018,168,0,utRho15
123,asnS,1978088,1978088,1977970,118,8286,utRho15
124,asnT,4089082,4089098,4089082,16,392,utRho15
125,asnU,4119690,4119702,4119690,12,0,utRho15
126,asnV,4124504,4124520,4124504,16,30,utRho15
127,aspA,17473728,17473728,17473308,420,220,utRho15
128,aspC,1971486,1971486,1971418,68,78,utRho15
129,aspS,3901402,3901402,3901044,358,110,utRho15
130,aspT,7893560,7893744,7893560,184,61464,utRho15
131,aspV,473826,473862,473826,36,10,utRho15
132,asr,3342654,3342752,3342654,98,0,utRho15
133,astC,3664088,3664088,3663964,124,0,utRho15
134,astE,3654138,3654138,3653846,292,0,utRho15
135,atoD,4646824,4646894,4646824,70,48,utRho15
136,atpB,7844540,7844540,7844102,438,322,utRho15
137,atpC,7832118,7832118,7831944,174,1746,utRho15
138,atpI,7845050,7845050,7844880,170,72,utRho15
139,avtA,7479348,7479410,7479348,62,122,utRho15
140,azoR,2965982,2965982,2965720,262,20,utRho15
141,azuC,3976002,3976002,3975918,84,0,utRho15
142,bacA,6408350,6408350,6408262,88,2,utRho15
143,bamA,394052,395856,394052,1804,1034,utRho15
144,bamB,5277950,5277950,5277304,646,776,utRho15
145,bamC,5198028,5198028,5197730,298,1412,utRho15
146,bamD,5471922,5472292,5471922,370,802,utRho15
147,bamE,5506972,5507210,5506972,238,702,utRho15
148,basS,8666954,8666954,8666544,410,382,utRho15
149,bax,7474468,7474468,7474354,114,0,utRho15
150,bcp,5200874,5200956,5200874,82,2976,utRho15
151,bcsB,7385346,7385346,7385214,132,2,utRho15
152,bcsE,7392644,7392916,7392644,272,0,utRho15
153,bdcA,8948128,8948128,8948106,22,18,utRho15
154,bdcR,8948192,8948248,8948192,56,8,utRho15
155,bdm,3112680,3112680,3112560,120,0,utRho15
156,betA,654522,654522,654494,28,66,utRho15
157,betI,658722,658722,658668,54,22,utRho15
158,betT,658842,658926,658842,84,4,utRho15
159,bfr,6933498,6933498,6933450,48,0,utRho15
160,bglG,23440182,23440182,23439402,780,6,utRho15
161,bglX,4444240,4444240,4443978,262,20,utRho15
162,bhsA,2337962,2338146,2337962,184,2,utRho15
163,bioA,1618584,1618584,1618514,70,0,utRho15
164,bioB,1618604,1618688,1618604,84,4,utRho15
165,bioH,7089716,7089716,7089688,28,0,utRho15
166,bisC,7433026,7433026,7432788,238,36,utRho15
167,blc,8755490,8755490,8755444,46,0,utRho15
168,blr,3409024,3409102,3409024,78,4,utRho15
169,bluF,2431226,2431226,2430950,276,6,utRho15
170,bluR,2428226,2428226,2428118,108,0,utRho15
171,bolA,908698,908944,908698,246,0,utRho15
172,borD,1157842,1157842,1157786,56,6,utRho15
173,brnQ,838976,839182,838976,206,482,utRho15
174,bssR,1756492,1756496,1756492,4,2,utRho15
175,bssS,2242116,2242116,2241910,206,60,utRho15
176,btuB,8326798,8327278,8326798,480,2432,utRho15
177,cadB,8720212,8720212,8720062,150,32,utRho15
178,cadC,8723926,8723926,8723868,58,0,utRho15
179,caiE,70998,70998,70742,256,4,utRho15
180,caiF,68436,68600,68436,164,4,utRho15
181,caiT,84074,84074,83862,212,0,utRho15
182,can,285406,285406,285340,66,74,utRho15
183,carA,59102,59302,59102,200,0,utRho15
184,carB,61550,61634,61550,84,162,utRho15
185,cas2,5757830,5757830,5757706,124,60,utRho15
186,casA,5768638,5768638,5768276,362,0,utRho15
187,cbl,4121882,4121882,4121828,54,4,utRho15
188,cbpA,2128074,2128074,2127550,524,14,utRho15
189,cbrA,7738628,7738754,7738628,126,0,utRho15
190,cbrB,7794958,7795012,7794958,54,34,utRho15
191,ccmH,4585242,4585242,4584820,422,2,utRho15
192,cdaR,364894,364926,364894,32,2,utRho15
193,cdd,4463638,4463688,4463638,50,132,utRho15
194,cdh,8219814,8219860,8219814,46,22,utRho15
195,cdsA,391110,391354,391110,244,748,utRho15
196,cedA,3627484,3627484,3627326,158,26,utRho15
197,cfa,3482402,3482826,3482402,424,340,utRho15
198,chaC,2544844,2544972,2544844,128,6,utRho15
199,chbB,3643452,3643452,3643238,214,0,utRho15
200,chbG,3634624,3634624,3634270,354,8,utRho15
201,cheW,3946924,3946924,3946678,246,514,utRho15
202,chiA,6939792,6939792,6939706,86,4,utRho15
203,chiP,1416472,1416668,1416472,196,36,utRho15
204,cho,3646984,3647030,3646984,46,18,utRho15
205,chpS,8896804,8896894,8896804,90,2,utRho15
206,cirA,4493884,4493884,4493538,346,2,utRho15
207,citC,1304078,1304078,1303712,366,6,utRho15
208,citT,1293264,1293264,1293160,104,0,utRho15
209,clcA,350104,350214,350104,110,0,utRho15
210,clpA,1846160,1846528,1846160,368,166,utRho15
211,clpB,5468410,5468410,5468346,64,60,utRho15
212,clpP,913154,913354,913154,200,456,utRho15
213,clpS,1845500,1845826,1845500,326,4,utRho15
214,clpX,914404,914852,914404,448,2186,utRho15
215,clsA,2617346,2617346,2617290,56,0,utRho15
216,clsC,2212584,2212710,2212584,126,176,utRho15
217,cmk,1922330,1922402,1922330,72,18,utRho15
218,cnu,3409522,3409898,3409522,376,248,utRho15
219,coaA,8350214,8350214,8350052,162,358,utRho15
220,cobC,1340092,1340092,1339814,278,154,utRho15
221,cobT,4129202,4129202,4128934,268,6,utRho15
222,cobU,4131944,4131944,4131528,416,28,utRho15
223,codB,709768,709844,709768,76,48,utRho15
224,comR,2337726,2337726,2337664,62,0,utRho15
225,copA,1022822,1022822,1022758,64,0,utRho15
226,corA,8002388,8002852,8002388,464,3174,utRho15
227,cpdB,8873258,8873258,8873130,128,244,utRho15
228,cptB,6082198,6082198,6082140,58,2,utRho15
229,cpxA,8210202,8210202,8209950,252,260,utRho15
230,cpxP,8211570,8211640,8211570,70,50,utRho15
231,cpxR,8211372,8211372,8211340,32,20,utRho15
232,cra,175894,176056,175894,162,24,utRho15
233,crcB,1316016,1316016,1315876,140,0,utRho15
234,creA,9270486,9271042,9270486,556,274,utRho15
235,creD,9276320,9276356,9276320,36,12,utRho15
236,crl,515620,515658,515620,38,406,utRho15
237,crp,6971906,6972240,6971906,334,4126,utRho15
238,crr,5070960,5071668,5070960,708,2874,utRho15
239,csdA,5886414,5886674,5886414,260,2,utRho15
240,csgB,2207718,2207902,2207718,184,0,utRho15
241,csgD,2206688,2206688,2206392,296,0,utRho15
242,csgG,2203510,2203510,2203368,142,64,utRho15
243,csiD,5577854,5577970,5577854,116,130,utRho15
244,csiE,5330802,5330870,5330802,68,2,utRho15
245,csiR,5590942,5591348,5590942,406,84,utRho15
246,cspA,7439778,7440098,7439778,320,2650,utRho15
247,cspB,3283430,3283430,3283108,322,0,utRho15
248,cspC,3815018,3815018,3814870,148,590,utRho15
249,cspD,1845352,1845352,1845180,172,11592,utRho15
250,cspE,1314294,1314584,1314294,290,0,utRho15
251,cspF,3283380,3283710,3283380,330,32,utRho15
252,cspG,2102610,2102922,2102610,312,622,utRho15
253,cspH,2102746,2102746,2102350,396,14,utRho15
254,cspI,3277624,3277624,3277334,290,0,utRho15
255,csrA,5638746,5638746,5638292,454,824,utRho15
256,csrB,5849048,5849048,5849048,0,0,utRho15
257,csrC,8102072,8102072,8102072,0,0,utRho15
258,csrD,6806850,6806850,6806664,186,92,utRho15
259,cstA,1259710,1259788,1259710,78,20,utRho15
260,cueO,274090,274166,274090,76,0,utRho15
261,cueR,1027948,1027986,1027948,38,2,utRho15
262,curA,3037784,3038054,3037784,270,2,utRho15
263,cusC,1191146,1191200,1191146,54,4,utRho15
264,cusR,1190924,1190924,1190886,38,8,utRho15
265,cutA,8730784,8730784,8730712,72,52,utRho15
266,cutC,3918534,3918534,3917920,614,54,utRho15
267,cvpA,4861600,4861600,4861526,74,22,utRho15
268,cvrA,2484328,2484328,2484142,186,2,utRho15
269,cyaA,7981548,7982306,7981548,758,324,utRho15
270,cyaR,4334228,4334224,4334228,4,2,utRho15
271,cyaY,7988166,7988166,7988118,48,18,utRho15
272,cybB,2981522,2981804,2981522,282,2,utRho15
273,cycA,8859560,8859728,8859560,168,296,utRho15
274,cydA,1542340,1542916,1542340,576,66,utRho15
275,cydC,1858800,1858800,1858390,410,110,utRho15
276,cydD,1862062,1862062,1861924,138,28,utRho15
277,cydX,1548300,1548392,1548300,92,248,utRho15
278,cynR,717418,717418,717380,38,2,utRho15
279,cynT,1435092,1435196,1435092,104,0,utRho15
280,cyoA,903306,903306,903220,86,2516,utRho15
281,cyoE,895540,895540,895410,130,650,utRho15
282,cysB,2667576,2667710,2667576,134,62,utRho15
283,cysC,5748056,5748056,5747984,72,2,utRho15
284,cysD,5752736,5752736,5752658,78,0,utRho15
285,cysE,7565362,7565362,7565124,238,2014,utRho15
286,cysG,6995508,6995656,6995508,148,12,utRho15
287,cysJ,5783928,5783928,5783796,132,136,utRho15
288,cysK,5064688,5064818,5064688,130,62,utRho15
289,cysP,5087114,5087114,5087056,58,6,utRho15
290,cysS,1109154,1109222,1109154,68,48,utRho15
291,cysT,3984100,3984100,3983974,126,102,utRho15
292,cysZ,5062766,5062926,5062766,160,30,utRho15
293,cytR,8249018,8249018,8248912,106,68,utRho15
294,dacA,1328002,1328002,1327926,76,204,utRho15
295,dacB,6657714,6657926,6657714,212,10,utRho15
296,dacC,1761306,1761454,1761306,148,32,utRho15
297,dadA,2475018,2475142,2475018,124,0,utRho15
298,dam,7032504,7032504,7031826,678,796,utRho15
299,damX,7035200,7035200,7034612,588,248,utRho15
300,dapA,5199568,5199568,5199520,48,0,utRho15
301,dapB,56576,56748,56576,172,74,utRho15
302,dapD,371954,371954,371894,60,122,utRho15
303,dapE,5183120,5183214,5183120,94,782,utRho15
304,dcp,3254844,3254844,3254760,84,70,utRho15
305,dcrB,7219534,7219910,7219534,376,6,utRho15
306,dctA,7366996,7366996,7366894,102,468,utRho15
307,dcuA,8733686,8733686,8733546,140,0,utRho15
308,dcuB,8698182,8698182,8697488,694,76,utRho15
309,dcuC,1312166,1312166,1311936,230,0,utRho15
310,dcuD,6749166,6749738,6749166,572,8,utRho15
311,dcuR,8701130,8701130,8700068,1062,486,utRho15
312,dcuS,8703370,8703370,8703324,46,10,utRho15
313,dcyD,3999016,3999016,3998960,56,0,utRho15
314,ddpX,3126498,3126498,3126152,346,4,utRho15
315,deaD,6615818,6615818,6615720,98,68,utRho15
316,dedA,4869880,4869880,4869482,398,2748,utRho15
317,dedD,4863750,4863750,4863368,382,0,utRho15
318,def,6867300,6867380,6867300,80,4,utRho15
319,degP,361690,361768,361690,78,0,utRho15
320,degQ,6761308,6761486,6761308,178,200,utRho15
321,deoB,9239134,9239206,9239134,72,0,utRho15
322,deoC,9233358,9234646,9233358,1288,312,utRho15
323,dfp,7625406,7625462,7625406,56,36,utRho15
324,dgcZ,3247758,3247758,3247700,58,0,utRho15
325,dgkA,8512914,8513274,8512914,360,368,utRho15
326,dgt,358392,358474,358392,82,0,utRho15
327,dhaK,2501888,2501888,2501676,212,172,utRho15
328,dhaR,2502006,2502132,2502006,126,4,utRho15
329,dicB,3299194,3299218,3299194,24,0,utRho15
330,dicC,3295752,3295752,3295700,52,0,utRho15
331,dinB,501760,501796,501760,36,0,utRho15
332,dinD,7635398,7635520,7635398,122,0,utRho15
333,dinG,1666146,1666140,1666146,6,0,utRho15
334,dinI,2243018,2243018,2242974,44,34,utRho15
335,dinJ,493230,493230,493004,226,14,utRho15
336,dinQ,7295964,7295964,7295576,388,602,utRho15
337,djlA,114536,114728,114536,192,0,utRho15
338,dkgA,6313142,6313246,6313142,104,264,utRho15
339,dkgB,458196,458334,458196,138,0,utRho15
340,dksA,321502,321502,321208,294,996,utRho15
341,dld,4444164,4444370,4444164,206,28,utRho15
342,dmlA,3763424,3763824,3763424,400,38,utRho15
343,dmlR,3763710,3763710,3763618,92,0,utRho15
344,dmsA,1881646,1881918,1881646,272,0,utRho15
345,dnaA,7767922,7767922,7767458,464,470,utRho15
346,dnaB,8528566,8528628,8528566,62,84,utRho15
347,dnaK,24096,24326,24096,230,2106,utRho15
348,dnaN,7765466,7765466,7764642,824,460,utRho15
349,dnaQ,471868,472134,471868,266,524,utRho15
350,dnaT,18406460,18406460,18406068,392,80,utRho15
351,dnaX,984112,984184,984112,72,58,utRho15
352,dosP,3131486,3131486,3131466,20,2,utRho15
353,dpiB,1303968,1304470,1303968,502,0,utRho15
354,dppA,7415740,7415740,7415410,330,2988,utRho15
355,dps,1697900,1697900,1697822,78,0,utRho15
356,dsbA,8086754,8086836,8086754,82,1446,utRho15
357,dsbB,2466294,2466294,2466060,234,2,utRho15
358,dsbC,6079266,6079266,6077644,1622,526,utRho15
359,dsbG,1277600,1277600,1277146,454,284,utRho15
360,dsdA,4958242,4958404,4958242,162,576,utRho15
361,dsdC,4955492,4955492,4955258,234,2,utRho15
362,dsdX,4955642,4955694,4955642,52,0,utRho15
363,dsrA,4050626,4050626,4050626,0,0,utRho15
364,dsrB,4049686,4049686,4049646,40,2,utRho15
365,dtpD,1485340,1485340,1485112,228,32,utRho15
366,dusA,8523200,8523338,8523200,138,598,utRho15
367,dusB,6820492,6820560,6820492,68,0,utRho15
368,dusC,4460790,4460790,4460770,20,0,utRho15
369,dut,7627704,7627864,7627704,160,1068,utRho15
370,dxr,386670,387042,386670,372,352,utRho15
371,ebgA,6445102,6445266,6445102,164,12,utRho15
372,ebgR,6442874,6442932,6442874,58,32,utRho15
373,ecnB,8753018,8753106,8753018,88,0,utRho15
374,eco,4607594,4607810,4607594,216,22,utRho15
375,ecpA,621594,621594,621342,252,4,utRho15
376,ecpB,620238,620238,620052,186,2,utRho15
377,ecpR,622964,622964,622672,292,2,utRho15
378,eda,3866218,3866218,3865512,706,146,utRho15
379,edd,3869426,3869426,3869208,218,134,utRho15
380,efeO,2164308,2164486,2164308,178,180,utRho15
381,efeU_1,2162614,2162712,2162614,98,0,utRho15
382,efp,8751134,8751398,8751134,264,1970,utRho15
383,elaA,4763372,4763372,4763086,286,28,utRho15
384,elaD,4765308,4765426,4765308,118,6,utRho15
385,elfA,1995530,1995736,1995530,206,0,utRho15
386,elfD,1996642,1996980,1996642,338,2,utRho15
387,emrD,7707690,7707844,7707690,154,0,utRho15
388,emrK,4966896,4966896,4966678,218,2,utRho15
389,emrY,4964668,4964668,4964352,316,44,utRho15
390,emtA,2486250,2486360,2486250,110,2,utRho15
391,endA,12361100,12361388,12361100,288,0,utRho15
392,eno,5817692,5817692,5815882,1810,2102,utRho15
393,entC,1249662,1249770,1249662,108,0,utRho15
394,entD,1220508,1220508,1220158,350,30,utRho15
395,entH,1258584,1258600,1258584,16,44,utRho15
396,entS,1244506,1244600,1244506,94,0,utRho15
397,envR,6827266,6827266,6826930,336,0,utRho15
398,epd,12295292,12295292,12294764,528,100,utRho15
399,epmA,8765236,8765286,8765236,50,2,utRho15
400,epmB,8751406,8751406,8751314,92,800,utRho15
401,eptB,7421162,7421162,7420950,212,0,utRho15
402,eptC,8300622,8300622,8300530,92,76,utRho15
403,erfK,4126708,4126708,4126646,62,40,utRho15
404,erpA,353122,353220,353122,98,0,utRho15
405,esrE,8039956,8039956,8039956,0,0,utRho15
406,essD,1153746,1154796,1153746,1050,64,utRho15
407,etk,2088606,2088606,2088420,186,8,utRho15
408,evgA,4967262,4967510,4967262,248,2,utRho15
409,exbB,6304028,6304028,6303968,60,2,utRho15
410,exbD,6302780,6302780,6302486,294,34,utRho15
411,exuR,6493016,6493304,6493016,288,0,utRho15
412,exuT,6490004,6490208,6490004,204,0,utRho15
413,fabA,2032996,2032996,2032940,56,118,utRho15
414,fabB,4883282,4883282,4883210,72,0,utRho15
415,fabH,2297032,2297518,2297032,486,1030,utRho15
416,fabI,2702236,2702236,2702078,158,0,utRho15
417,fadB,8062026,8062026,8061942,84,0,utRho15
418,fadD,3779614,3779614,3779492,122,0,utRho15
419,fadE,486812,486812,486606,206,0,utRho15
420,fadH,6463248,6463330,6463248,82,6,utRho15
421,fadI,4921022,4921022,4920938,84,16,utRho15
422,fadL,4922410,4922600,4922410,190,60,utRho15
423,fadM,928720,928804,928720,84,40,utRho15
424,fadR,2469810,2469876,2469810,66,0,utRho15
425,fbaB,4357334,4357334,4357128,206,2,utRho15
426,fdhE,8162722,8162722,8162456,266,1124,utRho15
427,fdhF,8598814,8598814,8598732,82,0,utRho15
428,fdnG,3094744,3094802,3094744,58,0,utRho15
429,fdrA,1093012,1093360,1093012,348,28,utRho15
430,feaB,2894994,2895038,2894994,44,0,utRho15
431,feaR,2894734,2894734,2894566,168,78,utRho15
432,fecA,9033454,9033454,9033354,100,20,utRho15
433,fecE,9023288,9023288,9022914,374,1874,utRho15
434,fecI,9036564,9036564,9036470,94,4,utRho15
435,feoA,7080114,7080326,7080114,212,112,utRho15
436,fepA,1225334,1225334,1224988,346,2,utRho15
437,fepB,1249454,1249454,1249020,434,172,utRho15
438,fepD,1244468,1244468,1244378,90,0,utRho15
439,fes,1225374,1225630,1225374,256,34,utRho15
440,ffh,5495706,5495706,5495590,116,420,utRho15
441,ffs,952576,952848,952576,272,14,utRho15
442,fhuA,334884,334968,334884,84,30,utRho15
443,fhuE,2323294,2323294,2323102,192,6,utRho15
444,fhuF,9211504,9211504,9211326,178,428,utRho15
445,fic,6983296,6983296,6982926,370,124,utRho15
446,fieF,8212864,8212938,8212864,74,0,utRho15
447,fimA,9085388,9086230,9085388,842,490,utRho15
448,fimB,9081334,9081914,9081334,580,696,utRho15
449,fimE,9083742,9084074,9083742,332,12,utRho15
450,fimZ,1129214,1129214,1128960,254,0,utRho15
451,fiu,1683296,1683296,1683062,234,42,utRho15
452,fixA,84650,84806,84650,156,0,utRho15
453,fkpA,6955050,6955050,6954838,212,5240,utRho15
454,fldA,2846084,2846084,2845860,224,1384,utRho15
455,fldB,6079644,6079710,6079644,66,0,utRho15
456,flgA,2261770,2261770,2261726,44,4,utRho15
457,flgB,2261986,2262036,2261986,50,0,utRho15
458,flgK,2276702,2276756,2276702,54,278,utRho15
459,flgM,2260330,2260330,2260256,74,376,utRho15
460,flgN,2259828,2259828,2259660,168,26,utRho15
461,flhB,3932432,3932432,3932382,50,56,utRho15
462,flhC,3955864,3955864,3955688,176,60,utRho15
463,flhD,3957154,3957154,3956394,760,168,utRho15
464,fliA,4003638,4003638,4003578,60,2,utRho15
465,fliC,4007352,4007352,4007212,140,94,utRho15
466,fliD,4007634,4007744,4007634,110,92,utRho15
467,fliE,4026186,4026186,4026028,158,2,utRho15
468,fliF,4026292,4026458,4026292,166,248,utRho15
469,fliL,4039168,4039236,4039168,68,66,utRho15
470,flk,4875824,4875900,4875824,76,0,utRho15
471,flu,4142634,4143078,4142634,444,28,utRho15
472,flxA,3292776,3292810,3292776,34,0,utRho15
473,fnr,2799104,2799104,2799052,52,60,utRho15
474,fnrS,2818258,2818258,2818258,0,0,utRho15
475,focA,1909628,1909628,1908932,696,160,utRho15
476,folA,99598,99646,99598,48,2,utRho15
477,folB,6409296,6409296,6409178,118,0,utRho15
478,folD,1115562,1115562,1115482,80,48,utRho15
479,folE,4487696,4487696,4487304,392,1996,utRho15
480,fpr,8228998,8228998,8228944,54,22,utRho15
481,frc,4986878,4986878,4986508,370,16,utRho15
482,frdA,8764824,8764824,8764636,188,32,utRho15
483,frdD,8758948,8758948,8758732,216,1562,utRho15
484,fre,8052886,8053054,8052886,168,1108,utRho15
485,frlA,6999518,6999820,6999518,302,12,utRho15
486,frr,385624,385744,385624,120,628,utRho15
487,frsA,513004,513054,513004,50,52,utRho15
488,fruB,4527194,4527194,4526990,204,12,utRho15
489,frvR,8179804,8179804,8179710,94,0,utRho15
490,fryA,5008986,5008986,5008970,16,6,utRho15
491,fsaA,1727060,1727284,1727060,224,2,utRho15
492,fsr,1009710,1009710,1009392,318,92,utRho15
493,ftnA,3977364,3977432,3977364,68,2,utRho15
494,ftnB,3973550,3973850,3973550,300,32,utRho15
495,ftsA,207122,207964,207122,842,206,utRho15
496,ftsB,5745802,5745802,5745640,162,20,utRho15
497,ftsH,6654204,6654204,6653870,334,588,utRho15
498,ftsK,1865858,1866448,1865858,590,1272,utRho15
499,ftsL,181376,182064,181376,688,1312,utRho15
500,ftsP,6325732,6325732,6325338,394,218,utRho15
501,ftsQ,205484,206310,205484,826,286,utRho15
502,ftsX,7204512,7204512,7204172,340,744,utRho15
503,ftsZ,209272,210610,209272,1338,192,utRho15
504,fucA,5867708,5867708,5867376,332,8,utRho15
505,fucP,5868238,5868470,5868238,232,2,utRho15
506,fumA,6753760,6753760,6753508,252,7060,utRho15
507,fumB,8694696,8694696,8694652,44,0,utRho15
508,fumC,3373418,3373418,3373176,242,28,utRho15
509,fur,2842892,2842892,2842584,308,3064,utRho15
510,fusA,6947370,6947370,6947028,342,14946,utRho15
511,fxsA,8737206,8737328,8737206,122,318,utRho15
512,gabD,5581824,5582546,5581824,722,2102,utRho15
513,gadA,7335214,7335214,7335160,54,0,utRho15
514,gadB,3144144,3144144,3144090,54,4,utRho15
515,gadC,3141168,3141168,3140978,190,2,utRho15
516,gadE,7315600,7316732,7315600,1132,18,utRho15
517,gadW,7329562,7329562,7329236,326,38,utRho15
518,gadX,14663356,14663356,14663240,116,0,utRho15
519,gadY,7329728,7329728,7329728,0,0,utRho15
520,galE,1584354,1584354,1584110,244,48,utRho15
521,galF,4228702,4228702,4228654,48,0,utRho15
522,galM,1577796,1577796,1577674,122,1068,utRho15
523,galP,6176510,6176568,6176510,58,0,utRho15
524,galR,5953138,5953198,5953138,60,42,utRho15
525,galS,4483420,4483420,4483336,84,0,utRho15
526,galU,2582810,2582914,2582810,104,354,utRho15
527,gapA,3724480,3725542,3724480,1062,7092,utRho15
528,garP,6549868,6549868,6549814,54,22,utRho15
529,gatY,4354468,4354468,4354408,60,66,utRho15
530,gatZ,4352864,4352864,4352642,222,27812,utRho15
531,gcd,282558,282558,282450,108,0,utRho15
532,gcl,1067814,1067832,1067814,18,0,utRho15
533,gcvA,5885278,5885278,5885134,144,2,utRho15
534,gcvB,5885392,5885392,5885392,0,0,utRho15
535,gcvR,5199758,5199812,5199758,54,148,utRho15
536,gcvT,6101544,6101544,6101334,210,3130,utRho15
537,gdhA,3684616,3684742,3684616,126,0,utRho15
538,gfcA,2099668,2099668,2099488,180,4,utRho15
539,gfcD,2096236,2096236,2095890,346,12,utRho15
540,ghrA,2195648,2195772,2195648,124,96,utRho15
541,ghrB,7434378,7434620,7434378,242,500,utRho15
542,glcA,6242728,6242728,6242558,170,6,utRho15
543,glcC,6256412,6256544,6256412,132,0,utRho15
544,glcD,6256152,6256152,6256042,110,16,utRho15
545,gldA,8278092,8278092,8278070,22,26,utRho15
546,glgA,7136784,7136784,7136066,718,758,utRho15
547,glgB,7147314,7147314,7147004,310,174,utRho15
548,glgC,7139142,7139142,7138656,486,234,utRho15
549,glgP,7133546,7133546,7133162,384,344,utRho15
550,glgS,6384024,6384024,6383878,146,0,utRho15
551,glgX,7142838,7142838,7142638,200,0,utRho15
552,glk,5018922,5018922,5018852,70,16,utRho15
553,glmS,7827622,7827622,7827336,286,3004,utRho15
554,glmU,7830652,7830652,7830400,252,0,utRho15
555,glmY,10765360,10765360,10765360,0,0,utRho15
556,glmZ,7972864,7972864,7972864,0,0,utRho15
557,glnA,16232888,16232888,16232136,752,1040,utRho15
558,glnB,5375052,5375052,5374816,236,52,utRho15
559,glnD,377310,377310,377300,10,0,utRho15
560,glnE,6399602,6399602,6399282,320,180,utRho15
561,glnH,1696396,1696396,1696008,388,454,utRho15
562,glnK,945112,945196,945112,84,2,utRho15
563,glnL,8112742,8112742,8112678,64,0,utRho15
564,glnQ,1693262,1693262,1692926,336,760,utRho15
565,glnS,1411998,1412186,1411998,188,428,utRho15
566,gloA,3455602,3455674,3455602,72,0,utRho15
567,gloB,469852,469852,469564,288,1086,utRho15
568,glpA,4705166,4705294,4705166,128,0,utRho15
569,glpD,7123942,7124026,7123942,84,26,utRho15
570,glpE,7123698,7123698,7123646,52,112,utRho15
571,glpF,8236322,8236322,8236180,142,344,utRho15
572,glpG,7122960,7122960,7122904,56,206,utRho15
573,glpR,7121782,7121782,7121210,572,62,utRho15
574,glpT,4704902,4704902,4704748,154,480,utRho15
575,glpX,8231212,8231212,8231158,54,2248,utRho15
576,glrK,5382246,5382246,5382196,50,2,utRho15
577,gltA,1509534,1509534,1508936,598,12674,utRho15
578,gltB,6709018,6709264,6709018,246,80,utRho15
579,gltI,1375792,1375792,1375494,298,1356,utRho15
580,gltP,8588536,8588962,8588536,426,750,utRho15
581,gltS,7657382,7657382,7657330,52,148,utRho15
582,gltX,5041568,5041568,5041344,224,68,utRho15
583,gluQ,320286,320286,320224,62,360,utRho15
584,glyA,5371148,5371148,5371014,134,60,utRho15
585,glyQ,7450708,7450708,7450636,72,98,utRho15
586,glyS,7448990,7448990,7448794,196,1472,utRho15
587,glyU,5998128,5998128,5998114,14,0,utRho15
588,glyV,8784626,8784720,8784626,94,78,utRho15
589,glyW,3984360,3984360,3984234,126,18,utRho15
590,gmhB,445612,445666,445612,54,0,utRho15
591,gmk,7642776,7642856,7642776,80,2,utRho15
592,gmr,2693686,2693686,2693484,202,42,utRho15
593,gnd,4202648,4202648,4202536,112,496,utRho15
594,gnsB,3275692,3275692,3275564,128,46,utRho15
595,gntK,14310580,14310580,14310368,212,32,utRho15
596,gntP,9102668,9102668,9102592,76,2,utRho15
597,gntR,7157760,7157760,7157452,308,324,utRho15
598,gntT,7092810,7093118,7092810,308,38,utRho15
599,gntU,7154170,7154170,7154122,48,0,utRho15
600,gntX,7089334,7089764,7089334,430,54,utRho15
601,gor,7292224,7292598,7292224,374,368,utRho15
602,gpmA,1575340,1575340,1575190,150,20,utRho15
603,gpmM,7570374,7570520,7570374,146,0,utRho15
604,gpsA,7567620,7567620,7567322,298,13468,utRho15
605,gpt,511828,511954,511828,126,136,utRho15
606,grcA,5433046,5433046,5432898,148,42,utRho15
607,greA,6657728,6657728,6657430,298,620,utRho15
608,greB,7073488,7073624,7073488,136,22,utRho15
609,groL,8741566,8742050,8741566,484,6078,utRho15
610,groS,8741232,8741376,8741232,144,7810,utRho15
611,grpE,5501494,5501494,5501416,78,168,utRho15
612,grxA,1781552,1781552,1781506,46,16,utRho15
613,grxB,2248206,2248206,2248108,98,14,utRho15
614,grxC,7569152,7569152,7568884,268,6560,utRho15
615,grxD,3468324,3468324,3468202,122,2682,utRho15
616,gspA,6911268,6911268,6910796,472,4,utRho15
617,gspC,6910964,6911156,6910964,192,2,utRho15
618,gss,6277220,6277220,6277044,176,42,utRho15
619,gstA,3428654,3428754,3428654,100,0,utRho15
620,gstB,1761038,1761038,1760960,78,42,utRho15
621,guaB,5268214,5268214,5268140,74,86,utRho15
622,gudD,5839026,5839026,5838770,256,4,utRho15
623,gyrA,4678914,4678914,4678840,74,2,utRho15
624,gyrB,7760300,7760300,7760238,62,76,utRho15
625,hcaE,5337964,5338064,5337964,100,46,utRho15
626,hcaR,5337928,5337928,5337792,136,54,utRho15
627,hcaT,5336106,5336106,5335692,414,288,utRho15
628,hchA,4071260,4071670,4071260,410,34,utRho15
629,hcp,1828258,1828258,1827628,630,12,utRho15
630,hcr,1824400,1824400,1824300,100,2,utRho15
631,hdeA,7313582,7313582,7313480,102,0,utRho15
632,hdeD,7313920,7313990,7313920,70,12,utRho15
633,hdfR,7896320,7896320,7895934,386,414,utRho15
634,hdhA,3396244,3396244,3396080,164,2,utRho15
635,helD,2048876,2048942,2048876,66,0,utRho15
636,hemA,2527166,2527428,2527166,262,80,utRho15
637,hemB,779722,779722,779454,268,58,utRho15
638,hemF,5106410,5106450,5106410,40,52,utRho15
639,hemH,996062,996110,996062,48,4,utRho15
640,hemL,349882,349882,349764,118,88,utRho15
641,hemN,8103886,8104090,8103886,204,52,utRho15
642,hepA,127176,127176,126528,648,538,utRho15
643,hflD,2385372,2385372,2385262,110,238,utRho15
644,hfq,8799602,8800576,8799602,974,7618,utRho15
645,hha,961006,961006,960616,390,70,utRho15
646,hicA,3018442,3018572,3018442,130,0,utRho15
647,higA,6468682,6468682,6468288,394,4,utRho15
648,higB,6468960,6468960,6468910,50,0,utRho15
649,hinT,2323642,2323770,2323642,128,0,utRho15
650,hipB,3184964,3184964,3184884,80,32,utRho15
651,hisB,4186720,4186936,4186720,216,506,utRho15
652,hisJ,4853674,4853674,4853576,98,44,utRho15
653,hisL,8359856,8359984,8359856,128,20,utRho15
654,hisS,5281284,5281284,5281150,134,416,utRho15
655,hlpA,400910,400964,400910,54,170,utRho15
656,hlyE,2460932,2460932,2460788,144,10,utRho15
657,hmp,5371594,5371670,5371594,76,0,utRho15
658,hns,2585916,2585916,2585844,72,564,utRho15
659,hofM,7045856,7045856,7045502,354,2,utRho15
660,hokA,7441620,7441620,7441200,420,38,utRho15
661,hokC,33902,33902,33806,96,116,utRho15
662,hokE,1215462,1215672,1215462,210,0,utRho15
663,holC,8968546,8968546,8968560,14,452,utRho15
664,holD,9215562,9215606,9215562,44,0,utRho15
665,holE,3850040,3850216,3850040,176,80,utRho15
666,hpt,282720,282862,282720,142,154,utRho15
667,hrpB,324150,324210,324150,60,8,utRho15
668,hscB,5319048,5319048,5318934,114,2074,utRho15
669,hscC,1367188,1367188,1366786,402,1264,utRho15
670,hsdS,9163004,9163004,9162924,80,54,utRho15
671,hslJ,2883560,2883560,2883486,74,34,utRho15
672,hslO,7059344,7059548,7059344,204,7302,utRho15
673,hslR,7058220,7058696,7058220,476,950,utRho15
674,hslV,8244708,8244708,8244574,134,206,utRho15
675,hsrA,7881412,7881412,7881224,188,82,utRho15
676,htgA,21286,21660,21286,374,170,utRho15
677,htpG,989634,990240,989634,606,976,utRho15
678,htpX,3825236,3825236,3825152,84,0,utRho15
679,htrE,311036,311036,310852,184,24,utRho15
680,htrL,7587668,7587668,7587366,302,0,utRho15
681,hupA,8400352,8400562,8400352,210,144,utRho15
682,hupB,1845220,1845804,1845220,584,1048,utRho15
683,hyaA,2063968,2064278,2063968,310,0,utRho15
684,hybO,6292726,6292726,6292522,204,242,utRho15
685,hycA,5700922,5700922,5700870,52,0,utRho15
686,hycI,5686204,5686204,5686086,118,106,utRho15
687,hydN,5676264,5676264,5676210,54,0,utRho15
688,hyfA,5202342,5202402,5202342,60,30,utRho15
689,hypA,11402508,11402588,11402508,80,0,utRho15
690,hypB,11403356,11404004,11403356,648,304,utRho15
691,hypF,5676210,5676210,5674850,1360,138,utRho15
692,hypT,9116634,9116634,9116578,56,2,utRho15
693,hyuA,6019660,6020056,6019660,396,0,utRho15
694,iaaA,1733074,1733136,1733074,62,0,utRho15
695,iadA,9119074,9119074,9119052,22,58,utRho15
696,iap,5753072,5753162,5753072,90,0,utRho15
697,ibaG,6673966,6673966,6673606,360,82,utRho15
698,ibpA,7735036,7735036,7734844,192,1072,utRho15
699,ibpB,7733962,7733962,7733794,168,3402,utRho15
700,icd,2389922,2390246,2389922,324,272,utRho15
701,iclR,8447304,8447304,8447256,48,34,utRho15
702,idi,6065876,6066130,6065876,254,0,utRho15
703,idnD,8988870,8988870,8988812,58,4,utRho15
704,idnK,8989194,8989246,8989194,52,0,utRho15
705,ihfA,3591442,3591442,3591104,338,358,utRho15
706,ihfB,1927498,1927656,1927498,158,720,utRho15
707,ileS,43666,44782,43666,1116,4910,utRho15
708,ileX,6431194,6431196,6431194,2,0,utRho15
709,ilvA,15820940,15821324,15820940,384,16,utRho15
710,ilvC,7915824,7915940,7915824,116,2,utRho15
711,ilvE,15809552,15809936,15809552,384,192,utRho15
712,ilvI,170840,171260,170840,420,0,utRho15
713,ilvL,23701308,23701932,23701308,624,0,utRho15
714,ilvY,7915734,7915734,7915640,94,0,utRho15
715,inaA,4698998,4698998,4698944,54,14,utRho15
716,infA,1853370,1853370,1852886,484,694,utRho15
717,infC,3602692,3602692,3601276,1416,2690,utRho15
718,insA-5,3958452,3958452,3958430,22,4,utRho15
719,insA-7,9036758,9037054,9036758,296,98,utRho15
720,insC-5,6372080,6372284,6372080,204,58,utRho15
721,insEF-2,785238,785238,785820,582,198,utRho15
722,insEF-4,2190310,2190310,2190892,582,152,utRho15
723,insG,9007098,9007098,9006862,236,14,utRho15
724,insH-1,550596,550596,550234,362,178,utRho15
725,insH-11,7306538,7306538,7306396,142,110,utRho15
726,insH-2,1151548,1151548,1151506,42,272,utRho15
727,insH-3,1378444,1378444,1378026,418,150,utRho15
728,insH-4,2791942,2792152,2791942,210,134,utRho15
729,insH-5,2857852,2857852,2857452,400,0,utRho15
730,insH-6,4135022,4135022,4134642,380,46,utRho15
731,insH-7,4206186,4206186,4205822,364,2900,utRho15
732,insH-9,6260050,6260356,6260050,306,150,utRho15
733,insI-3,9017372,9017372,9017234,138,22,utRho15
734,insJ,7441188,7441360,7441188,172,18,utRho15
735,insK,7442130,7442308,7442130,178,0,utRho15
736,insL-1,30760,30890,30760,130,2378,utRho15
737,insL-2,1216112,1216130,1216112,18,8,utRho15
738,insL-3,5028644,5028662,5028644,18,44,utRho15
739,insN-1,540452,540484,540452,32,0,utRho15
740,intD,1132202,1132202,1131956,246,64,utRho15
741,intR,2826520,2826520,2826470,50,2,utRho15
742,intS,4933026,4933090,4933026,64,24,utRho15
743,intZ,5117386,5117542,5117386,156,42,utRho15
744,iraD,9113152,9113986,9113152,834,12,utRho15
745,iraM,2424246,2424246,2424006,240,0,utRho15
746,iraP,802638,802772,802638,134,0,utRho15
747,iscA,5319924,5319924,5319772,152,1256,utRho15
748,iscR,5324398,5324398,5324262,136,10460,utRho15
749,iscX,5313834,5313834,5313472,362,1342,utRho15
750,ispF,5743968,5743968,5743560,408,758,utRho15
751,ispG,5283908,5283908,5283608,300,600,utRho15
752,ispU,389568,389806,389568,238,46,utRho15
753,isrA,2811502,2811502,2811618,116,24,utRho15
754,istr-1,7706384,7706384,7706384,0,0,utRho15
755,istr-2,7706514,7706514,7706514,0,0,utRho15
756,ivbL,15412092,15412092,15411952,140,512,utRho15
757,ivy,480638,480686,480638,48,2,utRho15
758,katE,3627628,3627734,3627628,106,2,utRho15
759,katG,8267624,8267670,8267624,46,84,utRho15
760,kbaZ,6557732,6557828,6557732,96,0,utRho15
761,kbl,7585154,7585154,7585102,52,638,utRho15
762,kch,2621046,2621046,2620538,508,0,utRho15
763,kdgR,3820506,3820506,3820198,308,0,utRho15
764,kdpE,1443788,1443788,1443466,322,102,utRho15
765,kdpF,1457698,1457698,1457642,56,12,utRho15
766,kdsA,2535708,2536330,2535708,622,686,utRho15
767,kdsC,6683438,6684546,6683438,1108,1420,utRho15
768,kduI,5968388,5968388,5968248,140,74,utRho15
769,kefF,94160,94492,94160,332,8,utRho15
770,kgtP,5451624,5451624,5451492,132,10,utRho15
771,kup,7862206,7862632,7862206,426,10,utRho15
772,lacI,735076,735076,735020,56,60,utRho15
773,lacZ,1465508,1465508,1465220,288,12,utRho15
774,ldcA,2486394,2486394,2486160,234,6,utRho15
775,ldhA,2885830,2885830,2885686,144,0,utRho15
776,ldrA,2538954,2538954,2538550,404,56,utRho15
777,ldrB,2540024,2540024,2539620,404,14,utRho15
778,ldrC,2541092,2541092,2540690,402,10,utRho15
779,ldrD,7400544,7400544,7400174,370,110,utRho15
780,lepA,5414392,5414392,5414248,144,122,utRho15
781,lepB,5410928,5410928,5410618,310,422,utRho15
782,leuD,159188,159188,158906,282,0,utRho15
783,leuE,3761600,3761600,3761518,82,2,utRho15
784,leuL,168048,168048,167416,632,0,utRho15
785,leuO,168308,168736,168308,428,4,utRho15
786,leuQ,9212864,9212864,9212802,62,2,utRho15
787,leuU,6644556,6644556,6644316,240,1846,utRho15
788,leuV,9212546,9212546,9212330,216,790,utRho15
789,leuX,8992772,8992810,8992772,38,4,utRho15
790,lexA,8514174,8514230,8514174,56,14,utRho15
791,lhr,3456706,3458174,3456706,1468,608,utRho15
792,ligA,5060402,5060402,5060352,50,28,utRho15
793,ligB,7642576,7642576,7642340,236,26,utRho15
794,lipA,1320602,1320602,1320432,170,62,utRho15
795,lipB,1324802,1324802,1324556,246,1594,utRho15
796,lit,2397032,2397390,2397032,358,8,utRho15
797,livJ,7199524,7199524,7199316,208,30,utRho15
798,livK,7195510,7195510,7195120,390,22,utRho15
799,lldP,7554578,7554798,7554578,220,3134,utRho15
800,lnt,1381968,1381968,1381762,206,408,utRho15
801,loiP,6163784,6163826,6163784,42,8,utRho15
802,lolA,1874656,1874738,1874656,82,184,utRho15
803,lolB,2527112,2527112,2527000,112,28,utRho15
804,lolC,2350748,2350854,2350748,106,0,utRho15
805,lon,917630,917776,917630,146,268,utRho15
806,lpcA,486936,487086,486936,150,16,utRho15
807,lpd,255434,255824,255434,390,4358,utRho15
808,lplA,9248476,9248476,9248234,242,1082,utRho15
809,lplT,5947878,5947878,5947724,154,24,utRho15
810,lpoA,6586422,6586800,6586422,378,114,utRho15
811,lpp,3514592,3514842,3514592,250,168,utRho15
812,lptA,6686598,6686760,6686598,162,188,utRho15
813,lptB,6686792,6687888,6686792,1096,990,utRho15
814,lptD,114672,114672,114218,454,770,utRho15
815,lptF,8972244,8972436,8972244,192,4,utRho15
816,lpxC,213016,213114,213016,98,4426,utRho15
817,lpxD,401920,401942,401920,22,22,utRho15
818,lpxL,2233418,2233418,2233164,254,20,utRho15
819,lpxM,3880456,3880456,3880386,70,2,utRho15
820,lpxP,4991156,4991290,4991156,134,20,utRho15
821,lrhA,4813312,4813312,4813282,30,32,utRho15
822,lrp,1864656,1865190,1864656,534,568,utRho15
823,lspA,50028,50414,50028,386,714,utRho15
824,lsrA,3202920,3202980,3202920,60,0,utRho15
825,lsrR,3202514,3202514,3202482,32,2,utRho15
826,ltaE,1818640,1818640,1818588,52,0,utRho15
827,luxS,5630130,5630130,5629466,664,620,utRho15
828,lysA,5957902,5957902,5957798,104,0,utRho15
829,lysC,8467232,8467232,8466466,766,356,utRho15
830,lysP,4497120,4497120,4497064,56,2,utRho15
831,lysR,5957900,5958042,5957900,142,0,utRho15
832,lysT,1561028,1561108,1561028,80,60,utRho15
833,lysU,8709610,8709610,8709434,176,130,utRho15
834,macB,1840188,1840694,1840188,506,200,utRho15
835,maeA,3111484,3111484,3111338,146,5696,utRho15
836,mak,820236,820288,820236,52,24,utRho15
837,malE,8492928,8492928,8492838,90,34,utRho15
838,malI,3398456,3398456,3398360,96,0,utRho15
839,malK,8493472,8493568,8493472,96,2,utRho15
840,malP,7105020,7105020,7104946,74,142,utRho15
841,malQ,7100798,7100798,7100140,658,1390,utRho15
842,malS,14949880,14949988,14949880,108,0,utRho15
843,malT,7106048,7106170,7106048,122,104,utRho15
844,malX,3398626,3398710,3398626,84,8,utRho15
845,malZ,1689980,1690072,1689980,92,20,utRho15
846,manA,3377102,3377152,3377102,50,0,utRho15
847,manX,3803866,3804096,3803866,230,92,utRho15
848,marC,3237882,3237882,3237816,66,22,utRho15
849,marR,3238186,3238240,3238186,54,0,utRho15
850,matP,2036918,2036970,2036918,52,0,utRho15
851,mazE,5822736,5822736,5822678,58,10,utRho15
852,mazG,5821720,5821720,5821370,350,1768,utRho15
853,mcbA,1684306,1684306,1684112,194,0,utRho15
854,mcbR,3040192,3040524,3040192,332,0,utRho15
855,mcrA,2420278,2420692,2420278,414,2,utRho15
856,mcrC,9156124,9156124,9155916,208,94,utRho15
857,mdaB,6344814,6345060,6344814,246,8,utRho15
858,mdfA,1767138,1767346,1767138,208,0,utRho15
859,mdh,6768940,6768940,6768536,404,352,utRho15
860,mdoB,9198988,9198988,9198882,106,632,utRho15
861,mdoD,2993290,2993712,2993290,422,0,utRho15
862,mdoG,2218514,2218670,2218514,156,16,utRho15
863,mdtA,4307958,4308032,4307958,74,2,utRho15
864,mdtE,7318168,7318464,7318168,296,112,utRho15
865,mdtK,3486538,3486914,3486538,376,96,utRho15
866,mdtP,8602472,8602472,8602060,412,24,utRho15
867,melA,8683774,8683822,8683774,48,0,utRho15
868,melR,8683300,8683300,8683256,44,24,utRho15
869,menA,8240812,8240812,8240698,114,4,utRho15
870,menB,4753774,4753774,4753638,136,308,utRho15
871,mepH,3468714,3468870,3468714,156,0,utRho15
872,mepM,3883666,3883666,3883270,396,308,utRho15
873,mepS,4539840,4539958,4539840,118,132,utRho15
874,metA,8428318,8428560,8428318,242,6,utRho15
875,metB,8257272,8257344,8257272,72,798,utRho15
876,metC,6304150,6304472,6304150,322,12,utRho15
877,metE,8025768,8026106,8025768,338,282,utRho15
878,metF,8265092,8265232,8265092,140,0,utRho15
879,metG,4388538,4388600,4388538,62,74,utRho15
880,metH,8447010,8447656,8447010,646,1352,utRho15
881,metJ,8257116,8257116,8256790,326,82,utRho15
882,metK,6173154,6173412,6173154,258,96,utRho15
883,metN,445428,445428,445290,138,28,utRho15
884,metR,8025710,8025710,8025632,78,0,utRho15
885,metT,1394326,1394326,1394266,60,86,utRho15
886,metY,19910250,19910250,19909734,516,108,utRho15
887,metZ,11789528,11789548,11789528,20,16,utRho15
888,mfd,2348056,2348056,2347928,128,182,utRho15
889,mglA,4478782,4478782,4478578,204,1238,utRho15
890,mglB,4481132,4481132,4480696,436,24410,utRho15
891,mglC,4475918,4475918,4475506,412,430,utRho15
892,mgrB,3817584,3817584,3817532,52,0,utRho15
893,mgrR,3245828,3245828,3245828,0,0,utRho15
894,mgsA,2054082,2054082,2054030,52,58,utRho15
895,mgtL,8934560,8934862,8934560,302,8,utRho15
896,mhpA,737038,737222,737038,184,6,utRho15
897,mhpR,737072,737072,736840,232,38,utRho15
898,mhpT,750772,750918,750772,146,0,utRho15
899,miaA,8797964,8798504,8797964,540,396,utRho15
900,micA,5629604,5629604,5629604,0,0,utRho15
901,micC,2874242,2874238,2874242,4,0,utRho15
902,micF,4626168,4626168,4626168,0,0,utRho15
903,micM,1014408,1014408,1014408,0,0,utRho15
904,minE,2449422,2449422,2449090,332,2350,utRho15
905,mioC,7852950,7852950,7852910,40,16,utRho15
906,mipA,3733012,3733012,3732944,68,1826,utRho15
907,mlaA,4930270,4930270,4930014,256,0,utRho15
908,mlc,3337206,3337206,3337128,78,0,utRho15
909,mlrA,4429498,4429732,4429498,234,0,utRho15
910,mltA,5894546,5894546,5894356,190,0,utRho15
911,mltD,468050,468050,467910,140,0,utRho15
912,mltF,5391534,5391602,5391534,68,0,utRho15
913,mmuP,550238,550650,550238,412,220,utRho15
914,mngA,1531622,1531968,1531622,346,0,utRho15
915,mngR,1531852,1531852,1531750,102,0,utRho15
916,mnmG,7851348,7851348,7851266,82,368,utRho15
917,mntH,5025470,5025470,5025412,58,0,utRho15
918,mntP,3810918,3811376,3810918,458,232,utRho15
919,mntR,1706160,1706366,1706160,206,0,utRho15
920,mntS,1706128,1706128,1705994,134,2,utRho15
921,moaA,1633654,1634088,1633654,434,360,utRho15
922,moaB,1635954,1636110,1635954,156,690,utRho15
923,mobA,8084242,8084242,8083998,244,28,utRho15
924,mocA,6030112,6030320,6030112,208,28,utRho15
925,modA,1589990,1590178,1589990,188,2,utRho15
926,moeA,1732788,1732788,1732728,60,188,utRho15
927,mokB,2984610,2984610,2984258,352,262,utRho15
928,molR_1,4392888,4392948,4392888,60,4,utRho15
929,motA,3954604,3954604,3954278,326,2,utRho15
930,mpaA,2781278,2781278,2781196,82,18,utRho15
931,mpl,8911456,8911570,8911456,114,0,utRho15
932,mppA,2786108,2786454,2786108,346,32,utRho15
933,mprA,5621494,5621540,5621494,46,442,utRho15
934,mqo,4613848,4613848,4613508,340,4,utRho15
935,mqsA,6336742,6336742,6336492,250,458,utRho15
936,mqsR,6337306,6337306,6337088,218,118,utRho15
937,mraZ,179192,179268,179192,76,0,utRho15
938,mrcA,7045652,7045742,7045652,90,0,utRho15
939,mrcB,329442,329460,329442,18,0,utRho15
940,mreB,13605424,13605424,13604348,1076,1364,utRho15
941,mreD,6798166,6798166,6797750,416,58,utRho15
942,mrp,4388360,4388360,4388336,24,0,utRho15
943,mscK,972984,973072,972984,88,0,utRho15
944,mscL,6876002,6876048,6876002,46,10,utRho15
945,mscS,6139742,6139742,6139614,128,16,utRho15
946,msrA,8884522,8884522,8884352,170,254,utRho15
947,msrB,3725168,3725168,3724858,310,0,utRho15
948,msyB,2228426,2228426,2228362,64,0,utRho15
949,mtfA,4087236,4087302,4087236,66,2178,utRho15
950,mtgA,6699662,6699662,6699618,44,48,utRho15
951,mtlA,30177504,30178248,30177504,744,1480,utRho15
952,mtn,358366,358366,358306,60,6,utRho15
953,mtr,6611864,6611864,6611634,230,0,utRho15
954,mug,6430992,6430992,6430946,46,0,utRho15
955,murQ,5091466,5091546,5091466,80,8,utRho15
956,murR,5091586,5091586,5091218,368,8,utRho15
957,mutH,5939164,5939324,5939164,160,16,utRho15
958,mutL,8794092,8794824,8794092,732,232,utRho15
959,mutM,7622554,7622554,7622304,250,300,utRho15
960,mutS,5714038,5714186,5714038,148,584,utRho15
961,mutY,18617466,18618078,18617466,612,54,utRho15
962,nac,4123956,4123956,4123866,90,2,utRho15
963,nadA,1564122,1564170,1564122,48,0,utRho15
964,nadB,5420714,5420840,5420714,126,0,utRho15
965,nadC,237326,237326,237290,36,2,utRho15
966,nadE,3644604,3644916,3644604,312,4,utRho15
967,nadK,5501526,5501662,5501526,136,64,utRho15
968,nagA,1406350,1406350,1405502,848,12074,utRho15
969,nagB,1407416,1407416,1407222,194,110,utRho15
970,nagC,1404016,1404016,1403188,828,542,utRho15
971,nagE,1407680,1407888,1407680,208,0,utRho15
972,nagK,2357080,2357186,2357080,106,4,utRho15
973,nanA,6747240,6747240,6747152,88,108,utRho15
974,nanC,9079856,9079856,9079002,854,1648,utRho15
975,nanR,6749406,6749406,6748978,428,46,utRho15
976,nanS,9075406,9075406,9075188,218,356,utRho15
977,napF,4607390,4607390,4606994,396,0,utRho15
978,narG,2559614,2559728,2559614,114,2,utRho15
979,narK,2555642,2555914,2555642,272,2,utRho15
980,narP,4580844,4581000,4580844,156,30,utRho15
981,narQ,5171154,5171462,5171154,308,66,utRho15
982,narU,3088326,3088326,3088120,206,0,utRho15
983,narW,3077374,3077374,3074618,2756,60,utRho15
984,narX,2555554,2555554,2555236,318,2,utRho15
985,narZ,3085380,3085380,3085180,200,0,utRho15
986,ndh,2331984,2332170,2331984,186,0,utRho15
987,ndk,5289920,5289920,5289728,192,178,utRho15
988,nemR,6904084,6904092,6904084,8,0,utRho15
989,nepI,7683542,7683542,7683478,64,2,utRho15
990,nfo,4501612,4501680,4501612,68,114,utRho15
991,nfsB,1210906,1210906,1210848,58,2,utRho15
992,nfuA,7090916,7091248,7090916,332,516,utRho15
993,nhaA,34634,34978,34634,344,12,utRho15
994,nhaB,2469534,2469534,2469434,100,0,utRho15
995,nhoA,3067926,3068048,3067926,122,4,utRho15
996,nikA,7226878,7227334,7226878,456,176,utRho15
997,nikR,7237074,7237176,7237074,102,266,utRho15
998,nirB,6987974,6988022,6987974,48,0,utRho15
999,nlpA,7680034,7680034,7679986,48,0,utRho15
1000,nlpC,3585654,3585654,3585462,192,0,utRho15
1001,nlpD,5737658,5737658,5737506,152,14,utRho15
1002,nlpI,6618080,6618080,6617848,232,0,utRho15
1003,nmpC,1153740,1153740,1153650,90,50,utRho15
1004,nohA,3273206,3273206,3272734,472,2,utRho15
1005,norR,5664614,5664614,5664578,36,0,utRho15
1006,norV,5664878,5664952,5664878,74,2,utRho15
1007,nrdA,4689510,4689730,4689510,220,8752,utRho15
1008,nrdD,8925676,8925676,8925320,356,2190,utRho15
1009,nrdH,5601312,5601446,5601312,134,404,utRho15
1010,nrdR,865954,866004,865954,50,2,utRho15
1011,nrfA,8575342,8575528,8575342,186,2,utRho15
1012,nsrR,8812088,8812380,8812088,292,458,utRho15
1013,nudB,3897348,3897348,3897264,84,14,utRho15
1014,nudC,8393428,8393806,8393428,378,26,utRho15
1015,nudE,7052658,7052658,7052298,360,234,utRho15
1016,nudG,3682876,3682980,3682876,104,12,utRho15
1017,nudI,4729050,4729108,4729050,58,0,utRho15
1018,nudJ,2388874,2388874,2388576,298,598,utRho15
1019,nuoA,4810670,4810670,4810144,526,4438,utRho15
1020,nuoN,4783434,4783434,4783010,424,1208,utRho15
1021,nupC,5026018,5026084,5026018,66,0,utRho15
1022,nupG,6211302,6211428,6211302,126,0,utRho15
1023,ogrK,4335096,4335096,4335040,56,0,utRho15
1024,ogt,2800568,2800568,2800472,96,60,utRho15
1025,ohsC,5401036,5401040,5401036,4,0,utRho15
1026,ompA,2040382,2040382,2040106,276,23848,utRho15
1027,ompC,4625774,4625774,4625498,276,412,utRho15
1028,ompF,1974184,1974184,1973964,220,472,utRho15
1029,ompL,8128958,8128958,8128590,368,4,utRho15
1030,ompN,2874158,2874158,2873786,372,0,utRho15
1031,ompR,7073510,7073510,7073168,342,44,utRho15
1032,ompT,1171330,1171330,1171266,64,50,utRho15
1033,ompW,2627982,2628040,2627982,58,0,utRho15
1034,ompX,1700418,1700900,1700418,482,622,utRho15
1035,omrA,5952378,5952378,5952378,0,0,utRho15
1036,omrB,5952770,5952770,5952770,0,0,utRho15
1037,oppA,2602170,2602364,2602170,194,3642,utRho15
1038,orn,8783168,8783208,8783168,40,18,utRho15
1039,osmB,2686952,2686952,2686656,296,16,utRho15
1040,osmC,3113192,3113250,3113192,58,132,utRho15
1041,osmE,3644566,3644566,3644512,54,2,utRho15
1042,osmF,4439046,4439046,4438962,84,396,utRho15
1043,osmY,9222306,9222792,9222306,486,50,utRho15
1044,otsA,3963302,3963302,3963224,78,0,utRho15
1045,otsB,3964930,3964930,3964774,156,0,utRho15
1046,oxc,4984288,4984288,4983900,388,10,utRho15
1047,oxyR,8316914,8316980,8316914,66,4,utRho15
1048,oxyS,8316788,8316788,8316788,0,0,utRho15
1049,paaA,2907730,2907854,2907730,124,0,utRho15
1050,paaX,2927018,2927078,2927018,60,18,utRho15
1051,paaZ,2907340,2907340,2907284,56,0,utRho15
1052,pabA,6981702,6981702,6981658,44,2,utRho15
1053,pabB,3789256,3789610,3789256,354,120,utRho15
1054,pabC,2306186,2306600,2306186,414,272,utRho15
1055,pagP,1313052,1313114,1313052,62,0,utRho15
1056,panB,299260,299260,299202,58,100,utRho15
1057,panC,297840,297840,297590,250,218,utRho15
1058,panD,293490,293490,293388,102,12,utRho15
1059,panZ,7195656,7195968,7195656,312,72,utRho15
1060,parC,6332060,6332060,6331946,114,300,utRho15
1061,patA,6438916,6438988,6438916,72,0,utRho15
1062,patD,3030830,3031156,3030830,326,2,utRho15
1063,pbpC,5294986,5294986,5294650,336,6,utRho15
1064,pbpG,4450132,4450132,4449740,392,132,utRho15
1065,pck,7065358,7065636,7065358,278,3064,utRho15
1066,pcnB,318782,318782,318252,530,188,utRho15
1067,pdhR,244068,244184,244068,116,0,utRho15
1068,pdxB,4875768,4875768,4875702,66,2,utRho15
1069,pdxH,3436068,3436068,3436014,54,118,utRho15
1070,pdxJ,5403626,5403626,5403458,168,54,utRho15
1071,pdxK,5074638,5074638,5074474,164,0,utRho15
1072,pepA,8972278,8972278,8971902,376,106,utRho15
1073,pepD,511618,511618,511432,186,6940,utRho15
1074,pepN,1981182,1981244,1981182,62,134,utRho15
1075,pepQ,8062294,8062322,8062294,28,0,utRho15
1076,pepT,2371646,2371688,2371646,42,2,utRho15
1077,pfkA,8214948,8215104,8214948,156,102,utRho15
1078,pfkB,3612646,3612740,3612646,94,0,utRho15
1079,pflA,1902456,1902456,1902160,296,54,utRho15
1080,pflB,1907850,1907850,1907108,742,1076,utRho15
1081,pflD,8287716,8287990,8287716,274,0,utRho15
1082,pgaA,2185046,2185046,2184578,468,0,utRho15
1083,pgi,8467444,8467516,8467444,72,72,utRho15
1084,pgk,12291428,12291428,12290488,940,4580,utRho15
1085,pgl,1597078,1597172,1597078,94,0,utRho15
1086,pgpB,2678324,2678660,2678324,336,2,utRho15
1087,pgpC,5397276,5397276,5397100,176,0,utRho15
1088,pgrR,2783744,2783982,2783744,238,0,utRho15
1089,pheL,5475158,5475198,5475158,40,0,utRho15
1090,pheM,7197204,7197204,7197080,124,0,utRho15
1091,pheP,1203858,1203918,1203858,60,0,utRho15
1092,pheU,8725254,8725254,8725252,2,0,utRho15
1093,pheV,6220730,6220732,6220730,2,34,utRho15
1094,phnC,8650412,8650412,8650330,82,18,utRho15
1095,phoA,803414,803494,803414,80,20,utRho15
1096,phoB,834202,834284,834202,82,8,utRho15
1097,phoE,520316,520316,520200,116,4,utRho15
1098,phoH,2169730,2169984,2169730,254,120,utRho15
1099,phoP,2381016,2381016,2380894,122,1410,utRho15
1100,phoQ,2379880,2379880,2379552,328,658,utRho15
1101,phoU,7815330,7815330,7815156,174,36,utRho15
1102,phr,1478842,1479014,1478842,172,0,utRho15
1103,pinE,2419054,2419370,2419054,316,0,utRho15
1104,pinQ,3267168,3267244,3267168,76,6,utRho15
1105,pinR,2867424,2867424,2867348,76,6,utRho15
1106,pitA,7275224,7275284,7275224,60,24,utRho15
1107,pitB,6272806,6272806,6272742,64,0,utRho15
1108,pka,5439862,5439906,5439862,44,6,utRho15
1109,plaP,4174476,4174476,4174124,352,48,utRho15
1110,pldA,8009628,8009724,8009628,96,46,utRho15
1111,pldB,8018028,8018340,8018028,312,110,utRho15
1112,plsB,8513196,8513196,8512932,264,230,utRho15
1113,pmbA,8915890,8915918,8915890,28,0,utRho15
1114,pmrD,4747148,4747148,4747076,72,0,utRho15
1115,pncB,1980828,1980828,1980712,116,0,utRho15
1116,pncC,5648788,5648788,5648692,96,0,utRho15
1117,pnp,6622652,6622652,6622336,316,68,utRho15
1118,pntA,3355950,3355950,3355806,144,0,utRho15
1119,pntB,3353096,3353096,3352720,376,14,utRho15
1120,polA,8093880,8093932,8093880,52,32,utRho15
1121,polB,131606,131606,131560,46,0,utRho15
1122,potD,2365700,2365700,2365658,42,26,utRho15
1123,potE,1436688,1436688,1436530,158,2,utRho15
1124,potF,1787268,1787568,1787268,300,18,utRho15
1125,poxB,1822152,1822152,1822098,54,0,utRho15
1126,ppa,8899372,8899372,8899304,68,72,utRho15
1127,ppc,8306380,8306380,8306196,184,678,utRho15
1128,ppdA,5928440,5928440,5928354,86,16,utRho15
1129,ppdD,235410,235410,235098,312,14,utRho15
1130,pphA,3846770,3846770,3845938,832,1894,utRho15
1131,pphB,5719474,5719520,5719474,46,0,utRho15
1132,ppiA,6984898,6984898,6984594,304,34,utRho15
1133,ppiC,7919682,7919682,7919626,56,0,utRho15
1134,ppiD,923638,923830,923638,192,328,utRho15
1135,ppk,5245748,5246088,5245748,340,172,utRho15
1136,pppA,6228958,6228958,6228704,254,0,utRho15
1137,ppsA,3574322,3574322,3574224,98,0,utRho15
1138,ppsR,3574678,3574890,3574678,212,0,utRho15
1139,pptA,3065716,3066104,3065716,388,6,utRho15
1140,pqiA,2023318,2024002,2023318,684,114,utRho15
1141,prc,3830054,3830054,3829632,422,11574,utRho15
1142,preT,4467978,4468066,4467978,88,142,utRho15
1143,prfC,9218688,9218828,9218688,140,328,utRho15
1144,prkB,6968622,6968980,6968622,358,640,utRho15
1145,prlC,7290476,7290476,7290364,112,154,utRho15
1146,prlF,6553944,6554004,6553944,60,150,utRho15
1147,proB,520432,520776,520432,344,10,utRho15
1148,proC,811372,811372,811288,84,2,utRho15
1149,proK,7417388,7417388,7417384,4,44,utRho15
1150,proL,4572414,4572422,4572414,8,16,utRho15
1151,proP,8660640,8661004,8660640,364,216,utRho15
1152,proS,437674,437674,437550,124,750,utRho15
1153,proV,5609126,5609630,5609126,504,22,utRho15
1154,prpB,697292,697364,697292,72,12,utRho15
1155,prpR,696942,696942,696886,56,0,utRho15
1156,prs,2524354,2524354,2523750,604,48290,utRho15
1157,psd,8781276,8781276,8780720,556,1434,utRho15
1158,psiE,8480600,8480650,8480600,50,24,utRho15
1159,pspA,2736076,2736158,2736076,82,0,utRho15
1160,pspF,2736080,2736080,2735824,256,0,utRho15
1161,pspG,8525632,8525680,8525632,48,0,utRho15
1162,pssA,5445156,5445454,5445156,298,4202,utRho15
1163,pstB,7817112,7817112,7816732,380,140,utRho15
1164,pstC,7821084,7821084,7820796,288,28,utRho15
1165,pstS,23469408,23469408,23469150,258,90,utRho15
1166,psuG,4517114,4517114,4516734,380,1144,utRho15
1167,psuT,4514992,4514992,4514670,322,0,utRho15
1168,pth,2517084,2517084,2517026,58,0,utRho15
1169,ptrA,5918022,5918022,5917768,254,0,utRho15
1170,ptrB,3857730,3857730,3857678,52,166,utRho15
1171,ptsG,2315252,2315738,2315252,486,642,utRho15
1172,ptsH,5066996,5067528,5066996,532,3370,utRho15
1173,purA,8809328,8809374,8809328,46,0,utRho15
1174,purC,5195562,5195562,5195236,326,60,utRho15
1175,purD,8411972,8411972,8411862,110,38,utRho15
1176,purE,1106284,1106284,1106200,84,144,utRho15
1177,purH,8415254,8415254,8415064,190,0,utRho15
1178,purL,5391178,5391178,5391086,92,378,utRho15
1179,purM,5242306,5242394,5242306,88,14,utRho15
1180,purR,3475378,3475688,3475378,310,182,utRho15
1181,purT,3861438,3861762,3861438,324,2,utRho15
1182,purU,2577512,2577512,2577248,264,322,utRho15
1183,putA,2157850,2157850,2157764,86,0,utRho15
1184,putP,2158336,2158610,2158336,274,1190,utRho15
1185,puuA,2721936,2721936,2721816,120,0,utRho15
1186,puuC,2725456,2725486,2725456,30,0,utRho15
1187,puuD,2722104,2722240,2722104,136,0,utRho15
1188,puuP,2718746,2718746,2718374,372,302,utRho15
1189,pykA,3874988,3875298,3874988,310,154,utRho15
1190,pykF,3510934,3511396,3510934,462,292,utRho15
1191,pyrC,2245286,2245286,2245214,72,60,utRho15
1192,pyrD,2009464,2009536,2009464,72,46,utRho15
1193,pyrE,7631970,7631970,7631536,434,2,utRho15
1194,pyrF,2683740,2683842,2683740,102,218,utRho15
1195,pyrG,5819594,5819594,5819332,262,390,utRho15
1196,pyrH,383624,383710,383624,86,538,utRho15
1197,pyrL,8945490,8945490,8945066,424,52,utRho15
1198,qmcA,1031646,1031646,1031546,100,20,utRho15
1199,qor,8528608,8528608,8528462,146,72,utRho15
1200,qseB,6339502,6339656,6339502,154,10,utRho15
1201,queA,849970,850022,849970,52,70,utRho15
1202,queE,5811212,5811212,5810836,376,4,utRho15
1203,queF,5850642,5850696,5850642,54,0,utRho15
1204,queG,8788184,8788184,8788134,50,1134,utRho15
1205,racC,2835630,2835630,2835526,104,0,utRho15
1206,racR,2840898,2840898,2840482,416,24,utRho15
1207,raiA,5474208,5474308,5474208,100,2,utRho15
1208,rarD,8008594,8008594,8008356,238,208,utRho15
1209,ravA,7862256,7862256,7862186,70,26,utRho15
1210,rayT,495088,495274,495088,186,2,utRho15
1211,rbn,4763162,4763216,4763162,54,0,utRho15
1212,rbsD,7866644,7866702,7866644,58,20,utRho15
1213,rcnA,4371654,4371834,4371654,180,0,utRho15
1214,rcnB,4373768,4373920,4373768,152,34,utRho15
1215,rcnR,4371806,4371806,4371592,214,0,utRho15
1216,rcsA,4047672,4047936,4047672,264,26,utRho15
1217,rcsB,4631390,4632354,4631390,964,714,utRho15
1218,rcsC,4640162,4640162,4639656,506,144,utRho15
1219,rcsD,4626904,4626976,4626904,72,30,utRho15
1220,rdgB,6193240,6193362,6193240,122,292,utRho15
1221,rdlA,2538646,2538646,2538646,0,0,utRho15
1222,rdlB,2539712,2539716,2539712,4,0,utRho15
1223,rdlC,2540782,2540786,2540782,4,0,utRho15
1224,rdlD,7400272,7400272,7400272,0,0,utRho15
1225,rdoA,8084782,8084830,8084782,48,64,utRho15
1226,recA,11295276,11295276,11295076,200,472,utRho15
1227,recC,5925014,5925014,5924856,158,56,utRho15
1228,recF,7763722,7763722,7762442,1280,2780,utRho15
1229,recN,5503518,5503590,5503518,72,0,utRho15
1230,recQ,8011666,8011728,8011666,62,54,utRho15
1231,relA,5828554,5828554,5827302,1252,348,utRho15
1232,relB,3291806,3291806,3291744,62,0,utRho15
1233,rem,3289950,3289950,3289804,146,0,utRho15
1234,rep,7921294,7921354,7921294,60,26,utRho15
1235,rfaD,7587730,7587974,7587730,244,6,utRho15
1236,rfaE,6393852,6393852,6393506,346,68,utRho15
1237,rfaH,8049930,8049930,8049642,288,752,utRho15
1238,rfbX,4219436,4219436,4219168,268,762,utRho15
1239,rfe,7935600,7935832,7935600,232,20,utRho15
1240,rhaB,8194944,8194944,8194896,48,2,utRho15
1241,rhaD,8188770,8188770,8188544,226,0,utRho15
1242,rhaS,8195422,8195472,8195422,50,0,utRho15
1243,rhaT,8201132,8201132,8201050,82,2,utRho15
1244,rhlE,1661566,1661744,1661566,178,4,utRho15
1245,rhoL,47593944,47594772,47593944,828,16680,utRho15
1246,rhsB,7238006,7238384,7238006,378,10,utRho15
1247,rhsC,1458758,1459166,1458758,408,0,utRho15
1248,rhsD,1046132,1046522,1046132,390,0,utRho15
1249,rhtA,1700608,1700608,1700194,414,50,utRho15
1250,rhtC,8015478,8015514,8015478,36,350,utRho15
1251,ribA,2678468,2678468,2678320,148,2,utRho15
1252,ribC,3486916,3486916,3486484,432,126,utRho15
1253,ribE,869008,869294,869008,286,6556,utRho15
1254,ribF,42766,42814,42766,48,0,utRho15
1255,ridA,8941892,8941892,8941826,66,18,utRho15
1256,rihA,1369204,1369204,1368824,380,248,utRho15
1257,rihB,4510504,4510504,4510372,132,0,utRho15
1258,rimJ,2251044,2251124,2251044,80,38,utRho15
1259,rimK,1783752,1783934,1783752,182,510,utRho15
1260,rimL,2997486,2997876,2997486,390,246,utRho15
1261,rimO,1756140,1756140,1756070,70,2,utRho15
1262,rimP,6636350,6636350,6636012,338,470,utRho15
1263,rlmA,3814172,3814172,3814120,52,260,utRho15
1264,rlmD,5830086,5830086,5830000,86,80,utRho15
1265,rlmE,6655520,6655520,6655328,192,498,utRho15
1266,rlmF,1684384,1684664,1684384,280,0,utRho15
1267,rlmG,6471784,6471784,6471750,34,0,utRho15
1268,rlmI,2060002,2060002,2059938,64,0,utRho15
1269,rlmJ,7290700,7290770,7290700,70,62,utRho15
1270,rlmL,2015344,2015688,2015344,344,844,utRho15
1271,rlpA,1330444,1330444,1330380,64,68,utRho15
1272,rluA,120900,120900,120692,208,22,utRho15
1273,rluF,8460324,8460708,8460324,384,0,utRho15
1274,rmf,2031006,2031430,2031006,424,274,utRho15
1275,rna,1290068,1290068,1290006,62,0,utRho15
1276,rnb,2698258,2698258,2697824,434,1000,utRho15
1277,rnc,10816892,10816892,10816252,640,2308,utRho15
1278,rnd,3776122,3776122,3775982,140,60,utRho15
1279,rne,2289746,2289746,2288734,1012,6064,utRho15
1280,rnhA,472082,472082,472004,78,218,utRho15
1281,rnk,1288360,1288360,1287934,426,52,utRho15
1282,rnlA,5531788,5531836,5531788,48,18,utRho15
1283,rnlB,5533414,5533968,5533414,554,158,utRho15
1284,rnpB,19623552,19623552,19623552,0,0,utRho15
1285,rob,9270706,9270706,9270620,86,0,utRho15
1286,rodZ,5285868,5285868,5285688,180,34,utRho15
1287,rpe,7030306,7030306,7030118,188,78,utRho15
1288,rph,15266320,15266320,15266196,124,32,utRho15
1289,rpiA,6118706,6118706,6118650,56,94,utRho15
1290,rpiB,8626514,8626700,8626514,186,0,utRho15
1291,rpiR,8626274,8626274,8625982,292,0,utRho15
1292,rplJ,8359246,8359992,8359246,746,4884,utRho15
1293,rplK,8356708,8356894,8356708,186,540,utRho15
1294,rplM,6757344,6757344,6757302,42,6340,utRho15
1295,rplN,6896444,6896444,6896298,146,4258,utRho15
1296,rplS,5489284,5489284,5489060,224,6540,utRho15
1297,rplT,7199052,7199052,7198996,56,268,utRho15
1298,rplU,6667036,6667036,6666902,134,50,utRho15
1299,rplY,4564866,4565034,4564866,168,52,utRho15
1300,rpmA,6666450,6666450,6666238,212,416,utRho15
1301,rpmB,15247980,15247980,15246696,1284,50028,utRho15
1302,rpmE,8253816,8254026,8253816,210,170,utRho15
1303,rpmF,2294676,2294734,2294676,58,21544,utRho15
1304,rpmH,7768130,7768672,7768130,542,2584,utRho15
1305,rpmI,3600854,3600854,3599998,856,8632,utRho15
1306,rpoB,8362126,8362490,8362126,364,118,utRho15
1307,rpoD,6424946,6426094,6424946,1148,14266,utRho15
1308,rpoE,5420372,5420372,5420024,348,2,utRho15
1309,rpoH,7202006,7202006,7201566,440,1472,utRho15
1310,rpoN,6689324,6689434,6689324,110,36,utRho15
1311,rpoS,5736236,5736236,5735102,1134,3616,utRho15
1312,rpoZ,7644154,7644212,7644154,58,206,utRho15
1313,rppH,5937986,5937986,5937954,32,0,utRho15
1314,rprA,3540744,3540744,3540744,0,0,utRho15
1315,rpsA,1923434,1923990,1923434,556,73202,utRho15
1316,rpsF,8850050,8850236,8850050,186,16464,utRho15
1317,rpsI,6756580,6756580,6756414,166,4522,utRho15
1318,rpsJ,6906884,6906884,6906540,344,6122,utRho15
1319,rpsL,6949242,6949242,6949104,138,496,utRho15
1320,rpsM,6885130,6885130,6884942,188,812,utRho15
1321,rpsO,13247144,13247144,13246736,408,632,utRho15
1322,rpsP,5492508,5492508,5492370,138,206,utRho15
1323,rpsT,42420,42420,42156,264,576,utRho15
1324,rpsU,12842584,12843124,12842584,540,1616,utRho15
1325,rraA,8238716,8238716,8238660,56,176,utRho15
1326,rraB,8956768,8956946,8956768,178,2,utRho15
1327,rrsA,8070478,8071062,8070478,584,6058,utRho15
1328,rrsB,16665468,16666636,16665468,1168,12692,utRho15
1329,rrsC,7883032,7883616,7883032,584,5200,utRho15
1330,rrsD,6858094,6858094,6857524,570,362,utRho15
1331,rrsE,8415726,8416294,8415726,568,610,utRho15
1332,rrsG,5462896,5462896,5462314,582,4716,utRho15
1333,rrsH,446970,447542,446970,572,1544,utRho15
1334,rsd,8393908,8393908,8393616,292,30,utRho15
1335,rseA,5419264,5419264,5418808,456,548,utRho15
1336,rseP,392940,393092,392940,152,0,utRho15
1337,rseX,4067298,4067298,4067298,0,0,utRho15
1338,rsfS,1338144,1338144,1338072,72,56,utRho15
1339,rsgA,8783132,8783132,8783018,114,132,utRho15
1340,rsmA,105176,105176,104860,316,1570,utRho15
1341,rsmB,6869982,6870414,6869982,432,376,utRho15
1342,rsmC,9215736,9215736,9215400,336,124,utRho15
1343,rsmD,7208594,7208786,7208594,192,82,utRho15
1344,rsmE,6182036,6182268,6182036,232,170,utRho15
1345,rsmG,7847512,7847512,7847360,152,218,utRho15
1346,rsmH,180020,180188,180020,168,140,utRho15
1347,rsmI,6587106,6587106,6586670,436,932,utRho15
1348,rssA,2578212,2578412,2578212,200,236,utRho15
1349,rssB,2580440,2580484,2580440,44,108,utRho15
1350,rstA,3364276,3364300,3364276,24,0,utRho15
1351,rsuA,4561096,4561096,4560966,130,108,utRho15
1352,rsxA,3411510,3411534,3411510,24,8,utRho15
1353,rtcA,7114004,7114004,7113698,306,24,utRho15
1354,rtcB,7116214,7116214,7116158,56,0,utRho15
1355,rtn,4541356,4541452,4541356,96,0,utRho15
1356,rutA,2148052,2148052,2148022,30,0,utRho15
1357,rutG,2140090,2140090,2139678,412,0,utRho15
1358,rutR,2148226,2148484,2148226,258,0,utRho15
1359,ruvA,7784096,7784096,7783904,192,0,utRho15
1360,ruvB,7782176,7782176,7781424,752,736,utRho15
1361,ruvC,3894878,3894878,3894752,126,34,utRho15
1362,rybB,1776114,1776114,1776114,0,0,utRho15
1363,rydB,3529860,3529860,3529322,538,74,utRho15
1364,rydC,2983012,2983012,2983012,0,0,utRho15
1365,ryfA,5307398,5307710,5307398,312,0,utRho15
1366,ryfD,5468590,5468590,5468590,0,0,utRho15
1367,ryhB,7162032,7162032,7162032,0,0,utRho15
1368,ryjA,8556132,8556132,8556132,0,0,utRho15
1369,ryjB,9055954,9055954,9055954,0,0,utRho15
1370,sad,3229598,3229598,3229406,192,4,utRho15
1371,safA,3168056,3168056,3167918,138,4,utRho15
1372,sanA,4465368,4465756,4465368,388,100,utRho15
1373,sapF,2705314,2705314,2705268,46,38,utRho15
1374,sbcB,4165456,4165512,4165456,56,0,utRho15
1375,sbcC,831694,831694,831506,188,102,utRho15
1376,sbcD,833954,833954,833904,50,42,utRho15
1377,sbmA,793106,793278,793106,172,8,utRho15
1378,sbmC,4162650,4162650,4162524,126,0,utRho15
1379,sdaA,3793618,3793864,3793618,246,86,utRho15
1380,sdaC,5856070,5856458,5856070,388,1494,utRho15
1381,sdhC,1509916,1510354,1509916,438,54518,utRho15
1382,sdhD,1510808,1511120,1510808,312,11658,utRho15
1383,sdiA,3993834,3993834,3993664,170,50,utRho15
1384,secE,8354354,8354716,8354354,362,68,utRho15
1385,secG,6645180,6645180,6645010,170,938,utRho15
1386,selA,7522594,7522594,7522498,96,316,utRho15
1387,selB,7519850,7519850,7519722,128,150,utRho15
1388,selC,7672396,7672444,7672396,48,4,utRho15
1389,selD,3696058,3696058,3696016,42,1366,utRho15
1390,seqA,1425884,1425974,1425884,90,520,utRho15
1391,serA,6117098,6117098,6116820,278,2,utRho15
1392,serB,9249712,9249790,9249712,78,24,utRho15
1393,serC,3830380,3830612,3830380,232,0,utRho15
1394,serS,1878730,1878856,1878730,126,622,utRho15
1395,serT,2063438,2063438,2063424,14,0,utRho15
1396,serU,4087124,4087124,4087114,10,382,utRho15
1397,serV,5637394,5637394,5637290,104,0,utRho15
1398,serW,1852014,1852014,1851942,72,32,utRho15
1399,serX,2195352,2195352,2195304,48,14,utRho15
1400,setB,4527426,4527726,4527426,300,0,utRho15
1401,setC,7673488,7673906,7673488,418,12,utRho15
1402,sfmA,1116124,1116424,1116124,300,0,utRho15
1403,sfmC,1117606,1117948,1117606,342,0,utRho15
1404,sfsA,323030,323030,322972,58,460,utRho15
1405,sfsB,6669592,6669818,6669592,226,46,utRho15
1406,sgrR,154676,154676,154598,78,2,utRho15
1407,sgrS,154734,154734,154734,0,0,utRho15
1408,shiA,4107068,4107286,4107068,218,0,utRho15
1409,sibA,4306622,4306622,4306622,0,0,utRho15
1410,sibB,4307292,4307292,4307292,0,0,utRho15
1411,sibC,6113702,6113702,6113702,0,0,utRho15
1412,sibD,6389730,6389730,6389730,0,0,utRho15
1413,sibE,6390480,6390480,6390480,0,0,utRho15
1414,sixA,4913998,4913998,4913624,374,28,utRho15
1415,slp,7307872,7307922,7307872,50,0,utRho15
1416,slt,9261400,9261466,9261400,66,4,utRho15
1417,slyA,3442028,3442028,3441648,380,8,utRho15
1418,slyB,3439496,3439752,3439496,256,0,utRho15
1419,slyD,6957398,6957398,6956994,404,556,utRho15
1420,slyX,6954862,6955280,6954862,418,5042,utRho15
1421,smf,6867372,6867372,6867120,252,6,utRho15
1422,smpB,5509534,5509792,5509534,258,548,utRho15
1423,smrA,2811872,2811958,2811872,86,74,utRho15
1424,smrB,4896872,4897212,4896872,340,28,utRho15
1425,smtA,1946808,1947074,1946808,266,44,utRho15
1426,sodA,8201518,8201620,8201518,102,8702,utRho15
1427,sodB,3470646,3470756,3470646,110,10,utRho15
1428,sodC,3449358,3449358,3449310,48,36,utRho15
1429,sohB,2658568,2658664,2658568,96,22,utRho15
1430,sokB,2984232,2984238,2984232,6,90,utRho15
1431,solA,2241218,2241218,2241172,46,0,utRho15
1432,soxR,8554894,8554938,8554894,44,0,utRho15
1433,soxS,8554846,8554846,8554766,80,0,utRho15
1434,speA,6172096,6172096,6171822,274,64,utRho15
1435,speB,6167892,6167892,6167594,298,108,utRho15
1436,speC,6218350,6218350,6218310,40,0,utRho15
1437,spf,8099798,8099798,8099798,0,0,utRho15
1438,sppA,3697422,3697674,3697422,252,12,utRho15
1439,spy,3651376,3651376,3651250,126,34,utRho15
1440,sra,3112092,3112092,3111926,166,0,utRho15
1441,sraB,2293178,2293178,2293178,0,0,utRho15
1442,sraC,3846132,3846132,3846132,0,0,utRho15
1443,srlA,5651582,5651664,5651582,82,0,utRho15
1444,srlR,5657720,5658094,5657720,374,2416,utRho15
1445,srmB,5425752,5425792,5425752,40,128,utRho15
1446,sroA,151216,151216,151216,0,0,utRho15
1447,sroG,6369436,6369436,6369436,0,0,utRho15
1448,sroH,8380974,8380974,8380974,0,0,utRho15
1449,ssb,8548022,8548250,8548022,228,54,utRho15
1450,sseA,5304782,5304988,5304782,206,13390,utRho15
1451,sspA,6755138,6755138,6754840,298,526,utRho15
1452,ssrA,5511014,5511186,5511014,172,70,utRho15
1453,ssrS,12223036,12223932,12223036,896,1460,utRho15
1454,sstT,6479726,6479888,6479726,162,16,utRho15
1455,ssuB,1988282,1988282,1988088,194,2,utRho15
1456,ssuE,1995126,1995126,1995024,102,0,utRho15
1457,sthA,8321604,8321604,8321580,24,2130,utRho15
1458,stpA,5597156,5597156,5596990,166,0,utRho15
1459,sucA,3034344,3034824,3034344,480,5828,utRho15
1460,sufA,3528836,3528836,3528772,64,20,utRho15
1461,sufE,3518962,3518962,3518580,382,120,utRho15
1462,sugE,8753588,8753750,8753588,162,52,utRho15
1463,sulA,2041894,2041894,2041838,56,40,utRho15
1464,syd,5850738,5850738,5850560,178,0,utRho15
1465,symE,9159834,9159834,9159680,154,14,utRho15
1466,symR,9159670,9159670,9159670,0,0,utRho15
1467,tabA,8949566,8949724,8949566,158,2,utRho15
1468,talA,5157140,5157332,5157140,192,0,utRho15
1469,talB,16382,16476,16382,94,8350,utRho15
1470,tam,3214442,3214692,3214442,250,120,utRho15
1471,tamA,8884540,8884764,8884540,224,74,utRho15
1472,tar,3945432,3945432,3945382,50,2,utRho15
1473,tas,5943138,5943194,5943138,56,114,utRho15
1474,tatA,16087636,16087780,16087636,144,40,utRho15
1475,tatE,1317742,1317894,1317742,152,0,utRho15
1476,tauA,770410,770464,770410,54,0,utRho15
1477,tdcA,6534186,6534186,6534130,56,0,utRho15
1478,tdcG,6519652,6519652,6519298,354,206,utRho15
1479,tdcR,6534380,6534760,6534380,380,0,utRho15
1480,tdk,2586986,2587054,2586986,68,24,utRho15
1481,tehA,3001072,3001146,3001072,74,0,utRho15
1482,tesA,1039898,1039898,1039530,368,130,utRho15
1483,tesB,950402,950402,950322,80,0,utRho15
1484,tfaE,2418532,2418532,2418238,294,12,utRho15
1485,tfaQ,3269912,3269912,3269770,142,2,utRho15
1486,tff,379424,379256,379424,168,30,utRho15
1487,tgt,852110,852274,852110,164,0,utRho15
1488,thiD,4369346,4369346,4369032,314,2,utRho15
1489,thiI,882936,883098,882936,162,270,utRho15
1490,thiM,4370902,4370902,4370602,300,44,utRho15
1491,thiQ,146170,146170,145854,316,192,utRho15
1492,thrL,592,760,592,168,80,utRho15
1493,thrS,7210932,7210932,7210280,652,288,utRho15
1494,thrU,8350762,8350776,8350762,14,16,utRho15
1495,thrV,6847414,6847414,6847310,104,92968,utRho15
1496,thrW,525682,525742,525682,60,36,utRho15
1497,thyA,5930696,5930696,5930310,386,1290,utRho15
1498,tig,909986,910266,909986,280,692,utRho15
1499,tisB,7706674,7707106,7706674,432,420,utRho15
1500,tktA,6163414,6163414,6163270,144,124,utRho15
1501,tktB,5158616,5159272,5158616,656,706,utRho15
1502,tldD,6784368,6784368,6784056,312,16,utRho15
1503,tmcA,5191876,5191876,5191718,158,0,utRho15
1504,tnaC,15553644,15553740,15553644,96,4800,utRho15
1505,tolB,1555074,1555480,1555074,406,226,utRho15
1506,tolC,6356008,6356230,6356008,222,444,utRho15
1507,tomB,961588,961588,961416,172,190,utRho15
1508,tonB,2622108,2622178,2622108,70,0,utRho15
1509,topA,2661578,2662096,2661578,518,198,utRho15
1510,torC,2116112,2116168,2116112,56,74,utRho15
1511,torR,2115968,2115968,2115908,60,90,utRho15
1512,torS,2112364,2112364,2112356,8,0,utRho15
1513,torT,2112414,2112522,2112414,108,0,utRho15
1514,tpiA,8223138,8223138,8223014,124,158,utRho15
1515,tppB,3425342,3425538,3425342,196,3094,utRho15
1516,tpr,2574376,2574376,2574376,0,0,utRho15
1517,tpx,2777688,2777688,2777622,66,118,utRho15
1518,tqsA,3347780,3347826,3347780,46,4,utRho15
1519,treA,2494850,2494850,2494752,98,8,utRho15
1520,treB,8932420,8932420,8932360,60,230,utRho15
1521,treF,7339102,7339184,7339102,82,4,utRho15
1522,treR,8934694,8934694,8934492,202,10,utRho15
1523,trg,2984878,2984940,2984878,62,0,utRho15
1524,trkG,2847342,2847564,2847342,222,2,utRho15
1525,trmA,8326590,8326590,8326540,50,22,utRho15
1526,trpA,2634678,2634678,2634444,234,378,utRho15
1527,trpC,2639888,2639888,2639570,318,116,utRho15
1528,trpL,5292432,5292432,5292328,104,0,utRho15
1529,trpR,9265408,9265520,9265408,112,108,utRho15
1530,trpS,7027394,7027394,7027276,118,1786,utRho15
1531,trpT,7893560,7893914,7893560,354,62544,utRho15
1532,trxA,7931294,7931522,7931294,228,358,utRho15
1533,trxB,1864156,1864156,1864100,56,28,utRho15
1534,trxC,5437350,5437470,5437350,120,52,utRho15
1535,tsaD,6421256,6421256,6421086,170,10,utRho15
1536,tsgA,6985038,6985136,6985038,98,0,utRho15
1537,tsr,9182824,9183314,9182824,490,52,utRho15
1538,tsx,864490,864490,864026,464,852,utRho15
1539,ttcA,2823970,2823970,2823896,74,1176,utRho15
1540,ttdA,6412848,6412926,6412848,78,0,utRho15
1541,ttdR,6412760,6412760,6412512,248,2,utRho15
1542,tufA,6943448,6943448,6942658,790,138074,utRho15
1543,tus,3368346,3368518,3368346,172,2,utRho15
1544,tusA,7218040,7218040,7217992,48,58,utRho15
1545,tusB,6950218,6950218,6949930,288,444,utRho15
1546,tynA,2902996,2902996,2902698,298,0,utRho15
1547,typA,8116460,8116814,8116460,354,2040,utRho15
1548,tyrB,8534164,8534228,8534164,64,2082,utRho15
1549,tyrP,3979004,3979362,3979004,358,10,utRho15
1550,tyrR,2773384,2773440,2773384,56,36,utRho15
1551,tyrS,3434566,3434566,3434444,122,0,utRho15
1552,tyrT,2575330,2575330,2575244,86,62,utRho15
1553,uacT,6062378,6062734,6062378,356,30,utRho15
1554,ubiC,8504886,8505012,8504886,126,2,utRho15
1555,ubiD,8049618,8049976,8049618,358,758,utRho15
1556,ubiE,8037494,8037710,8037494,216,128,utRho15
1557,ubiG,4679078,4679134,4679078,56,0,utRho15
1558,ucpA,5089342,5089342,5089246,96,66,utRho15
1559,udp,8032782,8032862,8032782,80,0,utRho15
1560,ugd,4199470,4199470,4199226,244,0,utRho15
1561,ugpB,7184852,7184852,7184650,202,262,utRho15
1562,ugpQ,7176600,7176600,7176226,374,52,utRho15
1563,uhpT,7694396,7694396,7694334,62,6,utRho15
1564,uidA,3392304,3392304,3392142,162,0,utRho15
1565,uidC,3386012,3386012,3385702,310,0,utRho15
1566,uidR,3394150,3394150,3394104,46,80,utRho15
1567,ulaA,8839854,8839960,8839854,106,26,utRho15
1568,ulaG,8839350,8839350,8839250,100,0,utRho15
1569,ulaR,8837124,8837124,8836906,218,4,utRho15
1570,umpG,5741372,5741372,5740548,824,100,utRho15
1571,umpH,1400704,1400704,1400652,52,82,utRho15
1572,umuD,2461476,2461534,2461476,58,0,utRho15
1573,ung,5433476,5433508,5433476,32,2,utRho15
1574,uof,2843316,2843316,2842900,416,3152,utRho15
1575,upp,5241818,5241818,5241744,74,308,utRho15
1576,usg,4873780,4873780,4873298,482,120,utRho15
1577,ushA,1009772,1009828,1009772,56,0,utRho15
1578,uspA,7279966,7280222,7279966,256,526,utRho15
1579,uspB,7279696,7279696,7279440,256,58,utRho15
1580,uspC,3959172,3959506,3959172,334,0,utRho15
1581,uspE,2797318,2797318,2797244,74,8,utRho15
1582,uspF,2871282,2871282,2871238,44,0,utRho15
1583,uspG,1283806,1283806,1283734,72,76,utRho15
1584,uvrA,8547872,8547872,8547742,130,42,utRho15
1585,uvrB,1626304,1627052,1626304,748,838,utRho15
1586,uvrC,3989758,3989758,3989412,346,94,utRho15
1587,uvrD,7995814,7995966,7995814,152,122,utRho15
1588,uvrY,3990812,3990812,3990718,94,2,utRho15
1589,uxaB,3221474,3221474,3221360,114,0,utRho15
1590,uxaC,6489714,6489714,6489482,232,38,utRho15
1591,uxuA,9103036,9103272,9103036,236,646,utRho15
1592,uxuR,9108916,9109152,9108916,236,18,utRho15
1593,valS,8967854,8967854,8967674,180,296,utRho15
1594,valU,5041848,5041862,5041848,14,20,utRho15
1595,valV,3492830,3492870,3492830,40,24,utRho15
1596,ves,3649968,3649968,3649874,94,14,utRho15
1597,waaA,7616512,7617080,7616512,568,166,utRho15
1598,waaH,7580298,7580298,7580162,136,6,utRho15
1599,waaQ,7616476,7616476,7616196,280,58,utRho15
1600,waaU,7598996,7598996,7598624,372,80,utRho15
1601,waaY,7602272,7602272,7601930,342,2340,utRho15
1602,wbbH,4214888,4214888,4214452,436,978,utRho15
1603,wbbK,4209212,4209212,4209018,194,132,utRho15
1604,wcaM,4231868,4231868,4231792,76,0,utRho15
1605,wrbA,2135516,2135516,2135416,100,2,utRho15
1606,wza,4275166,4275166,4274486,680,4,utRho15
1607,wzxC,4240674,4240674,4240316,358,0,utRho15
1608,wzzB,4196950,4196950,4196602,348,26,utRho15
1609,xanP,7657642,7657890,7657642,248,0,utRho15
1610,xanQ,6048520,6048702,6048520,182,0,utRho15
1611,xapA,5049820,5049820,5049756,64,0,utRho15
1612,xapR,10090252,10090252,10089908,344,0,utRho15
1613,xdhA,6000514,6000690,6000514,176,38,utRho15
1614,xerD,6079702,6079702,6079486,216,0,utRho15
1615,xseA,5268394,5268464,5268394,70,46,utRho15
1616,xseB,882746,882746,882686,60,330,utRho15
1617,xthA,3664798,3664856,3664798,58,0,utRho15
1618,xylA,7461614,7461614,7461530,84,632,utRho15
1619,xylE,8484540,8484540,8484508,32,0,utRho15
1620,xylF,7462138,7462262,7462138,124,4,utRho15
1621,xylR,7469812,7469958,7469812,146,44,utRho15
1622,yaaA,13230,13230,12918,312,22,utRho15
1623,yaaI,23876,23876,23572,304,6,utRho15
1624,yaaJ,16034,16034,15918,116,0,utRho15
1625,yaaU,91184,91614,91184,430,50,utRho15
1626,yaaW,23084,23084,22712,372,4,utRho15
1627,yaaX,10060,10468,10060,408,34,utRho15
1628,yabI,142542,142702,142542,160,0,utRho15
1629,yacC,273880,273880,273834,46,390,utRho15
1630,yacH,262932,262932,262520,412,12,utRho15
1631,yacL,268678,268776,268678,98,0,utRho15
1632,yadD,293796,293936,293796,140,0,utRho15
1633,yadE,289930,290162,289930,232,6,utRho15
1634,yadN,314110,314110,313766,344,0,utRho15
1635,yadS,355572,355572,355248,324,76,utRho15
1636,yadV,312470,312470,312402,68,48,utRho15
1637,yaeF,434270,434270,434006,264,0,utRho15
1638,yaeP,428374,428374,428250,124,8,utRho15
1639,yaeQ,428176,428582,428176,406,12,utRho15
1640,yaeR,423716,423754,423716,38,24,utRho15
1641,yafC,462166,462166,461762,404,114,utRho15
1642,yafD,462128,462244,462128,116,120,utRho15
1643,yafK,491986,491986,491610,376,326,utRho15
1644,yafL,493282,493424,493282,142,10,utRho15
1645,yafN,503938,504010,503938,72,4,utRho15
1646,yafS,469568,469632,469568,64,476,utRho15
1647,yafT,474470,474670,474470,200,0,utRho15
1648,yafV,480432,480432,480378,54,2,utRho15
1649,yafZ,536052,536052,536010,42,2,utRho15
1650,yagE,564446,564556,564446,110,12,utRho15
1651,yagG,570414,570790,570414,376,4,utRho15
1652,yagI,578384,578384,578324,60,2,utRho15
1653,yagK,586236,586236,585896,340,48,utRho15
1654,yagL,588062,588062,587836,226,6,utRho15
1655,yagN,591342,591342,591158,184,292,utRho15
1656,yahA,663746,664742,663746,996,12,utRho15
1657,yahC,670136,670136,670044,92,8,utRho15
1658,yahE,671478,671850,671478,372,0,utRho15
1659,yahM,690504,690808,690504,304,0,utRho15
1660,yahN,692872,692872,692674,198,6,utRho15
1661,yahO,692864,692968,692864,104,0,utRho15
1662,yaiE,816296,816354,816296,58,14,utRho15
1663,yaiI,811396,811528,811396,132,0,utRho15
1664,yaiO,761946,761946,761684,262,6,utRho15
1665,yaiP,767970,767970,767870,100,8,utRho15
1666,yaiS,769660,769660,769232,428,0,utRho15
1667,yaiV,788922,788922,788922,0,0,utRho15
1668,yaiY,799094,799094,798666,428,0,utRho15
1669,yaiZ,798888,799186,798888,298,0,utRho15
1670,yajC,854410,854574,854410,164,426,utRho15
1671,yajD,860938,861210,860938,272,198,utRho15
1672,yajI,866068,866068,865702,366,208,utRho15
1673,yajL,887496,887496,887282,214,508,utRho15
1674,yajQ,889316,889366,889316,50,0,utRho15
1675,yajR,893374,893374,893332,42,110,utRho15
1676,ybaB,987418,988152,987418,734,2226,utRho15
1677,ybaL,1006590,1006590,1006476,114,4,utRho15
1678,ybaM,980648,980648,980542,106,48,utRho15
1679,ybaN,981436,981764,981436,328,332,utRho15
1680,ybaO,936704,936766,936704,62,0,utRho15
1681,ybaP,1016568,1016568,1016160,408,352,utRho15
1682,ybaQ,1016348,1016436,1016348,88,0,utRho15
1683,ybaS,1023146,1023282,1023146,136,58,utRho15
1684,ybaV,927504,927874,927504,370,204,utRho15
1685,ybaY,950490,950758,950490,268,52,utRho15
1686,ybbB,1062724,1062724,1062452,272,28,utRho15
1687,ybbJ,1030154,1030154,1029718,436,148,utRho15
1688,ybbL,1031784,1031838,1031784,54,0,utRho15
1689,ybbN,1037136,1037136,1036558,578,1588,utRho15
1690,ybbO,1038658,1038658,1038298,360,438,utRho15
1691,ybbY,1080718,1081130,1080718,412,8,utRho15
1692,ybcH,1176140,1176140,1175962,178,4,utRho15
1693,ybcI,1113264,1113264,1113106,158,134,utRho15
1694,ybcJ,1114050,1114050,1113746,304,262,utRho15
1695,ybcK,1137502,1137804,1137502,302,4,utRho15
1696,ybcL,1141690,1141786,1141690,96,0,utRho15
1697,ybcN,1144628,1144932,1144628,304,0,utRho15
1698,ybcQ,1147548,1147912,1147548,364,2,utRho15
1699,ybcW,1159610,1159760,1159610,150,0,utRho15
1700,ybdD,1263982,1264364,1263982,382,28,utRho15
1701,ybdF,1212106,1212106,1211772,334,104,utRho15
1702,ybdH,1267048,1267048,1266954,94,0,utRho15
1703,ybdJ,1212822,1212822,1212398,424,46,utRho15
1704,ybdK,1215122,1215122,1214766,356,24,utRho15
1705,ybdL,1267114,1267172,1267114,58,30,utRho15
1706,ybdM,1271110,1271110,1270752,358,8,utRho15
1707,ybdN,1273372,1273372,1273138,234,4,utRho15
1708,ybdR,1283844,1284176,1283844,332,96,utRho15
1709,ybeD,1325412,1325412,1325284,128,292,utRho15
1710,ybeF,1323090,1323090,1322756,334,10,utRho15
1711,ybeL,1349986,1350036,1349986,50,112,utRho15
1712,ybeQ,1353412,1353412,1353094,318,0,utRho15
1713,ybeR,1353120,1353422,1353120,302,0,utRho15
1714,ybeT,1358832,1358832,1358812,20,0,utRho15
1715,ybeU,1358924,1359016,1358924,92,0,utRho15
1716,ybeZ,1386938,1386938,1386834,104,690,utRho15
1717,ybfA,1458074,1458268,1458074,194,6,utRho15
1718,ybfE,1423878,1423878,1423796,82,34,utRho15
1719,ybfF,1425692,1425692,1425604,88,72,utRho15
1720,ybfH,1433282,1433282,1433194,88,0,utRho15
1721,ybgA,1477840,1478002,1477840,162,0,utRho15
1722,ybgC,1549288,1549504,1549288,216,0,utRho15
1723,ybgD,1505916,1505916,1505590,326,108,utRho15
1724,ybgI,1485238,1485654,1485238,416,0,utRho15
1725,ybgO,1498370,1498370,1497964,406,8,utRho15
1726,ybgS,1570992,1570992,1570634,358,2,utRho15
1727,ybhA,1597184,1597184,1596862,322,0,utRho15
1728,ybhB,1616070,1616070,1615818,252,140,utRho15
1729,ybhC,1614642,1614642,1614562,80,1462,utRho15
1730,ybhD,1601418,1601418,1601276,142,0,utRho15
1731,ybhH,1601104,1601518,1601104,414,0,utRho15
1732,ybhK,1633384,1633384,1633294,90,4,utRho15
1733,ybhM,1641556,1641586,1641556,30,2,utRho15
1734,ybhN,1645296,1645296,1644996,300,6,utRho15
1735,ybhQ,1649202,1649260,1649202,58,8,utRho15
1736,ybiA,1665920,1665920,1665900,20,0,utRho15
1737,ybiI,1676968,1676968,1676912,56,60,utRho15
1738,ybiO,1691328,1691328,1690960,368,396,utRho15
1739,ybiP,1705252,1705252,1705194,58,14,utRho15
1740,ybiS,1711572,1711572,1711488,84,220,utRho15
1741,ybiT,1711894,1711926,1711894,32,0,utRho15
1742,ybiU,1718212,1718212,1718122,90,2,utRho15
1743,ybiV,1720176,1720176,1720056,120,0,utRho15
1744,ybiW,1725566,1725566,1725212,354,130,utRho15
1745,ybiX,1678548,1678548,1678414,134,120,utRho15
1746,ybjC,1781784,1781826,1781784,42,0,utRho15
1747,ybjE,1830154,1830154,1829714,440,54,utRho15
1748,ybjG,1767016,1767016,1766776,240,710,utRho15
1749,ybjL,1779882,1779882,1779638,244,6,utRho15
1750,ybjM,1779770,1780178,1779770,408,38,utRho15
1751,ybjO,1795704,1795978,1795704,274,4,utRho15
1752,ybjP,1809046,1809046,1808934,112,0,utRho15
1753,ybjQ,1809034,1809186,1809034,152,0,utRho15
1754,ybjS,1813796,1813796,1813506,290,74,utRho15
1755,ybjX,1838206,1838206,1838168,38,0,utRho15
1756,ycaD,1891438,1891742,1891438,304,0,utRho15
1757,ycaI,1928210,1928640,1928210,430,18,utRho15
1758,ycaK,1899094,1899336,1899094,242,0,utRho15
1759,ycaL,1920264,1920528,1920264,264,0,utRho15
1760,ycaM,1894240,1894458,1894240,218,0,utRho15
1761,ycaR,1941284,1941346,1941284,62,394,utRho15
1762,ycbB,1961862,1962094,1961862,232,0,utRho15
1763,ycbJ,1943344,1943504,1943344,160,0,utRho15
1764,ycbK,1966046,1966150,1966046,104,762,utRho15
1765,ycbZ,2036920,2036920,2036598,322,2,utRho15
1766,yccA,2062886,2062886,2062836,50,2,utRho15
1767,yccF,2048730,2048730,2048696,34,0,utRho15
1768,yccS,2047988,2047988,2047766,222,2,utRho15
1769,yccT,2055674,2055674,2055546,128,0,utRho15
1770,yccX,2059960,2060128,2059960,168,30,utRho15
1771,ycdT,2185682,2185752,2185682,70,0,utRho15
1772,ycdU,2191266,2191686,2191266,420,4,utRho15
1773,ycdZ,2200504,2200592,2200504,88,88,utRho15
1774,yceA,2233544,2233614,2233544,70,10,utRho15
1775,yceD,2293298,2293588,2293298,290,3396,utRho15
1776,yceF,2293522,2293522,2293190,332,2296,utRho15
1777,yceH,2252154,2252314,2252154,160,2174,utRho15
1778,yceI,2237282,2237282,2236952,330,364,utRho15
1779,yceJ,2238142,2238142,2238092,50,4,utRho15
1780,yceM,2253208,2253612,2253208,404,208,utRho15
1781,yceO,2239264,2239264,2238894,370,368,utRho15
1782,yceQ,2288760,2289004,2288760,244,4182,utRho15
1783,ycfD,2376540,2376540,2376480,60,58,utRho15
1784,ycfJ,2334814,2335198,2334814,384,4,utRho15
1785,ycfS,2340834,2340834,2340748,86,0,utRho15
1786,ycfT,2350658,2350658,2350330,328,0,utRho15
1787,ycfZ,2362760,2362760,2362534,226,86,utRho15
1788,ycgB,2474570,2474570,2474482,88,2,utRho15
1789,ycgG,2434614,2434656,2434614,42,4,utRho15
1790,ycgJ,2452956,2453200,2452956,244,12,utRho15
1791,ycgL,2455218,2455362,2455218,144,2,utRho15
1792,ycgN,2457366,2457660,2457366,294,46,utRho15
1793,ycgR,2489112,2489112,2489054,58,0,utRho15
1794,ycgV,2512222,2512222,2511904,318,0,utRho15
1795,ycgX,2426568,2426568,2426214,354,552,utRho15
1796,ycgY,2490166,2490320,2490166,154,4,utRho15
1797,ycgZ,2431504,2431578,2431504,74,0,utRho15
1798,ychE,2596904,2597196,2596904,292,0,utRho15
1799,ychF,2515764,2515764,2515624,140,8,utRho15
1800,ychH,2517476,2517582,2517476,106,58,utRho15
1801,ychJ,2578354,2578354,2578264,90,2,utRho15
1802,ychN,2547310,2547310,2547198,112,46,utRho15
1803,ychO,2547520,2547850,2547520,330,20,utRho15
1804,ychQ,2533798,2533848,2533798,50,0,utRho15
1805,yciA,2624828,2624828,2624492,336,30,utRho15
1806,yciB,2626110,2626110,2625780,330,1098,utRho15
1807,yciC,2627396,2627396,2627326,70,12,utRho15
1808,yciE,2630794,2630794,2630448,346,4,utRho15
1809,yciG,5264368,5264368,5264140,228,0,utRho15
1810,yciI,2621784,2621784,2621730,54,12,utRho15
1811,yciN,2661606,2661606,2661336,270,18,utRho15
1812,yciS,2680270,2680486,2680270,216,0,utRho15
1813,yciT,2689088,2689088,2688692,396,246,utRho15
1814,yciU,2614718,2614718,2614300,418,242,utRho15
1815,yciV,2646376,2646440,2646376,64,0,utRho15
1816,yciW,2700472,2700472,2700214,258,24,utRho15
1817,yciZ,2689276,2689276,2689218,58,106,utRho15
1818,ycjD,2703792,2703792,2703520,272,22,utRho15
1819,ycjG,2777748,2777860,2777748,112,58,utRho15
1820,ycjM,2740006,2740432,2740006,426,52,utRho15
1821,ycjW,2767982,2767982,2767922,60,0,utRho15
1822,ycjX,2768138,2768234,2768138,96,0,utRho15
1823,ycjY,5568288,5568288,5567460,828,0,utRho15
1824,ydaE,2836438,2836438,2836016,422,0,utRho15
1825,ydaN,2816048,2816100,2816048,52,0,utRho15
1826,ydaS,2840340,2840730,2840340,390,60,utRho15
1827,ydbC,2948376,2948442,2948376,66,0,utRho15
1828,ydbD,2950132,2950288,2950132,156,40,utRho15
1829,ydbH,2885800,2886102,2885800,302,0,utRho15
1830,ydbJ,2881712,2882116,2881712,404,0,utRho15
1831,ydbK,2881692,2881692,2881568,124,26,utRho15
1832,ydcA,2983294,2983354,2983294,60,2,utRho15
1833,ydcF,2974404,2974470,2974404,66,8,utRho15
1834,ydcI,2990268,2990268,2990142,126,0,utRho15
1835,ydcJ,2990266,2990576,2990266,310,0,utRho15
1836,ydcK,3001280,3001280,3000898,382,0,utRho15
1837,ydcL,3004646,3004914,3004646,268,0,utRho15
1838,ydcN,3012308,3012344,3012308,36,4,utRho15
1839,ydcP,3013508,3013562,3013508,54,0,utRho15
1840,ydcR,3019956,3020006,3019956,50,2,utRho15
1841,ydcS,3022906,3023308,3022906,402,2,utRho15
1842,ydcX,3034442,3034778,3034442,336,2,utRho15
1843,ydcY,3035220,3035296,3035220,76,24,utRho15
1844,ydcZ,3036750,3036750,3036662,88,36,utRho15
1845,yddB,3155332,3155332,3155238,94,2,utRho15
1846,yddE,3071738,3071738,3071716,22,0,utRho15
1847,yddG,3094410,3094410,3094338,72,0,utRho15
1848,yddJ,3089732,3089732,3089438,294,6,utRho15
1849,yddW,3137704,3137704,3137646,58,12,utRho15
1850,ydeA,3233910,3234056,3233910,146,36,utRho15
1851,ydeE,3242528,3242664,3242528,136,4,utRho15
1852,ydeI,3249118,3249118,3248994,124,2,utRho15
1853,ydeJ,3249376,3249546,3249376,170,2,utRho15
1854,ydeN,3165458,3165458,3165048,410,2,utRho15
1855,ydeP,3173328,3173328,3172972,356,0,utRho15
1856,ydeR,3176596,3176596,3176592,4,0,utRho15
1857,ydfA,3296872,3297016,3296872,144,0,utRho15
1858,ydfG,3254982,3255034,3254982,52,0,utRho15
1859,ydfH,3256652,3256704,3256652,52,46,utRho15
1860,ydfK,3265446,3266144,3265446,698,160,utRho15
1861,ydgA,3379588,3379704,3379588,116,80,utRho15
1862,ydgC,3364124,3364124,3364060,64,2,utRho15
1863,ydgD,3343906,3343920,3343906,14,46,utRho15
1864,ydgH,3356754,3356854,3356754,100,50,utRho15
1865,ydgJ,3408798,3408798,3408616,182,0,utRho15
1866,ydgK,3410414,3410500,3410414,86,32,utRho15
1867,ydhB,3479618,3479618,3479596,22,2,utRho15
1868,ydhC,3479698,3479822,3479698,124,0,utRho15
1869,ydhF,3451310,3451310,3451264,46,0,utRho15
1870,ydhI,3441996,3442050,3441996,54,0,utRho15
1871,ydhL,3451864,3451864,3451840,24,2,utRho15
1872,ydhQ,3492404,3492404,3492254,150,2,utRho15
1873,ydhS,3494136,3494262,3494136,126,32,utRho15
1874,ydhT,3499138,3499138,3499118,20,0,utRho15
1875,ydhY,3509284,3509284,3508954,330,6,utRho15
1876,ydhZ,3510418,3510418,3510282,136,2,utRho15
1877,ydiE,3579206,3579226,3579206,20,0,utRho15
1878,ydiH,3530582,3530582,3530406,176,0,utRho15
1879,ydiM,3541852,3542142,3541852,290,4,utRho15
1880,ydiN,3544818,3545024,3544818,206,0,utRho15
1881,ydiP,3558656,3558656,3558602,54,0,utRho15
1882,ydiU,3582508,3582508,3582488,20,6,utRho15
1883,ydiV,3584174,3584174,3584040,134,14,utRho15
1884,ydiY,3612500,3612500,3612166,334,2,utRho15
1885,ydjA,3697400,3697400,3697352,48,58,utRho15
1886,ydjE,3708082,3708082,3707958,124,0,utRho15
1887,ydjF,3709848,3709848,3709708,140,0,utRho15
1888,ydjM,3620340,3620422,3620340,82,0,utRho15
1889,ydjO,3626696,3626696,3626288,408,4,utRho15
1890,ydjX,3666434,3666802,3666434,368,536,utRho15
1891,yeaE,3731448,3731448,3731272,176,68,utRho15
1892,yeaG,3733530,3733816,3733530,286,0,utRho15
1893,yeaI,3740486,3740770,3740486,284,0,utRho15
1894,yeaJ,3743874,3744082,3743874,208,0,utRho15
1895,yeaL,3748646,3748704,3748646,58,160,utRho15
1896,yeaM,3751296,3751296,3751152,144,0,utRho15
1897,yeaN,3750926,3751346,3750926,420,4,utRho15
1898,yeaO,3753554,3753818,3753554,264,4,utRho15
1899,yeaP,3755314,3755430,3755314,116,192,utRho15
1900,yeaQ,3758780,3758780,3758510,270,12,utRho15
1901,yeaR,3759988,3759988,3759896,92,2,utRho15
1902,yeaY,3781122,3781122,3781064,58,90,utRho15
1903,yebB,3892220,3892502,3892220,282,4,utRho15
1904,yebC,3896370,3896370,3896302,68,8,utRho15
1905,yebE,3859464,3859464,3859414,50,24,utRho15
1906,yebG,3861530,3861530,3861494,36,0,utRho15
1907,yebK,3873180,3873304,3873180,124,28,utRho15
1908,yebQ,3820314,3820552,3820314,238,0,utRho15
1909,yebS,3832238,3832516,3832238,278,24,utRho15
1910,yebV,3843430,3843560,3843430,130,0,utRho15
1911,yebW,3843914,3844242,3843914,328,190,utRho15
1912,yecC,3995646,3995646,3995628,18,0,utRho15
1913,yecD,3901272,3901664,3901272,392,136,utRho15
1914,yecF,3991434,3991636,3991434,202,0,utRho15
1915,yecH,3979304,3979304,3978980,324,8,utRho15
1916,yecJ,3975604,3975604,3975516,88,0,utRho15
1917,yecM,3919968,3919968,3919692,276,20,utRho15
1918,yecR,3976400,3976444,3976400,44,0,utRho15
1919,yecT,3923862,3923944,3923862,82,2,utRho15
1920,yedD,4016522,4016522,4016180,342,46,utRho15
1921,yedE,4016310,4016554,4016310,244,54,utRho15
1922,yedI,4058922,4058922,4058732,190,4,utRho15
1923,yedJ,4066446,4066446,4066158,288,6,utRho15
1924,yedV,4076404,4076404,4076304,100,6,utRho15
1925,yedX,4077680,4077912,4077680,232,0,utRho15
1926,yedY,4078572,4078956,4078572,384,4,utRho15
1927,yeeA,4161322,4161322,4161182,140,0,utRho15
1928,yeeE,4171104,4171104,4171050,54,0,utRho15
1929,yeeJ,4089526,4089822,4089526,296,6,utRho15
1930,yeeN,4113508,4113716,4113508,208,82,utRho15
1931,yeeO,4119444,4119444,4119692,248,0,utRho15
1932,yeeX,4158834,4158834,4158722,112,114,utRho15
1933,yeeZ,4178422,4178422,4178256,166,0,utRho15
1934,yefM,4179466,4179466,4179426,40,30,utRho15
1935,yegD,4295288,4295348,4295288,60,56,utRho15
1936,yegH,4275726,4275804,4275726,78,20,utRho15
1937,yegI,4302154,4302154,4301970,184,0,utRho15
1938,yegJ,4302032,4302370,4302032,338,0,utRho15
1939,yegQ,4331182,4331336,4331182,154,12,utRho15
1940,yegR,4336698,4336698,4336612,86,4,utRho15
1941,yegS,4337086,4337424,4337086,338,2,utRho15
1942,yegT,4357562,4357642,4357562,80,8,utRho15
1943,yegX,4367640,4367640,4367302,338,22,utRho15
1944,yehA,4376944,4376944,4376828,116,0,utRho15
1945,yehE,4385818,4385818,4385592,226,2,utRho15
1946,yehK,4407568,4407944,4407568,376,0,utRho15
1947,yehL,4408804,4409192,4408804,388,0,utRho15
1948,yeiB,4486146,4486146,4485934,212,76,utRho15
1949,yeiE,4499422,4499422,4499236,186,0,utRho15
1950,yeiG,4487776,4487820,4487776,44,282,utRho15
1951,yeiH,4499332,4499434,4499332,102,0,utRho15
1952,yeiI,4503306,4503400,4503306,94,66,utRho15
1953,yeiL,4510580,4510710,4510580,130,0,utRho15
1954,yeiP,4530834,4530900,4530834,66,196,utRho15
1955,yeiQ,4532328,4532490,4532328,162,2,utRho15
1956,yeiR,4535484,4535658,4535484,174,80,utRho15
1957,yeiW,4530840,4530840,4530590,250,228,utRho15
1958,yejA,4544624,4544728,4544624,104,0,utRho15
1959,yejG,4556892,4556892,4556474,418,242,utRho15
1960,yejH,4561244,4561264,4561244,20,2,utRho15
1961,yejK,4568218,4568218,4567894,324,42,utRho15
1962,yejO,4578352,4578352,4577800,552,92,utRho15
1963,yfaD,4713380,4713808,4713380,428,336,utRho15
1964,yfaE,4696676,4697028,4696676,352,620,utRho15
1965,yfaL,4688568,4688568,4688338,230,0,utRho15
1966,yfaP,4656398,4656398,4656286,112,2,utRho15
1967,yfaU,4717892,4717892,4717690,202,2,utRho15
1968,yfaY,4727310,4727310,4727266,44,0,utRho15
1969,yfaZ,4728744,4728744,4728550,194,0,utRho15
1970,yfbK,4771810,4771810,4771444,366,0,utRho15
1971,yfbL,4771500,4771720,4771500,220,0,utRho15
1972,yfbN,4777174,4777174,4776852,322,32,utRho15
1973,yfbO,4776916,4777162,4776916,246,16,utRho15
1974,yfbP,4777990,4778232,4777990,242,118,utRho15
1975,yfbR,4817662,4817724,4817662,62,2,utRho15
1976,yfcI,4847424,4847424,4847078,346,54,utRho15
1977,yfcJ,4880482,4880482,4880240,242,98,utRho15
1978,yfcL,4888502,4888502,4888338,164,26,utRho15
1979,yfcV,4911642,4911642,4911292,350,2,utRho15
1980,yfcZ,4921958,4921958,4921868,90,36,utRho15
1981,yfdF,4925604,4926024,4925604,420,46,utRho15
1982,yfdG,4935474,4935710,4935474,236,0,utRho15
1983,yfdP,4946844,4947040,4946844,196,2,utRho15
1984,yfdX,4988866,4988866,4988804,62,0,utRho15
1985,yfdY,4990672,4990672,4990584,88,4,utRho15
1986,yfeA,5035784,5035784,5035664,120,2116,utRho15
1987,yfeC,5036668,5036934,5036668,266,146,utRho15
1988,yfeH,5053818,5053892,5053818,74,0,utRho15
1989,yfeK,5074630,5074684,5074630,54,0,utRho15
1990,yfeO,5018906,5019260,5018906,354,28,utRho15
1991,yfeR,5054078,5054078,5053712,366,0,utRho15
1992,yfeX,5101356,5101356,5101090,266,0,utRho15
1993,yfeY,5102486,5102486,5102432,54,0,utRho15
1994,yfeZ,5103842,5103842,5103452,390,10,utRho15
1995,yffO,5123804,5124222,5123804,418,0,utRho15
1996,yffQ,5126778,5127154,5126778,376,28,utRho15
1997,yffS,5128800,5128986,5128800,186,20,utRho15
1998,yfgC,5232052,5232188,5232052,136,4,utRho15
1999,yfgF,5258062,5258062,5257876,186,12,utRho15
2000,yfgG,5258170,5258580,5258170,410,128,utRho15
2001,yfgH,5259344,5259584,5259344,240,26,utRho15
2002,yfgM,5278866,5278866,5278566,300,406,utRho15
2003,yfhH,5397414,5397518,5397414,104,14,utRho15
2004,yfhM,5304648,5304648,5304574,74,6,utRho15
2005,yfhR,5328408,5328726,5328408,318,82,utRho15
2006,yfiC,5425610,5425610,5425528,82,0,utRho15
2007,yfiE,5430688,5430688,5430640,48,2,utRho15
2008,yfiL,5482630,5482720,5482630,90,0,utRho15
2009,yfiM,5448066,5448358,5448066,292,1298,utRho15
2010,yfiR,5483354,5483750,5483354,396,0,utRho15
2011,yfjH,5517326,5517326,5517200,126,0,utRho15
2012,yfjI,5517710,5517970,5517710,260,0,utRho15
2013,yfjJ,5521014,5521094,5521014,80,6,utRho15
2014,yfjM,5531970,5531970,5531552,418,214,utRho15
2015,yfjP,5535080,5535420,5535080,340,16,utRho15
2016,yfjW,5546570,5546636,5546570,66,0,utRho15
2017,yfjX,5551776,5551838,5551776,62,0,utRho15
2018,ygaC,5601180,5601180,5599988,1192,52,utRho15
2019,ygaM,5600242,5600292,5600242,50,2,utRho15
2020,ygaU,5593628,5593628,5593572,56,2,utRho15
2021,ygaZ,5619190,5619234,5619190,44,36,utRho15
2022,ygbA,5713656,5713656,5713612,44,2,utRho15
2023,ygbE,5746784,5746784,5746674,110,136,utRho15
2024,ygbI,5722882,5722882,5722528,354,0,utRho15
2025,ygbK,5724394,5724670,5724394,276,8,utRho15
2026,ygbL,5727074,5727186,5727074,112,0,utRho15
2027,ygbN,5729814,5730202,5729814,388,166,utRho15
2028,ygcG,5811210,5811422,5811210,212,6,utRho15
2029,ygcN,5785144,5785314,5785144,170,2,utRho15
2030,ygcU,5799214,5799214,5798836,378,6,utRho15
2031,ygcW,5800942,5800942,5800546,396,0,utRho15
2032,ygdD,5883442,5883442,5883262,180,90,utRho15
2033,ygdG,5861746,5861930,5861746,184,518,utRho15
2034,ygdI,5886526,5886526,5886290,236,2,utRho15
2035,ygdQ,5940784,5940840,5940784,56,4,utRho15
2036,ygdR,5942494,5942542,5942494,48,44,utRho15
2037,ygeA,5961606,5961606,5961270,336,24,utRho15
2038,ygeH,5983758,5984188,5983758,430,4,utRho15
2039,ygeI,5987162,5987276,5987162,114,40,utRho15
2040,ygeR,6000078,6000078,5999782,296,8,utRho15
2041,ygeV,6011694,6011694,6011572,122,0,utRho15
2042,ygeW,6012234,6012524,6012234,290,22,utRho15
2043,ygfB,6110946,6110946,6110888,58,64,utRho15
2044,ygfK,6031984,6032120,6031984,136,28,utRho15
2045,ygfS,6058328,6058328,6058024,304,0,utRho15
2046,ygfZ,6082564,6082626,6082564,62,48,utRho15
2047,yggC,6149512,6149512,6149378,134,152,utRho15
2048,yggE,6136370,6136370,6136160,210,80,utRho15
2049,yggI,6179176,6179510,6179176,334,90,utRho15
2050,yggL,6204508,6204508,6204266,242,48,utRho15
2051,yggM,6199514,6199514,6199130,384,18,utRho15
2052,yggN,6203596,6203596,6203246,350,2,utRho15
2053,yggX,18623958,18624558,18623958,600,1284,utRho15
2054,yghA,6298966,6299324,6298966,358,54,utRho15
2055,yghB,6307058,6307126,6307058,68,78,utRho15
2056,yghD,6222614,6222614,6222252,362,22,utRho15
2057,yghF,6225798,6225798,6225840,42,4,utRho15
2058,yghJ,6238640,6238640,6238224,416,4,utRho15
2059,yghQ,6265186,6265186,6264816,370,0,utRho15
2060,yghT,6267830,6268262,6267830,432,0,utRho15
2061,yghU,6277400,6277454,6277400,54,20,utRho15
2062,yghW,6293506,6293506,6293474,32,0,utRho15
2063,yghZ,6295562,6295794,6295562,232,4,utRho15
2064,ygiD,6365122,6365122,6364868,254,436,utRho15
2065,ygiH,6409066,6409388,6409066,322,40,utRho15
2066,ygiL,6370622,6370828,6370622,206,4,utRho15
2067,ygiM,6402084,6402414,6402084,330,310,utRho15
2068,ygiN,6346156,6346284,6346156,128,1692,utRho15
2069,ygiQ,6322620,6322620,6322292,328,194,utRho15
2070,ygiS,6335462,6335462,6335436,26,4,utRho15
2071,ygiV,6338582,6338582,6338462,120,16,utRho15
2072,ygiW,6339774,6339774,6339352,422,24,utRho15
2073,ygiZ,6344506,6344506,6344422,84,0,utRho15
2074,ygjH,6442528,6442528,6442494,34,2,utRho15
2075,ygjI,6452140,6452468,6452140,328,50,utRho15
2076,ygjQ,6472730,6473080,6472730,350,108,utRho15
2077,ygjR,6474564,6474586,6474564,22,0,utRho15
2078,ygjV,6483638,6483638,6483488,150,28,utRho15
2079,yhaB,6535632,6535708,6535632,76,0,utRho15
2080,yhaH,6504498,6504608,6504498,110,6,utRho15
2081,yhaI,6505400,6505822,6505400,422,26,utRho15
2082,yhaJ,6508560,6508560,6508428,132,80,utRho15
2083,yhaK,6508538,6508638,6508538,100,2,utRho15
2084,yhbQ,6599878,6599932,6599878,54,6,utRho15
2085,yhbT,6602736,6602736,6602552,184,2,utRho15
2086,yhbU,6602558,6602970,6602558,412,4,utRho15
2087,yhbX,6643302,6643302,6643226,76,2,utRho15
2088,yhbY,6655518,6655580,6655518,62,322,utRho15
2089,yhcA,6723956,6724224,6723956,268,12,utRho15
2090,yhcB,6760364,6760382,6760364,18,68,utRho15
2091,yhcC,6708470,6708470,6708100,370,8,utRho15
2092,yhcF,6733440,6733852,6733440,412,114,utRho15
2093,yhcH,6739124,6739124,6738956,168,262,utRho15
2094,yhcM,6760312,6760312,6759994,318,60,utRho15
2095,yhcN,6770812,6771076,6770812,264,28,utRho15
2096,yhcO,6772606,6772606,6772258,348,46,utRho15
2097,yhdH,6806560,6806968,6806560,408,194,utRho15
2098,yhdJ,6823234,6823306,6823234,72,0,utRho15
2099,yhdN,6879092,6879092,6879018,74,306,utRho15
2100,yhdT,6814702,6814750,6814702,48,124,utRho15
2101,yhdU,6824994,6825242,6824994,248,0,utRho15
2102,yhdV,6836392,6836780,6836392,388,64,utRho15
2103,yhdW,6837944,6838298,6837944,354,0,utRho15
2104,yheO,6953082,6953082,6952880,202,754,utRho15
2105,yheV,6957970,6957970,6957584,386,78,utRho15
2106,yhfA,6971902,6971902,6971636,266,26,utRho15
2107,yhfG,6983294,6983294,6983240,54,86,utRho15
2108,yhfL,6998622,6998896,6998622,274,38,utRho15
2109,yhfY,7023244,7023244,7022844,400,102,utRho15
2110,yhgA,7086294,7086334,7086294,40,0,utRho15
2111,yhgE,7065176,7065176,7064878,298,18,utRho15
2112,yhgF,7074352,7074770,7074352,418,1686,utRho15
2113,yhhA,7173458,7173886,7173458,428,4,utRho15
2114,yhhI,7248346,7248756,7248346,410,0,utRho15
2115,yhhJ,7253696,7253696,7253606,90,36,utRho15
2116,yhhM,7211588,7211588,7211220,368,60,utRho15
2117,yhhN,7211150,7211502,7211150,352,20,utRho15
2118,yhhQ,7218238,7218434,7218238,196,62,utRho15
2119,yhhT,7223682,7223730,7223682,48,12,utRho15
2120,yhhX,7162032,7162032,7161610,422,8,utRho15
2121,yhhY,7162222,7162276,7162222,54,0,utRho15
2122,yhhZ,7163516,7163726,7163516,210,2,utRho15
2123,yhiD,7312220,7312220,7311804,416,3818,utRho15
2124,yhiJ,7265190,7265190,7265180,10,0,utRho15
2125,yhiM,7269270,7269682,7269270,412,2,utRho15
2126,yhiN,7275000,7275000,7274820,180,60,utRho15
2127,yhjA,7338522,7338522,7338376,146,0,utRho15
2128,yhjB,7344090,7344090,7343788,302,4,utRho15
2129,yhjC,7344272,7344684,7344272,412,0,utRho15
2130,yhjD,7346660,7346724,7346660,64,38,utRho15
2131,yhjE,7349274,7349572,7349274,298,36,utRho15
2132,yhjG,7356824,7356824,7356730,94,0,utRho15
2133,yhjH,7358458,7358458,7358374,84,80,utRho15
2134,yhjJ,7364032,7364032,7363880,152,114,utRho15
2135,yhjK,7371296,7371296,7371158,138,0,utRho15
2136,yhjR,7392750,7392750,7392370,380,78,utRho15
2137,yhjV,7400796,7401126,7400796,330,78,utRho15
2138,yhjX,7424194,7424194,7424014,180,0,utRho15
2139,yhjY,7425966,7425966,7425868,98,22,utRho15
2140,yiaB,7455654,7455654,7455496,158,2,utRho15
2141,yiaD,7432712,7433094,7432712,382,40,utRho15
2142,yiaF,7438194,7438194,7438088,106,4,utRho15
2143,yiaG,7438862,7438956,7438862,94,38,utRho15
2144,yiaJ,7485236,7485236,7485064,172,20,utRho15
2145,yiaK,7485348,7485466,7485348,118,44,utRho15
2146,yiaT,7503924,7503924,7503736,188,0,utRho15
2147,yiaU,7503792,7503984,7503792,192,2,utRho15
2148,yiaY,7515856,7515856,7515654,202,6,utRho15
2149,yibF,7523950,7523950,7523910,40,0,utRho15
2150,yibG,7536128,7536354,7536128,226,4,utRho15
2151,yibL,7553194,7553330,7553194,136,102,utRho15
2152,yibN,7570112,7570112,7570030,82,272,utRho15
2153,yibT,7552848,7552848,7552760,88,38,utRho15
2154,yicC,7633290,7633352,7633290,62,30,utRho15
2155,yicH,7660862,7660914,7660862,52,0,utRho15
2156,yicJ,7673328,7673328,7671858,1470,468,utRho15
2157,yicN,7685018,7685018,7684804,214,10,utRho15
2158,yicO,7687914,7687914,7687578,336,4,utRho15
2159,yicR,15250308,15250308,15250236,72,0,utRho15
2160,yidB,7755230,7755230,7754930,300,0,utRho15
2161,yidE,7732780,7732780,7732546,234,44,utRho15
2162,yidF,7711580,7711580,7711222,358,42,utRho15
2163,yidQ,7735088,7735456,7735088,368,1164,utRho15
2164,yidR,7738824,7738824,7738618,206,2,utRho15
2165,yieE,7787658,7787738,7787658,80,2,utRho15
2166,yieH,7793314,7793548,7793314,234,4,utRho15
2167,yieK,7798928,7798928,7798786,142,2,utRho15
2168,yifB,7900350,7900350,7899998,352,54,utRho15
2169,yifL,7988984,7989044,7988984,60,54,utRho15
2170,yigF,8005750,8005750,8005598,152,116,utRho15
2171,yigI,8009448,8009448,8009394,54,54,utRho15
2172,yigM,8022100,8022152,8022100,52,0,utRho15
2173,yihA,8101970,8101970,8101458,512,56,utRho15
2174,yihD,8084098,8084138,8084098,40,0,utRho15
2175,yihF,8088110,8088398,8088110,288,2,utRho15
2176,yihG,8093304,8093304,8093204,100,2,utRho15
2177,yihI,8102616,8102694,8102616,78,18,utRho15
2178,yihL,8120506,8120894,8120506,388,0,utRho15
2179,yihN,8124332,8124494,8124332,162,4,utRho15
2180,yihO,8131942,8131942,8131532,410,0,utRho15
2181,yihQ,8138892,8138892,8138552,340,4,utRho15
2182,yihV,8147064,8147478,8147064,414,2,utRho15
2183,yihX,8151096,8151106,8151096,10,66,utRho15
2184,yiiE,8158192,8158582,8158192,390,2,utRho15
2185,yiiF,8159124,8159502,8159124,378,0,utRho15
2186,yiiG,8173762,8174004,8173762,242,0,utRho15
2187,yiiM,8205506,8205644,8205506,138,16,utRho15
2188,yiiQ,8224624,8224624,8224428,196,126,utRho15
2189,yiiS,8225738,8225934,8225738,196,2,utRho15
2190,yijE,8272178,8272216,8272178,38,62,utRho15
2191,yijF,8275728,8275728,8275314,414,68,utRho15
2192,yijO,8296858,8296858,8296634,224,56,utRho15
2193,yjaA,8426240,8426468,8426240,228,59272,utRho15
2194,yjaB,8428312,8428312,8428246,66,8,utRho15
2195,yjaG,8398746,8399008,8398746,262,624,utRho15
2196,yjaH,8401022,8401132,8401022,110,358,utRho15
2197,yjaZ,8379506,8379572,8379506,66,0,utRho15
2198,yjbB,8455204,8455462,8455204,258,56,utRho15
2199,yjbE,16943432,16943624,16943432,192,0,utRho15
2200,yjbL,8520318,8520642,8520318,324,0,utRho15
2201,yjbQ,8540428,8540476,8540428,48,36,utRho15
2202,yjcB,8550328,8550328,8550082,246,170,utRho15
2203,yjcC,8550836,8550942,8550836,106,4,utRho15
2204,yjcD,8556628,8556958,8556628,330,8,utRho15
2205,yjcE,8559658,8559960,8559658,302,2,utRho15
2206,yjcF,8566212,8566212,8566150,62,0,utRho15
2207,yjcO,8594660,8594660,8594250,410,126,utRho15
2208,yjdA,8654128,8654270,8654128,142,0,utRho15
2209,yjdC,8726660,8726660,8726616,44,30,utRho15
2210,yjdK,8704780,8705168,8704780,388,22,utRho15
2211,yjdL,8713034,8713034,8712822,212,0,utRho15
2212,yjdM,8653672,8653672,8653468,204,202,utRho15
2213,yjeF,8787354,8788132,8787354,778,2718,utRho15
2214,yjeI,8745522,8745618,8745522,96,0,utRho15
2215,yjeJ,8748806,8748806,8748468,338,30,utRho15
2216,yjeV,8785472,8785784,8785472,312,40,utRho15
2217,yjfP,8833512,8833904,8833512,392,2,utRho15
2218,yjfY,8849656,8849656,8849582,74,2,utRho15
2219,yjfZ,8855052,8855052,8854844,208,0,utRho15
2220,yjgA,8916162,8916162,8915730,432,64,utRho15
2221,yjgL,8950802,8950874,8950802,72,0,utRho15
2222,yjgM,8959342,8959342,8959074,268,0,utRho15
2223,yjgN,8959132,8959460,8959132,328,0,utRho15
2224,yjgR,8980170,8980170,8980126,44,42,utRho15
2225,yjgZ,9002116,9002520,9002116,404,190,utRho15
2226,yjhB,9007764,9008116,9007764,352,328,utRho15
2227,yjhG,9048452,9048452,9048188,264,438,utRho15
2228,yjhU,9041080,9041080,9040648,432,136,utRho15
2229,yjiA,9178096,9178096,9177730,366,5000,utRho15
2230,yjiJ,9125364,9125364,9125350,14,2,utRho15
2231,yjiK,9127270,9127270,9127422,152,8,utRho15
2232,yjiL,9129604,9129604,9129378,226,16,utRho15
2233,yjiS,9143410,9143502,9143410,92,0,utRho15
2234,yjiY,9182734,9182734,9182558,176,3968,utRho15
2235,yjjA,9200674,9200674,9200378,296,36,utRho15
2236,yjjB,18408708,18408708,18407800,908,108,utRho15
2237,yjjJ,9243314,9243538,9243314,224,10,utRho15
2238,yjjK,9261132,9261132,9261044,88,6,utRho15
2239,yjjL,9189764,9189764,9189444,320,50,utRho15
2240,yjjM,9191894,9191894,9191702,192,4,utRho15
2241,yjjP,9206068,9206068,9205716,352,92,utRho15
2242,yjjQ,9206638,9206954,9206638,316,46,utRho15
2243,yjjX,9267798,9267798,9267490,308,702,utRho15
2244,yjjY,9280716,9280804,9280716,88,590,utRho15
2245,yjjZ,9211554,9211608,9211554,54,270,utRho15
2246,yjtD,9281676,9281884,9281676,208,8,utRho15
2247,ykfB,532454,532454,532174,280,402,utRho15
2248,ykfI,527636,527636,527338,298,18,utRho15
2249,ykgB,637050,637050,636638,412,0,utRho15
2250,ykgC,640430,640430,640002,428,2,utRho15
2251,ykgD,640232,640454,640232,222,2,utRho15
2252,ykgE,642962,643216,642962,254,48,utRho15
2253,ykgJ,608524,608524,608364,160,128,utRho15
2254,ykgL,623878,624224,623878,346,4,utRho15
2255,ykgM,625610,625610,625554,56,0,utRho15
2256,ykgR,626570,626570,626484,86,0,utRho15
2257,ylaC,958576,958576,958502,74,380,utRho15
2258,yliE,1745938,1745958,1745938,20,0,utRho15
2259,ymcE,2103660,2103694,2103660,34,0,utRho15
2260,ymdA,2210450,2210828,2210450,378,104,utRho15
2261,ymdB,2211428,2211640,2211428,212,2,utRho15
2262,ymfD,2395322,2395322,2395064,258,296,utRho15
2263,ymfI,2402880,2402994,2402880,114,2,utRho15
2264,ymfJ,2404518,2404518,2404168,350,184,utRho15
2265,ymfK,2406176,2406176,2405866,310,0,utRho15
2266,ymfT,2405766,2406048,2405766,282,92,utRho15
2267,ymgE,2489110,2489456,2489110,346,4,utRho15
2268,ymgF,2437628,2437966,2437628,338,0,utRho15
2269,ymiA,2670112,2670320,2670112,208,58,utRho15
2270,ymjA,2715620,2715620,2715336,284,208,utRho15
2271,ynaI,2791946,2791946,2791844,102,0,utRho15
2272,ynaK,2850438,2850754,2850438,316,6,utRho15
2273,ynbA,2954924,2955242,2954924,318,0,utRho15
2274,yncD,3046552,3046552,3046130,422,46,utRho15
2275,yncE,3046454,3046614,3046454,160,0,utRho15
2276,yncG,3052456,3052494,3052456,38,4,utRho15
2277,yncL,3034492,3034492,3034388,104,4,utRho15
2278,yneE,3218364,3218364,3218044,320,0,utRho15
2279,yneF,3223748,3223748,3223708,40,0,utRho15
2280,yneJ,3229560,3229608,3229560,48,2,utRho15
2281,yneK,3231100,3231526,3231100,426,0,utRho15
2282,yneM,3245176,3245292,3245176,116,2,utRho15
2283,ynfA,3311398,3311398,3311346,52,0,utRho15
2284,ynfB,3311418,3311616,3311418,198,128,utRho15
2285,ynfC,3315094,3315094,3314914,180,0,utRho15
2286,ynfD,3314828,3315130,3314828,302,18,utRho15
2287,ynfE,3316006,3316138,3316006,132,0,utRho15
2288,ynfK,3334670,3334670,3334438,232,94,utRho15
2289,ynfL,3339304,3339304,3339184,120,0,utRho15
2290,ynfM,3339260,3339398,3339260,138,34,utRho15
2291,ynfN,3276598,3276598,3276218,380,2,utRho15
2292,ynfO,3273454,3273512,3273454,58,0,utRho15
2293,ynhG,3517890,3517890,3517450,440,252,utRho15
2294,yniA,3615158,3615592,3615158,434,0,utRho15
2295,yniB,3618526,3618526,3618466,60,0,utRho15
2296,yniC,3618652,3618760,3618652,108,8,utRho15
2297,yniD,3610202,3610330,3610202,128,0,utRho15
2298,ynjE,3678880,3678934,3678880,54,0,utRho15
2299,ynjF,3683222,3683222,3682806,416,44,utRho15
2300,ynjH,3684376,3684376,3684270,106,34,utRho15
2301,ynjI,3690022,3690022,3689742,280,96,utRho15
2302,yoaB,3786642,3786734,3786642,92,0,utRho15
2303,yoaC,3787932,3788146,3787932,214,28,utRho15
2304,yoaE,3803544,3803544,3803170,374,268,utRho15
2305,yoaF,3755444,3755444,3755064,380,212,utRho15
2306,yoaH,3789866,3789866,3789462,404,616,utRho15
2307,yobB,3850418,3850880,3850418,462,428,utRho15
2308,yobF,3815586,3815586,3815182,404,2,utRho15
2309,yobH,3817800,3817850,3817800,50,20,utRho15
2310,yodB,4084352,4084736,4084352,384,6,utRho15
2311,yodC,4057008,4057008,4056740,268,4,utRho15
2312,yohC,4451358,4451358,4451262,96,0,utRho15
2313,yohD,4451526,4451602,4451526,76,0,utRho15
2314,yohJ,4460986,4461248,4460986,262,2,utRho15
2315,yohO,4431172,4431314,4431172,142,26,utRho15
2316,yojI,4617282,4617282,4617230,52,0,utRho15
2317,ypdI,4988988,4989396,4988988,408,0,utRho15
2318,ypfG,5165786,5165786,5165554,232,0,utRho15
2319,ypfM,5182140,5182140,5181732,408,1818,utRho15
2320,yphB,5349590,5349590,5349376,214,0,utRho15
2321,ypjA,5565644,5565644,5565452,192,6,utRho15
2322,ypjB,5569636,5569636,5568858,778,2,utRho15
2323,ypjD,5495860,5495774,5495860,86,30,utRho15
2324,yqaE,5594170,5594170,5594056,114,22,utRho15
2325,yqcA,5846100,5846100,5845968,132,24,utRho15
2326,yqcE,5800944,5801184,5800944,240,0,utRho15
2327,yqeC,6030468,6030468,6030114,354,94,utRho15
2328,yqeF,5971618,5971618,5971184,434,44,utRho15
2329,yqeG,5971438,5971694,5971438,256,58,utRho15
2330,yqeH,5975016,5975072,5975016,56,26,utRho15
2331,yqeI,5976688,5977004,5976688,316,0,utRho15
2332,yqeK,5981140,5981140,5980720,420,20,utRho15
2333,yqfA,6086728,6086728,6086296,432,458,utRho15
2334,yqgA,6219042,6219106,6219042,64,0,utRho15
2335,yqgB,6172500,6172500,6172102,398,478,utRho15
2336,yqgE,6185768,6185874,6185768,106,510,utRho15
2337,yqhA,6299150,6299150,6298942,208,54,utRho15
2338,yqhC,6310768,6310768,6310436,332,156,utRho15
2339,yqhD,6310604,6310710,6310604,106,132,utRho15
2340,yqhH,6316842,6317254,6316842,412,20,utRho15
2341,yqiC,6369662,6369680,6369662,18,10,utRho15
2342,yqiJ,6384108,6384416,6384108,308,6,utRho15
2343,yqjA,6495096,6495546,6495096,450,694,utRho15
2344,yqjF,6500932,6501124,6500932,192,182,utRho15
2345,yqjG,6501948,6502048,6501948,100,0,utRho15
2346,yqjH,6433078,6433078,6432982,96,2,utRho15
2347,yqjI,6433506,6433558,6433506,52,0,utRho15
2348,yraH,6574552,6574852,6574552,300,2,utRho15
2349,yraP,6592144,6592818,6592144,674,156,utRho15
2350,yraQ,6596414,6596414,6596276,138,0,utRho15
2351,yraR,6598024,6598024,6597692,332,30,utRho15
2352,yrbG,13360844,13361100,13360844,256,0,utRho15
2353,yrbL,6696842,6696904,6696842,62,10,utRho15
2354,yrbN,6616172,6616172,6615866,306,512,utRho15
2355,yrdB,6860176,6860176,6860046,130,30,utRho15
2356,yrfF,7052548,7052938,7052548,390,266,utRho15
2357,yrhB,7169440,7169518,7169440,78,0,utRho15
2358,ysaB,7451804,7451804,7451424,380,4,utRho15
2359,ysgA,8032686,8032686,8032338,348,78,utRho15
2360,ytfB,8857638,8857638,8857434,204,32,utRho15
2361,ytfE,8864018,8864018,8863966,52,0,utRho15
2362,ytfF,8866296,8866296,8866130,166,2,utRho15
2363,ytfH,8868164,8868226,8868164,62,10,utRho15
2364,ytfI,8875234,8875414,8875234,180,0,utRho15
2365,ytfJ,8878572,8878572,8878524,48,74,utRho15
2366,ytfK,8879022,8879174,8879022,152,1080,utRho15
2367,ytfL,8882642,8882642,8882430,212,0,utRho15
2368,ytfQ,8899634,8899924,8899634,290,170,utRho15
2369,ytjB,9249598,9249598,9249578,20,0,utRho15
2370,yzfA,8896588,8896588,8896490,98,2,utRho15
2371,zapA,6111102,6111224,6111102,122,3014,utRho15
2372,zapB,8236772,8237030,8236772,258,358,utRho15
2373,zapC,2011700,2011904,2011700,204,0,utRho15
2374,zinT,4082692,4082750,4082692,58,2,utRho15
2375,zipA,5062814,5062814,5062466,348,0,utRho15
2376,zitB,1569716,1569716,1569646,70,0,utRho15
2377,zntA,7212844,7212902,7212844,58,0,utRho15
2378,zntR,6878336,6878336,6878260,76,4,utRho15
2379,znuA,3885322,3885322,3885166,156,16,utRho15
2380,znuC,3885268,3885324,3885268,56,16,utRho15
2381,zraP,8403424,8403424,8403376,48,0,utRho15
2382,zraS,8403810,8403852,8403810,42,0,utRho15
2383,zupT,6364866,6365100,6364866,234,382,utRho15
2384,zur,8520282,8520282,8520006,276,134,utRho15
2385,zwf,3872752,3872752,3872628,124,114,utRho15
0,C0343,2818676,2818728,2818676,52,0,utRho16
1,aaeB,6776526,6776526,6776376,150,208,utRho16
2,aaeR,6778762,6779040,6778762,278,860,utRho16
3,aaeX,6778860,6778860,6778674,186,1164,utRho16
4,aat,1854920,1854920,1854864,56,0,utRho16
5,accA,416822,417242,416822,420,1828,utRho16
6,accB,6810280,6810872,6810280,592,4884,utRho16
7,accD,4868030,4868030,4867852,178,160,utRho16
8,aceB,8430804,8430956,8430804,152,392,utRho16
9,aceE,245938,246034,245938,96,96,utRho16
10,ackA,4826918,4826940,4826918,22,622,utRho16
11,acnA,2670848,2671662,2670848,814,600,utRho16
12,acnB,263038,263230,263038,192,348,utRho16
13,acpP,2303148,2303230,2303148,82,378,utRho16
14,acpS,5402324,5402324,5401996,328,234,utRho16
15,acrA,971396,971396,971238,158,44,utRho16
16,acrB,969370,969370,968806,564,1338,utRho16
17,acrD,5174950,5175190,5174950,240,40,utRho16
18,acrE,6827404,6827728,6827404,324,386,utRho16
19,acrR,971398,971522,971398,124,82,utRho16
20,acrZ,1589502,1589546,1589502,44,168,utRho16
21,acs,8575190,8575190,8574742,448,1328,utRho16
22,actP,8569870,8569870,8569804,66,26,utRho16
23,ada,4620854,4620854,4620810,44,0,utRho16
24,add,3404404,3404466,3404404,62,320,utRho16
25,ade,7687802,7687928,7687802,126,284,utRho16
26,adhE,2596826,2596826,2596242,584,130,utRho16
27,adhP,3107988,3107988,3107676,312,1288,utRho16
28,adiA,8681112,8681112,8681042,70,152,utRho16
29,adiC,8674404,8674404,8674062,342,208,utRho16
30,adiY,8676084,8676084,8675858,226,70,utRho16
31,adk,994278,994350,994278,72,1208,utRho16
32,adrA,807374,807406,807374,32,106,utRho16
33,aer,6438240,6438240,6438152,88,56,utRho16
34,aes,1000102,1000102,999946,156,1828,utRho16
35,agaR,6557406,6557406,6557330,76,14,utRho16
36,agaS,6563778,6563952,6563778,174,38,utRho16
37,agp,2131118,2131170,2131118,52,0,utRho16
38,agrA,7296126,7296126,7296126,0,0,utRho16
39,agrB,7296588,7296588,7296588,0,0,utRho16
40,ahpC,1277386,1277890,1277386,504,522,utRho16
41,ahpF,1278004,1279506,1278004,1502,44634,utRho16
42,ahr,8992698,8992698,8992418,280,314,utRho16
43,aidB,8828494,8828550,8828494,56,20,utRho16
44,ais,4731512,4731512,4731240,272,4,utRho16
45,alaA,4814816,4815122,4814816,306,124,utRho16
46,alaC,4996798,4996798,4996590,208,20,utRho16
47,alaE,5598140,5598328,5598140,188,262,utRho16
48,alaS,5644180,5644180,5644022,158,2558,utRho16
49,alaW,5036612,5036612,5036462,150,0,utRho16
50,aldA,2976380,2976464,2976380,84,356,utRho16
51,aldB,7513070,7513070,7513022,48,568,utRho16
52,alkA,4295118,4295118,4295080,38,158,utRho16
53,alkB,4618890,4618890,4618682,208,8,utRho16
54,allA,1064780,1064902,1064780,122,24,utRho16
55,allD,1092822,1092822,1092726,96,132,utRho16
56,allE,1088112,1088112,1088092,20,0,utRho16
57,allS,1064600,1064600,1064442,158,78,utRho16
58,alr,8531178,8531564,8531178,386,1898,utRho16
59,alsE,8617334,8617334,8616956,378,846,utRho16
60,alsK,8615990,8615990,8615598,392,1586,utRho16
61,alx,6476740,6477160,6476740,420,146,utRho16
62,amiA,5104482,5104704,5104482,222,0,utRho16
63,amiC,5898378,5898378,5898020,358,690,utRho16
64,amn,4110062,4110122,4110062,60,116,utRho16
65,ampC,8758006,8758006,8757888,118,226,utRho16
66,ampD,237362,237466,237362,104,56,utRho16
67,ampG,907372,907372,907090,282,362,utRho16
68,ampH,792726,792726,792574,152,250,utRho16
69,amyA,4012230,4012312,4012230,82,82,utRho16
70,anmK,3439346,3439346,3439204,142,0,utRho16
71,ansB,6201580,6201580,6201456,124,622,utRho16
72,ansP,3052040,3052040,3051960,80,260,utRho16
73,apaG,104068,104068,103212,856,3786,utRho16
74,apaH,102586,102586,102444,142,3724,utRho16
75,apbE,4623188,4623188,4623068,120,0,utRho16
76,appA,2081198,2081234,2081198,36,50,utRho16
77,appC,2075420,2075480,2075420,60,0,utRho16
78,appY,1167134,1167362,1167134,228,6,utRho16
79,apt,982620,982824,982620,204,300,utRho16
80,aqpZ,1832424,1832424,1832094,330,286,utRho16
81,araB,140150,140150,140096,54,20,utRho16
82,araC,140482,140774,140482,292,1134,utRho16
83,araE,5964416,5964416,5964364,52,30,utRho16
84,araF,3972476,3972476,3972256,220,114,utRho16
85,araH,3967120,3967120,3967086,34,298,utRho16
86,araJ,825058,825058,824962,96,1300,utRho16
87,arcA,9281602,9281602,9280612,990,2314,utRho16
88,arcB,6706098,6706098,6706050,48,82,utRho16
89,arcZ,6701154,6701154,6701154,0,0,utRho16
90,arfA,6877346,6877346,6877298,48,922,utRho16
91,argA,5898312,5898484,5898312,172,198,utRho16
92,argC,8309770,8310002,8309770,232,44,utRho16
93,argD,6980442,6980442,6980360,82,432,utRho16
94,argE,8310156,8310156,8309694,462,112,utRho16
95,argF,580680,580680,580610,70,38,utRho16
96,argG,6637124,6637274,6637124,150,236,utRho16
97,argI,8956688,8956688,8956622,66,590,utRho16
98,argO,6137672,6137672,6137616,56,292,utRho16
99,argP,6119460,6119506,6119460,46,324,utRho16
100,argR,6769204,6769406,6769204,202,36,utRho16
101,argS,3920002,3920124,3920002,122,0,utRho16
102,argT,4855698,4855698,4855582,116,276,utRho16
103,argU,1129406,1129446,1129406,40,264,utRho16
104,argW,4932616,4932618,4932616,2,0,utRho16
105,argX,7964728,7964750,7964728,22,54,utRho16
106,aroF,5482402,5482402,5482300,102,0,utRho16
107,aroG,1571182,1571266,1571182,84,172,utRho16
108,aroH,3576636,3576870,3576636,234,646,utRho16
109,aroK,7038760,7038760,7038128,632,1044,utRho16
110,aroL,812560,812810,812560,250,1162,utRho16
111,aroP,243342,243342,243102,240,132,utRho16
112,arpA,8445382,8445382,8444974,408,380,utRho16
113,arrS,7316108,7316108,7316108,0,0,utRho16
114,arsR,7297024,7297056,7297024,32,34,utRho16
115,artJ,1801252,1801252,1801150,102,0,utRho16
116,artP,1807686,1807686,1807468,218,1768,utRho16
117,ascF,5678858,5679048,5678858,190,0,utRho16
118,ascG,5678574,5678574,5678528,46,0,utRho16
119,aslB,7965562,7965916,7965562,354,4886,utRho16
120,asnA,7854258,7854310,7854258,52,440,utRho16
121,asnB,1398444,1398444,1398354,90,660,utRho16
122,asnC,23562186,23562186,23562018,168,426,utRho16
123,asnS,1978088,1978088,1977970,118,5210,utRho16
124,asnT,4089082,4089098,4089082,16,124,utRho16
125,asnU,4119690,4119702,4119690,12,0,utRho16
126,asnV,4124504,4124520,4124504,16,156,utRho16
127,aspA,17473728,17473728,17473308,420,128,utRho16
128,aspC,1971486,1971486,1971418,68,544,utRho16
129,aspS,3901402,3901402,3901044,358,222,utRho16
130,aspT,7893560,7893744,7893560,184,90266,utRho16
131,aspV,473826,473862,473826,36,48,utRho16
132,asr,3342654,3342752,3342654,98,0,utRho16
133,astC,3664088,3664088,3663964,124,44,utRho16
134,astE,3654138,3654138,3653846,292,370,utRho16
135,atoD,4646824,4646894,4646824,70,982,utRho16
136,atpB,7844540,7844540,7844102,438,420,utRho16
137,atpC,7832118,7832118,7831944,174,1278,utRho16
138,atpI,7845050,7845050,7844880,170,108,utRho16
139,avtA,7479348,7479410,7479348,62,896,utRho16
140,azoR,2965982,2965982,2965720,262,132,utRho16
141,azuC,3976002,3976002,3975918,84,96,utRho16
142,bacA,6408350,6408350,6408262,88,568,utRho16
143,bamA,394052,395856,394052,1804,358,utRho16
144,bamB,5277950,5277950,5277304,646,530,utRho16
145,bamC,5198028,5198028,5197730,298,108,utRho16
146,bamD,5471922,5472292,5471922,370,4878,utRho16
147,bamE,5506972,5507210,5506972,238,300,utRho16
148,basS,8666954,8666954,8666544,410,1622,utRho16
149,bax,7474468,7474468,7474354,114,156,utRho16
150,bcp,5200874,5200956,5200874,82,1522,utRho16
151,bcsB,7385346,7385346,7385214,132,20,utRho16
152,bcsE,7392644,7392916,7392644,272,0,utRho16
153,bdcA,8948128,8948128,8948106,22,2386,utRho16
154,bdcR,8948192,8948248,8948192,56,1196,utRho16
155,bdm,3112680,3112680,3112560,120,0,utRho16
156,betA,654522,654522,654494,28,58,utRho16
157,betI,658722,658722,658668,54,236,utRho16
158,betT,658842,658926,658842,84,390,utRho16
159,bfr,6933498,6933498,6933450,48,180,utRho16
160,bglG,23440182,23440182,23439402,780,1134,utRho16
161,bglX,4444240,4444240,4443978,262,90,utRho16
162,bhsA,2337962,2338146,2337962,184,54,utRho16
163,bioA,1618584,1618584,1618514,70,0,utRho16
164,bioB,1618604,1618688,1618604,84,0,utRho16
165,bioH,7089716,7089716,7089688,28,58,utRho16
166,bisC,7433026,7433026,7432788,238,342,utRho16
167,blc,8755490,8755490,8755444,46,0,utRho16
168,blr,3409024,3409102,3409024,78,238,utRho16
169,bluF,2431226,2431226,2430950,276,406,utRho16
170,bluR,2428226,2428226,2428118,108,22,utRho16
171,bolA,908698,908944,908698,246,0,utRho16
172,borD,1157842,1157842,1157786,56,196,utRho16
173,brnQ,838976,839182,838976,206,598,utRho16
174,bssR,1756492,1756496,1756492,4,50,utRho16
175,bssS,2242116,2242116,2241910,206,252,utRho16
176,btuB,8326798,8327278,8326798,480,3146,utRho16
177,cadB,8720212,8720212,8720062,150,316,utRho16
178,cadC,8723926,8723926,8723868,58,0,utRho16
179,caiE,70998,70998,70742,256,364,utRho16
180,caiF,68436,68600,68436,164,598,utRho16
181,caiT,84074,84074,83862,212,190,utRho16
182,can,285406,285406,285340,66,158,utRho16
183,carA,59102,59302,59102,200,264,utRho16
184,carB,61550,61634,61550,84,76,utRho16
185,cas2,5757830,5757830,5757706,124,460,utRho16
186,casA,5768638,5768638,5768276,362,28,utRho16
187,cbl,4121882,4121882,4121828,54,1792,utRho16
188,cbpA,2128074,2128074,2127550,524,202,utRho16
189,cbrA,7738628,7738754,7738628,126,48,utRho16
190,cbrB,7794958,7795012,7794958,54,124,utRho16
191,ccmH,4585242,4585242,4584820,422,770,utRho16
192,cdaR,364894,364926,364894,32,148,utRho16
193,cdd,4463638,4463688,4463638,50,28,utRho16
194,cdh,8219814,8219860,8219814,46,1070,utRho16
195,cdsA,391110,391354,391110,244,532,utRho16
196,cedA,3627484,3627484,3627326,158,664,utRho16
197,cfa,3482402,3482826,3482402,424,956,utRho16
198,chaC,2544844,2544972,2544844,128,1006,utRho16
199,chbB,3643452,3643452,3643238,214,36,utRho16
200,chbG,3634624,3634624,3634270,354,490,utRho16
201,cheW,3946924,3946924,3946678,246,570,utRho16
202,chiA,6939792,6939792,6939706,86,38,utRho16
203,chiP,1416472,1416668,1416472,196,46,utRho16
204,cho,3646984,3647030,3646984,46,40,utRho16
205,chpS,8896804,8896894,8896804,90,152,utRho16
206,cirA,4493884,4493884,4493538,346,124,utRho16
207,citC,1304078,1304078,1303712,366,184,utRho16
208,citT,1293264,1293264,1293160,104,0,utRho16
209,clcA,350104,350214,350104,110,0,utRho16
210,clpA,1846160,1846528,1846160,368,162,utRho16
211,clpB,5468410,5468410,5468346,64,64,utRho16
212,clpP,913154,913354,913154,200,176,utRho16
213,clpS,1845500,1845826,1845500,326,42,utRho16
214,clpX,914404,914852,914404,448,908,utRho16
215,clsA,2617346,2617346,2617290,56,0,utRho16
216,clsC,2212584,2212710,2212584,126,266,utRho16
217,cmk,1922330,1922402,1922330,72,60,utRho16
218,cnu,3409522,3409898,3409522,376,1050,utRho16
219,coaA,8350214,8350214,8350052,162,676,utRho16
220,cobC,1340092,1340092,1339814,278,312,utRho16
221,cobT,4129202,4129202,4128934,268,370,utRho16
222,cobU,4131944,4131944,4131528,416,808,utRho16
223,codB,709768,709844,709768,76,494,utRho16
224,comR,2337726,2337726,2337664,62,0,utRho16
225,copA,1022822,1022822,1022758,64,0,utRho16
226,corA,8002388,8002852,8002388,464,19176,utRho16
227,cpdB,8873258,8873258,8873130,128,616,utRho16
228,cptB,6082198,6082198,6082140,58,92,utRho16
229,cpxA,8210202,8210202,8209950,252,168,utRho16
230,cpxP,8211570,8211640,8211570,70,6,utRho16
231,cpxR,8211372,8211372,8211340,32,2,utRho16
232,cra,175894,176056,175894,162,70,utRho16
233,crcB,1316016,1316016,1315876,140,242,utRho16
234,creA,9270486,9271042,9270486,556,504,utRho16
235,creD,9276320,9276356,9276320,36,506,utRho16
236,crl,515620,515658,515620,38,784,utRho16
237,crp,6971906,6972240,6971906,334,2598,utRho16
238,crr,5070960,5071668,5070960,708,1714,utRho16
239,csdA,5886414,5886674,5886414,260,272,utRho16
240,csgB,2207718,2207902,2207718,184,86,utRho16
241,csgD,2206688,2206688,2206392,296,380,utRho16
242,csgG,2203510,2203510,2203368,142,306,utRho16
243,csiD,5577854,5577970,5577854,116,242,utRho16
244,csiE,5330802,5330870,5330802,68,88,utRho16
245,csiR,5590942,5591348,5590942,406,246,utRho16
246,cspA,7439778,7440098,7439778,320,8108,utRho16
247,cspB,3283430,3283430,3283108,322,92,utRho16
248,cspC,3815018,3815018,3814870,148,466,utRho16
249,cspD,1845352,1845352,1845180,172,3328,utRho16
250,cspE,1314294,1314584,1314294,290,0,utRho16
251,cspF,3283380,3283710,3283380,330,118,utRho16
252,cspG,2102610,2102922,2102610,312,426,utRho16
253,cspH,2102746,2102746,2102350,396,0,utRho16
254,cspI,3277624,3277624,3277334,290,6,utRho16
255,csrA,5638746,5638746,5638292,454,802,utRho16
256,csrB,5849048,5849048,5849048,0,0,utRho16
257,csrC,8102072,8102072,8102072,0,0,utRho16
258,csrD,6806850,6806850,6806664,186,334,utRho16
259,cstA,1259710,1259788,1259710,78,0,utRho16
260,cueO,274090,274166,274090,76,48,utRho16
261,cueR,1027948,1027986,1027948,38,138,utRho16
262,curA,3037784,3038054,3037784,270,662,utRho16
263,cusC,1191146,1191200,1191146,54,104,utRho16
264,cusR,1190924,1190924,1190886,38,240,utRho16
265,cutA,8730784,8730784,8730712,72,780,utRho16
266,cutC,3918534,3918534,3917920,614,486,utRho16
267,cvpA,4861600,4861600,4861526,74,94,utRho16
268,cvrA,2484328,2484328,2484142,186,54,utRho16
269,cyaA,7981548,7982306,7981548,758,1296,utRho16
270,cyaR,4334228,4334224,4334228,4,56,utRho16
271,cyaY,7988166,7988166,7988118,48,344,utRho16
272,cybB,2981522,2981804,2981522,282,218,utRho16
273,cycA,8859560,8859728,8859560,168,796,utRho16
274,cydA,1542340,1542916,1542340,576,228,utRho16
275,cydC,1858800,1858800,1858390,410,92,utRho16
276,cydD,1862062,1862062,1861924,138,64,utRho16
277,cydX,1548300,1548392,1548300,92,146,utRho16
278,cynR,717418,717418,717380,38,310,utRho16
279,cynT,1435092,1435196,1435092,104,124,utRho16
280,cyoA,903306,903306,903220,86,1998,utRho16
281,cyoE,895540,895540,895410,130,406,utRho16
282,cysB,2667576,2667710,2667576,134,470,utRho16
283,cysC,5748056,5748056,5747984,72,42,utRho16
284,cysD,5752736,5752736,5752658,78,28,utRho16
285,cysE,7565362,7565362,7565124,238,1366,utRho16
286,cysG,6995508,6995656,6995508,148,1040,utRho16
287,cysJ,5783928,5783928,5783796,132,2806,utRho16
288,cysK,5064688,5064818,5064688,130,380,utRho16
289,cysP,5087114,5087114,5087056,58,590,utRho16
290,cysS,1109154,1109222,1109154,68,96,utRho16
291,cysT,3984100,3984100,3983974,126,60,utRho16
292,cysZ,5062766,5062926,5062766,160,68,utRho16
293,cytR,8249018,8249018,8248912,106,148,utRho16
294,dacA,1328002,1328002,1327926,76,224,utRho16
295,dacB,6657714,6657926,6657714,212,60,utRho16
296,dacC,1761306,1761454,1761306,148,844,utRho16
297,dadA,2475018,2475142,2475018,124,36,utRho16
298,dam,7032504,7032504,7031826,678,830,utRho16
299,damX,7035200,7035200,7034612,588,428,utRho16
300,dapA,5199568,5199568,5199520,48,0,utRho16
301,dapB,56576,56748,56576,172,638,utRho16
302,dapD,371954,371954,371894,60,48,utRho16
303,dapE,5183120,5183214,5183120,94,1210,utRho16
304,dcp,3254844,3254844,3254760,84,32,utRho16
305,dcrB,7219534,7219910,7219534,376,450,utRho16
306,dctA,7366996,7366996,7366894,102,326,utRho16
307,dcuA,8733686,8733686,8733546,140,48,utRho16
308,dcuB,8698182,8698182,8697488,694,2840,utRho16
309,dcuC,1312166,1312166,1311936,230,232,utRho16
310,dcuD,6749166,6749738,6749166,572,552,utRho16
311,dcuR,8701130,8701130,8700068,1062,2408,utRho16
312,dcuS,8703370,8703370,8703324,46,1102,utRho16
313,dcyD,3999016,3999016,3998960,56,0,utRho16
314,ddpX,3126498,3126498,3126152,346,512,utRho16
315,deaD,6615818,6615818,6615720,98,1560,utRho16
316,dedA,4869880,4869880,4869482,398,3278,utRho16
317,dedD,4863750,4863750,4863368,382,0,utRho16
318,def,6867300,6867380,6867300,80,500,utRho16
319,degP,361690,361768,361690,78,0,utRho16
320,degQ,6761308,6761486,6761308,178,3724,utRho16
321,deoB,9239134,9239206,9239134,72,0,utRho16
322,deoC,9233358,9234646,9233358,1288,838,utRho16
323,dfp,7625406,7625462,7625406,56,36,utRho16
324,dgcZ,3247758,3247758,3247700,58,204,utRho16
325,dgkA,8512914,8513274,8512914,360,270,utRho16
326,dgt,358392,358474,358392,82,864,utRho16
327,dhaK,2501888,2501888,2501676,212,158,utRho16
328,dhaR,2502006,2502132,2502006,126,42,utRho16
329,dicB,3299194,3299218,3299194,24,0,utRho16
330,dicC,3295752,3295752,3295700,52,0,utRho16
331,dinB,501760,501796,501760,36,56,utRho16
332,dinD,7635398,7635520,7635398,122,62,utRho16
333,dinG,1666146,1666140,1666146,6,14,utRho16
334,dinI,2243018,2243018,2242974,44,440,utRho16
335,dinJ,493230,493230,493004,226,278,utRho16
336,dinQ,7295964,7295964,7295576,388,396,utRho16
337,djlA,114536,114728,114536,192,278,utRho16
338,dkgA,6313142,6313246,6313142,104,212,utRho16
339,dkgB,458196,458334,458196,138,78,utRho16
340,dksA,321502,321502,321208,294,674,utRho16
341,dld,4444164,4444370,4444164,206,38,utRho16
342,dmlA,3763424,3763824,3763424,400,1384,utRho16
343,dmlR,3763710,3763710,3763618,92,270,utRho16
344,dmsA,1881646,1881918,1881646,272,0,utRho16
345,dnaA,7767922,7767922,7767458,464,1490,utRho16
346,dnaB,8528566,8528628,8528566,62,464,utRho16
347,dnaK,24096,24326,24096,230,3930,utRho16
348,dnaN,7765466,7765466,7764642,824,240,utRho16
349,dnaQ,471868,472134,471868,266,2078,utRho16
350,dnaT,18406460,18406460,18406068,392,9840,utRho16
351,dnaX,984112,984184,984112,72,764,utRho16
352,dosP,3131486,3131486,3131466,20,64,utRho16
353,dpiB,1303968,1304470,1303968,502,0,utRho16
354,dppA,7415740,7415740,7415410,330,1780,utRho16
355,dps,1697900,1697900,1697822,78,64,utRho16
356,dsbA,8086754,8086836,8086754,82,1032,utRho16
357,dsbB,2466294,2466294,2466060,234,106,utRho16
358,dsbC,6079266,6079266,6077644,1622,1482,utRho16
359,dsbG,1277600,1277600,1277146,454,290,utRho16
360,dsdA,4958242,4958404,4958242,162,440,utRho16
361,dsdC,4955492,4955492,4955258,234,164,utRho16
362,dsdX,4955642,4955694,4955642,52,60,utRho16
363,dsrA,4050626,4050626,4050626,0,0,utRho16
364,dsrB,4049686,4049686,4049646,40,316,utRho16
365,dtpD,1485340,1485340,1485112,228,118,utRho16
366,dusA,8523200,8523338,8523200,138,1348,utRho16
367,dusB,6820492,6820560,6820492,68,28,utRho16
368,dusC,4460790,4460790,4460770,20,0,utRho16
369,dut,7627704,7627864,7627704,160,792,utRho16
370,dxr,386670,387042,386670,372,210,utRho16
371,ebgA,6445102,6445266,6445102,164,472,utRho16
372,ebgR,6442874,6442932,6442874,58,112,utRho16
373,ecnB,8753018,8753106,8753018,88,280,utRho16
374,eco,4607594,4607810,4607594,216,0,utRho16
375,ecpA,621594,621594,621342,252,148,utRho16
376,ecpB,620238,620238,620052,186,126,utRho16
377,ecpR,622964,622964,622672,292,124,utRho16
378,eda,3866218,3866218,3865512,706,96,utRho16
379,edd,3869426,3869426,3869208,218,56,utRho16
380,efeO,2164308,2164486,2164308,178,40,utRho16
381,efeU_1,2162614,2162712,2162614,98,172,utRho16
382,efp,8751134,8751398,8751134,264,1836,utRho16
383,elaA,4763372,4763372,4763086,286,16,utRho16
384,elaD,4765308,4765426,4765308,118,86,utRho16
385,elfA,1995530,1995736,1995530,206,0,utRho16
386,elfD,1996642,1996980,1996642,338,44,utRho16
387,emrD,7707690,7707844,7707690,154,18,utRho16
388,emrK,4966896,4966896,4966678,218,104,utRho16
389,emrY,4964668,4964668,4964352,316,280,utRho16
390,emtA,2486250,2486360,2486250,110,186,utRho16
391,endA,12361100,12361388,12361100,288,28,utRho16
392,eno,5817692,5817692,5815882,1810,2912,utRho16
393,entC,1249662,1249770,1249662,108,0,utRho16
394,entD,1220508,1220508,1220158,350,0,utRho16
395,entH,1258584,1258600,1258584,16,0,utRho16
396,entS,1244506,1244600,1244506,94,46,utRho16
397,envR,6827266,6827266,6826930,336,84,utRho16
398,epd,12295292,12295292,12294764,528,524,utRho16
399,epmA,8765236,8765286,8765236,50,200,utRho16
400,epmB,8751406,8751406,8751314,92,452,utRho16
401,eptB,7421162,7421162,7420950,212,252,utRho16
402,eptC,8300622,8300622,8300530,92,646,utRho16
403,erfK,4126708,4126708,4126646,62,414,utRho16
404,erpA,353122,353220,353122,98,178,utRho16
405,esrE,8039956,8039956,8039956,0,0,utRho16
406,essD,1153746,1154796,1153746,1050,2322,utRho16
407,etk,2088606,2088606,2088420,186,976,utRho16
408,evgA,4967262,4967510,4967262,248,186,utRho16
409,exbB,6304028,6304028,6303968,60,200,utRho16
410,exbD,6302780,6302780,6302486,294,62,utRho16
411,exuR,6493016,6493304,6493016,288,500,utRho16
412,exuT,6490004,6490208,6490004,204,102,utRho16
413,fabA,2032996,2032996,2032940,56,108,utRho16
414,fabB,4883282,4883282,4883210,72,32,utRho16
415,fabH,2297032,2297518,2297032,486,1122,utRho16
416,fabI,2702236,2702236,2702078,158,288,utRho16
417,fadB,8062026,8062026,8061942,84,72,utRho16
418,fadD,3779614,3779614,3779492,122,32,utRho16
419,fadE,486812,486812,486606,206,192,utRho16
420,fadH,6463248,6463330,6463248,82,462,utRho16
421,fadI,4921022,4921022,4920938,84,202,utRho16
422,fadL,4922410,4922600,4922410,190,208,utRho16
423,fadM,928720,928804,928720,84,2,utRho16
424,fadR,2469810,2469876,2469810,66,0,utRho16
425,fbaB,4357334,4357334,4357128,206,78,utRho16
426,fdhE,8162722,8162722,8162456,266,788,utRho16
427,fdhF,8598814,8598814,8598732,82,414,utRho16
428,fdnG,3094744,3094802,3094744,58,8,utRho16
429,fdrA,1093012,1093360,1093012,348,768,utRho16
430,feaB,2894994,2895038,2894994,44,62,utRho16
431,feaR,2894734,2894734,2894566,168,0,utRho16
432,fecA,9033454,9033454,9033354,100,50,utRho16
433,fecE,9023288,9023288,9022914,374,1990,utRho16
434,fecI,9036564,9036564,9036470,94,490,utRho16
435,feoA,7080114,7080326,7080114,212,54,utRho16
436,fepA,1225334,1225334,1224988,346,324,utRho16
437,fepB,1249454,1249454,1249020,434,298,utRho16
438,fepD,1244468,1244468,1244378,90,0,utRho16
439,fes,1225374,1225630,1225374,256,212,utRho16
440,ffh,5495706,5495706,5495590,116,398,utRho16
441,ffs,952576,952848,952576,272,2876,utRho16
442,fhuA,334884,334968,334884,84,184,utRho16
443,fhuE,2323294,2323294,2323102,192,272,utRho16
444,fhuF,9211504,9211504,9211326,178,67056,utRho16
445,fic,6983296,6983296,6982926,370,2064,utRho16
446,fieF,8212864,8212938,8212864,74,186,utRho16
447,fimA,9085388,9086230,9085388,842,2142,utRho16
448,fimB,9081334,9081914,9081334,580,3392,utRho16
449,fimE,9083742,9084074,9083742,332,2084,utRho16
450,fimZ,1129214,1129214,1128960,254,0,utRho16
451,fiu,1683296,1683296,1683062,234,250,utRho16
452,fixA,84650,84806,84650,156,94,utRho16
453,fkpA,6955050,6955050,6954838,212,2624,utRho16
454,fldA,2846084,2846084,2845860,224,2560,utRho16
455,fldB,6079644,6079710,6079644,66,166,utRho16
456,flgA,2261770,2261770,2261726,44,1118,utRho16
457,flgB,2261986,2262036,2261986,50,94,utRho16
458,flgK,2276702,2276756,2276702,54,500,utRho16
459,flgM,2260330,2260330,2260256,74,26,utRho16
460,flgN,2259828,2259828,2259660,168,440,utRho16
461,flhB,3932432,3932432,3932382,50,324,utRho16
462,flhC,3955864,3955864,3955688,176,126,utRho16
463,flhD,3957154,3957154,3956394,760,1786,utRho16
464,fliA,4003638,4003638,4003578,60,202,utRho16
465,fliC,4007352,4007352,4007212,140,100,utRho16
466,fliD,4007634,4007744,4007634,110,694,utRho16
467,fliE,4026186,4026186,4026028,158,644,utRho16
468,fliF,4026292,4026458,4026292,166,746,utRho16
469,fliL,4039168,4039236,4039168,68,170,utRho16
470,flk,4875824,4875900,4875824,76,132,utRho16
471,flu,4142634,4143078,4142634,444,110,utRho16
472,flxA,3292776,3292810,3292776,34,12,utRho16
473,fnr,2799104,2799104,2799052,52,70,utRho16
474,fnrS,2818258,2818258,2818258,0,0,utRho16
475,focA,1909628,1909628,1908932,696,2064,utRho16
476,folA,99598,99646,99598,48,54,utRho16
477,folB,6409296,6409296,6409178,118,52,utRho16
478,folD,1115562,1115562,1115482,80,158,utRho16
479,folE,4487696,4487696,4487304,392,1786,utRho16
480,fpr,8228998,8228998,8228944,54,204,utRho16
481,frc,4986878,4986878,4986508,370,212,utRho16
482,frdA,8764824,8764824,8764636,188,464,utRho16
483,frdD,8758948,8758948,8758732,216,4924,utRho16
484,fre,8052886,8053054,8052886,168,516,utRho16
485,frlA,6999518,6999820,6999518,302,744,utRho16
486,frr,385624,385744,385624,120,638,utRho16
487,frsA,513004,513054,513004,50,40,utRho16
488,fruB,4527194,4527194,4526990,204,0,utRho16
489,frvR,8179804,8179804,8179710,94,46,utRho16
490,fryA,5008986,5008986,5008970,16,788,utRho16
491,fsaA,1727060,1727284,1727060,224,398,utRho16
492,fsr,1009710,1009710,1009392,318,120,utRho16
493,ftnA,3977364,3977432,3977364,68,0,utRho16
494,ftnB,3973550,3973850,3973550,300,100,utRho16
495,ftsA,207122,207964,207122,842,332,utRho16
496,ftsB,5745802,5745802,5745640,162,830,utRho16
497,ftsH,6654204,6654204,6653870,334,988,utRho16
498,ftsK,1865858,1866448,1865858,590,366,utRho16
499,ftsL,181376,182064,181376,688,1202,utRho16
500,ftsP,6325732,6325732,6325338,394,166,utRho16
501,ftsQ,205484,206310,205484,826,80,utRho16
502,ftsX,7204512,7204512,7204172,340,490,utRho16
503,ftsZ,209272,210610,209272,1338,4,utRho16
504,fucA,5867708,5867708,5867376,332,4322,utRho16
505,fucP,5868238,5868470,5868238,232,438,utRho16
506,fumA,6753760,6753760,6753508,252,2008,utRho16
507,fumB,8694696,8694696,8694652,44,44,utRho16
508,fumC,3373418,3373418,3373176,242,44,utRho16
509,fur,2842892,2842892,2842584,308,2648,utRho16
510,fusA,6947370,6947370,6947028,342,13008,utRho16
511,fxsA,8737206,8737328,8737206,122,492,utRho16
512,gabD,5581824,5582546,5581824,722,3360,utRho16
513,gadA,7335214,7335214,7335160,54,0,utRho16
514,gadB,3144144,3144144,3144090,54,98,utRho16
515,gadC,3141168,3141168,3140978,190,88,utRho16
516,gadE,7315600,7316732,7315600,1132,1136,utRho16
517,gadW,7329562,7329562,7329236,326,190,utRho16
518,gadX,14663356,14663356,14663240,116,968,utRho16
519,gadY,7329728,7329728,7329728,0,0,utRho16
520,galE,1584354,1584354,1584110,244,104,utRho16
521,galF,4228702,4228702,4228654,48,76,utRho16
522,galM,1577796,1577796,1577674,122,366,utRho16
523,galP,6176510,6176568,6176510,58,16,utRho16
524,galR,5953138,5953198,5953138,60,154,utRho16
525,galS,4483420,4483420,4483336,84,0,utRho16
526,galU,2582810,2582914,2582810,104,60,utRho16
527,gapA,3724480,3725542,3724480,1062,2394,utRho16
528,garP,6549868,6549868,6549814,54,570,utRho16
529,gatY,4354468,4354468,4354408,60,80,utRho16
530,gatZ,4352864,4352864,4352642,222,10838,utRho16
531,gcd,282558,282558,282450,108,30,utRho16
532,gcl,1067814,1067832,1067814,18,0,utRho16
533,gcvA,5885278,5885278,5885134,144,0,utRho16
534,gcvB,5885392,5885392,5885392,0,0,utRho16
535,gcvR,5199758,5199812,5199758,54,44,utRho16
536,gcvT,6101544,6101544,6101334,210,1514,utRho16
537,gdhA,3684616,3684742,3684616,126,0,utRho16
538,gfcA,2099668,2099668,2099488,180,1280,utRho16
539,gfcD,2096236,2096236,2095890,346,1496,utRho16
540,ghrA,2195648,2195772,2195648,124,212,utRho16
541,ghrB,7434378,7434620,7434378,242,2890,utRho16
542,glcA,6242728,6242728,6242558,170,340,utRho16
543,glcC,6256412,6256544,6256412,132,182,utRho16
544,glcD,6256152,6256152,6256042,110,300,utRho16
545,gldA,8278092,8278092,8278070,22,94,utRho16
546,glgA,7136784,7136784,7136066,718,6366,utRho16
547,glgB,7147314,7147314,7147004,310,912,utRho16
548,glgC,7139142,7139142,7138656,486,1530,utRho16
549,glgP,7133546,7133546,7133162,384,3074,utRho16
550,glgS,6384024,6384024,6383878,146,296,utRho16
551,glgX,7142838,7142838,7142638,200,150,utRho16
552,glk,5018922,5018922,5018852,70,246,utRho16
553,glmS,7827622,7827622,7827336,286,966,utRho16
554,glmU,7830652,7830652,7830400,252,328,utRho16
555,glmY,10765360,10765360,10765360,0,0,utRho16
556,glmZ,7972864,7972864,7972864,0,0,utRho16
557,glnA,16232888,16232888,16232136,752,368,utRho16
558,glnB,5375052,5375052,5374816,236,576,utRho16
559,glnD,377310,377310,377300,10,0,utRho16
560,glnE,6399602,6399602,6399282,320,98,utRho16
561,glnH,1696396,1696396,1696008,388,246,utRho16
562,glnK,945112,945196,945112,84,200,utRho16
563,glnL,8112742,8112742,8112678,64,122,utRho16
564,glnQ,1693262,1693262,1692926,336,160,utRho16
565,glnS,1411998,1412186,1411998,188,1186,utRho16
566,gloA,3455602,3455674,3455602,72,40,utRho16
567,gloB,469852,469852,469564,288,1122,utRho16
568,glpA,4705166,4705294,4705166,128,0,utRho16
569,glpD,7123942,7124026,7123942,84,0,utRho16
570,glpE,7123698,7123698,7123646,52,38,utRho16
571,glpF,8236322,8236322,8236180,142,240,utRho16
572,glpG,7122960,7122960,7122904,56,84,utRho16
573,glpR,7121782,7121782,7121210,572,2064,utRho16
574,glpT,4704902,4704902,4704748,154,162,utRho16
575,glpX,8231212,8231212,8231158,54,7598,utRho16
576,glrK,5382246,5382246,5382196,50,672,utRho16
577,gltA,1509534,1509534,1508936,598,4398,utRho16
578,gltB,6709018,6709264,6709018,246,914,utRho16
579,gltI,1375792,1375792,1375494,298,4168,utRho16
580,gltP,8588536,8588962,8588536,426,1966,utRho16
581,gltS,7657382,7657382,7657330,52,1572,utRho16
582,gltX,5041568,5041568,5041344,224,138,utRho16
583,gluQ,320286,320286,320224,62,142,utRho16
584,glyA,5371148,5371148,5371014,134,66,utRho16
585,glyQ,7450708,7450708,7450636,72,512,utRho16
586,glyS,7448990,7448990,7448794,196,868,utRho16
587,glyU,5998128,5998128,5998114,14,0,utRho16
588,glyV,8784626,8784720,8784626,94,340,utRho16
589,glyW,3984360,3984360,3984234,126,0,utRho16
590,gmhB,445612,445666,445612,54,0,utRho16
591,gmk,7642776,7642856,7642776,80,2,utRho16
592,gmr,2693686,2693686,2693484,202,674,utRho16
593,gnd,4202648,4202648,4202536,112,348,utRho16
594,gnsB,3275692,3275692,3275564,128,96,utRho16
595,gntK,14310580,14310580,14310368,212,884,utRho16
596,gntP,9102668,9102668,9102592,76,316,utRho16
597,gntR,7157760,7157760,7157452,308,648,utRho16
598,gntT,7092810,7093118,7092810,308,3076,utRho16
599,gntU,7154170,7154170,7154122,48,192,utRho16
600,gntX,7089334,7089764,7089334,430,298,utRho16
601,gor,7292224,7292598,7292224,374,96,utRho16
602,gpmA,1575340,1575340,1575190,150,0,utRho16
603,gpmM,7570374,7570520,7570374,146,38,utRho16
604,gpsA,7567620,7567620,7567322,298,5718,utRho16
605,gpt,511828,511954,511828,126,872,utRho16
606,grcA,5433046,5433046,5432898,148,928,utRho16
607,greA,6657728,6657728,6657430,298,694,utRho16
608,greB,7073488,7073624,7073488,136,52,utRho16
609,groL,8741566,8742050,8741566,484,4748,utRho16
610,groS,8741232,8741376,8741232,144,8368,utRho16
611,grpE,5501494,5501494,5501416,78,178,utRho16
612,grxA,1781552,1781552,1781506,46,0,utRho16
613,grxB,2248206,2248206,2248108,98,1278,utRho16
614,grxC,7569152,7569152,7568884,268,3122,utRho16
615,grxD,3468324,3468324,3468202,122,728,utRho16
616,gspA,6911268,6911268,6910796,472,130,utRho16
617,gspC,6910964,6911156,6910964,192,38,utRho16
618,gss,6277220,6277220,6277044,176,364,utRho16
619,gstA,3428654,3428754,3428654,100,0,utRho16
620,gstB,1761038,1761038,1760960,78,146,utRho16
621,guaB,5268214,5268214,5268140,74,102,utRho16
622,gudD,5839026,5839026,5838770,256,348,utRho16
623,gyrA,4678914,4678914,4678840,74,0,utRho16
624,gyrB,7760300,7760300,7760238,62,224,utRho16
625,hcaE,5337964,5338064,5337964,100,5868,utRho16
626,hcaR,5337928,5337928,5337792,136,8096,utRho16
627,hcaT,5336106,5336106,5335692,414,892,utRho16
628,hchA,4071260,4071670,4071260,410,60,utRho16
629,hcp,1828258,1828258,1827628,630,968,utRho16
630,hcr,1824400,1824400,1824300,100,136,utRho16
631,hdeA,7313582,7313582,7313480,102,30,utRho16
632,hdeD,7313920,7313990,7313920,70,574,utRho16
633,hdfR,7896320,7896320,7895934,386,868,utRho16
634,hdhA,3396244,3396244,3396080,164,52,utRho16
635,helD,2048876,2048942,2048876,66,0,utRho16
636,hemA,2527166,2527428,2527166,262,340,utRho16
637,hemB,779722,779722,779454,268,2298,utRho16
638,hemF,5106410,5106450,5106410,40,0,utRho16
639,hemH,996062,996110,996062,48,912,utRho16
640,hemL,349882,349882,349764,118,234,utRho16
641,hemN,8103886,8104090,8103886,204,236,utRho16
642,hepA,127176,127176,126528,648,3022,utRho16
643,hflD,2385372,2385372,2385262,110,20,utRho16
644,hfq,8799602,8800576,8799602,974,11428,utRho16
645,hha,961006,961006,960616,390,172,utRho16
646,hicA,3018442,3018572,3018442,130,116,utRho16
647,higA,6468682,6468682,6468288,394,1960,utRho16
648,higB,6468960,6468960,6468910,50,0,utRho16
649,hinT,2323642,2323770,2323642,128,112,utRho16
650,hipB,3184964,3184964,3184884,80,0,utRho16
651,hisB,4186720,4186936,4186720,216,88,utRho16
652,hisJ,4853674,4853674,4853576,98,102,utRho16
653,hisL,8359856,8359984,8359856,128,308,utRho16
654,hisS,5281284,5281284,5281150,134,52,utRho16
655,hlpA,400910,400964,400910,54,44,utRho16
656,hlyE,2460932,2460932,2460788,144,1046,utRho16
657,hmp,5371594,5371670,5371594,76,0,utRho16
658,hns,2585916,2585916,2585844,72,246,utRho16
659,hofM,7045856,7045856,7045502,354,200,utRho16
660,hokA,7441620,7441620,7441200,420,2662,utRho16
661,hokC,33902,33902,33806,96,142,utRho16
662,hokE,1215462,1215672,1215462,210,0,utRho16
663,holC,8968546,8968546,8968560,14,198,utRho16
664,holD,9215562,9215606,9215562,44,28,utRho16
665,holE,3850040,3850216,3850040,176,2190,utRho16
666,hpt,282720,282862,282720,142,898,utRho16
667,hrpB,324150,324210,324150,60,0,utRho16
668,hscB,5319048,5319048,5318934,114,3996,utRho16
669,hscC,1367188,1367188,1366786,402,872,utRho16
670,hsdS,9163004,9163004,9162924,80,222,utRho16
671,hslJ,2883560,2883560,2883486,74,288,utRho16
672,hslO,7059344,7059548,7059344,204,7788,utRho16
673,hslR,7058220,7058696,7058220,476,2024,utRho16
674,hslV,8244708,8244708,8244574,134,248,utRho16
675,hsrA,7881412,7881412,7881224,188,166,utRho16
676,htgA,21286,21660,21286,374,14362,utRho16
677,htpG,989634,990240,989634,606,20220,utRho16
678,htpX,3825236,3825236,3825152,84,2,utRho16
679,htrE,311036,311036,310852,184,532,utRho16
680,htrL,7587668,7587668,7587366,302,116,utRho16
681,hupA,8400352,8400562,8400352,210,70,utRho16
682,hupB,1845220,1845804,1845220,584,884,utRho16
683,hyaA,2063968,2064278,2063968,310,50,utRho16
684,hybO,6292726,6292726,6292522,204,9638,utRho16
685,hycA,5700922,5700922,5700870,52,0,utRho16
686,hycI,5686204,5686204,5686086,118,934,utRho16
687,hydN,5676264,5676264,5676210,54,0,utRho16
688,hyfA,5202342,5202402,5202342,60,172,utRho16
689,hypA,11402508,11402588,11402508,80,160,utRho16
690,hypB,11403356,11404004,11403356,648,28,utRho16
691,hypF,5676210,5676210,5674850,1360,1384,utRho16
692,hypT,9116634,9116634,9116578,56,60,utRho16
693,hyuA,6019660,6020056,6019660,396,556,utRho16
694,iaaA,1733074,1733136,1733074,62,52,utRho16
695,iadA,9119074,9119074,9119052,22,692,utRho16
696,iap,5753072,5753162,5753072,90,66,utRho16
697,ibaG,6673966,6673966,6673606,360,170,utRho16
698,ibpA,7735036,7735036,7734844,192,6856,utRho16
699,ibpB,7733962,7733962,7733794,168,20300,utRho16
700,icd,2389922,2390246,2389922,324,86,utRho16
701,iclR,8447304,8447304,8447256,48,66,utRho16
702,idi,6065876,6066130,6065876,254,28,utRho16
703,idnD,8988870,8988870,8988812,58,18,utRho16
704,idnK,8989194,8989246,8989194,52,44,utRho16
705,ihfA,3591442,3591442,3591104,338,416,utRho16
706,ihfB,1927498,1927656,1927498,158,194,utRho16
707,ileS,43666,44782,43666,1116,2872,utRho16
708,ileX,6431194,6431196,6431194,2,0,utRho16
709,ilvA,15820940,15821324,15820940,384,1252,utRho16
710,ilvC,7915824,7915940,7915824,116,264,utRho16
711,ilvE,15809552,15809936,15809552,384,1568,utRho16
712,ilvI,170840,171260,170840,420,204,utRho16
713,ilvL,23701308,23701932,23701308,624,552,utRho16
714,ilvY,7915734,7915734,7915640,94,236,utRho16
715,inaA,4698998,4698998,4698944,54,338,utRho16
716,infA,1853370,1853370,1852886,484,1068,utRho16
717,infC,3602692,3602692,3601276,1416,2368,utRho16
718,insA-5,3958452,3958452,3958430,22,154,utRho16
719,insA-7,9036758,9037054,9036758,296,1438,utRho16
720,insC-5,6372080,6372284,6372080,204,6404,utRho16
721,insEF-2,785238,785238,785820,582,2934,utRho16
722,insEF-4,2190310,2190310,2190892,582,3004,utRho16
723,insG,9007098,9007098,9006862,236,10,utRho16
724,insH-1,550596,550596,550234,362,23618,utRho16
725,insH-11,7306538,7306538,7306396,142,176,utRho16
726,insH-2,1151548,1151548,1151506,42,308,utRho16
727,insH-3,1378444,1378444,1378026,418,780,utRho16
728,insH-4,2791942,2792152,2791942,210,248,utRho16
729,insH-5,2857852,2857852,2857452,400,714,utRho16
730,insH-6,4135022,4135022,4134642,380,658,utRho16
731,insH-7,4206186,4206186,4205822,364,1516,utRho16
732,insH-9,6260050,6260356,6260050,306,1094,utRho16
733,insI-3,9017372,9017372,9017234,138,1450,utRho16
734,insJ,7441188,7441360,7441188,172,978,utRho16
735,insK,7442130,7442308,7442130,178,38,utRho16
736,insL-1,30760,30890,30760,130,3686,utRho16
737,insL-2,1216112,1216130,1216112,18,258,utRho16
738,insL-3,5028644,5028662,5028644,18,276,utRho16
739,insN-1,540452,540484,540452,32,176,utRho16
740,intD,1132202,1132202,1131956,246,17860,utRho16
741,intR,2826520,2826520,2826470,50,0,utRho16
742,intS,4933026,4933090,4933026,64,3892,utRho16
743,intZ,5117386,5117542,5117386,156,3882,utRho16
744,iraD,9113152,9113986,9113152,834,896,utRho16
745,iraM,2424246,2424246,2424006,240,140,utRho16
746,iraP,802638,802772,802638,134,0,utRho16
747,iscA,5319924,5319924,5319772,152,600,utRho16
748,iscR,5324398,5324398,5324262,136,8378,utRho16
749,iscX,5313834,5313834,5313472,362,1862,utRho16
750,ispF,5743968,5743968,5743560,408,2694,utRho16
751,ispG,5283908,5283908,5283608,300,718,utRho16
752,ispU,389568,389806,389568,238,74,utRho16
753,isrA,2811502,2811502,2811618,116,10,utRho16
754,istr-1,7706384,7706384,7706384,0,0,utRho16
755,istr-2,7706514,7706514,7706514,0,0,utRho16
756,ivbL,15412092,15412092,15411952,140,280,utRho16
757,ivy,480638,480686,480638,48,72,utRho16
758,katE,3627628,3627734,3627628,106,588,utRho16
759,katG,8267624,8267670,8267624,46,250,utRho16
760,kbaZ,6557732,6557828,6557732,96,0,utRho16
761,kbl,7585154,7585154,7585102,52,540,utRho16
762,kch,2621046,2621046,2620538,508,408,utRho16
763,kdgR,3820506,3820506,3820198,308,52,utRho16
764,kdpE,1443788,1443788,1443466,322,128,utRho16
765,kdpF,1457698,1457698,1457642,56,0,utRho16
766,kdsA,2535708,2536330,2535708,622,1274,utRho16
767,kdsC,6683438,6684546,6683438,1108,2280,utRho16
768,kduI,5968388,5968388,5968248,140,8378,utRho16
769,kefF,94160,94492,94160,332,1540,utRho16
770,kgtP,5451624,5451624,5451492,132,150,utRho16
771,kup,7862206,7862632,7862206,426,132,utRho16
772,lacI,735076,735076,735020,56,226,utRho16
773,lacZ,1465508,1465508,1465220,288,740,utRho16
774,ldcA,2486394,2486394,2486160,234,402,utRho16
775,ldhA,2885830,2885830,2885686,144,48,utRho16
776,ldrA,2538954,2538954,2538550,404,2066,utRho16
777,ldrB,2540024,2540024,2539620,404,894,utRho16
778,ldrC,2541092,2541092,2540690,402,358,utRho16
779,ldrD,7400544,7400544,7400174,370,1820,utRho16
780,lepA,5414392,5414392,5414248,144,110,utRho16
781,lepB,5410928,5410928,5410618,310,316,utRho16
782,leuD,159188,159188,158906,282,190,utRho16
783,leuE,3761600,3761600,3761518,82,114,utRho16
784,leuL,168048,168048,167416,632,34,utRho16
785,leuO,168308,168736,168308,428,432,utRho16
786,leuQ,9212864,9212864,9212802,62,28,utRho16
787,leuU,6644556,6644556,6644316,240,1572,utRho16
788,leuV,9212546,9212546,9212330,216,1238,utRho16
789,leuX,8992772,8992810,8992772,38,60,utRho16
790,lexA,8514174,8514230,8514174,56,446,utRho16
791,lhr,3456706,3458174,3456706,1468,4998,utRho16
792,ligA,5060402,5060402,5060352,50,0,utRho16
793,ligB,7642576,7642576,7642340,236,738,utRho16
794,lipA,1320602,1320602,1320432,170,216,utRho16
795,lipB,1324802,1324802,1324556,246,9234,utRho16
796,lit,2397032,2397390,2397032,358,990,utRho16
797,livJ,7199524,7199524,7199316,208,1230,utRho16
798,livK,7195510,7195510,7195120,390,392,utRho16
799,lldP,7554578,7554798,7554578,220,5320,utRho16
800,lnt,1381968,1381968,1381762,206,502,utRho16
801,loiP,6163784,6163826,6163784,42,188,utRho16
802,lolA,1874656,1874738,1874656,82,160,utRho16
803,lolB,2527112,2527112,2527000,112,196,utRho16
804,lolC,2350748,2350854,2350748,106,0,utRho16
805,lon,917630,917776,917630,146,110,utRho16
806,lpcA,486936,487086,486936,150,206,utRho16
807,lpd,255434,255824,255434,390,2132,utRho16
808,lplA,9248476,9248476,9248234,242,992,utRho16
809,lplT,5947878,5947878,5947724,154,228,utRho16
810,lpoA,6586422,6586800,6586422,378,580,utRho16
811,lpp,3514592,3514842,3514592,250,336,utRho16
812,lptA,6686598,6686760,6686598,162,228,utRho16
813,lptB,6686792,6687888,6686792,1096,1558,utRho16
814,lptD,114672,114672,114218,454,624,utRho16
815,lptF,8972244,8972436,8972244,192,104,utRho16
816,lpxC,213016,213114,213016,98,2708,utRho16
817,lpxD,401920,401942,401920,22,0,utRho16
818,lpxL,2233418,2233418,2233164,254,0,utRho16
819,lpxM,3880456,3880456,3880386,70,72,utRho16
820,lpxP,4991156,4991290,4991156,134,172,utRho16
821,lrhA,4813312,4813312,4813282,30,48,utRho16
822,lrp,1864656,1865190,1864656,534,428,utRho16
823,lspA,50028,50414,50028,386,184,utRho16
824,lsrA,3202920,3202980,3202920,60,118,utRho16
825,lsrR,3202514,3202514,3202482,32,172,utRho16
826,ltaE,1818640,1818640,1818588,52,156,utRho16
827,luxS,5630130,5630130,5629466,664,15796,utRho16
828,lysA,5957902,5957902,5957798,104,78,utRho16
829,lysC,8467232,8467232,8466466,766,1432,utRho16
830,lysP,4497120,4497120,4497064,56,162,utRho16
831,lysR,5957900,5958042,5957900,142,44,utRho16
832,lysT,1561028,1561108,1561028,80,52,utRho16
833,lysU,8709610,8709610,8709434,176,146,utRho16
834,macB,1840188,1840694,1840188,506,2082,utRho16
835,maeA,3111484,3111484,3111338,146,4586,utRho16
836,mak,820236,820288,820236,52,76,utRho16
837,malE,8492928,8492928,8492838,90,0,utRho16
838,malI,3398456,3398456,3398360,96,0,utRho16
839,malK,8493472,8493568,8493472,96,148,utRho16
840,malP,7105020,7105020,7104946,74,1498,utRho16
841,malQ,7100798,7100798,7100140,658,608,utRho16
842,malS,14949880,14949988,14949880,108,0,utRho16
843,malT,7106048,7106170,7106048,122,154,utRho16
844,malX,3398626,3398710,3398626,84,0,utRho16
845,malZ,1689980,1690072,1689980,92,1592,utRho16
846,manA,3377102,3377152,3377102,50,0,utRho16
847,manX,3803866,3804096,3803866,230,160,utRho16
848,marC,3237882,3237882,3237816,66,188,utRho16
849,marR,3238186,3238240,3238186,54,232,utRho16
850,matP,2036918,2036970,2036918,52,96,utRho16
851,mazE,5822736,5822736,5822678,58,30,utRho16
852,mazG,5821720,5821720,5821370,350,1888,utRho16
853,mcbA,1684306,1684306,1684112,194,2,utRho16
854,mcbR,3040192,3040524,3040192,332,68,utRho16
855,mcrA,2420278,2420692,2420278,414,256,utRho16
856,mcrC,9156124,9156124,9155916,208,1204,utRho16
857,mdaB,6344814,6345060,6344814,246,336,utRho16
858,mdfA,1767138,1767346,1767138,208,40,utRho16
859,mdh,6768940,6768940,6768536,404,180,utRho16
860,mdoB,9198988,9198988,9198882,106,7032,utRho16
861,mdoD,2993290,2993712,2993290,422,42,utRho16
862,mdoG,2218514,2218670,2218514,156,238,utRho16
863,mdtA,4307958,4308032,4307958,74,468,utRho16
864,mdtE,7318168,7318464,7318168,296,14482,utRho16
865,mdtK,3486538,3486914,3486538,376,1790,utRho16
866,mdtP,8602472,8602472,8602060,412,804,utRho16
867,melA,8683774,8683822,8683774,48,16,utRho16
868,melR,8683300,8683300,8683256,44,570,utRho16
869,menA,8240812,8240812,8240698,114,44,utRho16
870,menB,4753774,4753774,4753638,136,412,utRho16
871,mepH,3468714,3468870,3468714,156,0,utRho16
872,mepM,3883666,3883666,3883270,396,334,utRho16
873,mepS,4539840,4539958,4539840,118,304,utRho16
874,metA,8428318,8428560,8428318,242,386,utRho16
875,metB,8257272,8257344,8257272,72,1050,utRho16
876,metC,6304150,6304472,6304150,322,308,utRho16
877,metE,8025768,8026106,8025768,338,1044,utRho16
878,metF,8265092,8265232,8265092,140,184,utRho16
879,metG,4388538,4388600,4388538,62,104,utRho16
880,metH,8447010,8447656,8447010,646,2234,utRho16
881,metJ,8257116,8257116,8256790,326,484,utRho16
882,metK,6173154,6173412,6173154,258,166,utRho16
883,metN,445428,445428,445290,138,136,utRho16
884,metR,8025710,8025710,8025632,78,84,utRho16
885,metT,1394326,1394326,1394266,60,252,utRho16
886,metY,19910250,19910250,19909734,516,1104,utRho16
887,metZ,11789528,11789548,11789528,20,0,utRho16
888,mfd,2348056,2348056,2347928,128,70,utRho16
889,mglA,4478782,4478782,4478578,204,808,utRho16
890,mglB,4481132,4481132,4480696,436,8638,utRho16
891,mglC,4475918,4475918,4475506,412,370,utRho16
892,mgrB,3817584,3817584,3817532,52,0,utRho16
893,mgrR,3245828,3245828,3245828,0,0,utRho16
894,mgsA,2054082,2054082,2054030,52,0,utRho16
895,mgtL,8934560,8934862,8934560,302,18,utRho16
896,mhpA,737038,737222,737038,184,370,utRho16
897,mhpR,737072,737072,736840,232,110,utRho16
898,mhpT,750772,750918,750772,146,0,utRho16
899,miaA,8797964,8798504,8797964,540,6442,utRho16
900,micA,5629604,5629604,5629604,0,0,utRho16
901,micC,2874242,2874238,2874242,4,0,utRho16
902,micF,4626168,4626168,4626168,0,0,utRho16
903,micM,1014408,1014408,1014408,0,0,utRho16
904,minE,2449422,2449422,2449090,332,994,utRho16
905,mioC,7852950,7852950,7852910,40,0,utRho16
906,mipA,3733012,3733012,3732944,68,1062,utRho16
907,mlaA,4930270,4930270,4930014,256,2,utRho16
908,mlc,3337206,3337206,3337128,78,136,utRho16
909,mlrA,4429498,4429732,4429498,234,522,utRho16
910,mltA,5894546,5894546,5894356,190,196,utRho16
911,mltD,468050,468050,467910,140,30,utRho16
912,mltF,5391534,5391602,5391534,68,8,utRho16
913,mmuP,550238,550650,550238,412,27042,utRho16
914,mngA,1531622,1531968,1531622,346,196,utRho16
915,mngR,1531852,1531852,1531750,102,92,utRho16
916,mnmG,7851348,7851348,7851266,82,3184,utRho16
917,mntH,5025470,5025470,5025412,58,2,utRho16
918,mntP,3810918,3811376,3810918,458,2164,utRho16
919,mntR,1706160,1706366,1706160,206,0,utRho16
920,mntS,1706128,1706128,1705994,134,0,utRho16
921,moaA,1633654,1634088,1633654,434,1016,utRho16
922,moaB,1635954,1636110,1635954,156,1052,utRho16
923,mobA,8084242,8084242,8083998,244,270,utRho16
924,mocA,6030112,6030320,6030112,208,482,utRho16
925,modA,1589990,1590178,1589990,188,456,utRho16
926,moeA,1732788,1732788,1732728,60,198,utRho16
927,mokB,2984610,2984610,2984258,352,682,utRho16
928,molR_1,4392888,4392948,4392888,60,108,utRho16
929,motA,3954604,3954604,3954278,326,80,utRho16
930,mpaA,2781278,2781278,2781196,82,368,utRho16
931,mpl,8911456,8911570,8911456,114,122,utRho16
932,mppA,2786108,2786454,2786108,346,140,utRho16
933,mprA,5621494,5621540,5621494,46,1418,utRho16
934,mqo,4613848,4613848,4613508,340,416,utRho16
935,mqsA,6336742,6336742,6336492,250,552,utRho16
936,mqsR,6337306,6337306,6337088,218,488,utRho16
937,mraZ,179192,179268,179192,76,0,utRho16
938,mrcA,7045652,7045742,7045652,90,52,utRho16
939,mrcB,329442,329460,329442,18,0,utRho16
940,mreB,13605424,13605424,13604348,1076,740,utRho16
941,mreD,6798166,6798166,6797750,416,202,utRho16
942,mrp,4388360,4388360,4388336,24,44,utRho16
943,mscK,972984,973072,972984,88,0,utRho16
944,mscL,6876002,6876048,6876002,46,444,utRho16
945,mscS,6139742,6139742,6139614,128,148,utRho16
946,msrA,8884522,8884522,8884352,170,432,utRho16
947,msrB,3725168,3725168,3724858,310,0,utRho16
948,msyB,2228426,2228426,2228362,64,100,utRho16
949,mtfA,4087236,4087302,4087236,66,614,utRho16
950,mtgA,6699662,6699662,6699618,44,1554,utRho16
951,mtlA,30177504,30178248,30177504,744,3776,utRho16
952,mtn,358366,358366,358306,60,1464,utRho16
953,mtr,6611864,6611864,6611634,230,246,utRho16
954,mug,6430992,6430992,6430946,46,42,utRho16
955,murQ,5091466,5091546,5091466,80,38,utRho16
956,murR,5091586,5091586,5091218,368,288,utRho16
957,mutH,5939164,5939324,5939164,160,92,utRho16
958,mutL,8794092,8794824,8794092,732,7166,utRho16
959,mutM,7622554,7622554,7622304,250,1112,utRho16
960,mutS,5714038,5714186,5714038,148,702,utRho16
961,mutY,18617466,18618078,18617466,612,792,utRho16
962,nac,4123956,4123956,4123866,90,1132,utRho16
963,nadA,1564122,1564170,1564122,48,62,utRho16
964,nadB,5420714,5420840,5420714,126,68,utRho16
965,nadC,237326,237326,237290,36,56,utRho16
966,nadE,3644604,3644916,3644604,312,234,utRho16
967,nadK,5501526,5501662,5501526,136,366,utRho16
968,nagA,1406350,1406350,1405502,848,4546,utRho16
969,nagB,1407416,1407416,1407222,194,88,utRho16
970,nagC,1404016,1404016,1403188,828,124,utRho16
971,nagE,1407680,1407888,1407680,208,74,utRho16
972,nagK,2357080,2357186,2357080,106,36,utRho16
973,nanA,6747240,6747240,6747152,88,36,utRho16
974,nanC,9079856,9079856,9079002,854,602,utRho16
975,nanR,6749406,6749406,6748978,428,632,utRho16
976,nanS,9075406,9075406,9075188,218,256,utRho16
977,napF,4607390,4607390,4606994,396,46,utRho16
978,narG,2559614,2559728,2559614,114,1120,utRho16
979,narK,2555642,2555914,2555642,272,394,utRho16
980,narP,4580844,4581000,4580844,156,218,utRho16
981,narQ,5171154,5171462,5171154,308,202,utRho16
982,narU,3088326,3088326,3088120,206,116,utRho16
983,narW,3077374,3077374,3074618,2756,964,utRho16
984,narX,2555554,2555554,2555236,318,350,utRho16
985,narZ,3085380,3085380,3085180,200,0,utRho16
986,ndh,2331984,2332170,2331984,186,458,utRho16
987,ndk,5289920,5289920,5289728,192,28,utRho16
988,nemR,6904084,6904092,6904084,8,632,utRho16
989,nepI,7683542,7683542,7683478,64,78,utRho16
990,nfo,4501612,4501680,4501612,68,32,utRho16
991,nfsB,1210906,1210906,1210848,58,282,utRho16
992,nfuA,7090916,7091248,7090916,332,778,utRho16
993,nhaA,34634,34978,34634,344,434,utRho16
994,nhaB,2469534,2469534,2469434,100,32,utRho16
995,nhoA,3067926,3068048,3067926,122,84,utRho16
996,nikA,7226878,7227334,7226878,456,9256,utRho16
997,nikR,7237074,7237176,7237074,102,380,utRho16
998,nirB,6987974,6988022,6987974,48,116,utRho16
999,nlpA,7680034,7680034,7679986,48,0,utRho16
1000,nlpC,3585654,3585654,3585462,192,86,utRho16
1001,nlpD,5737658,5737658,5737506,152,74,utRho16
1002,nlpI,6618080,6618080,6617848,232,0,utRho16
1003,nmpC,1153740,1153740,1153650,90,0,utRho16
1004,nohA,3273206,3273206,3272734,472,586,utRho16
1005,norR,5664614,5664614,5664578,36,52,utRho16
1006,norV,5664878,5664952,5664878,74,244,utRho16
1007,nrdA,4689510,4689730,4689510,220,4264,utRho16
1008,nrdD,8925676,8925676,8925320,356,8756,utRho16
1009,nrdH,5601312,5601446,5601312,134,1420,utRho16
1010,nrdR,865954,866004,865954,50,0,utRho16
1011,nrfA,8575342,8575528,8575342,186,0,utRho16
1012,nsrR,8812088,8812380,8812088,292,5802,utRho16
1013,nudB,3897348,3897348,3897264,84,52,utRho16
1014,nudC,8393428,8393806,8393428,378,138,utRho16
1015,nudE,7052658,7052658,7052298,360,766,utRho16
1016,nudG,3682876,3682980,3682876,104,30,utRho16
1017,nudI,4729050,4729108,4729050,58,0,utRho16
1018,nudJ,2388874,2388874,2388576,298,686,utRho16
1019,nuoA,4810670,4810670,4810144,526,3890,utRho16
1020,nuoN,4783434,4783434,4783010,424,648,utRho16
1021,nupC,5026018,5026084,5026018,66,0,utRho16
1022,nupG,6211302,6211428,6211302,126,0,utRho16
1023,ogrK,4335096,4335096,4335040,56,50,utRho16
1024,ogt,2800568,2800568,2800472,96,88,utRho16
1025,ohsC,5401036,5401040,5401036,4,0,utRho16
1026,ompA,2040382,2040382,2040106,276,18232,utRho16
1027,ompC,4625774,4625774,4625498,276,214,utRho16
1028,ompF,1974184,1974184,1973964,220,600,utRho16
1029,ompL,8128958,8128958,8128590,368,574,utRho16
1030,ompN,2874158,2874158,2873786,372,24,utRho16
1031,ompR,7073510,7073510,7073168,342,116,utRho16
1032,ompT,1171330,1171330,1171266,64,212,utRho16
1033,ompW,2627982,2628040,2627982,58,0,utRho16
1034,ompX,1700418,1700900,1700418,482,2078,utRho16
1035,omrA,5952378,5952378,5952378,0,0,utRho16
1036,omrB,5952770,5952770,5952770,0,0,utRho16
1037,oppA,2602170,2602364,2602170,194,4936,utRho16
1038,orn,8783168,8783208,8783168,40,0,utRho16
1039,osmB,2686952,2686952,2686656,296,1572,utRho16
1040,osmC,3113192,3113250,3113192,58,292,utRho16
1041,osmE,3644566,3644566,3644512,54,148,utRho16
1042,osmF,4439046,4439046,4438962,84,1820,utRho16
1043,osmY,9222306,9222792,9222306,486,1026,utRho16
1044,otsA,3963302,3963302,3963224,78,488,utRho16
1045,otsB,3964930,3964930,3964774,156,558,utRho16
1046,oxc,4984288,4984288,4983900,388,888,utRho16
1047,oxyR,8316914,8316980,8316914,66,1162,utRho16
1048,oxyS,8316788,8316788,8316788,0,0,utRho16
1049,paaA,2907730,2907854,2907730,124,18,utRho16
1050,paaX,2927018,2927078,2927018,60,0,utRho16
1051,paaZ,2907340,2907340,2907284,56,40,utRho16
1052,pabA,6981702,6981702,6981658,44,352,utRho16
1053,pabB,3789256,3789610,3789256,354,844,utRho16
1054,pabC,2306186,2306600,2306186,414,1196,utRho16
1055,pagP,1313052,1313114,1313052,62,0,utRho16
1056,panB,299260,299260,299202,58,7772,utRho16
1057,panC,297840,297840,297590,250,350,utRho16
1058,panD,293490,293490,293388,102,138,utRho16
1059,panZ,7195656,7195968,7195656,312,374,utRho16
1060,parC,6332060,6332060,6331946,114,414,utRho16
1061,patA,6438916,6438988,6438916,72,118,utRho16
1062,patD,3030830,3031156,3030830,326,130,utRho16
1063,pbpC,5294986,5294986,5294650,336,218,utRho16
1064,pbpG,4450132,4450132,4449740,392,368,utRho16
1065,pck,7065358,7065636,7065358,278,3542,utRho16
1066,pcnB,318782,318782,318252,530,672,utRho16
1067,pdhR,244068,244184,244068,116,0,utRho16
1068,pdxB,4875768,4875768,4875702,66,226,utRho16
1069,pdxH,3436068,3436068,3436014,54,252,utRho16
1070,pdxJ,5403626,5403626,5403458,168,112,utRho16
1071,pdxK,5074638,5074638,5074474,164,132,utRho16
1072,pepA,8972278,8972278,8971902,376,94,utRho16
1073,pepD,511618,511618,511432,186,1788,utRho16
1074,pepN,1981182,1981244,1981182,62,0,utRho16
1075,pepQ,8062294,8062322,8062294,28,10,utRho16
1076,pepT,2371646,2371688,2371646,42,408,utRho16
1077,pfkA,8214948,8215104,8214948,156,266,utRho16
1078,pfkB,3612646,3612740,3612646,94,0,utRho16
1079,pflA,1902456,1902456,1902160,296,40,utRho16
1080,pflB,1907850,1907850,1907108,742,1626,utRho16
1081,pflD,8287716,8287990,8287716,274,0,utRho16
1082,pgaA,2185046,2185046,2184578,468,134,utRho16
1083,pgi,8467444,8467516,8467444,72,0,utRho16
1084,pgk,12291428,12291428,12290488,940,3808,utRho16
1085,pgl,1597078,1597172,1597078,94,0,utRho16
1086,pgpB,2678324,2678660,2678324,336,324,utRho16
1087,pgpC,5397276,5397276,5397100,176,172,utRho16
1088,pgrR,2783744,2783982,2783744,238,346,utRho16
1089,pheL,5475158,5475198,5475158,40,94,utRho16
1090,pheM,7197204,7197204,7197080,124,220,utRho16
1091,pheP,1203858,1203918,1203858,60,60,utRho16
1092,pheU,8725254,8725254,8725252,2,0,utRho16
1093,pheV,6220730,6220732,6220730,2,0,utRho16
1094,phnC,8650412,8650412,8650330,82,174,utRho16
1095,phoA,803414,803494,803414,80,482,utRho16
1096,phoB,834202,834284,834202,82,0,utRho16
1097,phoE,520316,520316,520200,116,816,utRho16
1098,phoH,2169730,2169984,2169730,254,506,utRho16
1099,phoP,2381016,2381016,2380894,122,1758,utRho16
1100,phoQ,2379880,2379880,2379552,328,1038,utRho16
1101,phoU,7815330,7815330,7815156,174,98,utRho16
1102,phr,1478842,1479014,1478842,172,70,utRho16
1103,pinE,2419054,2419370,2419054,316,896,utRho16
1104,pinQ,3267168,3267244,3267168,76,260,utRho16
1105,pinR,2867424,2867424,2867348,76,280,utRho16
1106,pitA,7275224,7275284,7275224,60,34,utRho16
1107,pitB,6272806,6272806,6272742,64,172,utRho16
1108,pka,5439862,5439906,5439862,44,438,utRho16
1109,plaP,4174476,4174476,4174124,352,276,utRho16
1110,pldA,8009628,8009724,8009628,96,1550,utRho16
1111,pldB,8018028,8018340,8018028,312,3108,utRho16
1112,plsB,8513196,8513196,8512932,264,224,utRho16
1113,pmbA,8915890,8915918,8915890,28,140,utRho16
1114,pmrD,4747148,4747148,4747076,72,46,utRho16
1115,pncB,1980828,1980828,1980712,116,0,utRho16
1116,pncC,5648788,5648788,5648692,96,0,utRho16
1117,pnp,6622652,6622652,6622336,316,192,utRho16
1118,pntA,3355950,3355950,3355806,144,36,utRho16
1119,pntB,3353096,3353096,3352720,376,80,utRho16
1120,polA,8093880,8093932,8093880,52,274,utRho16
1121,polB,131606,131606,131560,46,0,utRho16
1122,potD,2365700,2365700,2365658,42,30,utRho16
1123,potE,1436688,1436688,1436530,158,120,utRho16
1124,potF,1787268,1787568,1787268,300,406,utRho16
1125,poxB,1822152,1822152,1822098,54,182,utRho16
1126,ppa,8899372,8899372,8899304,68,56,utRho16
1127,ppc,8306380,8306380,8306196,184,654,utRho16
1128,ppdA,5928440,5928440,5928354,86,2786,utRho16
1129,ppdD,235410,235410,235098,312,308,utRho16
1130,pphA,3846770,3846770,3845938,832,4130,utRho16
1131,pphB,5719474,5719520,5719474,46,238,utRho16
1132,ppiA,6984898,6984898,6984594,304,220,utRho16
1133,ppiC,7919682,7919682,7919626,56,10,utRho16
1134,ppiD,923638,923830,923638,192,398,utRho16
1135,ppk,5245748,5246088,5245748,340,470,utRho16
1136,pppA,6228958,6228958,6228704,254,314,utRho16
1137,ppsA,3574322,3574322,3574224,98,0,utRho16
1138,ppsR,3574678,3574890,3574678,212,96,utRho16
1139,pptA,3065716,3066104,3065716,388,432,utRho16
1140,pqiA,2023318,2024002,2023318,684,98,utRho16
1141,prc,3830054,3830054,3829632,422,5752,utRho16
1142,preT,4467978,4468066,4467978,88,2654,utRho16
1143,prfC,9218688,9218828,9218688,140,1562,utRho16
1144,prkB,6968622,6968980,6968622,358,1500,utRho16
1145,prlC,7290476,7290476,7290364,112,514,utRho16
1146,prlF,6553944,6554004,6553944,60,690,utRho16
1147,proB,520432,520776,520432,344,564,utRho16
1148,proC,811372,811372,811288,84,82,utRho16
1149,proK,7417388,7417388,7417384,4,0,utRho16
1150,proL,4572414,4572422,4572414,8,0,utRho16
1151,proP,8660640,8661004,8660640,364,160,utRho16
1152,proS,437674,437674,437550,124,486,utRho16
1153,proV,5609126,5609630,5609126,504,3050,utRho16
1154,prpB,697292,697364,697292,72,226,utRho16
1155,prpR,696942,696942,696886,56,82,utRho16
1156,prs,2524354,2524354,2523750,604,29714,utRho16
1157,psd,8781276,8781276,8780720,556,1404,utRho16
1158,psiE,8480600,8480650,8480600,50,50,utRho16
1159,pspA,2736076,2736158,2736076,82,0,utRho16
1160,pspF,2736080,2736080,2735824,256,0,utRho16
1161,pspG,8525632,8525680,8525632,48,80,utRho16
1162,pssA,5445156,5445454,5445156,298,4724,utRho16
1163,pstB,7817112,7817112,7816732,380,276,utRho16
1164,pstC,7821084,7821084,7820796,288,192,utRho16
1165,pstS,23469408,23469408,23469150,258,462,utRho16
1166,psuG,4517114,4517114,4516734,380,4428,utRho16
1167,psuT,4514992,4514992,4514670,322,0,utRho16
1168,pth,2517084,2517084,2517026,58,16,utRho16
1169,ptrA,5918022,5918022,5917768,254,38,utRho16
1170,ptrB,3857730,3857730,3857678,52,2982,utRho16
1171,ptsG,2315252,2315738,2315252,486,2210,utRho16
1172,ptsH,5066996,5067528,5066996,532,3148,utRho16
1173,purA,8809328,8809374,8809328,46,24,utRho16
1174,purC,5195562,5195562,5195236,326,56,utRho16
1175,purD,8411972,8411972,8411862,110,154,utRho16
1176,purE,1106284,1106284,1106200,84,1062,utRho16
1177,purH,8415254,8415254,8415064,190,22,utRho16
1178,purL,5391178,5391178,5391086,92,350,utRho16
1179,purM,5242306,5242394,5242306,88,0,utRho16
1180,purR,3475378,3475688,3475378,310,322,utRho16
1181,purT,3861438,3861762,3861438,324,462,utRho16
1182,purU,2577512,2577512,2577248,264,278,utRho16
1183,putA,2157850,2157850,2157764,86,0,utRho16
1184,putP,2158336,2158610,2158336,274,210,utRho16
1185,puuA,2721936,2721936,2721816,120,0,utRho16
1186,puuC,2725456,2725486,2725456,30,0,utRho16
1187,puuD,2722104,2722240,2722104,136,0,utRho16
1188,puuP,2718746,2718746,2718374,372,1116,utRho16
1189,pykA,3874988,3875298,3874988,310,58,utRho16
1190,pykF,3510934,3511396,3510934,462,1048,utRho16
1191,pyrC,2245286,2245286,2245214,72,0,utRho16
1192,pyrD,2009464,2009536,2009464,72,78,utRho16
1193,pyrE,7631970,7631970,7631536,434,630,utRho16
1194,pyrF,2683740,2683842,2683740,102,278,utRho16
1195,pyrG,5819594,5819594,5819332,262,2168,utRho16
1196,pyrH,383624,383710,383624,86,644,utRho16
1197,pyrL,8945490,8945490,8945066,424,818,utRho16
1198,qmcA,1031646,1031646,1031546,100,736,utRho16
1199,qor,8528608,8528608,8528462,146,862,utRho16
1200,qseB,6339502,6339656,6339502,154,1144,utRho16
1201,queA,849970,850022,849970,52,632,utRho16
1202,queE,5811212,5811212,5810836,376,388,utRho16
1203,queF,5850642,5850696,5850642,54,116,utRho16
1204,queG,8788184,8788184,8788134,50,59610,utRho16
1205,racC,2835630,2835630,2835526,104,0,utRho16
1206,racR,2840898,2840898,2840482,416,122,utRho16
1207,raiA,5474208,5474308,5474208,100,62,utRho16
1208,rarD,8008594,8008594,8008356,238,892,utRho16
1209,ravA,7862256,7862256,7862186,70,68,utRho16
1210,rayT,495088,495274,495088,186,142,utRho16
1211,rbn,4763162,4763216,4763162,54,0,utRho16
1212,rbsD,7866644,7866702,7866644,58,48,utRho16
1213,rcnA,4371654,4371834,4371654,180,86,utRho16
1214,rcnB,4373768,4373920,4373768,152,54,utRho16
1215,rcnR,4371806,4371806,4371592,214,142,utRho16
1216,rcsA,4047672,4047936,4047672,264,2412,utRho16
1217,rcsB,4631390,4632354,4631390,964,320,utRho16
1218,rcsC,4640162,4640162,4639656,506,296,utRho16
1219,rcsD,4626904,4626976,4626904,72,196,utRho16
1220,rdgB,6193240,6193362,6193240,122,500,utRho16
1221,rdlA,2538646,2538646,2538646,0,0,utRho16
1222,rdlB,2539712,2539716,2539712,4,16,utRho16
1223,rdlC,2540782,2540786,2540782,4,0,utRho16
1224,rdlD,7400272,7400272,7400272,0,0,utRho16
1225,rdoA,8084782,8084830,8084782,48,58,utRho16
1226,recA,11295276,11295276,11295076,200,192,utRho16
1227,recC,5925014,5925014,5924856,158,112,utRho16
1228,recF,7763722,7763722,7762442,1280,6640,utRho16
1229,recN,5503518,5503590,5503518,72,0,utRho16
1230,recQ,8011666,8011728,8011666,62,132,utRho16
1231,relA,5828554,5828554,5827302,1252,374,utRho16
1232,relB,3291806,3291806,3291744,62,0,utRho16
1233,rem,3289950,3289950,3289804,146,0,utRho16
1234,rep,7921294,7921354,7921294,60,14,utRho16
1235,rfaD,7587730,7587974,7587730,244,522,utRho16
1236,rfaE,6393852,6393852,6393506,346,304,utRho16
1237,rfaH,8049930,8049930,8049642,288,2262,utRho16
1238,rfbX,4219436,4219436,4219168,268,434,utRho16
1239,rfe,7935600,7935832,7935600,232,172,utRho16
1240,rhaB,8194944,8194944,8194896,48,70,utRho16
1241,rhaD,8188770,8188770,8188544,226,170,utRho16
1242,rhaS,8195422,8195472,8195422,50,54,utRho16
1243,rhaT,8201132,8201132,8201050,82,148,utRho16
1244,rhlE,1661566,1661744,1661566,178,90,utRho16
1245,rhoL,47593944,47594772,47593944,828,68340,utRho16
1246,rhsB,7238006,7238384,7238006,378,2324,utRho16
1247,rhsC,1458758,1459166,1458758,408,0,utRho16
1248,rhsD,1046132,1046522,1046132,390,64,utRho16
1249,rhtA,1700608,1700608,1700194,414,286,utRho16
1250,rhtC,8015478,8015514,8015478,36,1426,utRho16
1251,ribA,2678468,2678468,2678320,148,246,utRho16
1252,ribC,3486916,3486916,3486484,432,3236,utRho16
1253,ribE,869008,869294,869008,286,3418,utRho16
1254,ribF,42766,42814,42766,48,14,utRho16
1255,ridA,8941892,8941892,8941826,66,194,utRho16
1256,rihA,1369204,1369204,1368824,380,6602,utRho16
1257,rihB,4510504,4510504,4510372,132,238,utRho16
1258,rimJ,2251044,2251124,2251044,80,102,utRho16
1259,rimK,1783752,1783934,1783752,182,588,utRho16
1260,rimL,2997486,2997876,2997486,390,64,utRho16
1261,rimO,1756140,1756140,1756070,70,70,utRho16
1262,rimP,6636350,6636350,6636012,338,220,utRho16
1263,rlmA,3814172,3814172,3814120,52,1128,utRho16
1264,rlmD,5830086,5830086,5830000,86,22,utRho16
1265,rlmE,6655520,6655520,6655328,192,930,utRho16
1266,rlmF,1684384,1684664,1684384,280,24,utRho16
1267,rlmG,6471784,6471784,6471750,34,32,utRho16
1268,rlmI,2060002,2060002,2059938,64,88,utRho16
1269,rlmJ,7290700,7290770,7290700,70,0,utRho16
1270,rlmL,2015344,2015688,2015344,344,1030,utRho16
1271,rlpA,1330444,1330444,1330380,64,56,utRho16
1272,rluA,120900,120900,120692,208,222,utRho16
1273,rluF,8460324,8460708,8460324,384,54,utRho16
1274,rmf,2031006,2031430,2031006,424,904,utRho16
1275,rna,1290068,1290068,1290006,62,32,utRho16
1276,rnb,2698258,2698258,2697824,434,4810,utRho16
1277,rnc,10816892,10816892,10816252,640,5520,utRho16
1278,rnd,3776122,3776122,3775982,140,4,utRho16
1279,rne,2289746,2289746,2288734,1012,3998,utRho16
1280,rnhA,472082,472082,472004,78,726,utRho16
1281,rnk,1288360,1288360,1287934,426,88,utRho16
1282,rnlA,5531788,5531836,5531788,48,320,utRho16
1283,rnlB,5533414,5533968,5533414,554,604,utRho16
1284,rnpB,19623552,19623552,19623552,0,0,utRho16
1285,rob,9270706,9270706,9270620,86,160,utRho16
1286,rodZ,5285868,5285868,5285688,180,16,utRho16
1287,rpe,7030306,7030306,7030118,188,24,utRho16
1288,rph,15266320,15266320,15266196,124,0,utRho16
1289,rpiA,6118706,6118706,6118650,56,1334,utRho16
1290,rpiB,8626514,8626700,8626514,186,440,utRho16
1291,rpiR,8626274,8626274,8625982,292,90,utRho16
1292,rplJ,8359246,8359992,8359246,746,4152,utRho16
1293,rplK,8356708,8356894,8356708,186,870,utRho16
1294,rplM,6757344,6757344,6757302,42,4464,utRho16
1295,rplN,6896444,6896444,6896298,146,6356,utRho16
1296,rplS,5489284,5489284,5489060,224,5224,utRho16
1297,rplT,7199052,7199052,7198996,56,816,utRho16
1298,rplU,6667036,6667036,6666902,134,0,utRho16
1299,rplY,4564866,4565034,4564866,168,68,utRho16
1300,rpmA,6666450,6666450,6666238,212,346,utRho16
1301,rpmB,15247980,15247980,15246696,1284,49352,utRho16
1302,rpmE,8253816,8254026,8253816,210,696,utRho16
1303,rpmF,2294676,2294734,2294676,58,14378,utRho16
1304,rpmH,7768130,7768672,7768130,542,3508,utRho16
1305,rpmI,3600854,3600854,3599998,856,9032,utRho16
1306,rpoB,8362126,8362490,8362126,364,988,utRho16
1307,rpoD,6424946,6426094,6424946,1148,21742,utRho16
1308,rpoE,5420372,5420372,5420024,348,46,utRho16
1309,rpoH,7202006,7202006,7201566,440,2702,utRho16
1310,rpoN,6689324,6689434,6689324,110,38,utRho16
1311,rpoS,5736236,5736236,5735102,1134,2968,utRho16
1312,rpoZ,7644154,7644212,7644154,58,272,utRho16
1313,rppH,5937986,5937986,5937954,32,0,utRho16
1314,rprA,3540744,3540744,3540744,0,0,utRho16
1315,rpsA,1923434,1923990,1923434,556,76834,utRho16
1316,rpsF,8850050,8850236,8850050,186,13926,utRho16
1317,rpsI,6756580,6756580,6756414,166,5062,utRho16
1318,rpsJ,6906884,6906884,6906540,344,3886,utRho16
1319,rpsL,6949242,6949242,6949104,138,760,utRho16
1320,rpsM,6885130,6885130,6884942,188,880,utRho16
1321,rpsO,13247144,13247144,13246736,408,460,utRho16
1322,rpsP,5492508,5492508,5492370,138,246,utRho16
1323,rpsT,42420,42420,42156,264,384,utRho16
1324,rpsU,12842584,12843124,12842584,540,1872,utRho16
1325,rraA,8238716,8238716,8238660,56,224,utRho16
1326,rraB,8956768,8956946,8956768,178,422,utRho16
1327,rrsA,8070478,8071062,8070478,584,4734,utRho16
1328,rrsB,16665468,16666636,16665468,1168,9892,utRho16
1329,rrsC,7883032,7883616,7883032,584,4838,utRho16
1330,rrsD,6858094,6858094,6857524,570,1084,utRho16
1331,rrsE,8415726,8416294,8415726,568,664,utRho16
1332,rrsG,5462896,5462896,5462314,582,3688,utRho16
1333,rrsH,446970,447542,446970,572,1076,utRho16
1334,rsd,8393908,8393908,8393616,292,252,utRho16
1335,rseA,5419264,5419264,5418808,456,6,utRho16
1336,rseP,392940,393092,392940,152,106,utRho16
1337,rseX,4067298,4067298,4067298,0,0,utRho16
1338,rsfS,1338144,1338144,1338072,72,74,utRho16
1339,rsgA,8783132,8783132,8783018,114,52,utRho16
1340,rsmA,105176,105176,104860,316,1526,utRho16
1341,rsmB,6869982,6870414,6869982,432,132,utRho16
1342,rsmC,9215736,9215736,9215400,336,138,utRho16
1343,rsmD,7208594,7208786,7208594,192,26,utRho16
1344,rsmE,6182036,6182268,6182036,232,760,utRho16
1345,rsmG,7847512,7847512,7847360,152,2330,utRho16
1346,rsmH,180020,180188,180020,168,140,utRho16
1347,rsmI,6587106,6587106,6586670,436,1206,utRho16
1348,rssA,2578212,2578412,2578212,200,178,utRho16
1349,rssB,2580440,2580484,2580440,44,184,utRho16
1350,rstA,3364276,3364300,3364276,24,0,utRho16
1351,rsuA,4561096,4561096,4560966,130,120,utRho16
1352,rsxA,3411510,3411534,3411510,24,36,utRho16
1353,rtcA,7114004,7114004,7113698,306,1914,utRho16
1354,rtcB,7116214,7116214,7116158,56,88,utRho16
1355,rtn,4541356,4541452,4541356,96,0,utRho16
1356,rutA,2148052,2148052,2148022,30,0,utRho16
1357,rutG,2140090,2140090,2139678,412,8,utRho16
1358,rutR,2148226,2148484,2148226,258,750,utRho16
1359,ruvA,7784096,7784096,7783904,192,40,utRho16
1360,ruvB,7782176,7782176,7781424,752,496,utRho16
1361,ruvC,3894878,3894878,3894752,126,110,utRho16
1362,rybB,1776114,1776114,1776114,0,0,utRho16
1363,rydB,3529860,3529860,3529322,538,232,utRho16
1364,rydC,2983012,2983012,2983012,0,0,utRho16
1365,ryfA,5307398,5307710,5307398,312,140,utRho16
1366,ryfD,5468590,5468590,5468590,0,0,utRho16
1367,ryhB,7162032,7162032,7162032,0,0,utRho16
1368,ryjA,8556132,8556132,8556132,0,0,utRho16
1369,ryjB,9055954,9055954,9055954,0,0,utRho16
1370,sad,3229598,3229598,3229406,192,54,utRho16
1371,safA,3168056,3168056,3167918,138,676,utRho16
1372,sanA,4465368,4465756,4465368,388,336,utRho16
1373,sapF,2705314,2705314,2705268,46,144,utRho16
1374,sbcB,4165456,4165512,4165456,56,0,utRho16
1375,sbcC,831694,831694,831506,188,80,utRho16
1376,sbcD,833954,833954,833904,50,100,utRho16
1377,sbmA,793106,793278,793106,172,1604,utRho16
1378,sbmC,4162650,4162650,4162524,126,74,utRho16
1379,sdaA,3793618,3793864,3793618,246,126,utRho16
1380,sdaC,5856070,5856458,5856070,388,1934,utRho16
1381,sdhC,1509916,1510354,1509916,438,30778,utRho16
1382,sdhD,1510808,1511120,1510808,312,7140,utRho16
1383,sdiA,3993834,3993834,3993664,170,370,utRho16
1384,secE,8354354,8354716,8354354,362,64,utRho16
1385,secG,6645180,6645180,6645010,170,808,utRho16
1386,selA,7522594,7522594,7522498,96,1574,utRho16
1387,selB,7519850,7519850,7519722,128,162,utRho16
1388,selC,7672396,7672444,7672396,48,126,utRho16
1389,selD,3696058,3696058,3696016,42,732,utRho16
1390,seqA,1425884,1425974,1425884,90,118,utRho16
1391,serA,6117098,6117098,6116820,278,438,utRho16
1392,serB,9249712,9249790,9249712,78,66,utRho16
1393,serC,3830380,3830612,3830380,232,0,utRho16
1394,serS,1878730,1878856,1878730,126,834,utRho16
1395,serT,2063438,2063438,2063424,14,0,utRho16
1396,serU,4087124,4087124,4087114,10,130,utRho16
1397,serV,5637394,5637394,5637290,104,116,utRho16
1398,serW,1852014,1852014,1851942,72,90,utRho16
1399,serX,2195352,2195352,2195304,48,50,utRho16
1400,setB,4527426,4527726,4527426,300,102,utRho16
1401,setC,7673488,7673906,7673488,418,2052,utRho16
1402,sfmA,1116124,1116424,1116124,300,0,utRho16
1403,sfmC,1117606,1117948,1117606,342,148,utRho16
1404,sfsA,323030,323030,322972,58,452,utRho16
1405,sfsB,6669592,6669818,6669592,226,830,utRho16
1406,sgrR,154676,154676,154598,78,0,utRho16
1407,sgrS,154734,154734,154734,0,0,utRho16
1408,shiA,4107068,4107286,4107068,218,102,utRho16
1409,sibA,4306622,4306622,4306622,0,0,utRho16
1410,sibB,4307292,4307292,4307292,0,0,utRho16
1411,sibC,6113702,6113702,6113702,0,0,utRho16
1412,sibD,6389730,6389730,6389730,0,0,utRho16
1413,sibE,6390480,6390480,6390480,0,0,utRho16
1414,sixA,4913998,4913998,4913624,374,18,utRho16
1415,slp,7307872,7307922,7307872,50,136,utRho16
1416,slt,9261400,9261466,9261400,66,58,utRho16
1417,slyA,3442028,3442028,3441648,380,278,utRho16
1418,slyB,3439496,3439752,3439496,256,0,utRho16
1419,slyD,6957398,6957398,6956994,404,364,utRho16
1420,slyX,6954862,6955280,6954862,418,2342,utRho16
1421,smf,6867372,6867372,6867120,252,668,utRho16
1422,smpB,5509534,5509792,5509534,258,732,utRho16
1423,smrA,2811872,2811958,2811872,86,356,utRho16
1424,smrB,4896872,4897212,4896872,340,802,utRho16
1425,smtA,1946808,1947074,1946808,266,58,utRho16
1426,sodA,8201518,8201620,8201518,102,2002,utRho16
1427,sodB,3470646,3470756,3470646,110,1196,utRho16
1428,sodC,3449358,3449358,3449310,48,76,utRho16
1429,sohB,2658568,2658664,2658568,96,288,utRho16
1430,sokB,2984232,2984238,2984232,6,164,utRho16
1431,solA,2241218,2241218,2241172,46,42,utRho16
1432,soxR,8554894,8554938,8554894,44,84,utRho16
1433,soxS,8554846,8554846,8554766,80,84,utRho16
1434,speA,6172096,6172096,6171822,274,400,utRho16
1435,speB,6167892,6167892,6167594,298,210,utRho16
1436,speC,6218350,6218350,6218310,40,0,utRho16
1437,spf,8099798,8099798,8099798,0,0,utRho16
1438,sppA,3697422,3697674,3697422,252,440,utRho16
1439,spy,3651376,3651376,3651250,126,0,utRho16
1440,sra,3112092,3112092,3111926,166,36,utRho16
1441,sraB,2293178,2293178,2293178,0,0,utRho16
1442,sraC,3846132,3846132,3846132,0,0,utRho16
1443,srlA,5651582,5651664,5651582,82,200,utRho16
1444,srlR,5657720,5658094,5657720,374,1512,utRho16
1445,srmB,5425752,5425792,5425752,40,24,utRho16
1446,sroA,151216,151216,151216,0,0,utRho16
1447,sroG,6369436,6369436,6369436,0,0,utRho16
1448,sroH,8380974,8380974,8380974,0,0,utRho16
1449,ssb,8548022,8548250,8548022,228,124,utRho16
1450,sseA,5304782,5304988,5304782,206,3122,utRho16
1451,sspA,6755138,6755138,6754840,298,268,utRho16
1452,ssrA,5511014,5511186,5511014,172,22,utRho16
1453,ssrS,12223036,12223932,12223036,896,2912,utRho16
1454,sstT,6479726,6479888,6479726,162,88,utRho16
1455,ssuB,1988282,1988282,1988088,194,172,utRho16
1456,ssuE,1995126,1995126,1995024,102,0,utRho16
1457,sthA,8321604,8321604,8321580,24,1494,utRho16
1458,stpA,5597156,5597156,5596990,166,60,utRho16
1459,sucA,3034344,3034824,3034344,480,5172,utRho16
1460,sufA,3528836,3528836,3528772,64,88,utRho16
1461,sufE,3518962,3518962,3518580,382,250,utRho16
1462,sugE,8753588,8753750,8753588,162,1096,utRho16
1463,sulA,2041894,2041894,2041838,56,1810,utRho16
1464,syd,5850738,5850738,5850560,178,228,utRho16
1465,symE,9159834,9159834,9159680,154,378,utRho16
1466,symR,9159670,9159670,9159670,0,0,utRho16
1467,tabA,8949566,8949724,8949566,158,102,utRho16
1468,talA,5157140,5157332,5157140,192,0,utRho16
1469,talB,16382,16476,16382,94,3772,utRho16
1470,tam,3214442,3214692,3214442,250,84,utRho16
1471,tamA,8884540,8884764,8884540,224,438,utRho16
1472,tar,3945432,3945432,3945382,50,70,utRho16
1473,tas,5943138,5943194,5943138,56,1536,utRho16
1474,tatA,16087636,16087780,16087636,144,228,utRho16
1475,tatE,1317742,1317894,1317742,152,88,utRho16
1476,tauA,770410,770464,770410,54,0,utRho16
1477,tdcA,6534186,6534186,6534130,56,0,utRho16
1478,tdcG,6519652,6519652,6519298,354,1130,utRho16
1479,tdcR,6534380,6534760,6534380,380,114,utRho16
1480,tdk,2586986,2587054,2586986,68,0,utRho16
1481,tehA,3001072,3001146,3001072,74,0,utRho16
1482,tesA,1039898,1039898,1039530,368,350,utRho16
1483,tesB,950402,950402,950322,80,0,utRho16
1484,tfaE,2418532,2418532,2418238,294,898,utRho16
1485,tfaQ,3269912,3269912,3269770,142,182,utRho16
1486,tff,379424,379256,379424,168,38,utRho16
1487,tgt,852110,852274,852110,164,20,utRho16
1488,thiD,4369346,4369346,4369032,314,122,utRho16
1489,thiI,882936,883098,882936,162,254,utRho16
1490,thiM,4370902,4370902,4370602,300,884,utRho16
1491,thiQ,146170,146170,145854,316,2438,utRho16
1492,thrL,592,760,592,168,188,utRho16
1493,thrS,7210932,7210932,7210280,652,576,utRho16
1494,thrU,8350762,8350776,8350762,14,60,utRho16
1495,thrV,6847414,6847414,6847310,104,135762,utRho16
1496,thrW,525682,525742,525682,60,1572,utRho16
1497,thyA,5930696,5930696,5930310,386,1830,utRho16
1498,tig,909986,910266,909986,280,542,utRho16
1499,tisB,7706674,7707106,7706674,432,1260,utRho16
1500,tktA,6163414,6163414,6163270,144,138,utRho16
1501,tktB,5158616,5159272,5158616,656,1350,utRho16
1502,tldD,6784368,6784368,6784056,312,154,utRho16
1503,tmcA,5191876,5191876,5191718,158,706,utRho16
1504,tnaC,15553644,15553740,15553644,96,724,utRho16
1505,tolB,1555074,1555480,1555074,406,220,utRho16
1506,tolC,6356008,6356230,6356008,222,518,utRho16
1507,tomB,961588,961588,961416,172,1868,utRho16
1508,tonB,2622108,2622178,2622108,70,18,utRho16
1509,topA,2661578,2662096,2661578,518,128,utRho16
1510,torC,2116112,2116168,2116112,56,262,utRho16
1511,torR,2115968,2115968,2115908,60,328,utRho16
1512,torS,2112364,2112364,2112356,8,0,utRho16
1513,torT,2112414,2112522,2112414,108,0,utRho16
1514,tpiA,8223138,8223138,8223014,124,376,utRho16
1515,tppB,3425342,3425538,3425342,196,5532,utRho16
1516,tpr,2574376,2574376,2574376,0,0,utRho16
1517,tpx,2777688,2777688,2777622,66,378,utRho16
1518,tqsA,3347780,3347826,3347780,46,0,utRho16
1519,treA,2494850,2494850,2494752,98,636,utRho16
1520,treB,8932420,8932420,8932360,60,150,utRho16
1521,treF,7339102,7339184,7339102,82,188,utRho16
1522,treR,8934694,8934694,8934492,202,0,utRho16
1523,trg,2984878,2984940,2984878,62,50,utRho16
1524,trkG,2847342,2847564,2847342,222,578,utRho16
1525,trmA,8326590,8326590,8326540,50,72,utRho16
1526,trpA,2634678,2634678,2634444,234,456,utRho16
1527,trpC,2639888,2639888,2639570,318,0,utRho16
1528,trpL,5292432,5292432,5292328,104,28,utRho16
1529,trpR,9265408,9265520,9265408,112,150,utRho16
1530,trpS,7027394,7027394,7027276,118,2008,utRho16
1531,trpT,7893560,7893914,7893560,354,90996,utRho16
1532,trxA,7931294,7931522,7931294,228,346,utRho16
1533,trxB,1864156,1864156,1864100,56,36,utRho16
1534,trxC,5437350,5437470,5437350,120,544,utRho16
1535,tsaD,6421256,6421256,6421086,170,18,utRho16
1536,tsgA,6985038,6985136,6985038,98,334,utRho16
1537,tsr,9182824,9183314,9182824,490,4462,utRho16
1538,tsx,864490,864490,864026,464,852,utRho16
1539,ttcA,2823970,2823970,2823896,74,3844,utRho16
1540,ttdA,6412848,6412926,6412848,78,176,utRho16
1541,ttdR,6412760,6412760,6412512,248,472,utRho16
1542,tufA,6943448,6943448,6942658,790,123096,utRho16
1543,tus,3368346,3368518,3368346,172,202,utRho16
1544,tusA,7218040,7218040,7217992,48,208,utRho16
1545,tusB,6950218,6950218,6949930,288,86,utRho16
1546,tynA,2902996,2902996,2902698,298,0,utRho16
1547,typA,8116460,8116814,8116460,354,4242,utRho16
1548,tyrB,8534164,8534228,8534164,64,2446,utRho16
1549,tyrP,3979004,3979362,3979004,358,1372,utRho16
1550,tyrR,2773384,2773440,2773384,56,174,utRho16
1551,tyrS,3434566,3434566,3434444,122,0,utRho16
1552,tyrT,2575330,2575330,2575244,86,62,utRho16
1553,uacT,6062378,6062734,6062378,356,728,utRho16
1554,ubiC,8504886,8505012,8504886,126,226,utRho16
1555,ubiD,8049618,8049976,8049618,358,2434,utRho16
1556,ubiE,8037494,8037710,8037494,216,178,utRho16
1557,ubiG,4679078,4679134,4679078,56,6,utRho16
1558,ucpA,5089342,5089342,5089246,96,106,utRho16
1559,udp,8032782,8032862,8032782,80,170,utRho16
1560,ugd,4199470,4199470,4199226,244,0,utRho16
1561,ugpB,7184852,7184852,7184650,202,1956,utRho16
1562,ugpQ,7176600,7176600,7176226,374,58,utRho16
1563,uhpT,7694396,7694396,7694334,62,410,utRho16
1564,uidA,3392304,3392304,3392142,162,114,utRho16
1565,uidC,3386012,3386012,3385702,310,0,utRho16
1566,uidR,3394150,3394150,3394104,46,0,utRho16
1567,ulaA,8839854,8839960,8839854,106,314,utRho16
1568,ulaG,8839350,8839350,8839250,100,180,utRho16
1569,ulaR,8837124,8837124,8836906,218,94,utRho16
1570,umpG,5741372,5741372,5740548,824,490,utRho16
1571,umpH,1400704,1400704,1400652,52,0,utRho16
1572,umuD,2461476,2461534,2461476,58,0,utRho16
1573,ung,5433476,5433508,5433476,32,268,utRho16
1574,uof,2843316,2843316,2842900,416,3288,utRho16
1575,upp,5241818,5241818,5241744,74,176,utRho16
1576,usg,4873780,4873780,4873298,482,74,utRho16
1577,ushA,1009772,1009828,1009772,56,104,utRho16
1578,uspA,7279966,7280222,7279966,256,410,utRho16
1579,uspB,7279696,7279696,7279440,256,384,utRho16
1580,uspC,3959172,3959506,3959172,334,24,utRho16
1581,uspE,2797318,2797318,2797244,74,0,utRho16
1582,uspF,2871282,2871282,2871238,44,70,utRho16
1583,uspG,1283806,1283806,1283734,72,1550,utRho16
1584,uvrA,8547872,8547872,8547742,130,394,utRho16
1585,uvrB,1626304,1627052,1626304,748,1798,utRho16
1586,uvrC,3989758,3989758,3989412,346,176,utRho16
1587,uvrD,7995814,7995966,7995814,152,584,utRho16
1588,uvrY,3990812,3990812,3990718,94,192,utRho16
1589,uxaB,3221474,3221474,3221360,114,0,utRho16
1590,uxaC,6489714,6489714,6489482,232,124,utRho16
1591,uxuA,9103036,9103272,9103036,236,2778,utRho16
1592,uxuR,9108916,9109152,9108916,236,748,utRho16
1593,valS,8967854,8967854,8967674,180,324,utRho16
1594,valU,5041848,5041862,5041848,14,22,utRho16
1595,valV,3492830,3492870,3492830,40,140,utRho16
1596,ves,3649968,3649968,3649874,94,84,utRho16
1597,waaA,7616512,7617080,7616512,568,892,utRho16
1598,waaH,7580298,7580298,7580162,136,216,utRho16
1599,waaQ,7616476,7616476,7616196,280,312,utRho16
1600,waaU,7598996,7598996,7598624,372,188,utRho16
1601,waaY,7602272,7602272,7601930,342,3592,utRho16
1602,wbbH,4214888,4214888,4214452,436,570,utRho16
1603,wbbK,4209212,4209212,4209018,194,322,utRho16
1604,wcaM,4231868,4231868,4231792,76,0,utRho16
1605,wrbA,2135516,2135516,2135416,100,84,utRho16
1606,wza,4275166,4275166,4274486,680,120,utRho16
1607,wzxC,4240674,4240674,4240316,358,116,utRho16
1608,wzzB,4196950,4196950,4196602,348,0,utRho16
1609,xanP,7657642,7657890,7657642,248,320,utRho16
1610,xanQ,6048520,6048702,6048520,182,176,utRho16
1611,xapA,5049820,5049820,5049756,64,2,utRho16
1612,xapR,10090252,10090252,10089908,344,0,utRho16
1613,xdhA,6000514,6000690,6000514,176,896,utRho16
1614,xerD,6079702,6079702,6079486,216,232,utRho16
1615,xseA,5268394,5268464,5268394,70,92,utRho16
1616,xseB,882746,882746,882686,60,190,utRho16
1617,xthA,3664798,3664856,3664798,58,0,utRho16
1618,xylA,7461614,7461614,7461530,84,10890,utRho16
1619,xylE,8484540,8484540,8484508,32,0,utRho16
1620,xylF,7462138,7462262,7462138,124,338,utRho16
1621,xylR,7469812,7469958,7469812,146,166,utRho16
1622,yaaA,13230,13230,12918,312,142,utRho16
1623,yaaI,23876,23876,23572,304,606,utRho16
1624,yaaJ,16034,16034,15918,116,100,utRho16
1625,yaaU,91184,91614,91184,430,856,utRho16
1626,yaaW,23084,23084,22712,372,514,utRho16
1627,yaaX,10060,10468,10060,408,134,utRho16
1628,yabI,142542,142702,142542,160,1022,utRho16
1629,yacC,273880,273880,273834,46,1110,utRho16
1630,yacH,262932,262932,262520,412,92,utRho16
1631,yacL,268678,268776,268678,98,550,utRho16
1632,yadD,293796,293936,293796,140,216,utRho16
1633,yadE,289930,290162,289930,232,614,utRho16
1634,yadN,314110,314110,313766,344,770,utRho16
1635,yadS,355572,355572,355248,324,5382,utRho16
1636,yadV,312470,312470,312402,68,354,utRho16
1637,yaeF,434270,434270,434006,264,40,utRho16
1638,yaeP,428374,428374,428250,124,868,utRho16
1639,yaeQ,428176,428582,428176,406,1474,utRho16
1640,yaeR,423716,423754,423716,38,0,utRho16
1641,yafC,462166,462166,461762,404,76,utRho16
1642,yafD,462128,462244,462128,116,220,utRho16
1643,yafK,491986,491986,491610,376,842,utRho16
1644,yafL,493282,493424,493282,142,50,utRho16
1645,yafN,503938,504010,503938,72,138,utRho16
1646,yafS,469568,469632,469568,64,510,utRho16
1647,yafT,474470,474670,474470,200,26,utRho16
1648,yafV,480432,480432,480378,54,252,utRho16
1649,yafZ,536052,536052,536010,42,440,utRho16
1650,yagE,564446,564556,564446,110,2262,utRho16
1651,yagG,570414,570790,570414,376,972,utRho16
1652,yagI,578384,578384,578324,60,432,utRho16
1653,yagK,586236,586236,585896,340,3170,utRho16
1654,yagL,588062,588062,587836,226,1204,utRho16
1655,yagN,591342,591342,591158,184,378,utRho16
1656,yahA,663746,664742,663746,996,2594,utRho16
1657,yahC,670136,670136,670044,92,2722,utRho16
1658,yahE,671478,671850,671478,372,1152,utRho16
1659,yahM,690504,690808,690504,304,232,utRho16
1660,yahN,692872,692872,692674,198,1210,utRho16
1661,yahO,692864,692968,692864,104,196,utRho16
1662,yaiE,816296,816354,816296,58,44,utRho16
1663,yaiI,811396,811528,811396,132,66,utRho16
1664,yaiO,761946,761946,761684,262,402,utRho16
1665,yaiP,767970,767970,767870,100,80,utRho16
1666,yaiS,769660,769660,769232,428,370,utRho16
1667,yaiV,788922,788922,788922,0,0,utRho16
1668,yaiY,799094,799094,798666,428,94,utRho16
1669,yaiZ,798888,799186,798888,298,726,utRho16
1670,yajC,854410,854574,854410,164,598,utRho16
1671,yajD,860938,861210,860938,272,468,utRho16
1672,yajI,866068,866068,865702,366,62,utRho16
1673,yajL,887496,887496,887282,214,492,utRho16
1674,yajQ,889316,889366,889316,50,42,utRho16
1675,yajR,893374,893374,893332,42,218,utRho16
1676,ybaB,987418,988152,987418,734,2560,utRho16
1677,ybaL,1006590,1006590,1006476,114,344,utRho16
1678,ybaM,980648,980648,980542,106,338,utRho16
1679,ybaN,981436,981764,981436,328,324,utRho16
1680,ybaO,936704,936766,936704,62,0,utRho16
1681,ybaP,1016568,1016568,1016160,408,800,utRho16
1682,ybaQ,1016348,1016436,1016348,88,96,utRho16
1683,ybaS,1023146,1023282,1023146,136,436,utRho16
1684,ybaV,927504,927874,927504,370,0,utRho16
1685,ybaY,950490,950758,950490,268,540,utRho16
1686,ybbB,1062724,1062724,1062452,272,246,utRho16
1687,ybbJ,1030154,1030154,1029718,436,1502,utRho16
1688,ybbL,1031784,1031838,1031784,54,0,utRho16
1689,ybbN,1037136,1037136,1036558,578,2164,utRho16
1690,ybbO,1038658,1038658,1038298,360,530,utRho16
1691,ybbY,1080718,1081130,1080718,412,330,utRho16
1692,ybcH,1176140,1176140,1175962,178,640,utRho16
1693,ybcI,1113264,1113264,1113106,158,1688,utRho16
1694,ybcJ,1114050,1114050,1113746,304,120,utRho16
1695,ybcK,1137502,1137804,1137502,302,884,utRho16
1696,ybcL,1141690,1141786,1141690,96,28,utRho16
1697,ybcN,1144628,1144932,1144628,304,290,utRho16
1698,ybcQ,1147548,1147912,1147548,364,1880,utRho16
1699,ybcW,1159610,1159760,1159610,150,0,utRho16
1700,ybdD,1263982,1264364,1263982,382,1246,utRho16
1701,ybdF,1212106,1212106,1211772,334,438,utRho16
1702,ybdH,1267048,1267048,1266954,94,122,utRho16
1703,ybdJ,1212822,1212822,1212398,424,230,utRho16
1704,ybdK,1215122,1215122,1214766,356,1950,utRho16
1705,ybdL,1267114,1267172,1267114,58,98,utRho16
1706,ybdM,1271110,1271110,1270752,358,510,utRho16
1707,ybdN,1273372,1273372,1273138,234,166,utRho16
1708,ybdR,1283844,1284176,1283844,332,1634,utRho16
1709,ybeD,1325412,1325412,1325284,128,258,utRho16
1710,ybeF,1323090,1323090,1322756,334,1020,utRho16
1711,ybeL,1349986,1350036,1349986,50,460,utRho16
1712,ybeQ,1353412,1353412,1353094,318,44,utRho16
1713,ybeR,1353120,1353422,1353120,302,30,utRho16
1714,ybeT,1358832,1358832,1358812,20,0,utRho16
1715,ybeU,1358924,1359016,1358924,92,0,utRho16
1716,ybeZ,1386938,1386938,1386834,104,2532,utRho16
1717,ybfA,1458074,1458268,1458074,194,406,utRho16
1718,ybfE,1423878,1423878,1423796,82,428,utRho16
1719,ybfF,1425692,1425692,1425604,88,50,utRho16
1720,ybfH,1433282,1433282,1433194,88,44,utRho16
1721,ybgA,1477840,1478002,1477840,162,48,utRho16
1722,ybgC,1549288,1549504,1549288,216,182,utRho16
1723,ybgD,1505916,1505916,1505590,326,6988,utRho16
1724,ybgI,1485238,1485654,1485238,416,2,utRho16
1725,ybgO,1498370,1498370,1497964,406,294,utRho16
1726,ybgS,1570992,1570992,1570634,358,0,utRho16
1727,ybhA,1597184,1597184,1596862,322,0,utRho16
1728,ybhB,1616070,1616070,1615818,252,230,utRho16
1729,ybhC,1614642,1614642,1614562,80,798,utRho16
1730,ybhD,1601418,1601418,1601276,142,0,utRho16
1731,ybhH,1601104,1601518,1601104,414,26,utRho16
1732,ybhK,1633384,1633384,1633294,90,170,utRho16
1733,ybhM,1641556,1641586,1641556,30,0,utRho16
1734,ybhN,1645296,1645296,1644996,300,320,utRho16
1735,ybhQ,1649202,1649260,1649202,58,892,utRho16
1736,ybiA,1665920,1665920,1665900,20,0,utRho16
1737,ybiI,1676968,1676968,1676912,56,460,utRho16
1738,ybiO,1691328,1691328,1690960,368,1590,utRho16
1739,ybiP,1705252,1705252,1705194,58,990,utRho16
1740,ybiS,1711572,1711572,1711488,84,166,utRho16
1741,ybiT,1711894,1711926,1711894,32,0,utRho16
1742,ybiU,1718212,1718212,1718122,90,106,utRho16
1743,ybiV,1720176,1720176,1720056,120,0,utRho16
1744,ybiW,1725566,1725566,1725212,354,4136,utRho16
1745,ybiX,1678548,1678548,1678414,134,66,utRho16
1746,ybjC,1781784,1781826,1781784,42,40,utRho16
1747,ybjE,1830154,1830154,1829714,440,942,utRho16
1748,ybjG,1767016,1767016,1766776,240,1860,utRho16
1749,ybjL,1779882,1779882,1779638,244,196,utRho16
1750,ybjM,1779770,1780178,1779770,408,548,utRho16
1751,ybjO,1795704,1795978,1795704,274,56,utRho16
1752,ybjP,1809046,1809046,1808934,112,94,utRho16
1753,ybjQ,1809034,1809186,1809034,152,0,utRho16
1754,ybjS,1813796,1813796,1813506,290,378,utRho16
1755,ybjX,1838206,1838206,1838168,38,0,utRho16
1756,ycaD,1891438,1891742,1891438,304,34,utRho16
1757,ycaI,1928210,1928640,1928210,430,64,utRho16
1758,ycaK,1899094,1899336,1899094,242,288,utRho16
1759,ycaL,1920264,1920528,1920264,264,34,utRho16
1760,ycaM,1894240,1894458,1894240,218,168,utRho16
1761,ycaR,1941284,1941346,1941284,62,1332,utRho16
1762,ycbB,1961862,1962094,1961862,232,254,utRho16
1763,ycbJ,1943344,1943504,1943344,160,0,utRho16
1764,ycbK,1966046,1966150,1966046,104,492,utRho16
1765,ycbZ,2036920,2036920,2036598,322,80,utRho16
1766,yccA,2062886,2062886,2062836,50,24,utRho16
1767,yccF,2048730,2048730,2048696,34,66,utRho16
1768,yccS,2047988,2047988,2047766,222,164,utRho16
1769,yccT,2055674,2055674,2055546,128,36,utRho16
1770,yccX,2059960,2060128,2059960,168,364,utRho16
1771,ycdT,2185682,2185752,2185682,70,0,utRho16
1772,ycdU,2191266,2191686,2191266,420,478,utRho16
1773,ycdZ,2200504,2200592,2200504,88,114,utRho16
1774,yceA,2233544,2233614,2233544,70,18,utRho16
1775,yceD,2293298,2293588,2293298,290,3388,utRho16
1776,yceF,2293522,2293522,2293190,332,2730,utRho16
1777,yceH,2252154,2252314,2252154,160,608,utRho16
1778,yceI,2237282,2237282,2236952,330,328,utRho16
1779,yceJ,2238142,2238142,2238092,50,310,utRho16
1780,yceM,2253208,2253612,2253208,404,1104,utRho16
1781,yceO,2239264,2239264,2238894,370,408,utRho16
1782,yceQ,2288760,2289004,2288760,244,2712,utRho16
1783,ycfD,2376540,2376540,2376480,60,184,utRho16
1784,ycfJ,2334814,2335198,2334814,384,326,utRho16
1785,ycfS,2340834,2340834,2340748,86,0,utRho16
1786,ycfT,2350658,2350658,2350330,328,230,utRho16
1787,ycfZ,2362760,2362760,2362534,226,740,utRho16
1788,ycgB,2474570,2474570,2474482,88,0,utRho16
1789,ycgG,2434614,2434656,2434614,42,326,utRho16
1790,ycgJ,2452956,2453200,2452956,244,144,utRho16
1791,ycgL,2455218,2455362,2455218,144,104,utRho16
1792,ycgN,2457366,2457660,2457366,294,74,utRho16
1793,ycgR,2489112,2489112,2489054,58,0,utRho16
1794,ycgV,2512222,2512222,2511904,318,794,utRho16
1795,ycgX,2426568,2426568,2426214,354,9244,utRho16
1796,ycgY,2490166,2490320,2490166,154,490,utRho16
1797,ycgZ,2431504,2431578,2431504,74,222,utRho16
1798,ychE,2596904,2597196,2596904,292,0,utRho16
1799,ychF,2515764,2515764,2515624,140,0,utRho16
1800,ychH,2517476,2517582,2517476,106,928,utRho16
1801,ychJ,2578354,2578354,2578264,90,110,utRho16
1802,ychN,2547310,2547310,2547198,112,38,utRho16
1803,ychO,2547520,2547850,2547520,330,148,utRho16
1804,ychQ,2533798,2533848,2533798,50,0,utRho16
1805,yciA,2624828,2624828,2624492,336,98,utRho16
1806,yciB,2626110,2626110,2625780,330,758,utRho16
1807,yciC,2627396,2627396,2627326,70,0,utRho16
1808,yciE,2630794,2630794,2630448,346,378,utRho16
1809,yciG,5264368,5264368,5264140,228,44,utRho16
1810,yciI,2621784,2621784,2621730,54,120,utRho16
1811,yciN,2661606,2661606,2661336,270,54,utRho16
1812,yciS,2680270,2680486,2680270,216,202,utRho16
1813,yciT,2689088,2689088,2688692,396,2250,utRho16
1814,yciU,2614718,2614718,2614300,418,1226,utRho16
1815,yciV,2646376,2646440,2646376,64,10,utRho16
1816,yciW,2700472,2700472,2700214,258,4708,utRho16
1817,yciZ,2689276,2689276,2689218,58,1340,utRho16
1818,ycjD,2703792,2703792,2703520,272,18,utRho16
1819,ycjG,2777748,2777860,2777748,112,228,utRho16
1820,ycjM,2740006,2740432,2740006,426,326,utRho16
1821,ycjW,2767982,2767982,2767922,60,72,utRho16
1822,ycjX,2768138,2768234,2768138,96,0,utRho16
1823,ycjY,5568288,5568288,5567460,828,692,utRho16
1824,ydaE,2836438,2836438,2836016,422,760,utRho16
1825,ydaN,2816048,2816100,2816048,52,198,utRho16
1826,ydaS,2840340,2840730,2840340,390,22,utRho16
1827,ydbC,2948376,2948442,2948376,66,0,utRho16
1828,ydbD,2950132,2950288,2950132,156,72,utRho16
1829,ydbH,2885800,2886102,2885800,302,92,utRho16
1830,ydbJ,2881712,2882116,2881712,404,414,utRho16
1831,ydbK,2881692,2881692,2881568,124,180,utRho16
1832,ydcA,2983294,2983354,2983294,60,162,utRho16
1833,ydcF,2974404,2974470,2974404,66,0,utRho16
1834,ydcI,2990268,2990268,2990142,126,0,utRho16
1835,ydcJ,2990266,2990576,2990266,310,0,utRho16
1836,ydcK,3001280,3001280,3000898,382,88,utRho16
1837,ydcL,3004646,3004914,3004646,268,0,utRho16
1838,ydcN,3012308,3012344,3012308,36,408,utRho16
1839,ydcP,3013508,3013562,3013508,54,202,utRho16
1840,ydcR,3019956,3020006,3019956,50,34,utRho16
1841,ydcS,3022906,3023308,3022906,402,196,utRho16
1842,ydcX,3034442,3034778,3034442,336,342,utRho16
1843,ydcY,3035220,3035296,3035220,76,132,utRho16
1844,ydcZ,3036750,3036750,3036662,88,1402,utRho16
1845,yddB,3155332,3155332,3155238,94,418,utRho16
1846,yddE,3071738,3071738,3071716,22,0,utRho16
1847,yddG,3094410,3094410,3094338,72,0,utRho16
1848,yddJ,3089732,3089732,3089438,294,260,utRho16
1849,yddW,3137704,3137704,3137646,58,0,utRho16
1850,ydeA,3233910,3234056,3233910,146,330,utRho16
1851,ydeE,3242528,3242664,3242528,136,218,utRho16
1852,ydeI,3249118,3249118,3248994,124,20,utRho16
1853,ydeJ,3249376,3249546,3249376,170,36,utRho16
1854,ydeN,3165458,3165458,3165048,410,52,utRho16
1855,ydeP,3173328,3173328,3172972,356,334,utRho16
1856,ydeR,3176596,3176596,3176592,4,312,utRho16
1857,ydfA,3296872,3297016,3296872,144,0,utRho16
1858,ydfG,3254982,3255034,3254982,52,42,utRho16
1859,ydfH,3256652,3256704,3256652,52,94,utRho16
1860,ydfK,3265446,3266144,3265446,698,2848,utRho16
1861,ydgA,3379588,3379704,3379588,116,60,utRho16
1862,ydgC,3364124,3364124,3364060,64,112,utRho16
1863,ydgD,3343906,3343920,3343906,14,34,utRho16
1864,ydgH,3356754,3356854,3356754,100,28,utRho16
1865,ydgJ,3408798,3408798,3408616,182,548,utRho16
1866,ydgK,3410414,3410500,3410414,86,370,utRho16
1867,ydhB,3479618,3479618,3479596,22,0,utRho16
1868,ydhC,3479698,3479822,3479698,124,0,utRho16
1869,ydhF,3451310,3451310,3451264,46,0,utRho16
1870,ydhI,3441996,3442050,3441996,54,0,utRho16
1871,ydhL,3451864,3451864,3451840,24,572,utRho16
1872,ydhQ,3492404,3492404,3492254,150,132,utRho16
1873,ydhS,3494136,3494262,3494136,126,1210,utRho16
1874,ydhT,3499138,3499138,3499118,20,178,utRho16
1875,ydhY,3509284,3509284,3508954,330,624,utRho16
1876,ydhZ,3510418,3510418,3510282,136,646,utRho16
1877,ydiE,3579206,3579226,3579206,20,0,utRho16
1878,ydiH,3530582,3530582,3530406,176,6,utRho16
1879,ydiM,3541852,3542142,3541852,290,0,utRho16
1880,ydiN,3544818,3545024,3544818,206,0,utRho16
1881,ydiP,3558656,3558656,3558602,54,98,utRho16
1882,ydiU,3582508,3582508,3582488,20,1022,utRho16
1883,ydiV,3584174,3584174,3584040,134,306,utRho16
1884,ydiY,3612500,3612500,3612166,334,104,utRho16
1885,ydjA,3697400,3697400,3697352,48,46,utRho16
1886,ydjE,3708082,3708082,3707958,124,78,utRho16
1887,ydjF,3709848,3709848,3709708,140,100,utRho16
1888,ydjM,3620340,3620422,3620340,82,0,utRho16
1889,ydjO,3626696,3626696,3626288,408,524,utRho16
1890,ydjX,3666434,3666802,3666434,368,2040,utRho16
1891,yeaE,3731448,3731448,3731272,176,142,utRho16
1892,yeaG,3733530,3733816,3733530,286,2,utRho16
1893,yeaI,3740486,3740770,3740486,284,0,utRho16
1894,yeaJ,3743874,3744082,3743874,208,344,utRho16
1895,yeaL,3748646,3748704,3748646,58,494,utRho16
1896,yeaM,3751296,3751296,3751152,144,0,utRho16
1897,yeaN,3750926,3751346,3750926,420,242,utRho16
1898,yeaO,3753554,3753818,3753554,264,164,utRho16
1899,yeaP,3755314,3755430,3755314,116,808,utRho16
1900,yeaQ,3758780,3758780,3758510,270,602,utRho16
1901,yeaR,3759988,3759988,3759896,92,196,utRho16
1902,yeaY,3781122,3781122,3781064,58,0,utRho16
1903,yebB,3892220,3892502,3892220,282,190,utRho16
1904,yebC,3896370,3896370,3896302,68,112,utRho16
1905,yebE,3859464,3859464,3859414,50,186,utRho16
1906,yebG,3861530,3861530,3861494,36,198,utRho16
1907,yebK,3873180,3873304,3873180,124,0,utRho16
1908,yebQ,3820314,3820552,3820314,238,66,utRho16
1909,yebS,3832238,3832516,3832238,278,0,utRho16
1910,yebV,3843430,3843560,3843430,130,0,utRho16
1911,yebW,3843914,3844242,3843914,328,950,utRho16
1912,yecC,3995646,3995646,3995628,18,0,utRho16
1913,yecD,3901272,3901664,3901272,392,292,utRho16
1914,yecF,3991434,3991636,3991434,202,264,utRho16
1915,yecH,3979304,3979304,3978980,324,1882,utRho16
1916,yecJ,3975604,3975604,3975516,88,0,utRho16
1917,yecM,3919968,3919968,3919692,276,756,utRho16
1918,yecR,3976400,3976444,3976400,44,36,utRho16
1919,yecT,3923862,3923944,3923862,82,192,utRho16
1920,yedD,4016522,4016522,4016180,342,268,utRho16
1921,yedE,4016310,4016554,4016310,244,208,utRho16
1922,yedI,4058922,4058922,4058732,190,536,utRho16
1923,yedJ,4066446,4066446,4066158,288,482,utRho16
1924,yedV,4076404,4076404,4076304,100,334,utRho16
1925,yedX,4077680,4077912,4077680,232,54,utRho16
1926,yedY,4078572,4078956,4078572,384,286,utRho16
1927,yeeA,4161322,4161322,4161182,140,198,utRho16
1928,yeeE,4171104,4171104,4171050,54,0,utRho16
1929,yeeJ,4089526,4089822,4089526,296,370,utRho16
1930,yeeN,4113508,4113716,4113508,208,654,utRho16
1931,yeeO,4119444,4119444,4119692,248,0,utRho16
1932,yeeX,4158834,4158834,4158722,112,538,utRho16
1933,yeeZ,4178422,4178422,4178256,166,0,utRho16
1934,yefM,4179466,4179466,4179426,40,0,utRho16
1935,yegD,4295288,4295348,4295288,60,12,utRho16
1936,yegH,4275726,4275804,4275726,78,140,utRho16
1937,yegI,4302154,4302154,4301970,184,0,utRho16
1938,yegJ,4302032,4302370,4302032,338,22,utRho16
1939,yegQ,4331182,4331336,4331182,154,1478,utRho16
1940,yegR,4336698,4336698,4336612,86,298,utRho16
1941,yegS,4337086,4337424,4337086,338,276,utRho16
1942,yegT,4357562,4357642,4357562,80,1208,utRho16
1943,yegX,4367640,4367640,4367302,338,182,utRho16
1944,yehA,4376944,4376944,4376828,116,172,utRho16
1945,yehE,4385818,4385818,4385592,226,2,utRho16
1946,yehK,4407568,4407944,4407568,376,56,utRho16
1947,yehL,4408804,4409192,4408804,388,0,utRho16
1948,yeiB,4486146,4486146,4485934,212,48,utRho16
1949,yeiE,4499422,4499422,4499236,186,0,utRho16
1950,yeiG,4487776,4487820,4487776,44,222,utRho16
1951,yeiH,4499332,4499434,4499332,102,0,utRho16
1952,yeiI,4503306,4503400,4503306,94,190,utRho16
1953,yeiL,4510580,4510710,4510580,130,56,utRho16
1954,yeiP,4530834,4530900,4530834,66,246,utRho16
1955,yeiQ,4532328,4532490,4532328,162,238,utRho16
1956,yeiR,4535484,4535658,4535484,174,746,utRho16
1957,yeiW,4530840,4530840,4530590,250,292,utRho16
1958,yejA,4544624,4544728,4544624,104,0,utRho16
1959,yejG,4556892,4556892,4556474,418,3802,utRho16
1960,yejH,4561244,4561264,4561244,20,0,utRho16
1961,yejK,4568218,4568218,4567894,324,46,utRho16
1962,yejO,4578352,4578352,4577800,552,2998,utRho16
1963,yfaD,4713380,4713808,4713380,428,1218,utRho16
1964,yfaE,4696676,4697028,4696676,352,2378,utRho16
1965,yfaL,4688568,4688568,4688338,230,24,utRho16
1966,yfaP,4656398,4656398,4656286,112,66,utRho16
1967,yfaU,4717892,4717892,4717690,202,136,utRho16
1968,yfaY,4727310,4727310,4727266,44,140,utRho16
1969,yfaZ,4728744,4728744,4728550,194,356,utRho16
1970,yfbK,4771810,4771810,4771444,366,414,utRho16
1971,yfbL,4771500,4771720,4771500,220,332,utRho16
1972,yfbN,4777174,4777174,4776852,322,402,utRho16
1973,yfbO,4776916,4777162,4776916,246,348,utRho16
1974,yfbP,4777990,4778232,4777990,242,9916,utRho16
1975,yfbR,4817662,4817724,4817662,62,116,utRho16
1976,yfcI,4847424,4847424,4847078,346,1734,utRho16
1977,yfcJ,4880482,4880482,4880240,242,1500,utRho16
1978,yfcL,4888502,4888502,4888338,164,272,utRho16
1979,yfcV,4911642,4911642,4911292,350,610,utRho16
1980,yfcZ,4921958,4921958,4921868,90,92,utRho16
1981,yfdF,4925604,4926024,4925604,420,7602,utRho16
1982,yfdG,4935474,4935710,4935474,236,0,utRho16
1983,yfdP,4946844,4947040,4946844,196,402,utRho16
1984,yfdX,4988866,4988866,4988804,62,36,utRho16
1985,yfdY,4990672,4990672,4990584,88,234,utRho16
1986,yfeA,5035784,5035784,5035664,120,14886,utRho16
1987,yfeC,5036668,5036934,5036668,266,364,utRho16
1988,yfeH,5053818,5053892,5053818,74,0,utRho16
1989,yfeK,5074630,5074684,5074630,54,146,utRho16
1990,yfeO,5018906,5019260,5018906,354,478,utRho16
1991,yfeR,5054078,5054078,5053712,366,0,utRho16
1992,yfeX,5101356,5101356,5101090,266,112,utRho16
1993,yfeY,5102486,5102486,5102432,54,0,utRho16
1994,yfeZ,5103842,5103842,5103452,390,0,utRho16
1995,yffO,5123804,5124222,5123804,418,136,utRho16
1996,yffQ,5126778,5127154,5126778,376,564,utRho16
1997,yffS,5128800,5128986,5128800,186,0,utRho16
1998,yfgC,5232052,5232188,5232052,136,164,utRho16
1999,yfgF,5258062,5258062,5257876,186,1056,utRho16
2000,yfgG,5258170,5258580,5258170,410,1328,utRho16
2001,yfgH,5259344,5259584,5259344,240,316,utRho16
2002,yfgM,5278866,5278866,5278566,300,204,utRho16
2003,yfhH,5397414,5397518,5397414,104,240,utRho16
2004,yfhM,5304648,5304648,5304574,74,74,utRho16
2005,yfhR,5328408,5328726,5328408,318,15088,utRho16
2006,yfiC,5425610,5425610,5425528,82,0,utRho16
2007,yfiE,5430688,5430688,5430640,48,696,utRho16
2008,yfiL,5482630,5482720,5482630,90,0,utRho16
2009,yfiM,5448066,5448358,5448066,292,9306,utRho16
2010,yfiR,5483354,5483750,5483354,396,402,utRho16
2011,yfjH,5517326,5517326,5517200,126,140,utRho16
2012,yfjI,5517710,5517970,5517710,260,72,utRho16
2013,yfjJ,5521014,5521094,5521014,80,276,utRho16
2014,yfjM,5531970,5531970,5531552,418,4480,utRho16
2015,yfjP,5535080,5535420,5535080,340,1004,utRho16
2016,yfjW,5546570,5546636,5546570,66,102,utRho16
2017,yfjX,5551776,5551838,5551776,62,0,utRho16
2018,ygaC,5601180,5601180,5599988,1192,6238,utRho16
2019,ygaM,5600242,5600292,5600242,50,1626,utRho16
2020,ygaU,5593628,5593628,5593572,56,246,utRho16
2021,ygaZ,5619190,5619234,5619190,44,422,utRho16
2022,ygbA,5713656,5713656,5713612,44,98,utRho16
2023,ygbE,5746784,5746784,5746674,110,1344,utRho16
2024,ygbI,5722882,5722882,5722528,354,352,utRho16
2025,ygbK,5724394,5724670,5724394,276,1074,utRho16
2026,ygbL,5727074,5727186,5727074,112,2,utRho16
2027,ygbN,5729814,5730202,5729814,388,928,utRho16
2028,ygcG,5811210,5811422,5811210,212,302,utRho16
2029,ygcN,5785144,5785314,5785144,170,158,utRho16
2030,ygcU,5799214,5799214,5798836,378,198,utRho16
2031,ygcW,5800942,5800942,5800546,396,20,utRho16
2032,ygdD,5883442,5883442,5883262,180,376,utRho16
2033,ygdG,5861746,5861930,5861746,184,1720,utRho16
2034,ygdI,5886526,5886526,5886290,236,464,utRho16
2035,ygdQ,5940784,5940840,5940784,56,40,utRho16
2036,ygdR,5942494,5942542,5942494,48,16,utRho16
2037,ygeA,5961606,5961606,5961270,336,142,utRho16
2038,ygeH,5983758,5984188,5983758,430,846,utRho16
2039,ygeI,5987162,5987276,5987162,114,6132,utRho16
2040,ygeR,6000078,6000078,5999782,296,252,utRho16
2041,ygeV,6011694,6011694,6011572,122,140,utRho16
2042,ygeW,6012234,6012524,6012234,290,558,utRho16
2043,ygfB,6110946,6110946,6110888,58,0,utRho16
2044,ygfK,6031984,6032120,6031984,136,42,utRho16
2045,ygfS,6058328,6058328,6058024,304,94,utRho16
2046,ygfZ,6082564,6082626,6082564,62,342,utRho16
2047,yggC,6149512,6149512,6149378,134,198,utRho16
2048,yggE,6136370,6136370,6136160,210,1184,utRho16
2049,yggI,6179176,6179510,6179176,334,1100,utRho16
2050,yggL,6204508,6204508,6204266,242,328,utRho16
2051,yggM,6199514,6199514,6199130,384,220,utRho16
2052,yggN,6203596,6203596,6203246,350,188,utRho16
2053,yggX,18623958,18624558,18623958,600,690,utRho16
2054,yghA,6298966,6299324,6298966,358,112,utRho16
2055,yghB,6307058,6307126,6307058,68,376,utRho16
2056,yghD,6222614,6222614,6222252,362,758,utRho16
2057,yghF,6225798,6225798,6225840,42,532,utRho16
2058,yghJ,6238640,6238640,6238224,416,190,utRho16
2059,yghQ,6265186,6265186,6264816,370,558,utRho16
2060,yghT,6267830,6268262,6267830,432,242,utRho16
2061,yghU,6277400,6277454,6277400,54,154,utRho16
2062,yghW,6293506,6293506,6293474,32,0,utRho16
2063,yghZ,6295562,6295794,6295562,232,440,utRho16
2064,ygiD,6365122,6365122,6364868,254,1466,utRho16
2065,ygiH,6409066,6409388,6409066,322,102,utRho16
2066,ygiL,6370622,6370828,6370622,206,172,utRho16
2067,ygiM,6402084,6402414,6402084,330,276,utRho16
2068,ygiN,6346156,6346284,6346156,128,832,utRho16
2069,ygiQ,6322620,6322620,6322292,328,1324,utRho16
2070,ygiS,6335462,6335462,6335436,26,166,utRho16
2071,ygiV,6338582,6338582,6338462,120,138,utRho16
2072,ygiW,6339774,6339774,6339352,422,2750,utRho16
2073,ygiZ,6344506,6344506,6344422,84,44,utRho16
2074,ygjH,6442528,6442528,6442494,34,280,utRho16
2075,ygjI,6452140,6452468,6452140,328,20,utRho16
2076,ygjQ,6472730,6473080,6472730,350,1192,utRho16
2077,ygjR,6474564,6474586,6474564,22,84,utRho16
2078,ygjV,6483638,6483638,6483488,150,116,utRho16
2079,yhaB,6535632,6535708,6535632,76,16,utRho16
2080,yhaH,6504498,6504608,6504498,110,240,utRho16
2081,yhaI,6505400,6505822,6505400,422,338,utRho16
2082,yhaJ,6508560,6508560,6508428,132,214,utRho16
2083,yhaK,6508538,6508638,6508538,100,294,utRho16
2084,yhbQ,6599878,6599932,6599878,54,500,utRho16
2085,yhbT,6602736,6602736,6602552,184,724,utRho16
2086,yhbU,6602558,6602970,6602558,412,924,utRho16
2087,yhbX,6643302,6643302,6643226,76,54,utRho16
2088,yhbY,6655518,6655580,6655518,62,746,utRho16
2089,yhcA,6723956,6724224,6723956,268,814,utRho16
2090,yhcB,6760364,6760382,6760364,18,2,utRho16
2091,yhcC,6708470,6708470,6708100,370,1330,utRho16
2092,yhcF,6733440,6733852,6733440,412,2034,utRho16
2093,yhcH,6739124,6739124,6738956,168,2076,utRho16
2094,yhcM,6760312,6760312,6759994,318,258,utRho16
2095,yhcN,6770812,6771076,6770812,264,284,utRho16
2096,yhcO,6772606,6772606,6772258,348,50,utRho16
2097,yhdH,6806560,6806968,6806560,408,576,utRho16
2098,yhdJ,6823234,6823306,6823234,72,0,utRho16
2099,yhdN,6879092,6879092,6879018,74,470,utRho16
2100,yhdT,6814702,6814750,6814702,48,98,utRho16
2101,yhdU,6824994,6825242,6824994,248,498,utRho16
2102,yhdV,6836392,6836780,6836392,388,914,utRho16
2103,yhdW,6837944,6838298,6837944,354,116,utRho16
2104,yheO,6953082,6953082,6952880,202,370,utRho16
2105,yheV,6957970,6957970,6957584,386,102,utRho16
2106,yhfA,6971902,6971902,6971636,266,1118,utRho16
2107,yhfG,6983294,6983294,6983240,54,1082,utRho16
2108,yhfL,6998622,6998896,6998622,274,332,utRho16
2109,yhfY,7023244,7023244,7022844,400,48,utRho16
2110,yhgA,7086294,7086334,7086294,40,0,utRho16
2111,yhgE,7065176,7065176,7064878,298,748,utRho16
2112,yhgF,7074352,7074770,7074352,418,8448,utRho16
2113,yhhA,7173458,7173886,7173458,428,936,utRho16
2114,yhhI,7248346,7248756,7248346,410,32,utRho16
2115,yhhJ,7253696,7253696,7253606,90,346,utRho16
2116,yhhM,7211588,7211588,7211220,368,598,utRho16
2117,yhhN,7211150,7211502,7211150,352,574,utRho16
2118,yhhQ,7218238,7218434,7218238,196,834,utRho16
2119,yhhT,7223682,7223730,7223682,48,72,utRho16
2120,yhhX,7162032,7162032,7161610,422,160,utRho16
2121,yhhY,7162222,7162276,7162222,54,44,utRho16
2122,yhhZ,7163516,7163726,7163516,210,346,utRho16
2123,yhiD,7312220,7312220,7311804,416,73338,utRho16
2124,yhiJ,7265190,7265190,7265180,10,0,utRho16
2125,yhiM,7269270,7269682,7269270,412,1268,utRho16
2126,yhiN,7275000,7275000,7274820,180,484,utRho16
2127,yhjA,7338522,7338522,7338376,146,188,utRho16
2128,yhjB,7344090,7344090,7343788,302,1192,utRho16
2129,yhjC,7344272,7344684,7344272,412,286,utRho16
2130,yhjD,7346660,7346724,7346660,64,284,utRho16
2131,yhjE,7349274,7349572,7349274,298,2240,utRho16
2132,yhjG,7356824,7356824,7356730,94,142,utRho16
2133,yhjH,7358458,7358458,7358374,84,600,utRho16
2134,yhjJ,7364032,7364032,7363880,152,182,utRho16
2135,yhjK,7371296,7371296,7371158,138,84,utRho16
2136,yhjR,7392750,7392750,7392370,380,50,utRho16
2137,yhjV,7400796,7401126,7400796,330,2078,utRho16
2138,yhjX,7424194,7424194,7424014,180,76,utRho16
2139,yhjY,7425966,7425966,7425868,98,58,utRho16
2140,yiaB,7455654,7455654,7455496,158,28,utRho16
2141,yiaD,7432712,7433094,7432712,382,996,utRho16
2142,yiaF,7438194,7438194,7438088,106,542,utRho16
2143,yiaG,7438862,7438956,7438862,94,374,utRho16
2144,yiaJ,7485236,7485236,7485064,172,1112,utRho16
2145,yiaK,7485348,7485466,7485348,118,118,utRho16
2146,yiaT,7503924,7503924,7503736,188,0,utRho16
2147,yiaU,7503792,7503984,7503792,192,0,utRho16
2148,yiaY,7515856,7515856,7515654,202,510,utRho16
2149,yibF,7523950,7523950,7523910,40,56,utRho16
2150,yibG,7536128,7536354,7536128,226,54,utRho16
2151,yibL,7553194,7553330,7553194,136,216,utRho16
2152,yibN,7570112,7570112,7570030,82,254,utRho16
2153,yibT,7552848,7552848,7552760,88,856,utRho16
2154,yicC,7633290,7633352,7633290,62,4,utRho16
2155,yicH,7660862,7660914,7660862,52,190,utRho16
2156,yicJ,7673328,7673328,7671858,1470,8308,utRho16
2157,yicN,7685018,7685018,7684804,214,1798,utRho16
2158,yicO,7687914,7687914,7687578,336,374,utRho16
2159,yicR,15250308,15250308,15250236,72,72,utRho16
2160,yidB,7755230,7755230,7754930,300,90,utRho16
2161,yidE,7732780,7732780,7732546,234,150,utRho16
2162,yidF,7711580,7711580,7711222,358,306,utRho16
2163,yidQ,7735088,7735456,7735088,368,798,utRho16
2164,yidR,7738824,7738824,7738618,206,48,utRho16
2165,yieE,7787658,7787738,7787658,80,524,utRho16
2166,yieH,7793314,7793548,7793314,234,94,utRho16
2167,yieK,7798928,7798928,7798786,142,76,utRho16
2168,yifB,7900350,7900350,7899998,352,436,utRho16
2169,yifL,7988984,7989044,7988984,60,2606,utRho16
2170,yigF,8005750,8005750,8005598,152,18944,utRho16
2171,yigI,8009448,8009448,8009394,54,728,utRho16
2172,yigM,8022100,8022152,8022100,52,28,utRho16
2173,yihA,8101970,8101970,8101458,512,228,utRho16
2174,yihD,8084098,8084138,8084098,40,90,utRho16
2175,yihF,8088110,8088398,8088110,288,344,utRho16
2176,yihG,8093304,8093304,8093204,100,46,utRho16
2177,yihI,8102616,8102694,8102616,78,2,utRho16
2178,yihL,8120506,8120894,8120506,388,116,utRho16
2179,yihN,8124332,8124494,8124332,162,300,utRho16
2180,yihO,8131942,8131942,8131532,410,384,utRho16
2181,yihQ,8138892,8138892,8138552,340,140,utRho16
2182,yihV,8147064,8147478,8147064,414,208,utRho16
2183,yihX,8151096,8151106,8151096,10,260,utRho16
2184,yiiE,8158192,8158582,8158192,390,1240,utRho16
2185,yiiF,8159124,8159502,8159124,378,1268,utRho16
2186,yiiG,8173762,8174004,8173762,242,44,utRho16
2187,yiiM,8205506,8205644,8205506,138,3252,utRho16
2188,yiiQ,8224624,8224624,8224428,196,142,utRho16
2189,yiiS,8225738,8225934,8225738,196,484,utRho16
2190,yijE,8272178,8272216,8272178,38,176,utRho16
2191,yijF,8275728,8275728,8275314,414,1220,utRho16
2192,yijO,8296858,8296858,8296634,224,306,utRho16
2193,yjaA,8426240,8426468,8426240,228,89610,utRho16
2194,yjaB,8428312,8428312,8428246,66,1028,utRho16
2195,yjaG,8398746,8399008,8398746,262,1060,utRho16
2196,yjaH,8401022,8401132,8401022,110,272,utRho16
2197,yjaZ,8379506,8379572,8379506,66,90,utRho16
2198,yjbB,8455204,8455462,8455204,258,118,utRho16
2199,yjbE,16943432,16943624,16943432,192,452,utRho16
2200,yjbL,8520318,8520642,8520318,324,218,utRho16
2201,yjbQ,8540428,8540476,8540428,48,90,utRho16
2202,yjcB,8550328,8550328,8550082,246,454,utRho16
2203,yjcC,8550836,8550942,8550836,106,276,utRho16
2204,yjcD,8556628,8556958,8556628,330,248,utRho16
2205,yjcE,8559658,8559960,8559658,302,138,utRho16
2206,yjcF,8566212,8566212,8566150,62,0,utRho16
2207,yjcO,8594660,8594660,8594250,410,420,utRho16
2208,yjdA,8654128,8654270,8654128,142,0,utRho16
2209,yjdC,8726660,8726660,8726616,44,0,utRho16
2210,yjdK,8704780,8705168,8704780,388,4092,utRho16
2211,yjdL,8713034,8713034,8712822,212,36,utRho16
2212,yjdM,8653672,8653672,8653468,204,602,utRho16
2213,yjeF,8787354,8788132,8787354,778,106518,utRho16
2214,yjeI,8745522,8745618,8745522,96,0,utRho16
2215,yjeJ,8748806,8748806,8748468,338,638,utRho16
2216,yjeV,8785472,8785784,8785472,312,3436,utRho16
2217,yjfP,8833512,8833904,8833512,392,190,utRho16
2218,yjfY,8849656,8849656,8849582,74,152,utRho16
2219,yjfZ,8855052,8855052,8854844,208,518,utRho16
2220,yjgA,8916162,8916162,8915730,432,428,utRho16
2221,yjgL,8950802,8950874,8950802,72,0,utRho16
2222,yjgM,8959342,8959342,8959074,268,118,utRho16
2223,yjgN,8959132,8959460,8959132,328,150,utRho16
2224,yjgR,8980170,8980170,8980126,44,200,utRho16
2225,yjgZ,9002116,9002520,9002116,404,9610,utRho16
2226,yjhB,9007764,9008116,9007764,352,668,utRho16
2227,yjhG,9048452,9048452,9048188,264,10714,utRho16
2228,yjhU,9041080,9041080,9040648,432,1166,utRho16
2229,yjiA,9178096,9178096,9177730,366,3164,utRho16
2230,yjiJ,9125364,9125364,9125350,14,0,utRho16
2231,yjiK,9127270,9127270,9127422,152,390,utRho16
2232,yjiL,9129604,9129604,9129378,226,138,utRho16
2233,yjiS,9143410,9143502,9143410,92,288,utRho16
2234,yjiY,9182734,9182734,9182558,176,5242,utRho16
2235,yjjA,9200674,9200674,9200378,296,2434,utRho16
2236,yjjB,18408708,18408708,18407800,908,2672,utRho16
2237,yjjJ,9243314,9243538,9243314,224,36,utRho16
2238,yjjK,9261132,9261132,9261044,88,268,utRho16
2239,yjjL,9189764,9189764,9189444,320,1718,utRho16
2240,yjjM,9191894,9191894,9191702,192,416,utRho16
2241,yjjP,9206068,9206068,9205716,352,17458,utRho16
2242,yjjQ,9206638,9206954,9206638,316,10460,utRho16
2243,yjjX,9267798,9267798,9267490,308,1666,utRho16
2244,yjjY,9280716,9280804,9280716,88,322,utRho16
2245,yjjZ,9211554,9211608,9211554,54,51876,utRho16
2246,yjtD,9281676,9281884,9281676,208,210,utRho16
2247,ykfB,532454,532454,532174,280,13014,utRho16
2248,ykfI,527636,527636,527338,298,1558,utRho16
2249,ykgB,637050,637050,636638,412,698,utRho16
2250,ykgC,640430,640430,640002,428,208,utRho16
2251,ykgD,640232,640454,640232,222,138,utRho16
2252,ykgE,642962,643216,642962,254,334,utRho16
2253,ykgJ,608524,608524,608364,160,274,utRho16
2254,ykgL,623878,624224,623878,346,632,utRho16
2255,ykgM,625610,625610,625554,56,66,utRho16
2256,ykgR,626570,626570,626484,86,0,utRho16
2257,ylaC,958576,958576,958502,74,3334,utRho16
2258,yliE,1745938,1745958,1745938,20,0,utRho16
2259,ymcE,2103660,2103694,2103660,34,0,utRho16
2260,ymdA,2210450,2210828,2210450,378,316,utRho16
2261,ymdB,2211428,2211640,2211428,212,112,utRho16
2262,ymfD,2395322,2395322,2395064,258,946,utRho16
2263,ymfI,2402880,2402994,2402880,114,56,utRho16
2264,ymfJ,2404518,2404518,2404168,350,770,utRho16
2265,ymfK,2406176,2406176,2405866,310,124,utRho16
2266,ymfT,2405766,2406048,2405766,282,176,utRho16
2267,ymgE,2489110,2489456,2489110,346,834,utRho16
2268,ymgF,2437628,2437966,2437628,338,48,utRho16
2269,ymiA,2670112,2670320,2670112,208,528,utRho16
2270,ymjA,2715620,2715620,2715336,284,554,utRho16
2271,ynaI,2791946,2791946,2791844,102,30,utRho16
2272,ynaK,2850438,2850754,2850438,316,168,utRho16
2273,ynbA,2954924,2955242,2954924,318,50,utRho16
2274,yncD,3046552,3046552,3046130,422,150,utRho16
2275,yncE,3046454,3046614,3046454,160,68,utRho16
2276,yncG,3052456,3052494,3052456,38,660,utRho16
2277,yncL,3034492,3034492,3034388,104,334,utRho16
2278,yneE,3218364,3218364,3218044,320,2,utRho16
2279,yneF,3223748,3223748,3223708,40,0,utRho16
2280,yneJ,3229560,3229608,3229560,48,308,utRho16
2281,yneK,3231100,3231526,3231100,426,1018,utRho16
2282,yneM,3245176,3245292,3245176,116,208,utRho16
2283,ynfA,3311398,3311398,3311346,52,0,utRho16
2284,ynfB,3311418,3311616,3311418,198,308,utRho16
2285,ynfC,3315094,3315094,3314914,180,26,utRho16
2286,ynfD,3314828,3315130,3314828,302,52,utRho16
2287,ynfE,3316006,3316138,3316006,132,112,utRho16
2288,ynfK,3334670,3334670,3334438,232,210,utRho16
2289,ynfL,3339304,3339304,3339184,120,0,utRho16
2290,ynfM,3339260,3339398,3339260,138,0,utRho16
2291,ynfN,3276598,3276598,3276218,380,32,utRho16
2292,ynfO,3273454,3273512,3273454,58,288,utRho16
2293,ynhG,3517890,3517890,3517450,440,70,utRho16
2294,yniA,3615158,3615592,3615158,434,780,utRho16
2295,yniB,3618526,3618526,3618466,60,0,utRho16
2296,yniC,3618652,3618760,3618652,108,42,utRho16
2297,yniD,3610202,3610330,3610202,128,36,utRho16
2298,ynjE,3678880,3678934,3678880,54,16,utRho16
2299,ynjF,3683222,3683222,3682806,416,316,utRho16
2300,ynjH,3684376,3684376,3684270,106,22,utRho16
2301,ynjI,3690022,3690022,3689742,280,410,utRho16
2302,yoaB,3786642,3786734,3786642,92,66,utRho16
2303,yoaC,3787932,3788146,3787932,214,254,utRho16
2304,yoaE,3803544,3803544,3803170,374,604,utRho16
2305,yoaF,3755444,3755444,3755064,380,1292,utRho16
2306,yoaH,3789866,3789866,3789462,404,1062,utRho16
2307,yobB,3850418,3850880,3850418,462,632,utRho16
2308,yobF,3815586,3815586,3815182,404,490,utRho16
2309,yobH,3817800,3817850,3817800,50,246,utRho16
2310,yodB,4084352,4084736,4084352,384,728,utRho16
2311,yodC,4057008,4057008,4056740,268,204,utRho16
2312,yohC,4451358,4451358,4451262,96,100,utRho16
2313,yohD,4451526,4451602,4451526,76,166,utRho16
2314,yohJ,4460986,4461248,4460986,262,56,utRho16
2315,yohO,4431172,4431314,4431172,142,176,utRho16
2316,yojI,4617282,4617282,4617230,52,0,utRho16
2317,ypdI,4988988,4989396,4988988,408,236,utRho16
2318,ypfG,5165786,5165786,5165554,232,0,utRho16
2319,ypfM,5182140,5182140,5181732,408,744,utRho16
2320,yphB,5349590,5349590,5349376,214,302,utRho16
2321,ypjA,5565644,5565644,5565452,192,1640,utRho16
2322,ypjB,5569636,5569636,5568858,778,60,utRho16
2323,ypjD,5495860,5495774,5495860,86,0,utRho16
2324,yqaE,5594170,5594170,5594056,114,596,utRho16
2325,yqcA,5846100,5846100,5845968,132,576,utRho16
2326,yqcE,5800944,5801184,5800944,240,0,utRho16
2327,yqeC,6030468,6030468,6030114,354,1028,utRho16
2328,yqeF,5971618,5971618,5971184,434,1730,utRho16
2329,yqeG,5971438,5971694,5971438,256,3404,utRho16
2330,yqeH,5975016,5975072,5975016,56,4178,utRho16
2331,yqeI,5976688,5977004,5976688,316,70,utRho16
2332,yqeK,5981140,5981140,5980720,420,3478,utRho16
2333,yqfA,6086728,6086728,6086296,432,726,utRho16
2334,yqgA,6219042,6219106,6219042,64,0,utRho16
2335,yqgB,6172500,6172500,6172102,398,1956,utRho16
2336,yqgE,6185768,6185874,6185768,106,610,utRho16
2337,yqhA,6299150,6299150,6298942,208,104,utRho16
2338,yqhC,6310768,6310768,6310436,332,436,utRho16
2339,yqhD,6310604,6310710,6310604,106,132,utRho16
2340,yqhH,6316842,6317254,6316842,412,1310,utRho16
2341,yqiC,6369662,6369680,6369662,18,322,utRho16
2342,yqiJ,6384108,6384416,6384108,308,538,utRho16
2343,yqjA,6495096,6495546,6495096,450,6948,utRho16
2344,yqjF,6500932,6501124,6500932,192,636,utRho16
2345,yqjG,6501948,6502048,6501948,100,34,utRho16
2346,yqjH,6433078,6433078,6432982,96,42,utRho16
2347,yqjI,6433506,6433558,6433506,52,42,utRho16
2348,yraH,6574552,6574852,6574552,300,42,utRho16
2349,yraP,6592144,6592818,6592144,674,1006,utRho16
2350,yraQ,6596414,6596414,6596276,138,38,utRho16
2351,yraR,6598024,6598024,6597692,332,328,utRho16
2352,yrbG,13360844,13361100,13360844,256,8,utRho16
2353,yrbL,6696842,6696904,6696842,62,776,utRho16
2354,yrbN,6616172,6616172,6615866,306,3380,utRho16
2355,yrdB,6860176,6860176,6860046,130,78,utRho16
2356,yrfF,7052548,7052938,7052548,390,532,utRho16
2357,yrhB,7169440,7169518,7169440,78,0,utRho16
2358,ysaB,7451804,7451804,7451424,380,228,utRho16
2359,ysgA,8032686,8032686,8032338,348,990,utRho16
2360,ytfB,8857638,8857638,8857434,204,482,utRho16
2361,ytfE,8864018,8864018,8863966,52,94,utRho16
2362,ytfF,8866296,8866296,8866130,166,484,utRho16
2363,ytfH,8868164,8868226,8868164,62,628,utRho16
2364,ytfI,8875234,8875414,8875234,180,284,utRho16
2365,ytfJ,8878572,8878572,8878524,48,104,utRho16
2366,ytfK,8879022,8879174,8879022,152,312,utRho16
2367,ytfL,8882642,8882642,8882430,212,240,utRho16
2368,ytfQ,8899634,8899924,8899634,290,212,utRho16
2369,ytjB,9249598,9249598,9249578,20,6,utRho16
2370,yzfA,8896588,8896588,8896490,98,120,utRho16
2371,zapA,6111102,6111224,6111102,122,1518,utRho16
2372,zapB,8236772,8237030,8236772,258,548,utRho16
2373,zapC,2011700,2011904,2011700,204,84,utRho16
2374,zinT,4082692,4082750,4082692,58,256,utRho16
2375,zipA,5062814,5062814,5062466,348,34,utRho16
2376,zitB,1569716,1569716,1569646,70,24,utRho16
2377,zntA,7212844,7212902,7212844,58,120,utRho16
2378,zntR,6878336,6878336,6878260,76,116,utRho16
2379,znuA,3885322,3885322,3885166,156,58,utRho16
2380,znuC,3885268,3885324,3885268,56,58,utRho16
2381,zraP,8403424,8403424,8403376,48,0,utRho16
2382,zraS,8403810,8403852,8403810,42,46,utRho16
2383,zupT,6364866,6365100,6364866,234,1418,utRho16
2384,zur,8520282,8520282,8520006,276,694,utRho16
2385,zwf,3872752,3872752,3872628,124,108,utRho16
0,C0343,2818676,2818728,2818676,52,0,utRho17
1,aaeB,6776526,6776526,6776376,150,210,utRho17
2,aaeR,6778762,6779040,6778762,278,622,utRho17
3,aaeX,6778860,6778860,6778674,186,700,utRho17
4,aat,1854920,1854920,1854864,56,0,utRho17
5,accA,416822,417242,416822,420,2634,utRho17
6,accB,6810280,6810872,6810280,592,5086,utRho17
7,accD,4868030,4868030,4867852,178,358,utRho17
8,aceB,8430804,8430956,8430804,152,342,utRho17
9,aceE,245938,246034,245938,96,46,utRho17
10,ackA,4826918,4826940,4826918,22,278,utRho17
11,acnA,2670848,2671662,2670848,814,922,utRho17
12,acnB,263038,263230,263038,192,592,utRho17
13,acpP,2303148,2303230,2303148,82,916,utRho17
14,acpS,5402324,5402324,5401996,328,568,utRho17
15,acrA,971396,971396,971238,158,128,utRho17
16,acrB,969370,969370,968806,564,1924,utRho17
17,acrD,5174950,5175190,5174950,240,50,utRho17
18,acrE,6827404,6827728,6827404,324,436,utRho17
19,acrR,971398,971522,971398,124,0,utRho17
20,acrZ,1589502,1589546,1589502,44,52,utRho17
21,acs,8575190,8575190,8574742,448,958,utRho17
22,actP,8569870,8569870,8569804,66,142,utRho17
23,ada,4620854,4620854,4620810,44,0,utRho17
24,add,3404404,3404466,3404404,62,204,utRho17
25,ade,7687802,7687928,7687802,126,252,utRho17
26,adhE,2596826,2596826,2596242,584,0,utRho17
27,adhP,3107988,3107988,3107676,312,2494,utRho17
28,adiA,8681112,8681112,8681042,70,124,utRho17
29,adiC,8674404,8674404,8674062,342,198,utRho17
30,adiY,8676084,8676084,8675858,226,84,utRho17
31,adk,994278,994350,994278,72,1422,utRho17
32,adrA,807374,807406,807374,32,104,utRho17
33,aer,6438240,6438240,6438152,88,0,utRho17
34,aes,1000102,1000102,999946,156,2620,utRho17
35,agaR,6557406,6557406,6557330,76,94,utRho17
36,agaS,6563778,6563952,6563778,174,2,utRho17
37,agp,2131118,2131170,2131118,52,58,utRho17
38,agrA,7296126,7296126,7296126,0,0,utRho17
39,agrB,7296588,7296588,7296588,0,0,utRho17
40,ahpC,1277386,1277890,1277386,504,694,utRho17
41,ahpF,1278004,1279506,1278004,1502,60604,utRho17
42,ahr,8992698,8992698,8992418,280,524,utRho17
43,aidB,8828494,8828550,8828494,56,0,utRho17
44,ais,4731512,4731512,4731240,272,88,utRho17
45,alaA,4814816,4815122,4814816,306,224,utRho17
46,alaC,4996798,4996798,4996590,208,30,utRho17
47,alaE,5598140,5598328,5598140,188,220,utRho17
48,alaS,5644180,5644180,5644022,158,3168,utRho17
49,alaW,5036612,5036612,5036462,150,38,utRho17
50,aldA,2976380,2976464,2976380,84,430,utRho17
51,aldB,7513070,7513070,7513022,48,372,utRho17
52,alkA,4295118,4295118,4295080,38,178,utRho17
53,alkB,4618890,4618890,4618682,208,76,utRho17
54,allA,1064780,1064902,1064780,122,24,utRho17
55,allD,1092822,1092822,1092726,96,6,utRho17
56,allE,1088112,1088112,1088092,20,152,utRho17
57,allS,1064600,1064600,1064442,158,182,utRho17
58,alr,8531178,8531564,8531178,386,2948,utRho17
59,alsE,8617334,8617334,8616956,378,502,utRho17
60,alsK,8615990,8615990,8615598,392,1398,utRho17
61,alx,6476740,6477160,6476740,420,32,utRho17
62,amiA,5104482,5104704,5104482,222,80,utRho17
63,amiC,5898378,5898378,5898020,358,264,utRho17
64,amn,4110062,4110122,4110062,60,0,utRho17
65,ampC,8758006,8758006,8757888,118,70,utRho17
66,ampD,237362,237466,237362,104,82,utRho17
67,ampG,907372,907372,907090,282,422,utRho17
68,ampH,792726,792726,792574,152,176,utRho17
69,amyA,4012230,4012312,4012230,82,194,utRho17
70,anmK,3439346,3439346,3439204,142,0,utRho17
71,ansB,6201580,6201580,6201456,124,444,utRho17
72,ansP,3052040,3052040,3051960,80,100,utRho17
73,apaG,104068,104068,103212,856,3598,utRho17
74,apaH,102586,102586,102444,142,4316,utRho17
75,apbE,4623188,4623188,4623068,120,58,utRho17
76,appA,2081198,2081234,2081198,36,78,utRho17
77,appC,2075420,2075480,2075420,60,0,utRho17
78,appY,1167134,1167362,1167134,228,0,utRho17
79,apt,982620,982824,982620,204,124,utRho17
80,aqpZ,1832424,1832424,1832094,330,220,utRho17
81,araB,140150,140150,140096,54,0,utRho17
82,araC,140482,140774,140482,292,938,utRho17
83,araE,5964416,5964416,5964364,52,0,utRho17
84,araF,3972476,3972476,3972256,220,44,utRho17
85,araH,3967120,3967120,3967086,34,234,utRho17
86,araJ,825058,825058,824962,96,1226,utRho17
87,arcA,9281602,9281602,9280612,990,5504,utRho17
88,arcB,6706098,6706098,6706050,48,760,utRho17
89,arcZ,6701154,6701154,6701154,0,0,utRho17
90,arfA,6877346,6877346,6877298,48,872,utRho17
91,argA,5898312,5898484,5898312,172,112,utRho17
92,argC,8309770,8310002,8309770,232,84,utRho17
93,argD,6980442,6980442,6980360,82,550,utRho17
94,argE,8310156,8310156,8309694,462,250,utRho17
95,argF,580680,580680,580610,70,50,utRho17
96,argG,6637124,6637274,6637124,150,74,utRho17
97,argI,8956688,8956688,8956622,66,242,utRho17
98,argO,6137672,6137672,6137616,56,270,utRho17
99,argP,6119460,6119506,6119460,46,222,utRho17
100,argR,6769204,6769406,6769204,202,40,utRho17
101,argS,3920002,3920124,3920002,122,0,utRho17
102,argT,4855698,4855698,4855582,116,448,utRho17
103,argU,1129406,1129446,1129406,40,32,utRho17
104,argW,4932616,4932618,4932616,2,94,utRho17
105,argX,7964728,7964750,7964728,22,0,utRho17
106,aroF,5482402,5482402,5482300,102,0,utRho17
107,aroG,1571182,1571266,1571182,84,586,utRho17
108,aroH,3576636,3576870,3576636,234,586,utRho17
109,aroK,7038760,7038760,7038128,632,1636,utRho17
110,aroL,812560,812810,812560,250,1126,utRho17
111,aroP,243342,243342,243102,240,88,utRho17
112,arpA,8445382,8445382,8444974,408,494,utRho17
113,arrS,7316108,7316108,7316108,0,0,utRho17
114,arsR,7297024,7297056,7297024,32,256,utRho17
115,artJ,1801252,1801252,1801150,102,0,utRho17
116,artP,1807686,1807686,1807468,218,2308,utRho17
117,ascF,5678858,5679048,5678858,190,0,utRho17
118,ascG,5678574,5678574,5678528,46,4,utRho17
119,aslB,7965562,7965916,7965562,354,3528,utRho17
120,asnA,7854258,7854310,7854258,52,472,utRho17
121,asnB,1398444,1398444,1398354,90,2062,utRho17
122,asnC,23562186,23562186,23562018,168,0,utRho17
123,asnS,1978088,1978088,1977970,118,7930,utRho17
124,asnT,4089082,4089098,4089082,16,106,utRho17
125,asnU,4119690,4119702,4119690,12,14,utRho17
126,asnV,4124504,4124520,4124504,16,124,utRho17
127,aspA,17473728,17473728,17473308,420,144,utRho17
128,aspC,1971486,1971486,1971418,68,664,utRho17
129,aspS,3901402,3901402,3901044,358,152,utRho17
130,aspT,7893560,7893744,7893560,184,181422,utRho17
131,aspV,473826,473862,473826,36,356,utRho17
132,asr,3342654,3342752,3342654,98,94,utRho17
133,astC,3664088,3664088,3663964,124,0,utRho17
134,astE,3654138,3654138,3653846,292,84,utRho17
135,atoD,4646824,4646894,4646824,70,1020,utRho17
136,atpB,7844540,7844540,7844102,438,280,utRho17
137,atpC,7832118,7832118,7831944,174,1864,utRho17
138,atpI,7845050,7845050,7844880,170,92,utRho17
139,avtA,7479348,7479410,7479348,62,844,utRho17
140,azoR,2965982,2965982,2965720,262,282,utRho17
141,azuC,3976002,3976002,3975918,84,0,utRho17
142,bacA,6408350,6408350,6408262,88,590,utRho17
143,bamA,394052,395856,394052,1804,1332,utRho17
144,bamB,5277950,5277950,5277304,646,1030,utRho17
145,bamC,5198028,5198028,5197730,298,474,utRho17
146,bamD,5471922,5472292,5471922,370,5148,utRho17
147,bamE,5506972,5507210,5506972,238,492,utRho17
148,basS,8666954,8666954,8666544,410,1304,utRho17
149,bax,7474468,7474468,7474354,114,100,utRho17
150,bcp,5200874,5200956,5200874,82,1208,utRho17
151,bcsB,7385346,7385346,7385214,132,172,utRho17
152,bcsE,7392644,7392916,7392644,272,164,utRho17
153,bdcA,8948128,8948128,8948106,22,1508,utRho17
154,bdcR,8948192,8948248,8948192,56,1288,utRho17
155,bdm,3112680,3112680,3112560,120,42,utRho17
156,betA,654522,654522,654494,28,84,utRho17
157,betI,658722,658722,658668,54,242,utRho17
158,betT,658842,658926,658842,84,312,utRho17
159,bfr,6933498,6933498,6933450,48,318,utRho17
160,bglG,23440182,23440182,23439402,780,456,utRho17
161,bglX,4444240,4444240,4443978,262,172,utRho17
162,bhsA,2337962,2338146,2337962,184,234,utRho17
163,bioA,1618584,1618584,1618514,70,0,utRho17
164,bioB,1618604,1618688,1618604,84,0,utRho17
165,bioH,7089716,7089716,7089688,28,0,utRho17
166,bisC,7433026,7433026,7432788,238,420,utRho17
167,blc,8755490,8755490,8755444,46,0,utRho17
168,blr,3409024,3409102,3409024,78,138,utRho17
169,bluF,2431226,2431226,2430950,276,172,utRho17
170,bluR,2428226,2428226,2428118,108,28,utRho17
171,bolA,908698,908944,908698,246,0,utRho17
172,borD,1157842,1157842,1157786,56,256,utRho17
173,brnQ,838976,839182,838976,206,532,utRho17
174,bssR,1756492,1756496,1756492,4,0,utRho17
175,bssS,2242116,2242116,2241910,206,282,utRho17
176,btuB,8326798,8327278,8326798,480,3720,utRho17
177,cadB,8720212,8720212,8720062,150,76,utRho17
178,cadC,8723926,8723926,8723868,58,0,utRho17
179,caiE,70998,70998,70742,256,406,utRho17
180,caiF,68436,68600,68436,164,242,utRho17
181,caiT,84074,84074,83862,212,2,utRho17
182,can,285406,285406,285340,66,174,utRho17
183,carA,59102,59302,59102,200,142,utRho17
184,carB,61550,61634,61550,84,496,utRho17
185,cas2,5757830,5757830,5757706,124,310,utRho17
186,casA,5768638,5768638,5768276,362,70,utRho17
187,cbl,4121882,4121882,4121828,54,1330,utRho17
188,cbpA,2128074,2128074,2127550,524,346,utRho17
189,cbrA,7738628,7738754,7738628,126,56,utRho17
190,cbrB,7794958,7795012,7794958,54,246,utRho17
191,ccmH,4585242,4585242,4584820,422,228,utRho17
192,cdaR,364894,364926,364894,32,232,utRho17
193,cdd,4463638,4463688,4463638,50,72,utRho17
194,cdh,8219814,8219860,8219814,46,886,utRho17
195,cdsA,391110,391354,391110,244,458,utRho17
196,cedA,3627484,3627484,3627326,158,944,utRho17
197,cfa,3482402,3482826,3482402,424,506,utRho17
198,chaC,2544844,2544972,2544844,128,516,utRho17
199,chbB,3643452,3643452,3643238,214,0,utRho17
200,chbG,3634624,3634624,3634270,354,274,utRho17
201,cheW,3946924,3946924,3946678,246,804,utRho17
202,chiA,6939792,6939792,6939706,86,2,utRho17
203,chiP,1416472,1416668,1416472,196,80,utRho17
204,cho,3646984,3647030,3646984,46,98,utRho17
205,chpS,8896804,8896894,8896804,90,286,utRho17
206,cirA,4493884,4493884,4493538,346,332,utRho17
207,citC,1304078,1304078,1303712,366,60,utRho17
208,citT,1293264,1293264,1293160,104,70,utRho17
209,clcA,350104,350214,350104,110,64,utRho17
210,clpA,1846160,1846528,1846160,368,424,utRho17
211,clpB,5468410,5468410,5468346,64,320,utRho17
212,clpP,913154,913354,913154,200,556,utRho17
213,clpS,1845500,1845826,1845500,326,40,utRho17
214,clpX,914404,914852,914404,448,1944,utRho17
215,clsA,2617346,2617346,2617290,56,182,utRho17
216,clsC,2212584,2212710,2212584,126,214,utRho17
217,cmk,1922330,1922402,1922330,72,0,utRho17
218,cnu,3409522,3409898,3409522,376,1246,utRho17
219,coaA,8350214,8350214,8350052,162,754,utRho17
220,cobC,1340092,1340092,1339814,278,564,utRho17
221,cobT,4129202,4129202,4128934,268,466,utRho17
222,cobU,4131944,4131944,4131528,416,548,utRho17
223,codB,709768,709844,709768,76,476,utRho17
224,comR,2337726,2337726,2337664,62,0,utRho17
225,copA,1022822,1022822,1022758,64,74,utRho17
226,corA,8002388,8002852,8002388,464,19360,utRho17
227,cpdB,8873258,8873258,8873130,128,812,utRho17
228,cptB,6082198,6082198,6082140,58,100,utRho17
229,cpxA,8210202,8210202,8209950,252,268,utRho17
230,cpxP,8211570,8211640,8211570,70,224,utRho17
231,cpxR,8211372,8211372,8211340,32,0,utRho17
232,cra,175894,176056,175894,162,0,utRho17
233,crcB,1316016,1316016,1315876,140,474,utRho17
234,creA,9270486,9271042,9270486,556,322,utRho17
235,creD,9276320,9276356,9276320,36,348,utRho17
236,crl,515620,515658,515620,38,1164,utRho17
237,crp,6971906,6972240,6971906,334,3718,utRho17
238,crr,5070960,5071668,5070960,708,2028,utRho17
239,csdA,5886414,5886674,5886414,260,224,utRho17
240,csgB,2207718,2207902,2207718,184,30,utRho17
241,csgD,2206688,2206688,2206392,296,286,utRho17
242,csgG,2203510,2203510,2203368,142,278,utRho17
243,csiD,5577854,5577970,5577854,116,240,utRho17
244,csiE,5330802,5330870,5330802,68,156,utRho17
245,csiR,5590942,5591348,5590942,406,154,utRho17
246,cspA,7439778,7440098,7439778,320,11124,utRho17
247,cspB,3283430,3283430,3283108,322,0,utRho17
248,cspC,3815018,3815018,3814870,148,678,utRho17
249,cspD,1845352,1845352,1845180,172,6318,utRho17
250,cspE,1314294,1314584,1314294,290,94,utRho17
251,cspF,3283380,3283710,3283380,330,60,utRho17
252,cspG,2102610,2102922,2102610,312,1252,utRho17
253,cspH,2102746,2102746,2102350,396,56,utRho17
254,cspI,3277624,3277624,3277334,290,14,utRho17
255,csrA,5638746,5638746,5638292,454,1244,utRho17
256,csrB,5849048,5849048,5849048,0,0,utRho17
257,csrC,8102072,8102072,8102072,0,0,utRho17
258,csrD,6806850,6806850,6806664,186,198,utRho17
259,cstA,1259710,1259788,1259710,78,0,utRho17
260,cueO,274090,274166,274090,76,0,utRho17
261,cueR,1027948,1027986,1027948,38,14,utRho17
262,curA,3037784,3038054,3037784,270,838,utRho17
263,cusC,1191146,1191200,1191146,54,208,utRho17
264,cusR,1190924,1190924,1190886,38,324,utRho17
265,cutA,8730784,8730784,8730712,72,1262,utRho17
266,cutC,3918534,3918534,3917920,614,354,utRho17
267,cvpA,4861600,4861600,4861526,74,40,utRho17
268,cvrA,2484328,2484328,2484142,186,88,utRho17
269,cyaA,7981548,7982306,7981548,758,1092,utRho17
270,cyaR,4334228,4334224,4334228,4,0,utRho17
271,cyaY,7988166,7988166,7988118,48,180,utRho17
272,cybB,2981522,2981804,2981522,282,160,utRho17
273,cycA,8859560,8859728,8859560,168,1690,utRho17
274,cydA,1542340,1542916,1542340,576,184,utRho17
275,cydC,1858800,1858800,1858390,410,580,utRho17
276,cydD,1862062,1862062,1861924,138,98,utRho17
277,cydX,1548300,1548392,1548300,92,326,utRho17
278,cynR,717418,717418,717380,38,70,utRho17
279,cynT,1435092,1435196,1435092,104,0,utRho17
280,cyoA,903306,903306,903220,86,3176,utRho17
281,cyoE,895540,895540,895410,130,186,utRho17
282,cysB,2667576,2667710,2667576,134,326,utRho17
283,cysC,5748056,5748056,5747984,72,106,utRho17
284,cysD,5752736,5752736,5752658,78,66,utRho17
285,cysE,7565362,7565362,7565124,238,2232,utRho17
286,cysG,6995508,6995656,6995508,148,830,utRho17
287,cysJ,5783928,5783928,5783796,132,2796,utRho17
288,cysK,5064688,5064818,5064688,130,478,utRho17
289,cysP,5087114,5087114,5087056,58,800,utRho17
290,cysS,1109154,1109222,1109154,68,0,utRho17
291,cysT,3984100,3984100,3983974,126,614,utRho17
292,cysZ,5062766,5062926,5062766,160,198,utRho17
293,cytR,8249018,8249018,8248912,106,24,utRho17
294,dacA,1328002,1328002,1327926,76,230,utRho17
295,dacB,6657714,6657926,6657714,212,254,utRho17
296,dacC,1761306,1761454,1761306,148,510,utRho17
297,dadA,2475018,2475142,2475018,124,26,utRho17
298,dam,7032504,7032504,7031826,678,1128,utRho17
299,damX,7035200,7035200,7034612,588,392,utRho17
300,dapA,5199568,5199568,5199520,48,0,utRho17
301,dapB,56576,56748,56576,172,414,utRho17
302,dapD,371954,371954,371894,60,328,utRho17
303,dapE,5183120,5183214,5183120,94,1840,utRho17
304,dcp,3254844,3254844,3254760,84,90,utRho17
305,dcrB,7219534,7219910,7219534,376,664,utRho17
306,dctA,7366996,7366996,7366894,102,592,utRho17
307,dcuA,8733686,8733686,8733546,140,48,utRho17
308,dcuB,8698182,8698182,8697488,694,3128,utRho17
309,dcuC,1312166,1312166,1311936,230,520,utRho17
310,dcuD,6749166,6749738,6749166,572,232,utRho17
311,dcuR,8701130,8701130,8700068,1062,1830,utRho17
312,dcuS,8703370,8703370,8703324,46,684,utRho17
313,dcyD,3999016,3999016,3998960,56,0,utRho17
314,ddpX,3126498,3126498,3126152,346,334,utRho17
315,deaD,6615818,6615818,6615720,98,1162,utRho17
316,dedA,4869880,4869880,4869482,398,5650,utRho17
317,dedD,4863750,4863750,4863368,382,16,utRho17
318,def,6867300,6867380,6867300,80,230,utRho17
319,degP,361690,361768,361690,78,44,utRho17
320,degQ,6761308,6761486,6761308,178,4150,utRho17
321,deoB,9239134,9239206,9239134,72,158,utRho17
322,deoC,9233358,9234646,9233358,1288,470,utRho17
323,dfp,7625406,7625462,7625406,56,0,utRho17
324,dgcZ,3247758,3247758,3247700,58,116,utRho17
325,dgkA,8512914,8513274,8512914,360,300,utRho17
326,dgt,358392,358474,358392,82,628,utRho17
327,dhaK,2501888,2501888,2501676,212,310,utRho17
328,dhaR,2502006,2502132,2502006,126,254,utRho17
329,dicB,3299194,3299218,3299194,24,0,utRho17
330,dicC,3295752,3295752,3295700,52,0,utRho17
331,dinB,501760,501796,501760,36,38,utRho17
332,dinD,7635398,7635520,7635398,122,172,utRho17
333,dinG,1666146,1666140,1666146,6,0,utRho17
334,dinI,2243018,2243018,2242974,44,470,utRho17
335,dinJ,493230,493230,493004,226,190,utRho17
336,dinQ,7295964,7295964,7295576,388,1198,utRho17
337,djlA,114536,114728,114536,192,24,utRho17
338,dkgA,6313142,6313246,6313142,104,504,utRho17
339,dkgB,458196,458334,458196,138,26,utRho17
340,dksA,321502,321502,321208,294,1602,utRho17
341,dld,4444164,4444370,4444164,206,122,utRho17
342,dmlA,3763424,3763824,3763424,400,722,utRho17
343,dmlR,3763710,3763710,3763618,92,206,utRho17
344,dmsA,1881646,1881918,1881646,272,2,utRho17
345,dnaA,7767922,7767922,7767458,464,1632,utRho17
346,dnaB,8528566,8528628,8528566,62,322,utRho17
347,dnaK,24096,24326,24096,230,4394,utRho17
348,dnaN,7765466,7765466,7764642,824,798,utRho17
349,dnaQ,471868,472134,471868,266,1652,utRho17
350,dnaT,18406460,18406460,18406068,392,7764,utRho17
351,dnaX,984112,984184,984112,72,1062,utRho17
352,dosP,3131486,3131486,3131466,20,36,utRho17
353,dpiB,1303968,1304470,1303968,502,68,utRho17
354,dppA,7415740,7415740,7415410,330,2500,utRho17
355,dps,1697900,1697900,1697822,78,38,utRho17
356,dsbA,8086754,8086836,8086754,82,1438,utRho17
357,dsbB,2466294,2466294,2466060,234,110,utRho17
358,dsbC,6079266,6079266,6077644,1622,1768,utRho17
359,dsbG,1277600,1277600,1277146,454,232,utRho17
360,dsdA,4958242,4958404,4958242,162,258,utRho17
361,dsdC,4955492,4955492,4955258,234,0,utRho17
362,dsdX,4955642,4955694,4955642,52,242,utRho17
363,dsrA,4050626,4050626,4050626,0,0,utRho17
364,dsrB,4049686,4049686,4049646,40,608,utRho17
365,dtpD,1485340,1485340,1485112,228,140,utRho17
366,dusA,8523200,8523338,8523200,138,1474,utRho17
367,dusB,6820492,6820560,6820492,68,74,utRho17
368,dusC,4460790,4460790,4460770,20,0,utRho17
369,dut,7627704,7627864,7627704,160,854,utRho17
370,dxr,386670,387042,386670,372,402,utRho17
371,ebgA,6445102,6445266,6445102,164,450,utRho17
372,ebgR,6442874,6442932,6442874,58,24,utRho17
373,ecnB,8753018,8753106,8753018,88,546,utRho17
374,eco,4607594,4607810,4607594,216,12,utRho17
375,ecpA,621594,621594,621342,252,112,utRho17
376,ecpB,620238,620238,620052,186,74,utRho17
377,ecpR,622964,622964,622672,292,0,utRho17
378,eda,3866218,3866218,3865512,706,0,utRho17
379,edd,3869426,3869426,3869208,218,54,utRho17
380,efeO,2164308,2164486,2164308,178,4,utRho17
381,efeU_1,2162614,2162712,2162614,98,66,utRho17
382,efp,8751134,8751398,8751134,264,2258,utRho17
383,elaA,4763372,4763372,4763086,286,0,utRho17
384,elaD,4765308,4765426,4765308,118,38,utRho17
385,elfA,1995530,1995736,1995530,206,0,utRho17
386,elfD,1996642,1996980,1996642,338,128,utRho17
387,emrD,7707690,7707844,7707690,154,0,utRho17
388,emrK,4966896,4966896,4966678,218,50,utRho17
389,emrY,4964668,4964668,4964352,316,72,utRho17
390,emtA,2486250,2486360,2486250,110,40,utRho17
391,endA,12361100,12361388,12361100,288,152,utRho17
392,eno,5817692,5817692,5815882,1810,4324,utRho17
393,entC,1249662,1249770,1249662,108,0,utRho17
394,entD,1220508,1220508,1220158,350,20,utRho17
395,entH,1258584,1258600,1258584,16,50,utRho17
396,entS,1244506,1244600,1244506,94,0,utRho17
397,envR,6827266,6827266,6826930,336,146,utRho17
398,epd,12295292,12295292,12294764,528,176,utRho17
399,epmA,8765236,8765286,8765236,50,26,utRho17
400,epmB,8751406,8751406,8751314,92,886,utRho17
401,eptB,7421162,7421162,7420950,212,146,utRho17
402,eptC,8300622,8300622,8300530,92,502,utRho17
403,erfK,4126708,4126708,4126646,62,598,utRho17
404,erpA,353122,353220,353122,98,140,utRho17
405,esrE,8039956,8039956,8039956,0,0,utRho17
406,essD,1153746,1154796,1153746,1050,2764,utRho17
407,etk,2088606,2088606,2088420,186,740,utRho17
408,evgA,4967262,4967510,4967262,248,108,utRho17
409,exbB,6304028,6304028,6303968,60,54,utRho17
410,exbD,6302780,6302780,6302486,294,372,utRho17
411,exuR,6493016,6493304,6493016,288,472,utRho17
412,exuT,6490004,6490208,6490004,204,0,utRho17
413,fabA,2032996,2032996,2032940,56,66,utRho17
414,fabB,4883282,4883282,4883210,72,0,utRho17
415,fabH,2297032,2297518,2297032,486,2774,utRho17
416,fabI,2702236,2702236,2702078,158,210,utRho17
417,fadB,8062026,8062026,8061942,84,0,utRho17
418,fadD,3779614,3779614,3779492,122,0,utRho17
419,fadE,486812,486812,486606,206,6,utRho17
420,fadH,6463248,6463330,6463248,82,194,utRho17
421,fadI,4921022,4921022,4920938,84,92,utRho17
422,fadL,4922410,4922600,4922410,190,272,utRho17
423,fadM,928720,928804,928720,84,0,utRho17
424,fadR,2469810,2469876,2469810,66,0,utRho17
425,fbaB,4357334,4357334,4357128,206,106,utRho17
426,fdhE,8162722,8162722,8162456,266,1304,utRho17
427,fdhF,8598814,8598814,8598732,82,384,utRho17
428,fdnG,3094744,3094802,3094744,58,50,utRho17
429,fdrA,1093012,1093360,1093012,348,114,utRho17
430,feaB,2894994,2895038,2894994,44,0,utRho17
431,feaR,2894734,2894734,2894566,168,44,utRho17
432,fecA,9033454,9033454,9033354,100,0,utRho17
433,fecE,9023288,9023288,9022914,374,2134,utRho17
434,fecI,9036564,9036564,9036470,94,344,utRho17
435,feoA,7080114,7080326,7080114,212,334,utRho17
436,fepA,1225334,1225334,1224988,346,266,utRho17
437,fepB,1249454,1249454,1249020,434,72,utRho17
438,fepD,1244468,1244468,1244378,90,0,utRho17
439,fes,1225374,1225630,1225374,256,158,utRho17
440,ffh,5495706,5495706,5495590,116,248,utRho17
441,ffs,952576,952848,952576,272,1882,utRho17
442,fhuA,334884,334968,334884,84,530,utRho17
443,fhuE,2323294,2323294,2323102,192,88,utRho17
444,fhuF,9211504,9211504,9211326,178,74750,utRho17
445,fic,6983296,6983296,6982926,370,1960,utRho17
446,fieF,8212864,8212938,8212864,74,184,utRho17
447,fimA,9085388,9086230,9085388,842,2120,utRho17
448,fimB,9081334,9081914,9081334,580,4118,utRho17
449,fimE,9083742,9084074,9083742,332,2310,utRho17
450,fimZ,1129214,1129214,1128960,254,0,utRho17
451,fiu,1683296,1683296,1683062,234,56,utRho17
452,fixA,84650,84806,84650,156,0,utRho17
453,fkpA,6955050,6955050,6954838,212,3978,utRho17
454,fldA,2846084,2846084,2845860,224,2428,utRho17
455,fldB,6079644,6079710,6079644,66,156,utRho17
456,flgA,2261770,2261770,2261726,44,1184,utRho17
457,flgB,2261986,2262036,2261986,50,152,utRho17
458,flgK,2276702,2276756,2276702,54,1114,utRho17
459,flgM,2260330,2260330,2260256,74,58,utRho17
460,flgN,2259828,2259828,2259660,168,198,utRho17
461,flhB,3932432,3932432,3932382,50,480,utRho17
462,flhC,3955864,3955864,3955688,176,98,utRho17
463,flhD,3957154,3957154,3956394,760,2330,utRho17
464,fliA,4003638,4003638,4003578,60,142,utRho17
465,fliC,4007352,4007352,4007212,140,224,utRho17
466,fliD,4007634,4007744,4007634,110,966,utRho17
467,fliE,4026186,4026186,4026028,158,524,utRho17
468,fliF,4026292,4026458,4026292,166,358,utRho17
469,fliL,4039168,4039236,4039168,68,62,utRho17
470,flk,4875824,4875900,4875824,76,156,utRho17
471,flu,4142634,4143078,4142634,444,338,utRho17
472,flxA,3292776,3292810,3292776,34,110,utRho17
473,fnr,2799104,2799104,2799052,52,80,utRho17
474,fnrS,2818258,2818258,2818258,0,0,utRho17
475,focA,1909628,1909628,1908932,696,1690,utRho17
476,folA,99598,99646,99598,48,256,utRho17
477,folB,6409296,6409296,6409178,118,98,utRho17
478,folD,1115562,1115562,1115482,80,382,utRho17
479,folE,4487696,4487696,4487304,392,2152,utRho17
480,fpr,8228998,8228998,8228944,54,32,utRho17
481,frc,4986878,4986878,4986508,370,44,utRho17
482,frdA,8764824,8764824,8764636,188,564,utRho17
483,frdD,8758948,8758948,8758732,216,5024,utRho17
484,fre,8052886,8053054,8052886,168,1334,utRho17
485,frlA,6999518,6999820,6999518,302,578,utRho17
486,frr,385624,385744,385624,120,836,utRho17
487,frsA,513004,513054,513004,50,188,utRho17
488,fruB,4527194,4527194,4526990,204,0,utRho17
489,frvR,8179804,8179804,8179710,94,0,utRho17
490,fryA,5008986,5008986,5008970,16,364,utRho17
491,fsaA,1727060,1727284,1727060,224,660,utRho17
492,fsr,1009710,1009710,1009392,318,96,utRho17
493,ftnA,3977364,3977432,3977364,68,0,utRho17
494,ftnB,3973550,3973850,3973550,300,276,utRho17
495,ftsA,207122,207964,207122,842,946,utRho17
496,ftsB,5745802,5745802,5745640,162,1220,utRho17
497,ftsH,6654204,6654204,6653870,334,646,utRho17
498,ftsK,1865858,1866448,1865858,590,828,utRho17
499,ftsL,181376,182064,181376,688,2798,utRho17
500,ftsP,6325732,6325732,6325338,394,262,utRho17
501,ftsQ,205484,206310,205484,826,510,utRho17
502,ftsX,7204512,7204512,7204172,340,580,utRho17
503,ftsZ,209272,210610,209272,1338,472,utRho17
504,fucA,5867708,5867708,5867376,332,4248,utRho17
505,fucP,5868238,5868470,5868238,232,894,utRho17
506,fumA,6753760,6753760,6753508,252,3164,utRho17
507,fumB,8694696,8694696,8694652,44,160,utRho17
508,fumC,3373418,3373418,3373176,242,28,utRho17
509,fur,2842892,2842892,2842584,308,2960,utRho17
510,fusA,6947370,6947370,6947028,342,15794,utRho17
511,fxsA,8737206,8737328,8737206,122,556,utRho17
512,gabD,5581824,5582546,5581824,722,2628,utRho17
513,gadA,7335214,7335214,7335160,54,0,utRho17
514,gadB,3144144,3144144,3144090,54,224,utRho17
515,gadC,3141168,3141168,3140978,190,68,utRho17
516,gadE,7315600,7316732,7315600,1132,756,utRho17
517,gadW,7329562,7329562,7329236,326,278,utRho17
518,gadX,14663356,14663356,14663240,116,672,utRho17
519,gadY,7329728,7329728,7329728,0,0,utRho17
520,galE,1584354,1584354,1584110,244,132,utRho17
521,galF,4228702,4228702,4228654,48,142,utRho17
522,galM,1577796,1577796,1577674,122,212,utRho17
523,galP,6176510,6176568,6176510,58,42,utRho17
524,galR,5953138,5953198,5953138,60,58,utRho17
525,galS,4483420,4483420,4483336,84,0,utRho17
526,galU,2582810,2582914,2582810,104,340,utRho17
527,gapA,3724480,3725542,3724480,1062,5310,utRho17
528,garP,6549868,6549868,6549814,54,236,utRho17
529,gatY,4354468,4354468,4354408,60,58,utRho17
530,gatZ,4352864,4352864,4352642,222,16678,utRho17
531,gcd,282558,282558,282450,108,0,utRho17
532,gcl,1067814,1067832,1067814,18,0,utRho17
533,gcvA,5885278,5885278,5885134,144,72,utRho17
534,gcvB,5885392,5885392,5885392,0,0,utRho17
535,gcvR,5199758,5199812,5199758,54,152,utRho17
536,gcvT,6101544,6101544,6101334,210,1774,utRho17
537,gdhA,3684616,3684742,3684616,126,82,utRho17
538,gfcA,2099668,2099668,2099488,180,1424,utRho17
539,gfcD,2096236,2096236,2095890,346,2530,utRho17
540,ghrA,2195648,2195772,2195648,124,0,utRho17
541,ghrB,7434378,7434620,7434378,242,4174,utRho17
542,glcA,6242728,6242728,6242558,170,1020,utRho17
543,glcC,6256412,6256544,6256412,132,0,utRho17
544,glcD,6256152,6256152,6256042,110,340,utRho17
545,gldA,8278092,8278092,8278070,22,32,utRho17
546,glgA,7136784,7136784,7136066,718,5596,utRho17
547,glgB,7147314,7147314,7147004,310,728,utRho17
548,glgC,7139142,7139142,7138656,486,756,utRho17
549,glgP,7133546,7133546,7133162,384,1470,utRho17
550,glgS,6384024,6384024,6383878,146,274,utRho17
551,glgX,7142838,7142838,7142638,200,172,utRho17
552,glk,5018922,5018922,5018852,70,238,utRho17
553,glmS,7827622,7827622,7827336,286,1354,utRho17
554,glmU,7830652,7830652,7830400,252,370,utRho17
555,glmY,10765360,10765360,10765360,0,0,utRho17
556,glmZ,7972864,7972864,7972864,0,0,utRho17
557,glnA,16232888,16232888,16232136,752,504,utRho17
558,glnB,5375052,5375052,5374816,236,1114,utRho17
559,glnD,377310,377310,377300,10,2,utRho17
560,glnE,6399602,6399602,6399282,320,50,utRho17
561,glnH,1696396,1696396,1696008,388,698,utRho17
562,glnK,945112,945196,945112,84,100,utRho17
563,glnL,8112742,8112742,8112678,64,84,utRho17
564,glnQ,1693262,1693262,1692926,336,488,utRho17
565,glnS,1411998,1412186,1411998,188,2108,utRho17
566,gloA,3455602,3455674,3455602,72,58,utRho17
567,gloB,469852,469852,469564,288,1070,utRho17
568,glpA,4705166,4705294,4705166,128,28,utRho17
569,glpD,7123942,7124026,7123942,84,0,utRho17
570,glpE,7123698,7123698,7123646,52,46,utRho17
571,glpF,8236322,8236322,8236180,142,478,utRho17
572,glpG,7122960,7122960,7122904,56,426,utRho17
573,glpR,7121782,7121782,7121210,572,900,utRho17
574,glpT,4704902,4704902,4704748,154,490,utRho17
575,glpX,8231212,8231212,8231158,54,12244,utRho17
576,glrK,5382246,5382246,5382196,50,734,utRho17
577,gltA,1509534,1509534,1508936,598,5936,utRho17
578,gltB,6709018,6709264,6709018,246,1130,utRho17
579,gltI,1375792,1375792,1375494,298,3310,utRho17
580,gltP,8588536,8588962,8588536,426,2908,utRho17
581,gltS,7657382,7657382,7657330,52,1324,utRho17
582,gltX,5041568,5041568,5041344,224,760,utRho17
583,gluQ,320286,320286,320224,62,152,utRho17
584,glyA,5371148,5371148,5371014,134,2,utRho17
585,glyQ,7450708,7450708,7450636,72,548,utRho17
586,glyS,7448990,7448990,7448794,196,1306,utRho17
587,glyU,5998128,5998128,5998114,14,86,utRho17
588,glyV,8784626,8784720,8784626,94,512,utRho17
589,glyW,3984360,3984360,3984234,126,34,utRho17
590,gmhB,445612,445666,445612,54,0,utRho17
591,gmk,7642776,7642856,7642776,80,112,utRho17
592,gmr,2693686,2693686,2693484,202,458,utRho17
593,gnd,4202648,4202648,4202536,112,516,utRho17
594,gnsB,3275692,3275692,3275564,128,50,utRho17
595,gntK,14310580,14310580,14310368,212,816,utRho17
596,gntP,9102668,9102668,9102592,76,408,utRho17
597,gntR,7157760,7157760,7157452,308,454,utRho17
598,gntT,7092810,7093118,7092810,308,2830,utRho17
599,gntU,7154170,7154170,7154122,48,452,utRho17
600,gntX,7089334,7089764,7089334,430,256,utRho17
601,gor,7292224,7292598,7292224,374,138,utRho17
602,gpmA,1575340,1575340,1575190,150,0,utRho17
603,gpmM,7570374,7570520,7570374,146,44,utRho17
604,gpsA,7567620,7567620,7567322,298,8044,utRho17
605,gpt,511828,511954,511828,126,400,utRho17
606,grcA,5433046,5433046,5432898,148,1092,utRho17
607,greA,6657728,6657728,6657430,298,754,utRho17
608,greB,7073488,7073624,7073488,136,138,utRho17
609,groL,8741566,8742050,8741566,484,7258,utRho17
610,groS,8741232,8741376,8741232,144,11080,utRho17
611,grpE,5501494,5501494,5501416,78,424,utRho17
612,grxA,1781552,1781552,1781506,46,48,utRho17
613,grxB,2248206,2248206,2248108,98,798,utRho17
614,grxC,7569152,7569152,7568884,268,3196,utRho17
615,grxD,3468324,3468324,3468202,122,584,utRho17
616,gspA,6911268,6911268,6910796,472,328,utRho17
617,gspC,6910964,6911156,6910964,192,88,utRho17
618,gss,6277220,6277220,6277044,176,190,utRho17
619,gstA,3428654,3428754,3428654,100,0,utRho17
620,gstB,1761038,1761038,1760960,78,308,utRho17
621,guaB,5268214,5268214,5268140,74,152,utRho17
622,gudD,5839026,5839026,5838770,256,136,utRho17
623,gyrA,4678914,4678914,4678840,74,14,utRho17
624,gyrB,7760300,7760300,7760238,62,298,utRho17
625,hcaE,5337964,5338064,5337964,100,3174,utRho17
626,hcaR,5337928,5337928,5337792,136,3604,utRho17
627,hcaT,5336106,5336106,5335692,414,1714,utRho17
628,hchA,4071260,4071670,4071260,410,86,utRho17
629,hcp,1828258,1828258,1827628,630,1166,utRho17
630,hcr,1824400,1824400,1824300,100,0,utRho17
631,hdeA,7313582,7313582,7313480,102,66,utRho17
632,hdeD,7313920,7313990,7313920,70,178,utRho17
633,hdfR,7896320,7896320,7895934,386,726,utRho17
634,hdhA,3396244,3396244,3396080,164,104,utRho17
635,helD,2048876,2048942,2048876,66,0,utRho17
636,hemA,2527166,2527428,2527166,262,324,utRho17
637,hemB,779722,779722,779454,268,1934,utRho17
638,hemF,5106410,5106450,5106410,40,0,utRho17
639,hemH,996062,996110,996062,48,1044,utRho17
640,hemL,349882,349882,349764,118,68,utRho17
641,hemN,8103886,8104090,8103886,204,158,utRho17
642,hepA,127176,127176,126528,648,2860,utRho17
643,hflD,2385372,2385372,2385262,110,40,utRho17
644,hfq,8799602,8800576,8799602,974,15684,utRho17
645,hha,961006,961006,960616,390,356,utRho17
646,hicA,3018442,3018572,3018442,130,20,utRho17
647,higA,6468682,6468682,6468288,394,1072,utRho17
648,higB,6468960,6468960,6468910,50,96,utRho17
649,hinT,2323642,2323770,2323642,128,0,utRho17
650,hipB,3184964,3184964,3184884,80,134,utRho17
651,hisB,4186720,4186936,4186720,216,508,utRho17
652,hisJ,4853674,4853674,4853576,98,0,utRho17
653,hisL,8359856,8359984,8359856,128,732,utRho17
654,hisS,5281284,5281284,5281150,134,212,utRho17
655,hlpA,400910,400964,400910,54,400,utRho17
656,hlyE,2460932,2460932,2460788,144,782,utRho17
657,hmp,5371594,5371670,5371594,76,34,utRho17
658,hns,2585916,2585916,2585844,72,642,utRho17
659,hofM,7045856,7045856,7045502,354,124,utRho17
660,hokA,7441620,7441620,7441200,420,3046,utRho17
661,hokC,33902,33902,33806,96,444,utRho17
662,hokE,1215462,1215672,1215462,210,0,utRho17
663,holC,8968546,8968546,8968560,14,680,utRho17
664,holD,9215562,9215606,9215562,44,44,utRho17
665,holE,3850040,3850216,3850040,176,2120,utRho17
666,hpt,282720,282862,282720,142,1032,utRho17
667,hrpB,324150,324210,324150,60,8,utRho17
668,hscB,5319048,5319048,5318934,114,5246,utRho17
669,hscC,1367188,1367188,1366786,402,850,utRho17
670,hsdS,9163004,9163004,9162924,80,290,utRho17
671,hslJ,2883560,2883560,2883486,74,322,utRho17
672,hslO,7059344,7059548,7059344,204,10450,utRho17
673,hslR,7058220,7058696,7058220,476,2548,utRho17
674,hslV,8244708,8244708,8244574,134,1238,utRho17
675,hsrA,7881412,7881412,7881224,188,350,utRho17
676,htgA,21286,21660,21286,374,17334,utRho17
677,htpG,989634,990240,989634,606,22000,utRho17
678,htpX,3825236,3825236,3825152,84,170,utRho17
679,htrE,311036,311036,310852,184,1104,utRho17
680,htrL,7587668,7587668,7587366,302,206,utRho17
681,hupA,8400352,8400562,8400352,210,256,utRho17
682,hupB,1845220,1845804,1845220,584,972,utRho17
683,hyaA,2063968,2064278,2063968,310,108,utRho17
684,hybO,6292726,6292726,6292522,204,11034,utRho17
685,hycA,5700922,5700922,5700870,52,164,utRho17
686,hycI,5686204,5686204,5686086,118,536,utRho17
687,hydN,5676264,5676264,5676210,54,0,utRho17
688,hyfA,5202342,5202402,5202342,60,112,utRho17
689,hypA,11402508,11402588,11402508,80,296,utRho17
690,hypB,11403356,11404004,11403356,648,116,utRho17
691,hypF,5676210,5676210,5674850,1360,3600,utRho17
692,hypT,9116634,9116634,9116578,56,88,utRho17
693,hyuA,6019660,6020056,6019660,396,762,utRho17
694,iaaA,1733074,1733136,1733074,62,54,utRho17
695,iadA,9119074,9119074,9119052,22,526,utRho17
696,iap,5753072,5753162,5753072,90,144,utRho17
697,ibaG,6673966,6673966,6673606,360,240,utRho17
698,ibpA,7735036,7735036,7734844,192,5270,utRho17
699,ibpB,7733962,7733962,7733794,168,22968,utRho17
700,icd,2389922,2390246,2389922,324,604,utRho17
701,iclR,8447304,8447304,8447256,48,10,utRho17
702,idi,6065876,6066130,6065876,254,0,utRho17
703,idnD,8988870,8988870,8988812,58,0,utRho17
704,idnK,8989194,8989246,8989194,52,122,utRho17
705,ihfA,3591442,3591442,3591104,338,516,utRho17
706,ihfB,1927498,1927656,1927498,158,696,utRho17
707,ileS,43666,44782,43666,1116,3644,utRho17
708,ileX,6431194,6431196,6431194,2,0,utRho17
709,ilvA,15820940,15821324,15820940,384,2320,utRho17
710,ilvC,7915824,7915940,7915824,116,164,utRho17
711,ilvE,15809552,15809936,15809552,384,1744,utRho17
712,ilvI,170840,171260,170840,420,588,utRho17
713,ilvL,23701308,23701932,23701308,624,456,utRho17
714,ilvY,7915734,7915734,7915640,94,70,utRho17
715,inaA,4698998,4698998,4698944,54,174,utRho17
716,infA,1853370,1853370,1852886,484,1182,utRho17
717,infC,3602692,3602692,3601276,1416,2872,utRho17
718,insA-5,3958452,3958452,3958430,22,52,utRho17
719,insA-7,9036758,9037054,9036758,296,1786,utRho17
720,insC-5,6372080,6372284,6372080,204,9000,utRho17
721,insEF-2,785238,785238,785820,582,2976,utRho17
722,insEF-4,2190310,2190310,2190892,582,2828,utRho17
723,insG,9007098,9007098,9006862,236,0,utRho17
724,insH-1,550596,550596,550234,362,13888,utRho17
725,insH-11,7306538,7306538,7306396,142,234,utRho17
726,insH-2,1151548,1151548,1151506,42,210,utRho17
727,insH-3,1378444,1378444,1378026,418,544,utRho17
728,insH-4,2791942,2792152,2791942,210,466,utRho17
729,insH-5,2857852,2857852,2857452,400,512,utRho17
730,insH-6,4135022,4135022,4134642,380,852,utRho17
731,insH-7,4206186,4206186,4205822,364,1792,utRho17
732,insH-9,6260050,6260356,6260050,306,1172,utRho17
733,insI-3,9017372,9017372,9017234,138,1076,utRho17
734,insJ,7441188,7441360,7441188,172,1116,utRho17
735,insK,7442130,7442308,7442130,178,56,utRho17
736,insL-1,30760,30890,30760,130,5906,utRho17
737,insL-2,1216112,1216130,1216112,18,312,utRho17
738,insL-3,5028644,5028662,5028644,18,254,utRho17
739,insN-1,540452,540484,540452,32,66,utRho17
740,intD,1132202,1132202,1131956,246,9894,utRho17
741,intR,2826520,2826520,2826470,50,8,utRho17
742,intS,4933026,4933090,4933026,64,3708,utRho17
743,intZ,5117386,5117542,5117386,156,2902,utRho17
744,iraD,9113152,9113986,9113152,834,502,utRho17
745,iraM,2424246,2424246,2424006,240,16,utRho17
746,iraP,802638,802772,802638,134,0,utRho17
747,iscA,5319924,5319924,5319772,152,1060,utRho17
748,iscR,5324398,5324398,5324262,136,11366,utRho17
749,iscX,5313834,5313834,5313472,362,2832,utRho17
750,ispF,5743968,5743968,5743560,408,2878,utRho17
751,ispG,5283908,5283908,5283608,300,196,utRho17
752,ispU,389568,389806,389568,238,14,utRho17
753,isrA,2811502,2811502,2811618,116,0,utRho17
754,istr-1,7706384,7706384,7706384,0,0,utRho17
755,istr-2,7706514,7706514,7706514,0,0,utRho17
756,ivbL,15412092,15412092,15411952,140,308,utRho17
757,ivy,480638,480686,480638,48,214,utRho17
758,katE,3627628,3627734,3627628,106,618,utRho17
759,katG,8267624,8267670,8267624,46,130,utRho17
760,kbaZ,6557732,6557828,6557732,96,22,utRho17
761,kbl,7585154,7585154,7585102,52,1466,utRho17
762,kch,2621046,2621046,2620538,508,392,utRho17
763,kdgR,3820506,3820506,3820198,308,162,utRho17
764,kdpE,1443788,1443788,1443466,322,166,utRho17
765,kdpF,1457698,1457698,1457642,56,150,utRho17
766,kdsA,2535708,2536330,2535708,622,1594,utRho17
767,kdsC,6683438,6684546,6683438,1108,2986,utRho17
768,kduI,5968388,5968388,5968248,140,6904,utRho17
769,kefF,94160,94492,94160,332,690,utRho17
770,kgtP,5451624,5451624,5451492,132,290,utRho17
771,kup,7862206,7862632,7862206,426,290,utRho17
772,lacI,735076,735076,735020,56,154,utRho17
773,lacZ,1465508,1465508,1465220,288,104,utRho17
774,ldcA,2486394,2486394,2486160,234,288,utRho17
775,ldhA,2885830,2885830,2885686,144,54,utRho17
776,ldrA,2538954,2538954,2538550,404,2900,utRho17
777,ldrB,2540024,2540024,2539620,404,954,utRho17
778,ldrC,2541092,2541092,2540690,402,502,utRho17
779,ldrD,7400544,7400544,7400174,370,1860,utRho17
780,lepA,5414392,5414392,5414248,144,36,utRho17
781,lepB,5410928,5410928,5410618,310,506,utRho17
782,leuD,159188,159188,158906,282,576,utRho17
783,leuE,3761600,3761600,3761518,82,68,utRho17
784,leuL,168048,168048,167416,632,268,utRho17
785,leuO,168308,168736,168308,428,208,utRho17
786,leuQ,9212864,9212864,9212802,62,0,utRho17
787,leuU,6644556,6644556,6644316,240,2064,utRho17
788,leuV,9212546,9212546,9212330,216,1528,utRho17
789,leuX,8992772,8992810,8992772,38,126,utRho17
790,lexA,8514174,8514230,8514174,56,642,utRho17
791,lhr,3456706,3458174,3456706,1468,4266,utRho17
792,ligA,5060402,5060402,5060352,50,0,utRho17
793,ligB,7642576,7642576,7642340,236,746,utRho17
794,lipA,1320602,1320602,1320432,170,176,utRho17
795,lipB,1324802,1324802,1324556,246,7352,utRho17
796,lit,2397032,2397390,2397032,358,710,utRho17
797,livJ,7199524,7199524,7199316,208,990,utRho17
798,livK,7195510,7195510,7195120,390,494,utRho17
799,lldP,7554578,7554798,7554578,220,4938,utRho17
800,lnt,1381968,1381968,1381762,206,436,utRho17
801,loiP,6163784,6163826,6163784,42,110,utRho17
802,lolA,1874656,1874738,1874656,82,0,utRho17
803,lolB,2527112,2527112,2527000,112,216,utRho17
804,lolC,2350748,2350854,2350748,106,40,utRho17
805,lon,917630,917776,917630,146,408,utRho17
806,lpcA,486936,487086,486936,150,14,utRho17
807,lpd,255434,255824,255434,390,2446,utRho17
808,lplA,9248476,9248476,9248234,242,786,utRho17
809,lplT,5947878,5947878,5947724,154,140,utRho17
810,lpoA,6586422,6586800,6586422,378,500,utRho17
811,lpp,3514592,3514842,3514592,250,236,utRho17
812,lptA,6686598,6686760,6686598,162,518,utRho17
813,lptB,6686792,6687888,6686792,1096,1710,utRho17
814,lptD,114672,114672,114218,454,652,utRho17
815,lptF,8972244,8972436,8972244,192,294,utRho17
816,lpxC,213016,213114,213016,98,4978,utRho17
817,lpxD,401920,401942,401920,22,46,utRho17
818,lpxL,2233418,2233418,2233164,254,0,utRho17
819,lpxM,3880456,3880456,3880386,70,0,utRho17
820,lpxP,4991156,4991290,4991156,134,254,utRho17
821,lrhA,4813312,4813312,4813282,30,68,utRho17
822,lrp,1864656,1865190,1864656,534,956,utRho17
823,lspA,50028,50414,50028,386,430,utRho17
824,lsrA,3202920,3202980,3202920,60,0,utRho17
825,lsrR,3202514,3202514,3202482,32,0,utRho17
826,ltaE,1818640,1818640,1818588,52,0,utRho17
827,luxS,5630130,5630130,5629466,664,14630,utRho17
828,lysA,5957902,5957902,5957798,104,64,utRho17
829,lysC,8467232,8467232,8466466,766,1548,utRho17
830,lysP,4497120,4497120,4497064,56,90,utRho17
831,lysR,5957900,5958042,5957900,142,254,utRho17
832,lysT,1561028,1561108,1561028,80,0,utRho17
833,lysU,8709610,8709610,8709434,176,866,utRho17
834,macB,1840188,1840694,1840188,506,824,utRho17
835,maeA,3111484,3111484,3111338,146,5838,utRho17
836,mak,820236,820288,820236,52,14,utRho17
837,malE,8492928,8492928,8492838,90,46,utRho17
838,malI,3398456,3398456,3398360,96,0,utRho17
839,malK,8493472,8493568,8493472,96,94,utRho17
840,malP,7105020,7105020,7104946,74,898,utRho17
841,malQ,7100798,7100798,7100140,658,236,utRho17
842,malS,14949880,14949988,14949880,108,0,utRho17
843,malT,7106048,7106170,7106048,122,162,utRho17
844,malX,3398626,3398710,3398626,84,0,utRho17
845,malZ,1689980,1690072,1689980,92,1324,utRho17
846,manA,3377102,3377152,3377102,50,0,utRho17
847,manX,3803866,3804096,3803866,230,104,utRho17
848,marC,3237882,3237882,3237816,66,370,utRho17
849,marR,3238186,3238240,3238186,54,406,utRho17
850,matP,2036918,2036970,2036918,52,84,utRho17
851,mazE,5822736,5822736,5822678,58,92,utRho17
852,mazG,5821720,5821720,5821370,350,1624,utRho17
853,mcbA,1684306,1684306,1684112,194,0,utRho17
854,mcbR,3040192,3040524,3040192,332,0,utRho17
855,mcrA,2420278,2420692,2420278,414,192,utRho17
856,mcrC,9156124,9156124,9155916,208,632,utRho17
857,mdaB,6344814,6345060,6344814,246,160,utRho17
858,mdfA,1767138,1767346,1767138,208,0,utRho17
859,mdh,6768940,6768940,6768536,404,8,utRho17
860,mdoB,9198988,9198988,9198882,106,6148,utRho17
861,mdoD,2993290,2993712,2993290,422,30,utRho17
862,mdoG,2218514,2218670,2218514,156,6,utRho17
863,mdtA,4307958,4308032,4307958,74,448,utRho17
864,mdtE,7318168,7318464,7318168,296,12448,utRho17
865,mdtK,3486538,3486914,3486538,376,2390,utRho17
866,mdtP,8602472,8602472,8602060,412,1328,utRho17
867,melA,8683774,8683822,8683774,48,0,utRho17
868,melR,8683300,8683300,8683256,44,654,utRho17
869,menA,8240812,8240812,8240698,114,4,utRho17
870,menB,4753774,4753774,4753638,136,866,utRho17
871,mepH,3468714,3468870,3468714,156,0,utRho17
872,mepM,3883666,3883666,3883270,396,264,utRho17
873,mepS,4539840,4539958,4539840,118,494,utRho17
874,metA,8428318,8428560,8428318,242,234,utRho17
875,metB,8257272,8257344,8257272,72,596,utRho17
876,metC,6304150,6304472,6304150,322,506,utRho17
877,metE,8025768,8026106,8025768,338,1286,utRho17
878,metF,8265092,8265232,8265092,140,156,utRho17
879,metG,4388538,4388600,4388538,62,96,utRho17
880,metH,8447010,8447656,8447010,646,3282,utRho17
881,metJ,8257116,8257116,8256790,326,334,utRho17
882,metK,6173154,6173412,6173154,258,52,utRho17
883,metN,445428,445428,445290,138,10,utRho17
884,metR,8025710,8025710,8025632,78,0,utRho17
885,metT,1394326,1394326,1394266,60,246,utRho17
886,metY,19910250,19910250,19909734,516,1722,utRho17
887,metZ,11789528,11789548,11789528,20,80,utRho17
888,mfd,2348056,2348056,2347928,128,202,utRho17
889,mglA,4478782,4478782,4478578,204,1302,utRho17
890,mglB,4481132,4481132,4480696,436,14030,utRho17
891,mglC,4475918,4475918,4475506,412,484,utRho17
892,mgrB,3817584,3817584,3817532,52,14,utRho17
893,mgrR,3245828,3245828,3245828,0,0,utRho17
894,mgsA,2054082,2054082,2054030,52,76,utRho17
895,mgtL,8934560,8934862,8934560,302,218,utRho17
896,mhpA,737038,737222,737038,184,2,utRho17
897,mhpR,737072,737072,736840,232,8,utRho17
898,mhpT,750772,750918,750772,146,72,utRho17
899,miaA,8797964,8798504,8797964,540,5930,utRho17
900,micA,5629604,5629604,5629604,0,0,utRho17
901,micC,2874242,2874238,2874242,4,0,utRho17
902,micF,4626168,4626168,4626168,0,0,utRho17
903,micM,1014408,1014408,1014408,0,0,utRho17
904,minE,2449422,2449422,2449090,332,882,utRho17
905,mioC,7852950,7852950,7852910,40,78,utRho17
906,mipA,3733012,3733012,3732944,68,1364,utRho17
907,mlaA,4930270,4930270,4930014,256,0,utRho17
908,mlc,3337206,3337206,3337128,78,120,utRho17
909,mlrA,4429498,4429732,4429498,234,200,utRho17
910,mltA,5894546,5894546,5894356,190,392,utRho17
911,mltD,468050,468050,467910,140,194,utRho17
912,mltF,5391534,5391602,5391534,68,0,utRho17
913,mmuP,550238,550650,550238,412,16492,utRho17
914,mngA,1531622,1531968,1531622,346,170,utRho17
915,mngR,1531852,1531852,1531750,102,92,utRho17
916,mnmG,7851348,7851348,7851266,82,4184,utRho17
917,mntH,5025470,5025470,5025412,58,0,utRho17
918,mntP,3810918,3811376,3810918,458,3190,utRho17
919,mntR,1706160,1706366,1706160,206,0,utRho17
920,mntS,1706128,1706128,1705994,134,62,utRho17
921,moaA,1633654,1634088,1633654,434,1228,utRho17
922,moaB,1635954,1636110,1635954,156,1108,utRho17
923,mobA,8084242,8084242,8083998,244,216,utRho17
924,mocA,6030112,6030320,6030112,208,672,utRho17
925,modA,1589990,1590178,1589990,188,124,utRho17
926,moeA,1732788,1732788,1732728,60,60,utRho17
927,mokB,2984610,2984610,2984258,352,1020,utRho17
928,molR_1,4392888,4392948,4392888,60,130,utRho17
929,motA,3954604,3954604,3954278,326,4,utRho17
930,mpaA,2781278,2781278,2781196,82,466,utRho17
931,mpl,8911456,8911570,8911456,114,114,utRho17
932,mppA,2786108,2786454,2786108,346,186,utRho17
933,mprA,5621494,5621540,5621494,46,956,utRho17
934,mqo,4613848,4613848,4613508,340,396,utRho17
935,mqsA,6336742,6336742,6336492,250,648,utRho17
936,mqsR,6337306,6337306,6337088,218,760,utRho17
937,mraZ,179192,179268,179192,76,0,utRho17
938,mrcA,7045652,7045742,7045652,90,0,utRho17
939,mrcB,329442,329460,329442,18,0,utRho17
940,mreB,13605424,13605424,13604348,1076,1152,utRho17
941,mreD,6798166,6798166,6797750,416,330,utRho17
942,mrp,4388360,4388360,4388336,24,0,utRho17
943,mscK,972984,973072,972984,88,44,utRho17
944,mscL,6876002,6876048,6876002,46,462,utRho17
945,mscS,6139742,6139742,6139614,128,152,utRho17
946,msrA,8884522,8884522,8884352,170,382,utRho17
947,msrB,3725168,3725168,3724858,310,14,utRho17
948,msyB,2228426,2228426,2228362,64,182,utRho17
949,mtfA,4087236,4087302,4087236,66,1132,utRho17
950,mtgA,6699662,6699662,6699618,44,2040,utRho17
951,mtlA,30177504,30178248,30177504,744,3664,utRho17
952,mtn,358366,358366,358306,60,810,utRho17
953,mtr,6611864,6611864,6611634,230,354,utRho17
954,mug,6430992,6430992,6430946,46,128,utRho17
955,murQ,5091466,5091546,5091466,80,90,utRho17
956,murR,5091586,5091586,5091218,368,142,utRho17
957,mutH,5939164,5939324,5939164,160,124,utRho17
958,mutL,8794092,8794824,8794092,732,8708,utRho17
959,mutM,7622554,7622554,7622304,250,300,utRho17
960,mutS,5714038,5714186,5714038,148,840,utRho17
961,mutY,18617466,18618078,18617466,612,894,utRho17
962,nac,4123956,4123956,4123866,90,768,utRho17
963,nadA,1564122,1564170,1564122,48,0,utRho17
964,nadB,5420714,5420840,5420714,126,6,utRho17
965,nadC,237326,237326,237290,36,106,utRho17
966,nadE,3644604,3644916,3644604,312,192,utRho17
967,nadK,5501526,5501662,5501526,136,356,utRho17
968,nagA,1406350,1406350,1405502,848,7340,utRho17
969,nagB,1407416,1407416,1407222,194,194,utRho17
970,nagC,1404016,1404016,1403188,828,596,utRho17
971,nagE,1407680,1407888,1407680,208,4,utRho17
972,nagK,2357080,2357186,2357080,106,0,utRho17
973,nanA,6747240,6747240,6747152,88,64,utRho17
974,nanC,9079856,9079856,9079002,854,1720,utRho17
975,nanR,6749406,6749406,6748978,428,654,utRho17
976,nanS,9075406,9075406,9075188,218,722,utRho17
977,napF,4607390,4607390,4606994,396,298,utRho17
978,narG,2559614,2559728,2559614,114,418,utRho17
979,narK,2555642,2555914,2555642,272,442,utRho17
980,narP,4580844,4581000,4580844,156,358,utRho17
981,narQ,5171154,5171462,5171154,308,158,utRho17
982,narU,3088326,3088326,3088120,206,94,utRho17
983,narW,3077374,3077374,3074618,2756,1086,utRho17
984,narX,2555554,2555554,2555236,318,296,utRho17
985,narZ,3085380,3085380,3085180,200,76,utRho17
986,ndh,2331984,2332170,2331984,186,412,utRho17
987,ndk,5289920,5289920,5289728,192,214,utRho17
988,nemR,6904084,6904092,6904084,8,668,utRho17
989,nepI,7683542,7683542,7683478,64,54,utRho17
990,nfo,4501612,4501680,4501612,68,174,utRho17
991,nfsB,1210906,1210906,1210848,58,20,utRho17
992,nfuA,7090916,7091248,7090916,332,698,utRho17
993,nhaA,34634,34978,34634,344,688,utRho17
994,nhaB,2469534,2469534,2469434,100,150,utRho17
995,nhoA,3067926,3068048,3067926,122,134,utRho17
996,nikA,7226878,7227334,7226878,456,7234,utRho17
997,nikR,7237074,7237176,7237074,102,682,utRho17
998,nirB,6987974,6988022,6987974,48,106,utRho17
999,nlpA,7680034,7680034,7679986,48,0,utRho17
1000,nlpC,3585654,3585654,3585462,192,60,utRho17
1001,nlpD,5737658,5737658,5737506,152,262,utRho17
1002,nlpI,6618080,6618080,6617848,232,64,utRho17
1003,nmpC,1153740,1153740,1153650,90,84,utRho17
1004,nohA,3273206,3273206,3272734,472,468,utRho17
1005,norR,5664614,5664614,5664578,36,0,utRho17
1006,norV,5664878,5664952,5664878,74,2,utRho17
1007,nrdA,4689510,4689730,4689510,220,4588,utRho17
1008,nrdD,8925676,8925676,8925320,356,11460,utRho17
1009,nrdH,5601312,5601446,5601312,134,334,utRho17
1010,nrdR,865954,866004,865954,50,38,utRho17
1011,nrfA,8575342,8575528,8575342,186,68,utRho17
1012,nsrR,8812088,8812380,8812088,292,6688,utRho17
1013,nudB,3897348,3897348,3897264,84,16,utRho17
1014,nudC,8393428,8393806,8393428,378,182,utRho17
1015,nudE,7052658,7052658,7052298,360,1056,utRho17
1016,nudG,3682876,3682980,3682876,104,134,utRho17
1017,nudI,4729050,4729108,4729050,58,34,utRho17
1018,nudJ,2388874,2388874,2388576,298,748,utRho17
1019,nuoA,4810670,4810670,4810144,526,7034,utRho17
1020,nuoN,4783434,4783434,4783010,424,1216,utRho17
1021,nupC,5026018,5026084,5026018,66,0,utRho17
1022,nupG,6211302,6211428,6211302,126,68,utRho17
1023,ogrK,4335096,4335096,4335040,56,14,utRho17
1024,ogt,2800568,2800568,2800472,96,274,utRho17
1025,ohsC,5401036,5401040,5401036,4,78,utRho17
1026,ompA,2040382,2040382,2040106,276,19338,utRho17
1027,ompC,4625774,4625774,4625498,276,218,utRho17
1028,ompF,1974184,1974184,1973964,220,256,utRho17
1029,ompL,8128958,8128958,8128590,368,616,utRho17
1030,ompN,2874158,2874158,2873786,372,0,utRho17
1031,ompR,7073510,7073510,7073168,342,128,utRho17
1032,ompT,1171330,1171330,1171266,64,106,utRho17
1033,ompW,2627982,2628040,2627982,58,0,utRho17
1034,ompX,1700418,1700900,1700418,482,2816,utRho17
1035,omrA,5952378,5952378,5952378,0,0,utRho17
1036,omrB,5952770,5952770,5952770,0,0,utRho17
1037,oppA,2602170,2602364,2602170,194,5678,utRho17
1038,orn,8783168,8783208,8783168,40,2,utRho17
1039,osmB,2686952,2686952,2686656,296,1882,utRho17
1040,osmC,3113192,3113250,3113192,58,486,utRho17
1041,osmE,3644566,3644566,3644512,54,110,utRho17
1042,osmF,4439046,4439046,4438962,84,2308,utRho17
1043,osmY,9222306,9222792,9222306,486,1288,utRho17
1044,otsA,3963302,3963302,3963224,78,296,utRho17
1045,otsB,3964930,3964930,3964774,156,690,utRho17
1046,oxc,4984288,4984288,4983900,388,690,utRho17
1047,oxyR,8316914,8316980,8316914,66,1548,utRho17
1048,oxyS,8316788,8316788,8316788,0,0,utRho17
1049,paaA,2907730,2907854,2907730,124,36,utRho17
1050,paaX,2927018,2927078,2927018,60,0,utRho17
1051,paaZ,2907340,2907340,2907284,56,0,utRho17
1052,pabA,6981702,6981702,6981658,44,122,utRho17
1053,pabB,3789256,3789610,3789256,354,294,utRho17
1054,pabC,2306186,2306600,2306186,414,1410,utRho17
1055,pagP,1313052,1313114,1313052,62,0,utRho17
1056,panB,299260,299260,299202,58,6454,utRho17
1057,panC,297840,297840,297590,250,222,utRho17
1058,panD,293490,293490,293388,102,282,utRho17
1059,panZ,7195656,7195968,7195656,312,564,utRho17
1060,parC,6332060,6332060,6331946,114,762,utRho17
1061,patA,6438916,6438988,6438916,72,46,utRho17
1062,patD,3030830,3031156,3030830,326,116,utRho17
1063,pbpC,5294986,5294986,5294650,336,2,utRho17
1064,pbpG,4450132,4450132,4449740,392,84,utRho17
1065,pck,7065358,7065636,7065358,278,3158,utRho17
1066,pcnB,318782,318782,318252,530,1104,utRho17
1067,pdhR,244068,244184,244068,116,68,utRho17
1068,pdxB,4875768,4875768,4875702,66,10,utRho17
1069,pdxH,3436068,3436068,3436014,54,308,utRho17
1070,pdxJ,5403626,5403626,5403458,168,506,utRho17
1071,pdxK,5074638,5074638,5074474,164,32,utRho17
1072,pepA,8972278,8972278,8971902,376,204,utRho17
1073,pepD,511618,511618,511432,186,3100,utRho17
1074,pepN,1981182,1981244,1981182,62,288,utRho17
1075,pepQ,8062294,8062322,8062294,28,56,utRho17
1076,pepT,2371646,2371688,2371646,42,122,utRho17
1077,pfkA,8214948,8215104,8214948,156,232,utRho17
1078,pfkB,3612646,3612740,3612646,94,0,utRho17
1079,pflA,1902456,1902456,1902160,296,198,utRho17
1080,pflB,1907850,1907850,1907108,742,1710,utRho17
1081,pflD,8287716,8287990,8287716,274,2,utRho17
1082,pgaA,2185046,2185046,2184578,468,220,utRho17
1083,pgi,8467444,8467516,8467444,72,0,utRho17
1084,pgk,12291428,12291428,12290488,940,2576,utRho17
1085,pgl,1597078,1597172,1597078,94,0,utRho17
1086,pgpB,2678324,2678660,2678324,336,476,utRho17
1087,pgpC,5397276,5397276,5397100,176,138,utRho17
1088,pgrR,2783744,2783982,2783744,238,222,utRho17
1089,pheL,5475158,5475198,5475158,40,0,utRho17
1090,pheM,7197204,7197204,7197080,124,20,utRho17
1091,pheP,1203858,1203918,1203858,60,132,utRho17
1092,pheU,8725254,8725254,8725252,2,4,utRho17
1093,pheV,6220730,6220732,6220730,2,22,utRho17
1094,phnC,8650412,8650412,8650330,82,90,utRho17
1095,phoA,803414,803494,803414,80,258,utRho17
1096,phoB,834202,834284,834202,82,92,utRho17
1097,phoE,520316,520316,520200,116,476,utRho17
1098,phoH,2169730,2169984,2169730,254,326,utRho17
1099,phoP,2381016,2381016,2380894,122,1776,utRho17
1100,phoQ,2379880,2379880,2379552,328,872,utRho17
1101,phoU,7815330,7815330,7815156,174,168,utRho17
1102,phr,1478842,1479014,1478842,172,10,utRho17
1103,pinE,2419054,2419370,2419054,316,606,utRho17
1104,pinQ,3267168,3267244,3267168,76,390,utRho17
1105,pinR,2867424,2867424,2867348,76,240,utRho17
1106,pitA,7275224,7275284,7275224,60,44,utRho17
1107,pitB,6272806,6272806,6272742,64,224,utRho17
1108,pka,5439862,5439906,5439862,44,270,utRho17
1109,plaP,4174476,4174476,4174124,352,202,utRho17
1110,pldA,8009628,8009724,8009628,96,1108,utRho17
1111,pldB,8018028,8018340,8018028,312,2860,utRho17
1112,plsB,8513196,8513196,8512932,264,218,utRho17
1113,pmbA,8915890,8915918,8915890,28,40,utRho17
1114,pmrD,4747148,4747148,4747076,72,34,utRho17
1115,pncB,1980828,1980828,1980712,116,0,utRho17
1116,pncC,5648788,5648788,5648692,96,0,utRho17
1117,pnp,6622652,6622652,6622336,316,54,utRho17
1118,pntA,3355950,3355950,3355806,144,0,utRho17
1119,pntB,3353096,3353096,3352720,376,400,utRho17
1120,polA,8093880,8093932,8093880,52,474,utRho17
1121,polB,131606,131606,131560,46,0,utRho17
1122,potD,2365700,2365700,2365658,42,76,utRho17
1123,potE,1436688,1436688,1436530,158,72,utRho17
1124,potF,1787268,1787568,1787268,300,548,utRho17
1125,poxB,1822152,1822152,1822098,54,434,utRho17
1126,ppa,8899372,8899372,8899304,68,124,utRho17
1127,ppc,8306380,8306380,8306196,184,660,utRho17
1128,ppdA,5928440,5928440,5928354,86,3056,utRho17
1129,ppdD,235410,235410,235098,312,740,utRho17
1130,pphA,3846770,3846770,3845938,832,5048,utRho17
1131,pphB,5719474,5719520,5719474,46,228,utRho17
1132,ppiA,6984898,6984898,6984594,304,176,utRho17
1133,ppiC,7919682,7919682,7919626,56,46,utRho17
1134,ppiD,923638,923830,923638,192,36,utRho17
1135,ppk,5245748,5246088,5245748,340,466,utRho17
1136,pppA,6228958,6228958,6228704,254,48,utRho17
1137,ppsA,3574322,3574322,3574224,98,98,utRho17
1138,ppsR,3574678,3574890,3574678,212,38,utRho17
1139,pptA,3065716,3066104,3065716,388,564,utRho17
1140,pqiA,2023318,2024002,2023318,684,62,utRho17
1141,prc,3830054,3830054,3829632,422,9322,utRho17
1142,preT,4467978,4468066,4467978,88,1554,utRho17
1143,prfC,9218688,9218828,9218688,140,1580,utRho17
1144,prkB,6968622,6968980,6968622,358,2240,utRho17
1145,prlC,7290476,7290476,7290364,112,306,utRho17
1146,prlF,6553944,6554004,6553944,60,718,utRho17
1147,proB,520432,520776,520432,344,1338,utRho17
1148,proC,811372,811372,811288,84,66,utRho17
1149,proK,7417388,7417388,7417384,4,62,utRho17
1150,proL,4572414,4572422,4572414,8,44,utRho17
1151,proP,8660640,8661004,8660640,364,324,utRho17
1152,proS,437674,437674,437550,124,1148,utRho17
1153,proV,5609126,5609630,5609126,504,1214,utRho17
1154,prpB,697292,697364,697292,72,42,utRho17
1155,prpR,696942,696942,696886,56,10,utRho17
1156,prs,2524354,2524354,2523750,604,35616,utRho17
1157,psd,8781276,8781276,8780720,556,848,utRho17
1158,psiE,8480600,8480650,8480600,50,0,utRho17
1159,pspA,2736076,2736158,2736076,82,0,utRho17
1160,pspF,2736080,2736080,2735824,256,0,utRho17
1161,pspG,8525632,8525680,8525632,48,0,utRho17
1162,pssA,5445156,5445454,5445156,298,4504,utRho17
1163,pstB,7817112,7817112,7816732,380,166,utRho17
1164,pstC,7821084,7821084,7820796,288,158,utRho17
1165,pstS,23469408,23469408,23469150,258,390,utRho17
1166,psuG,4517114,4517114,4516734,380,6614,utRho17
1167,psuT,4514992,4514992,4514670,322,196,utRho17
1168,pth,2517084,2517084,2517026,58,40,utRho17
1169,ptrA,5918022,5918022,5917768,254,0,utRho17
1170,ptrB,3857730,3857730,3857678,52,2816,utRho17
1171,ptsG,2315252,2315738,2315252,486,2872,utRho17
1172,ptsH,5066996,5067528,5066996,532,3274,utRho17
1173,purA,8809328,8809374,8809328,46,0,utRho17
1174,purC,5195562,5195562,5195236,326,32,utRho17
1175,purD,8411972,8411972,8411862,110,420,utRho17
1176,purE,1106284,1106284,1106200,84,802,utRho17
1177,purH,8415254,8415254,8415064,190,166,utRho17
1178,purL,5391178,5391178,5391086,92,492,utRho17
1179,purM,5242306,5242394,5242306,88,134,utRho17
1180,purR,3475378,3475688,3475378,310,260,utRho17
1181,purT,3861438,3861762,3861438,324,54,utRho17
1182,purU,2577512,2577512,2577248,264,302,utRho17
1183,putA,2157850,2157850,2157764,86,0,utRho17
1184,putP,2158336,2158610,2158336,274,646,utRho17
1185,puuA,2721936,2721936,2721816,120,0,utRho17
1186,puuC,2725456,2725486,2725456,30,0,utRho17
1187,puuD,2722104,2722240,2722104,136,82,utRho17
1188,puuP,2718746,2718746,2718374,372,1278,utRho17
1189,pykA,3874988,3875298,3874988,310,286,utRho17
1190,pykF,3510934,3511396,3510934,462,984,utRho17
1191,pyrC,2245286,2245286,2245214,72,58,utRho17
1192,pyrD,2009464,2009536,2009464,72,336,utRho17
1193,pyrE,7631970,7631970,7631536,434,602,utRho17
1194,pyrF,2683740,2683842,2683740,102,140,utRho17
1195,pyrG,5819594,5819594,5819332,262,1690,utRho17
1196,pyrH,383624,383710,383624,86,952,utRho17
1197,pyrL,8945490,8945490,8945066,424,882,utRho17
1198,qmcA,1031646,1031646,1031546,100,266,utRho17
1199,qor,8528608,8528608,8528462,146,554,utRho17
1200,qseB,6339502,6339656,6339502,154,410,utRho17
1201,queA,849970,850022,849970,52,302,utRho17
1202,queE,5811212,5811212,5810836,376,362,utRho17
1203,queF,5850642,5850696,5850642,54,14,utRho17
1204,queG,8788184,8788184,8788134,50,50836,utRho17
1205,racC,2835630,2835630,2835526,104,30,utRho17
1206,racR,2840898,2840898,2840482,416,318,utRho17
1207,raiA,5474208,5474308,5474208,100,98,utRho17
1208,rarD,8008594,8008594,8008356,238,366,utRho17
1209,ravA,7862256,7862256,7862186,70,42,utRho17
1210,rayT,495088,495274,495088,186,624,utRho17
1211,rbn,4763162,4763216,4763162,54,0,utRho17
1212,rbsD,7866644,7866702,7866644,58,0,utRho17
1213,rcnA,4371654,4371834,4371654,180,226,utRho17
1214,rcnB,4373768,4373920,4373768,152,208,utRho17
1215,rcnR,4371806,4371806,4371592,214,342,utRho17
1216,rcsA,4047672,4047936,4047672,264,2632,utRho17
1217,rcsB,4631390,4632354,4631390,964,704,utRho17
1218,rcsC,4640162,4640162,4639656,506,186,utRho17
1219,rcsD,4626904,4626976,4626904,72,420,utRho17
1220,rdgB,6193240,6193362,6193240,122,494,utRho17
1221,rdlA,2538646,2538646,2538646,0,0,utRho17
1222,rdlB,2539712,2539716,2539712,4,20,utRho17
1223,rdlC,2540782,2540786,2540782,4,0,utRho17
1224,rdlD,7400272,7400272,7400272,0,0,utRho17
1225,rdoA,8084782,8084830,8084782,48,18,utRho17
1226,recA,11295276,11295276,11295076,200,620,utRho17
1227,recC,5925014,5925014,5924856,158,0,utRho17
1228,recF,7763722,7763722,7762442,1280,8146,utRho17
1229,recN,5503518,5503590,5503518,72,0,utRho17
1230,recQ,8011666,8011728,8011666,62,104,utRho17
1231,relA,5828554,5828554,5827302,1252,1228,utRho17
1232,relB,3291806,3291806,3291744,62,82,utRho17
1233,rem,3289950,3289950,3289804,146,66,utRho17
1234,rep,7921294,7921354,7921294,60,108,utRho17
1235,rfaD,7587730,7587974,7587730,244,366,utRho17
1236,rfaE,6393852,6393852,6393506,346,184,utRho17
1237,rfaH,8049930,8049930,8049642,288,2298,utRho17
1238,rfbX,4219436,4219436,4219168,268,770,utRho17
1239,rfe,7935600,7935832,7935600,232,60,utRho17
1240,rhaB,8194944,8194944,8194896,48,0,utRho17
1241,rhaD,8188770,8188770,8188544,226,0,utRho17
1242,rhaS,8195422,8195472,8195422,50,0,utRho17
1243,rhaT,8201132,8201132,8201050,82,168,utRho17
1244,rhlE,1661566,1661744,1661566,178,258,utRho17
1245,rhoL,47593944,47594772,47593944,828,74772,utRho17
1246,rhsB,7238006,7238384,7238006,378,1694,utRho17
1247,rhsC,1458758,1459166,1458758,408,0,utRho17
1248,rhsD,1046132,1046522,1046132,390,0,utRho17
1249,rhtA,1700608,1700608,1700194,414,256,utRho17
1250,rhtC,8015478,8015514,8015478,36,1148,utRho17
1251,ribA,2678468,2678468,2678320,148,462,utRho17
1252,ribC,3486916,3486916,3486484,432,3552,utRho17
1253,ribE,869008,869294,869008,286,3720,utRho17
1254,ribF,42766,42814,42766,48,0,utRho17
1255,ridA,8941892,8941892,8941826,66,252,utRho17
1256,rihA,1369204,1369204,1368824,380,5316,utRho17
1257,rihB,4510504,4510504,4510372,132,274,utRho17
1258,rimJ,2251044,2251124,2251044,80,92,utRho17
1259,rimK,1783752,1783934,1783752,182,622,utRho17
1260,rimL,2997486,2997876,2997486,390,290,utRho17
1261,rimO,1756140,1756140,1756070,70,98,utRho17
1262,rimP,6636350,6636350,6636012,338,474,utRho17
1263,rlmA,3814172,3814172,3814120,52,1290,utRho17
1264,rlmD,5830086,5830086,5830000,86,74,utRho17
1265,rlmE,6655520,6655520,6655328,192,1124,utRho17
1266,rlmF,1684384,1684664,1684384,280,296,utRho17
1267,rlmG,6471784,6471784,6471750,34,48,utRho17
1268,rlmI,2060002,2060002,2059938,64,350,utRho17
1269,rlmJ,7290700,7290770,7290700,70,0,utRho17
1270,rlmL,2015344,2015688,2015344,344,1488,utRho17
1271,rlpA,1330444,1330444,1330380,64,178,utRho17
1272,rluA,120900,120900,120692,208,744,utRho17
1273,rluF,8460324,8460708,8460324,384,210,utRho17
1274,rmf,2031006,2031430,2031006,424,1216,utRho17
1275,rna,1290068,1290068,1290006,62,6,utRho17
1276,rnb,2698258,2698258,2697824,434,4840,utRho17
1277,rnc,10816892,10816892,10816252,640,6576,utRho17
1278,rnd,3776122,3776122,3775982,140,72,utRho17
1279,rne,2289746,2289746,2288734,1012,4794,utRho17
1280,rnhA,472082,472082,472004,78,648,utRho17
1281,rnk,1288360,1288360,1287934,426,0,utRho17
1282,rnlA,5531788,5531836,5531788,48,1084,utRho17
1283,rnlB,5533414,5533968,5533414,554,1176,utRho17
1284,rnpB,19623552,19623552,19623552,0,0,utRho17
1285,rob,9270706,9270706,9270620,86,12,utRho17
1286,rodZ,5285868,5285868,5285688,180,72,utRho17
1287,rpe,7030306,7030306,7030118,188,300,utRho17
1288,rph,15266320,15266320,15266196,124,192,utRho17
1289,rpiA,6118706,6118706,6118650,56,1464,utRho17
1290,rpiB,8626514,8626700,8626514,186,366,utRho17
1291,rpiR,8626274,8626274,8625982,292,0,utRho17
1292,rplJ,8359246,8359992,8359246,746,6730,utRho17
1293,rplK,8356708,8356894,8356708,186,492,utRho17
1294,rplM,6757344,6757344,6757302,42,6786,utRho17
1295,rplN,6896444,6896444,6896298,146,9506,utRho17
1296,rplS,5489284,5489284,5489060,224,5386,utRho17
1297,rplT,7199052,7199052,7198996,56,596,utRho17
1298,rplU,6667036,6667036,6666902,134,214,utRho17
1299,rplY,4564866,4565034,4564866,168,252,utRho17
1300,rpmA,6666450,6666450,6666238,212,1352,utRho17
1301,rpmB,15247980,15247980,15246696,1284,42296,utRho17
1302,rpmE,8253816,8254026,8253816,210,950,utRho17
1303,rpmF,2294676,2294734,2294676,58,12308,utRho17
1304,rpmH,7768130,7768672,7768130,542,3526,utRho17
1305,rpmI,3600854,3600854,3599998,856,11952,utRho17
1306,rpoB,8362126,8362490,8362126,364,342,utRho17
1307,rpoD,6424946,6426094,6424946,1148,28604,utRho17
1308,rpoE,5420372,5420372,5420024,348,174,utRho17
1309,rpoH,7202006,7202006,7201566,440,3720,utRho17
1310,rpoN,6689324,6689434,6689324,110,62,utRho17
1311,rpoS,5736236,5736236,5735102,1134,2944,utRho17
1312,rpoZ,7644154,7644212,7644154,58,238,utRho17
1313,rppH,5937986,5937986,5937954,32,0,utRho17
1314,rprA,3540744,3540744,3540744,0,0,utRho17
1315,rpsA,1923434,1923990,1923434,556,96734,utRho17
1316,rpsF,8850050,8850236,8850050,186,19820,utRho17
1317,rpsI,6756580,6756580,6756414,166,6960,utRho17
1318,rpsJ,6906884,6906884,6906540,344,7162,utRho17
1319,rpsL,6949242,6949242,6949104,138,1182,utRho17
1320,rpsM,6885130,6885130,6884942,188,1106,utRho17
1321,rpsO,13247144,13247144,13246736,408,1596,utRho17
1322,rpsP,5492508,5492508,5492370,138,192,utRho17
1323,rpsT,42420,42420,42156,264,270,utRho17
1324,rpsU,12842584,12843124,12842584,540,3276,utRho17
1325,rraA,8238716,8238716,8238660,56,112,utRho17
1326,rraB,8956768,8956946,8956768,178,254,utRho17
1327,rrsA,8070478,8071062,8070478,584,7482,utRho17
1328,rrsB,16665468,16666636,16665468,1168,15352,utRho17
1329,rrsC,7883032,7883616,7883032,584,8660,utRho17
1330,rrsD,6858094,6858094,6857524,570,964,utRho17
1331,rrsE,8415726,8416294,8415726,568,1018,utRho17
1332,rrsG,5462896,5462896,5462314,582,6640,utRho17
1333,rrsH,446970,447542,446970,572,1350,utRho17
1334,rsd,8393908,8393908,8393616,292,312,utRho17
1335,rseA,5419264,5419264,5418808,456,720,utRho17
1336,rseP,392940,393092,392940,152,0,utRho17
1337,rseX,4067298,4067298,4067298,0,0,utRho17
1338,rsfS,1338144,1338144,1338072,72,366,utRho17
1339,rsgA,8783132,8783132,8783018,114,48,utRho17
1340,rsmA,105176,105176,104860,316,1480,utRho17
1341,rsmB,6869982,6870414,6869982,432,192,utRho17
1342,rsmC,9215736,9215736,9215400,336,268,utRho17
1343,rsmD,7208594,7208786,7208594,192,156,utRho17
1344,rsmE,6182036,6182268,6182036,232,572,utRho17
1345,rsmG,7847512,7847512,7847360,152,2874,utRho17
1346,rsmH,180020,180188,180020,168,430,utRho17
1347,rsmI,6587106,6587106,6586670,436,870,utRho17
1348,rssA,2578212,2578412,2578212,200,540,utRho17
1349,rssB,2580440,2580484,2580440,44,174,utRho17
1350,rstA,3364276,3364300,3364276,24,0,utRho17
1351,rsuA,4561096,4561096,4560966,130,286,utRho17
1352,rsxA,3411510,3411534,3411510,24,0,utRho17
1353,rtcA,7114004,7114004,7113698,306,1242,utRho17
1354,rtcB,7116214,7116214,7116158,56,190,utRho17
1355,rtn,4541356,4541452,4541356,96,72,utRho17
1356,rutA,2148052,2148052,2148022,30,98,utRho17
1357,rutG,2140090,2140090,2139678,412,72,utRho17
1358,rutR,2148226,2148484,2148226,258,866,utRho17
1359,ruvA,7784096,7784096,7783904,192,112,utRho17
1360,ruvB,7782176,7782176,7781424,752,844,utRho17
1361,ruvC,3894878,3894878,3894752,126,0,utRho17
1362,rybB,1776114,1776114,1776114,0,0,utRho17
1363,rydB,3529860,3529860,3529322,538,250,utRho17
1364,rydC,2983012,2983012,2983012,0,0,utRho17
1365,ryfA,5307398,5307710,5307398,312,28,utRho17
1366,ryfD,5468590,5468590,5468590,0,0,utRho17
1367,ryhB,7162032,7162032,7162032,0,0,utRho17
1368,ryjA,8556132,8556132,8556132,0,0,utRho17
1369,ryjB,9055954,9055954,9055954,0,0,utRho17
1370,sad,3229598,3229598,3229406,192,424,utRho17
1371,safA,3168056,3168056,3167918,138,882,utRho17
1372,sanA,4465368,4465756,4465368,388,30,utRho17
1373,sapF,2705314,2705314,2705268,46,252,utRho17
1374,sbcB,4165456,4165512,4165456,56,0,utRho17
1375,sbcC,831694,831694,831506,188,84,utRho17
1376,sbcD,833954,833954,833904,50,92,utRho17
1377,sbmA,793106,793278,793106,172,1274,utRho17
1378,sbmC,4162650,4162650,4162524,126,0,utRho17
1379,sdaA,3793618,3793864,3793618,246,46,utRho17
1380,sdaC,5856070,5856458,5856070,388,2852,utRho17
1381,sdhC,1509916,1510354,1509916,438,37598,utRho17
1382,sdhD,1510808,1511120,1510808,312,7706,utRho17
1383,sdiA,3993834,3993834,3993664,170,180,utRho17
1384,secE,8354354,8354716,8354354,362,186,utRho17
1385,secG,6645180,6645180,6645010,170,1422,utRho17
1386,selA,7522594,7522594,7522498,96,1254,utRho17
1387,selB,7519850,7519850,7519722,128,564,utRho17
1388,selC,7672396,7672444,7672396,48,652,utRho17
1389,selD,3696058,3696058,3696016,42,1274,utRho17
1390,seqA,1425884,1425974,1425884,90,348,utRho17
1391,serA,6117098,6117098,6116820,278,760,utRho17
1392,serB,9249712,9249790,9249712,78,292,utRho17
1393,serC,3830380,3830612,3830380,232,0,utRho17
1394,serS,1878730,1878856,1878730,126,1294,utRho17
1395,serT,2063438,2063438,2063424,14,0,utRho17
1396,serU,4087124,4087124,4087114,10,86,utRho17
1397,serV,5637394,5637394,5637290,104,150,utRho17
1398,serW,1852014,1852014,1851942,72,178,utRho17
1399,serX,2195352,2195352,2195304,48,26,utRho17
1400,setB,4527426,4527726,4527426,300,100,utRho17
1401,setC,7673488,7673906,7673488,418,2110,utRho17
1402,sfmA,1116124,1116424,1116124,300,46,utRho17
1403,sfmC,1117606,1117948,1117606,342,154,utRho17
1404,sfsA,323030,323030,322972,58,286,utRho17
1405,sfsB,6669592,6669818,6669592,226,998,utRho17
1406,sgrR,154676,154676,154598,78,94,utRho17
1407,sgrS,154734,154734,154734,0,0,utRho17
1408,shiA,4107068,4107286,4107068,218,340,utRho17
1409,sibA,4306622,4306622,4306622,0,0,utRho17
1410,sibB,4307292,4307292,4307292,0,0,utRho17
1411,sibC,6113702,6113702,6113702,0,0,utRho17
1412,sibD,6389730,6389730,6389730,0,0,utRho17
1413,sibE,6390480,6390480,6390480,0,0,utRho17
1414,sixA,4913998,4913998,4913624,374,50,utRho17
1415,slp,7307872,7307922,7307872,50,238,utRho17
1416,slt,9261400,9261466,9261400,66,110,utRho17
1417,slyA,3442028,3442028,3441648,380,258,utRho17
1418,slyB,3439496,3439752,3439496,256,6,utRho17
1419,slyD,6957398,6957398,6956994,404,804,utRho17
1420,slyX,6954862,6955280,6954862,418,4120,utRho17
1421,smf,6867372,6867372,6867120,252,416,utRho17
1422,smpB,5509534,5509792,5509534,258,650,utRho17
1423,smrA,2811872,2811958,2811872,86,684,utRho17
1424,smrB,4896872,4897212,4896872,340,1098,utRho17
1425,smtA,1946808,1947074,1946808,266,76,utRho17
1426,sodA,8201518,8201620,8201518,102,2360,utRho17
1427,sodB,3470646,3470756,3470646,110,1298,utRho17
1428,sodC,3449358,3449358,3449310,48,188,utRho17
1429,sohB,2658568,2658664,2658568,96,458,utRho17
1430,sokB,2984232,2984238,2984232,6,106,utRho17
1431,solA,2241218,2241218,2241172,46,0,utRho17
1432,soxR,8554894,8554938,8554894,44,54,utRho17
1433,soxS,8554846,8554846,8554766,80,0,utRho17
1434,speA,6172096,6172096,6171822,274,378,utRho17
1435,speB,6167892,6167892,6167594,298,778,utRho17
1436,speC,6218350,6218350,6218310,40,124,utRho17
1437,spf,8099798,8099798,8099798,0,0,utRho17
1438,sppA,3697422,3697674,3697422,252,506,utRho17
1439,spy,3651376,3651376,3651250,126,0,utRho17
1440,sra,3112092,3112092,3111926,166,0,utRho17
1441,sraB,2293178,2293178,2293178,0,0,utRho17
1442,sraC,3846132,3846132,3846132,0,0,utRho17
1443,srlA,5651582,5651664,5651582,82,28,utRho17
1444,srlR,5657720,5658094,5657720,374,1778,utRho17
1445,srmB,5425752,5425792,5425752,40,108,utRho17
1446,sroA,151216,151216,151216,0,0,utRho17
1447,sroG,6369436,6369436,6369436,0,0,utRho17
1448,sroH,8380974,8380974,8380974,0,0,utRho17
1449,ssb,8548022,8548250,8548022,228,144,utRho17
1450,sseA,5304782,5304988,5304782,206,5418,utRho17
1451,sspA,6755138,6755138,6754840,298,316,utRho17
1452,ssrA,5511014,5511186,5511014,172,324,utRho17
1453,ssrS,12223036,12223932,12223036,896,8012,utRho17
1454,sstT,6479726,6479888,6479726,162,76,utRho17
1455,ssuB,1988282,1988282,1988088,194,134,utRho17
1456,ssuE,1995126,1995126,1995024,102,2,utRho17
1457,sthA,8321604,8321604,8321580,24,1182,utRho17
1458,stpA,5597156,5597156,5596990,166,72,utRho17
1459,sucA,3034344,3034824,3034344,480,5536,utRho17
1460,sufA,3528836,3528836,3528772,64,98,utRho17
1461,sufE,3518962,3518962,3518580,382,18,utRho17
1462,sugE,8753588,8753750,8753588,162,1778,utRho17
1463,sulA,2041894,2041894,2041838,56,1694,utRho17
1464,syd,5850738,5850738,5850560,178,14,utRho17
1465,symE,9159834,9159834,9159680,154,770,utRho17
1466,symR,9159670,9159670,9159670,0,0,utRho17
1467,tabA,8949566,8949724,8949566,158,0,utRho17
1468,talA,5157140,5157332,5157140,192,4,utRho17
1469,talB,16382,16476,16382,94,5094,utRho17
1470,tam,3214442,3214692,3214442,250,78,utRho17
1471,tamA,8884540,8884764,8884540,224,502,utRho17
1472,tar,3945432,3945432,3945382,50,32,utRho17
1473,tas,5943138,5943194,5943138,56,2852,utRho17
1474,tatA,16087636,16087780,16087636,144,136,utRho17
1475,tatE,1317742,1317894,1317742,152,46,utRho17
1476,tauA,770410,770464,770410,54,8,utRho17
1477,tdcA,6534186,6534186,6534130,56,54,utRho17
1478,tdcG,6519652,6519652,6519298,354,1268,utRho17
1479,tdcR,6534380,6534760,6534380,380,220,utRho17
1480,tdk,2586986,2587054,2586986,68,30,utRho17
1481,tehA,3001072,3001146,3001072,74,0,utRho17
1482,tesA,1039898,1039898,1039530,368,236,utRho17
1483,tesB,950402,950402,950322,80,0,utRho17
1484,tfaE,2418532,2418532,2418238,294,812,utRho17
1485,tfaQ,3269912,3269912,3269770,142,822,utRho17
1486,tff,379424,379256,379424,168,140,utRho17
1487,tgt,852110,852274,852110,164,8,utRho17
1488,thiD,4369346,4369346,4369032,314,140,utRho17
1489,thiI,882936,883098,882936,162,0,utRho17
1490,thiM,4370902,4370902,4370602,300,700,utRho17
1491,thiQ,146170,146170,145854,316,2736,utRho17
1492,thrL,592,760,592,168,4,utRho17
1493,thrS,7210932,7210932,7210280,652,532,utRho17
1494,thrU,8350762,8350776,8350762,14,0,utRho17
1495,thrV,6847414,6847414,6847310,104,276378,utRho17
1496,thrW,525682,525742,525682,60,1810,utRho17
1497,thyA,5930696,5930696,5930310,386,2402,utRho17
1498,tig,909986,910266,909986,280,856,utRho17
1499,tisB,7706674,7707106,7706674,432,1182,utRho17
1500,tktA,6163414,6163414,6163270,144,58,utRho17
1501,tktB,5158616,5159272,5158616,656,3068,utRho17
1502,tldD,6784368,6784368,6784056,312,88,utRho17
1503,tmcA,5191876,5191876,5191718,158,186,utRho17
1504,tnaC,15553644,15553740,15553644,96,3272,utRho17
1505,tolB,1555074,1555480,1555074,406,200,utRho17
1506,tolC,6356008,6356230,6356008,222,614,utRho17
1507,tomB,961588,961588,961416,172,2152,utRho17
1508,tonB,2622108,2622178,2622108,70,14,utRho17
1509,topA,2661578,2662096,2661578,518,174,utRho17
1510,torC,2116112,2116168,2116112,56,404,utRho17
1511,torR,2115968,2115968,2115908,60,258,utRho17
1512,torS,2112364,2112364,2112356,8,0,utRho17
1513,torT,2112414,2112522,2112414,108,64,utRho17
1514,tpiA,8223138,8223138,8223014,124,412,utRho17
1515,tppB,3425342,3425538,3425342,196,4540,utRho17
1516,tpr,2574376,2574376,2574376,0,0,utRho17
1517,tpx,2777688,2777688,2777622,66,388,utRho17
1518,tqsA,3347780,3347826,3347780,46,142,utRho17
1519,treA,2494850,2494850,2494752,98,1164,utRho17
1520,treB,8932420,8932420,8932360,60,96,utRho17
1521,treF,7339102,7339184,7339102,82,230,utRho17
1522,treR,8934694,8934694,8934492,202,0,utRho17
1523,trg,2984878,2984940,2984878,62,32,utRho17
1524,trkG,2847342,2847564,2847342,222,460,utRho17
1525,trmA,8326590,8326590,8326540,50,128,utRho17
1526,trpA,2634678,2634678,2634444,234,454,utRho17
1527,trpC,2639888,2639888,2639570,318,108,utRho17
1528,trpL,5292432,5292432,5292328,104,0,utRho17
1529,trpR,9265408,9265520,9265408,112,276,utRho17
1530,trpS,7027394,7027394,7027276,118,1708,utRho17
1531,trpT,7893560,7893914,7893560,354,183832,utRho17
1532,trxA,7931294,7931522,7931294,228,708,utRho17
1533,trxB,1864156,1864156,1864100,56,200,utRho17
1534,trxC,5437350,5437470,5437350,120,222,utRho17
1535,tsaD,6421256,6421256,6421086,170,28,utRho17
1536,tsgA,6985038,6985136,6985038,98,152,utRho17
1537,tsr,9182824,9183314,9182824,490,2984,utRho17
1538,tsx,864490,864490,864026,464,620,utRho17
1539,ttcA,2823970,2823970,2823896,74,3658,utRho17
1540,ttdA,6412848,6412926,6412848,78,230,utRho17
1541,ttdR,6412760,6412760,6412512,248,482,utRho17
1542,tufA,6943448,6943448,6942658,790,169760,utRho17
1543,tus,3368346,3368518,3368346,172,152,utRho17
1544,tusA,7218040,7218040,7217992,48,282,utRho17
1545,tusB,6950218,6950218,6949930,288,652,utRho17
1546,tynA,2902996,2902996,2902698,298,0,utRho17
1547,typA,8116460,8116814,8116460,354,6242,utRho17
1548,tyrB,8534164,8534228,8534164,64,2620,utRho17
1549,tyrP,3979004,3979362,3979004,358,760,utRho17
1550,tyrR,2773384,2773440,2773384,56,54,utRho17
1551,tyrS,3434566,3434566,3434444,122,0,utRho17
1552,tyrT,2575330,2575330,2575244,86,378,utRho17
1553,uacT,6062378,6062734,6062378,356,842,utRho17
1554,ubiC,8504886,8505012,8504886,126,120,utRho17
1555,ubiD,8049618,8049976,8049618,358,2532,utRho17
1556,ubiE,8037494,8037710,8037494,216,258,utRho17
1557,ubiG,4679078,4679134,4679078,56,14,utRho17
1558,ucpA,5089342,5089342,5089246,96,0,utRho17
1559,udp,8032782,8032862,8032782,80,34,utRho17
1560,ugd,4199470,4199470,4199226,244,4,utRho17
1561,ugpB,7184852,7184852,7184650,202,1964,utRho17
1562,ugpQ,7176600,7176600,7176226,374,396,utRho17
1563,uhpT,7694396,7694396,7694334,62,270,utRho17
1564,uidA,3392304,3392304,3392142,162,68,utRho17
1565,uidC,3386012,3386012,3385702,310,42,utRho17
1566,uidR,3394150,3394150,3394104,46,88,utRho17
1567,ulaA,8839854,8839960,8839854,106,178,utRho17
1568,ulaG,8839350,8839350,8839250,100,114,utRho17
1569,ulaR,8837124,8837124,8836906,218,0,utRho17
1570,umpG,5741372,5741372,5740548,824,138,utRho17
1571,umpH,1400704,1400704,1400652,52,168,utRho17
1572,umuD,2461476,2461534,2461476,58,0,utRho17
1573,ung,5433476,5433508,5433476,32,32,utRho17
1574,uof,2843316,2843316,2842900,416,4156,utRho17
1575,upp,5241818,5241818,5241744,74,578,utRho17
1576,usg,4873780,4873780,4873298,482,456,utRho17
1577,ushA,1009772,1009828,1009772,56,148,utRho17
1578,uspA,7279966,7280222,7279966,256,600,utRho17
1579,uspB,7279696,7279696,7279440,256,334,utRho17
1580,uspC,3959172,3959506,3959172,334,40,utRho17
1581,uspE,2797318,2797318,2797244,74,52,utRho17
1582,uspF,2871282,2871282,2871238,44,6,utRho17
1583,uspG,1283806,1283806,1283734,72,1200,utRho17
1584,uvrA,8547872,8547872,8547742,130,514,utRho17
1585,uvrB,1626304,1627052,1626304,748,2168,utRho17
1586,uvrC,3989758,3989758,3989412,346,120,utRho17
1587,uvrD,7995814,7995966,7995814,152,610,utRho17
1588,uvrY,3990812,3990812,3990718,94,32,utRho17
1589,uxaB,3221474,3221474,3221360,114,0,utRho17
1590,uxaC,6489714,6489714,6489482,232,148,utRho17
1591,uxuA,9103036,9103272,9103036,236,1456,utRho17
1592,uxuR,9108916,9109152,9108916,236,682,utRho17
1593,valS,8967854,8967854,8967674,180,378,utRho17
1594,valU,5041848,5041862,5041848,14,6,utRho17
1595,valV,3492830,3492870,3492830,40,82,utRho17
1596,ves,3649968,3649968,3649874,94,0,utRho17
1597,waaA,7616512,7617080,7616512,568,1086,utRho17
1598,waaH,7580298,7580298,7580162,136,112,utRho17
1599,waaQ,7616476,7616476,7616196,280,182,utRho17
1600,waaU,7598996,7598996,7598624,372,298,utRho17
1601,waaY,7602272,7602272,7601930,342,3898,utRho17
1602,wbbH,4214888,4214888,4214452,436,826,utRho17
1603,wbbK,4209212,4209212,4209018,194,0,utRho17
1604,wcaM,4231868,4231868,4231792,76,138,utRho17
1605,wrbA,2135516,2135516,2135416,100,232,utRho17
1606,wza,4275166,4275166,4274486,680,16,utRho17
1607,wzxC,4240674,4240674,4240316,358,12,utRho17
1608,wzzB,4196950,4196950,4196602,348,100,utRho17
1609,xanP,7657642,7657890,7657642,248,262,utRho17
1610,xanQ,6048520,6048702,6048520,182,14,utRho17
1611,xapA,5049820,5049820,5049756,64,146,utRho17
1612,xapR,10090252,10090252,10089908,344,180,utRho17
1613,xdhA,6000514,6000690,6000514,176,818,utRho17
1614,xerD,6079702,6079702,6079486,216,88,utRho17
1615,xseA,5268394,5268464,5268394,70,78,utRho17
1616,xseB,882746,882746,882686,60,188,utRho17
1617,xthA,3664798,3664856,3664798,58,92,utRho17
1618,xylA,7461614,7461614,7461530,84,8678,utRho17
1619,xylE,8484540,8484540,8484508,32,0,utRho17
1620,xylF,7462138,7462262,7462138,124,416,utRho17
1621,xylR,7469812,7469958,7469812,146,164,utRho17
1622,yaaA,13230,13230,12918,312,202,utRho17
1623,yaaI,23876,23876,23572,304,540,utRho17
1624,yaaJ,16034,16034,15918,116,174,utRho17
1625,yaaU,91184,91614,91184,430,342,utRho17
1626,yaaW,23084,23084,22712,372,644,utRho17
1627,yaaX,10060,10468,10060,408,216,utRho17
1628,yabI,142542,142702,142542,160,798,utRho17
1629,yacC,273880,273880,273834,46,1898,utRho17
1630,yacH,262932,262932,262520,412,84,utRho17
1631,yacL,268678,268776,268678,98,746,utRho17
1632,yadD,293796,293936,293796,140,290,utRho17
1633,yadE,289930,290162,289930,232,166,utRho17
1634,yadN,314110,314110,313766,344,352,utRho17
1635,yadS,355572,355572,355248,324,4486,utRho17
1636,yadV,312470,312470,312402,68,732,utRho17
1637,yaeF,434270,434270,434006,264,166,utRho17
1638,yaeP,428374,428374,428250,124,686,utRho17
1639,yaeQ,428176,428582,428176,406,1180,utRho17
1640,yaeR,423716,423754,423716,38,70,utRho17
1641,yafC,462166,462166,461762,404,274,utRho17
1642,yafD,462128,462244,462128,116,204,utRho17
1643,yafK,491986,491986,491610,376,1814,utRho17
1644,yafL,493282,493424,493282,142,86,utRho17
1645,yafN,503938,504010,503938,72,158,utRho17
1646,yafS,469568,469632,469568,64,384,utRho17
1647,yafT,474470,474670,474470,200,160,utRho17
1648,yafV,480432,480432,480378,54,128,utRho17
1649,yafZ,536052,536052,536010,42,612,utRho17
1650,yagE,564446,564556,564446,110,540,utRho17
1651,yagG,570414,570790,570414,376,628,utRho17
1652,yagI,578384,578384,578324,60,236,utRho17
1653,yagK,586236,586236,585896,340,3710,utRho17
1654,yagL,588062,588062,587836,226,1134,utRho17
1655,yagN,591342,591342,591158,184,262,utRho17
1656,yahA,663746,664742,663746,996,3934,utRho17
1657,yahC,670136,670136,670044,92,1928,utRho17
1658,yahE,671478,671850,671478,372,512,utRho17
1659,yahM,690504,690808,690504,304,432,utRho17
1660,yahN,692872,692872,692674,198,1558,utRho17
1661,yahO,692864,692968,692864,104,458,utRho17
1662,yaiE,816296,816354,816296,58,98,utRho17
1663,yaiI,811396,811528,811396,132,28,utRho17
1664,yaiO,761946,761946,761684,262,270,utRho17
1665,yaiP,767970,767970,767870,100,62,utRho17
1666,yaiS,769660,769660,769232,428,286,utRho17
1667,yaiV,788922,788922,788922,0,0,utRho17
1668,yaiY,799094,799094,798666,428,390,utRho17
1669,yaiZ,798888,799186,798888,298,642,utRho17
1670,yajC,854410,854574,854410,164,726,utRho17
1671,yajD,860938,861210,860938,272,566,utRho17
1672,yajI,866068,866068,865702,366,126,utRho17
1673,yajL,887496,887496,887282,214,516,utRho17
1674,yajQ,889316,889366,889316,50,14,utRho17
1675,yajR,893374,893374,893332,42,572,utRho17
1676,ybaB,987418,988152,987418,734,3074,utRho17
1677,ybaL,1006590,1006590,1006476,114,238,utRho17
1678,ybaM,980648,980648,980542,106,996,utRho17
1679,ybaN,981436,981764,981436,328,428,utRho17
1680,ybaO,936704,936766,936704,62,0,utRho17
1681,ybaP,1016568,1016568,1016160,408,1106,utRho17
1682,ybaQ,1016348,1016436,1016348,88,212,utRho17
1683,ybaS,1023146,1023282,1023146,136,632,utRho17
1684,ybaV,927504,927874,927504,370,0,utRho17
1685,ybaY,950490,950758,950490,268,182,utRho17
1686,ybbB,1062724,1062724,1062452,272,26,utRho17
1687,ybbJ,1030154,1030154,1029718,436,2236,utRho17
1688,ybbL,1031784,1031838,1031784,54,66,utRho17
1689,ybbN,1037136,1037136,1036558,578,1180,utRho17
1690,ybbO,1038658,1038658,1038298,360,698,utRho17
1691,ybbY,1080718,1081130,1080718,412,384,utRho17
1692,ybcH,1176140,1176140,1175962,178,252,utRho17
1693,ybcI,1113264,1113264,1113106,158,2372,utRho17
1694,ybcJ,1114050,1114050,1113746,304,460,utRho17
1695,ybcK,1137502,1137804,1137502,302,632,utRho17
1696,ybcL,1141690,1141786,1141690,96,148,utRho17
1697,ybcN,1144628,1144932,1144628,304,516,utRho17
1698,ybcQ,1147548,1147912,1147548,364,2388,utRho17
1699,ybcW,1159610,1159760,1159610,150,20,utRho17
1700,ybdD,1263982,1264364,1263982,382,506,utRho17
1701,ybdF,1212106,1212106,1211772,334,322,utRho17
1702,ybdH,1267048,1267048,1266954,94,230,utRho17
1703,ybdJ,1212822,1212822,1212398,424,502,utRho17
1704,ybdK,1215122,1215122,1214766,356,2112,utRho17
1705,ybdL,1267114,1267172,1267114,58,176,utRho17
1706,ybdM,1271110,1271110,1270752,358,626,utRho17
1707,ybdN,1273372,1273372,1273138,234,26,utRho17
1708,ybdR,1283844,1284176,1283844,332,1306,utRho17
1709,ybeD,1325412,1325412,1325284,128,248,utRho17
1710,ybeF,1323090,1323090,1322756,334,384,utRho17
1711,ybeL,1349986,1350036,1349986,50,100,utRho17
1712,ybeQ,1353412,1353412,1353094,318,94,utRho17
1713,ybeR,1353120,1353422,1353120,302,88,utRho17
1714,ybeT,1358832,1358832,1358812,20,2,utRho17
1715,ybeU,1358924,1359016,1358924,92,64,utRho17
1716,ybeZ,1386938,1386938,1386834,104,4076,utRho17
1717,ybfA,1458074,1458268,1458074,194,190,utRho17
1718,ybfE,1423878,1423878,1423796,82,384,utRho17
1719,ybfF,1425692,1425692,1425604,88,248,utRho17
1720,ybfH,1433282,1433282,1433194,88,138,utRho17
1721,ybgA,1477840,1478002,1477840,162,42,utRho17
1722,ybgC,1549288,1549504,1549288,216,60,utRho17
1723,ybgD,1505916,1505916,1505590,326,8010,utRho17
1724,ybgI,1485238,1485654,1485238,416,68,utRho17
1725,ybgO,1498370,1498370,1497964,406,556,utRho17
1726,ybgS,1570992,1570992,1570634,358,0,utRho17
1727,ybhA,1597184,1597184,1596862,322,40,utRho17
1728,ybhB,1616070,1616070,1615818,252,478,utRho17
1729,ybhC,1614642,1614642,1614562,80,1002,utRho17
1730,ybhD,1601418,1601418,1601276,142,84,utRho17
1731,ybhH,1601104,1601518,1601104,414,248,utRho17
1732,ybhK,1633384,1633384,1633294,90,430,utRho17
1733,ybhM,1641556,1641586,1641556,30,52,utRho17
1734,ybhN,1645296,1645296,1644996,300,304,utRho17
1735,ybhQ,1649202,1649260,1649202,58,652,utRho17
1736,ybiA,1665920,1665920,1665900,20,0,utRho17
1737,ybiI,1676968,1676968,1676912,56,152,utRho17
1738,ybiO,1691328,1691328,1690960,368,2592,utRho17
1739,ybiP,1705252,1705252,1705194,58,442,utRho17
1740,ybiS,1711572,1711572,1711488,84,136,utRho17
1741,ybiT,1711894,1711926,1711894,32,0,utRho17
1742,ybiU,1718212,1718212,1718122,90,182,utRho17
1743,ybiV,1720176,1720176,1720056,120,58,utRho17
1744,ybiW,1725566,1725566,1725212,354,3714,utRho17
1745,ybiX,1678548,1678548,1678414,134,108,utRho17
1746,ybjC,1781784,1781826,1781784,42,0,utRho17
1747,ybjE,1830154,1830154,1829714,440,458,utRho17
1748,ybjG,1767016,1767016,1766776,240,1236,utRho17
1749,ybjL,1779882,1779882,1779638,244,84,utRho17
1750,ybjM,1779770,1780178,1779770,408,676,utRho17
1751,ybjO,1795704,1795978,1795704,274,88,utRho17
1752,ybjP,1809046,1809046,1808934,112,0,utRho17
1753,ybjQ,1809034,1809186,1809034,152,0,utRho17
1754,ybjS,1813796,1813796,1813506,290,374,utRho17
1755,ybjX,1838206,1838206,1838168,38,2,utRho17
1756,ycaD,1891438,1891742,1891438,304,0,utRho17
1757,ycaI,1928210,1928640,1928210,430,96,utRho17
1758,ycaK,1899094,1899336,1899094,242,268,utRho17
1759,ycaL,1920264,1920528,1920264,264,28,utRho17
1760,ycaM,1894240,1894458,1894240,218,146,utRho17
1761,ycaR,1941284,1941346,1941284,62,1976,utRho17
1762,ycbB,1961862,1962094,1961862,232,270,utRho17
1763,ycbJ,1943344,1943504,1943344,160,56,utRho17
1764,ycbK,1966046,1966150,1966046,104,392,utRho17
1765,ycbZ,2036920,2036920,2036598,322,84,utRho17
1766,yccA,2062886,2062886,2062836,50,52,utRho17
1767,yccF,2048730,2048730,2048696,34,0,utRho17
1768,yccS,2047988,2047988,2047766,222,318,utRho17
1769,yccT,2055674,2055674,2055546,128,130,utRho17
1770,yccX,2059960,2060128,2059960,168,578,utRho17
1771,ycdT,2185682,2185752,2185682,70,2,utRho17
1772,ycdU,2191266,2191686,2191266,420,336,utRho17
1773,ycdZ,2200504,2200592,2200504,88,76,utRho17
1774,yceA,2233544,2233614,2233544,70,34,utRho17
1775,yceD,2293298,2293588,2293298,290,3296,utRho17
1776,yceF,2293522,2293522,2293190,332,2308,utRho17
1777,yceH,2252154,2252314,2252154,160,1056,utRho17
1778,yceI,2237282,2237282,2236952,330,986,utRho17
1779,yceJ,2238142,2238142,2238092,50,426,utRho17
1780,yceM,2253208,2253612,2253208,404,180,utRho17
1781,yceO,2239264,2239264,2238894,370,1190,utRho17
1782,yceQ,2288760,2289004,2288760,244,3124,utRho17
1783,ycfD,2376540,2376540,2376480,60,180,utRho17
1784,ycfJ,2334814,2335198,2334814,384,536,utRho17
1785,ycfS,2340834,2340834,2340748,86,0,utRho17
1786,ycfT,2350658,2350658,2350330,328,0,utRho17
1787,ycfZ,2362760,2362760,2362534,226,890,utRho17
1788,ycgB,2474570,2474570,2474482,88,20,utRho17
1789,ycgG,2434614,2434656,2434614,42,488,utRho17
1790,ycgJ,2452956,2453200,2452956,244,0,utRho17
1791,ycgL,2455218,2455362,2455218,144,92,utRho17
1792,ycgN,2457366,2457660,2457366,294,314,utRho17
1793,ycgR,2489112,2489112,2489054,58,0,utRho17
1794,ycgV,2512222,2512222,2511904,318,1238,utRho17
1795,ycgX,2426568,2426568,2426214,354,8082,utRho17
1796,ycgY,2490166,2490320,2490166,154,376,utRho17
1797,ycgZ,2431504,2431578,2431504,74,40,utRho17
1798,ychE,2596904,2597196,2596904,292,2,utRho17
1799,ychF,2515764,2515764,2515624,140,66,utRho17
1800,ychH,2517476,2517582,2517476,106,572,utRho17
1801,ychJ,2578354,2578354,2578264,90,184,utRho17
1802,ychN,2547310,2547310,2547198,112,0,utRho17
1803,ychO,2547520,2547850,2547520,330,228,utRho17
1804,ychQ,2533798,2533848,2533798,50,2,utRho17
1805,yciA,2624828,2624828,2624492,336,172,utRho17
1806,yciB,2626110,2626110,2625780,330,940,utRho17
1807,yciC,2627396,2627396,2627326,70,0,utRho17
1808,yciE,2630794,2630794,2630448,346,198,utRho17
1809,yciG,5264368,5264368,5264140,228,228,utRho17
1810,yciI,2621784,2621784,2621730,54,170,utRho17
1811,yciN,2661606,2661606,2661336,270,54,utRho17
1812,yciS,2680270,2680486,2680270,216,118,utRho17
1813,yciT,2689088,2689088,2688692,396,2454,utRho17
1814,yciU,2614718,2614718,2614300,418,1638,utRho17
1815,yciV,2646376,2646440,2646376,64,26,utRho17
1816,yciW,2700472,2700472,2700214,258,3506,utRho17
1817,yciZ,2689276,2689276,2689218,58,1370,utRho17
1818,ycjD,2703792,2703792,2703520,272,78,utRho17
1819,ycjG,2777748,2777860,2777748,112,298,utRho17
1820,ycjM,2740006,2740432,2740006,426,178,utRho17
1821,ycjW,2767982,2767982,2767922,60,90,utRho17
1822,ycjX,2768138,2768234,2768138,96,90,utRho17
1823,ycjY,5568288,5568288,5567460,828,648,utRho17
1824,ydaE,2836438,2836438,2836016,422,458,utRho17
1825,ydaN,2816048,2816100,2816048,52,158,utRho17
1826,ydaS,2840340,2840730,2840340,390,212,utRho17
1827,ydbC,2948376,2948442,2948376,66,0,utRho17
1828,ydbD,2950132,2950288,2950132,156,0,utRho17
1829,ydbH,2885800,2886102,2885800,302,282,utRho17
1830,ydbJ,2881712,2882116,2881712,404,1396,utRho17
1831,ydbK,2881692,2881692,2881568,124,122,utRho17
1832,ydcA,2983294,2983354,2983294,60,254,utRho17
1833,ydcF,2974404,2974470,2974404,66,0,utRho17
1834,ydcI,2990268,2990268,2990142,126,28,utRho17
1835,ydcJ,2990266,2990576,2990266,310,0,utRho17
1836,ydcK,3001280,3001280,3000898,382,186,utRho17
1837,ydcL,3004646,3004914,3004646,268,70,utRho17
1838,ydcN,3012308,3012344,3012308,36,1004,utRho17
1839,ydcP,3013508,3013562,3013508,54,32,utRho17
1840,ydcR,3019956,3020006,3019956,50,0,utRho17
1841,ydcS,3022906,3023308,3022906,402,222,utRho17
1842,ydcX,3034442,3034778,3034442,336,312,utRho17
1843,ydcY,3035220,3035296,3035220,76,138,utRho17
1844,ydcZ,3036750,3036750,3036662,88,1626,utRho17
1845,yddB,3155332,3155332,3155238,94,184,utRho17
1846,yddE,3071738,3071738,3071716,22,42,utRho17
1847,yddG,3094410,3094410,3094338,72,40,utRho17
1848,yddJ,3089732,3089732,3089438,294,708,utRho17
1849,yddW,3137704,3137704,3137646,58,0,utRho17
1850,ydeA,3233910,3234056,3233910,146,540,utRho17
1851,ydeE,3242528,3242664,3242528,136,76,utRho17
1852,ydeI,3249118,3249118,3248994,124,82,utRho17
1853,ydeJ,3249376,3249546,3249376,170,4,utRho17
1854,ydeN,3165458,3165458,3165048,410,144,utRho17
1855,ydeP,3173328,3173328,3172972,356,776,utRho17
1856,ydeR,3176596,3176596,3176592,4,56,utRho17
1857,ydfA,3296872,3297016,3296872,144,14,utRho17
1858,ydfG,3254982,3255034,3254982,52,242,utRho17
1859,ydfH,3256652,3256704,3256652,52,172,utRho17
1860,ydfK,3265446,3266144,3265446,698,4182,utRho17
1861,ydgA,3379588,3379704,3379588,116,152,utRho17
1862,ydgC,3364124,3364124,3364060,64,212,utRho17
1863,ydgD,3343906,3343920,3343906,14,2,utRho17
1864,ydgH,3356754,3356854,3356754,100,20,utRho17
1865,ydgJ,3408798,3408798,3408616,182,690,utRho17
1866,ydgK,3410414,3410500,3410414,86,430,utRho17
1867,ydhB,3479618,3479618,3479596,22,0,utRho17
1868,ydhC,3479698,3479822,3479698,124,28,utRho17
1869,ydhF,3451310,3451310,3451264,46,18,utRho17
1870,ydhI,3441996,3442050,3441996,54,0,utRho17
1871,ydhL,3451864,3451864,3451840,24,396,utRho17
1872,ydhQ,3492404,3492404,3492254,150,0,utRho17
1873,ydhS,3494136,3494262,3494136,126,806,utRho17
1874,ydhT,3499138,3499138,3499118,20,206,utRho17
1875,ydhY,3509284,3509284,3508954,330,336,utRho17
1876,ydhZ,3510418,3510418,3510282,136,312,utRho17
1877,ydiE,3579206,3579226,3579206,20,0,utRho17
1878,ydiH,3530582,3530582,3530406,176,0,utRho17
1879,ydiM,3541852,3542142,3541852,290,142,utRho17
1880,ydiN,3544818,3545024,3544818,206,68,utRho17
1881,ydiP,3558656,3558656,3558602,54,66,utRho17
1882,ydiU,3582508,3582508,3582488,20,634,utRho17
1883,ydiV,3584174,3584174,3584040,134,510,utRho17
1884,ydiY,3612500,3612500,3612166,334,104,utRho17
1885,ydjA,3697400,3697400,3697352,48,152,utRho17
1886,ydjE,3708082,3708082,3707958,124,0,utRho17
1887,ydjF,3709848,3709848,3709708,140,170,utRho17
1888,ydjM,3620340,3620422,3620340,82,0,utRho17
1889,ydjO,3626696,3626696,3626288,408,734,utRho17
1890,ydjX,3666434,3666802,3666434,368,1964,utRho17
1891,yeaE,3731448,3731448,3731272,176,274,utRho17
1892,yeaG,3733530,3733816,3733530,286,0,utRho17
1893,yeaI,3740486,3740770,3740486,284,42,utRho17
1894,yeaJ,3743874,3744082,3743874,208,94,utRho17
1895,yeaL,3748646,3748704,3748646,58,184,utRho17
1896,yeaM,3751296,3751296,3751152,144,80,utRho17
1897,yeaN,3750926,3751346,3750926,420,120,utRho17
1898,yeaO,3753554,3753818,3753554,264,176,utRho17
1899,yeaP,3755314,3755430,3755314,116,610,utRho17
1900,yeaQ,3758780,3758780,3758510,270,368,utRho17
1901,yeaR,3759988,3759988,3759896,92,42,utRho17
1902,yeaY,3781122,3781122,3781064,58,4,utRho17
1903,yebB,3892220,3892502,3892220,282,214,utRho17
1904,yebC,3896370,3896370,3896302,68,40,utRho17
1905,yebE,3859464,3859464,3859414,50,400,utRho17
1906,yebG,3861530,3861530,3861494,36,0,utRho17
1907,yebK,3873180,3873304,3873180,124,144,utRho17
1908,yebQ,3820314,3820552,3820314,238,162,utRho17
1909,yebS,3832238,3832516,3832238,278,10,utRho17
1910,yebV,3843430,3843560,3843430,130,54,utRho17
1911,yebW,3843914,3844242,3843914,328,1162,utRho17
1912,yecC,3995646,3995646,3995628,18,0,utRho17
1913,yecD,3901272,3901664,3901272,392,98,utRho17
1914,yecF,3991434,3991636,3991434,202,246,utRho17
1915,yecH,3979304,3979304,3978980,324,1510,utRho17
1916,yecJ,3975604,3975604,3975516,88,0,utRho17
1917,yecM,3919968,3919968,3919692,276,242,utRho17
1918,yecR,3976400,3976444,3976400,44,0,utRho17
1919,yecT,3923862,3923944,3923862,82,174,utRho17
1920,yedD,4016522,4016522,4016180,342,198,utRho17
1921,yedE,4016310,4016554,4016310,244,190,utRho17
1922,yedI,4058922,4058922,4058732,190,0,utRho17
1923,yedJ,4066446,4066446,4066158,288,478,utRho17
1924,yedV,4076404,4076404,4076304,100,372,utRho17
1925,yedX,4077680,4077912,4077680,232,0,utRho17
1926,yedY,4078572,4078956,4078572,384,676,utRho17
1927,yeeA,4161322,4161322,4161182,140,2,utRho17
1928,yeeE,4171104,4171104,4171050,54,2,utRho17
1929,yeeJ,4089526,4089822,4089526,296,546,utRho17
1930,yeeN,4113508,4113716,4113508,208,390,utRho17
1931,yeeO,4119444,4119444,4119692,248,194,utRho17
1932,yeeX,4158834,4158834,4158722,112,570,utRho17
1933,yeeZ,4178422,4178422,4178256,166,36,utRho17
1934,yefM,4179466,4179466,4179426,40,0,utRho17
1935,yegD,4295288,4295348,4295288,60,2,utRho17
1936,yegH,4275726,4275804,4275726,78,376,utRho17
1937,yegI,4302154,4302154,4301970,184,0,utRho17
1938,yegJ,4302032,4302370,4302032,338,146,utRho17
1939,yegQ,4331182,4331336,4331182,154,1834,utRho17
1940,yegR,4336698,4336698,4336612,86,376,utRho17
1941,yegS,4337086,4337424,4337086,338,482,utRho17
1942,yegT,4357562,4357642,4357562,80,636,utRho17
1943,yegX,4367640,4367640,4367302,338,600,utRho17
1944,yehA,4376944,4376944,4376828,116,324,utRho17
1945,yehE,4385818,4385818,4385592,226,0,utRho17
1946,yehK,4407568,4407944,4407568,376,204,utRho17
1947,yehL,4408804,4409192,4408804,388,76,utRho17
1948,yeiB,4486146,4486146,4485934,212,106,utRho17
1949,yeiE,4499422,4499422,4499236,186,26,utRho17
1950,yeiG,4487776,4487820,4487776,44,150,utRho17
1951,yeiH,4499332,4499434,4499332,102,60,utRho17
1952,yeiI,4503306,4503400,4503306,94,134,utRho17
1953,yeiL,4510580,4510710,4510580,130,6,utRho17
1954,yeiP,4530834,4530900,4530834,66,226,utRho17
1955,yeiQ,4532328,4532490,4532328,162,138,utRho17
1956,yeiR,4535484,4535658,4535484,174,380,utRho17
1957,yeiW,4530840,4530840,4530590,250,274,utRho17
1958,yejA,4544624,4544728,4544624,104,0,utRho17
1959,yejG,4556892,4556892,4556474,418,3746,utRho17
1960,yejH,4561244,4561264,4561244,20,0,utRho17
1961,yejK,4568218,4568218,4567894,324,62,utRho17
1962,yejO,4578352,4578352,4577800,552,1934,utRho17
1963,yfaD,4713380,4713808,4713380,428,1590,utRho17
1964,yfaE,4696676,4697028,4696676,352,2046,utRho17
1965,yfaL,4688568,4688568,4688338,230,14,utRho17
1966,yfaP,4656398,4656398,4656286,112,38,utRho17
1967,yfaU,4717892,4717892,4717690,202,114,utRho17
1968,yfaY,4727310,4727310,4727266,44,22,utRho17
1969,yfaZ,4728744,4728744,4728550,194,36,utRho17
1970,yfbK,4771810,4771810,4771444,366,984,utRho17
1971,yfbL,4771500,4771720,4771500,220,716,utRho17
1972,yfbN,4777174,4777174,4776852,322,130,utRho17
1973,yfbO,4776916,4777162,4776916,246,130,utRho17
1974,yfbP,4777990,4778232,4777990,242,10206,utRho17
1975,yfbR,4817662,4817724,4817662,62,16,utRho17
1976,yfcI,4847424,4847424,4847078,346,1328,utRho17
1977,yfcJ,4880482,4880482,4880240,242,756,utRho17
1978,yfcL,4888502,4888502,4888338,164,250,utRho17
1979,yfcV,4911642,4911642,4911292,350,520,utRho17
1980,yfcZ,4921958,4921958,4921868,90,40,utRho17
1981,yfdF,4925604,4926024,4925604,420,5856,utRho17
1982,yfdG,4935474,4935710,4935474,236,0,utRho17
1983,yfdP,4946844,4947040,4946844,196,152,utRho17
1984,yfdX,4988866,4988866,4988804,62,0,utRho17
1985,yfdY,4990672,4990672,4990584,88,44,utRho17
1986,yfeA,5035784,5035784,5035664,120,15036,utRho17
1987,yfeC,5036668,5036934,5036668,266,112,utRho17
1988,yfeH,5053818,5053892,5053818,74,132,utRho17
1989,yfeK,5074630,5074684,5074630,54,0,utRho17
1990,yfeO,5018906,5019260,5018906,354,762,utRho17
1991,yfeR,5054078,5054078,5053712,366,172,utRho17
1992,yfeX,5101356,5101356,5101090,266,56,utRho17
1993,yfeY,5102486,5102486,5102432,54,0,utRho17
1994,yfeZ,5103842,5103842,5103452,390,132,utRho17
1995,yffO,5123804,5124222,5123804,418,74,utRho17
1996,yffQ,5126778,5127154,5126778,376,762,utRho17
1997,yffS,5128800,5128986,5128800,186,0,utRho17
1998,yfgC,5232052,5232188,5232052,136,164,utRho17
1999,yfgF,5258062,5258062,5257876,186,978,utRho17
2000,yfgG,5258170,5258580,5258170,410,1612,utRho17
2001,yfgH,5259344,5259584,5259344,240,478,utRho17
2002,yfgM,5278866,5278866,5278566,300,644,utRho17
2003,yfhH,5397414,5397518,5397414,104,86,utRho17
2004,yfhM,5304648,5304648,5304574,74,74,utRho17
2005,yfhR,5328408,5328726,5328408,318,13442,utRho17
2006,yfiC,5425610,5425610,5425528,82,30,utRho17
2007,yfiE,5430688,5430688,5430640,48,996,utRho17
2008,yfiL,5482630,5482720,5482630,90,208,utRho17
2009,yfiM,5448066,5448358,5448066,292,11628,utRho17
2010,yfiR,5483354,5483750,5483354,396,486,utRho17
2011,yfjH,5517326,5517326,5517200,126,20,utRho17
2012,yfjI,5517710,5517970,5517710,260,168,utRho17
2013,yfjJ,5521014,5521094,5521014,80,266,utRho17
2014,yfjM,5531970,5531970,5531552,418,6866,utRho17
2015,yfjP,5535080,5535420,5535080,340,826,utRho17
2016,yfjW,5546570,5546636,5546570,66,0,utRho17
2017,yfjX,5551776,5551838,5551776,62,0,utRho17
2018,ygaC,5601180,5601180,5599988,1192,2466,utRho17
2019,ygaM,5600242,5600292,5600242,50,562,utRho17
2020,ygaU,5593628,5593628,5593572,56,196,utRho17
2021,ygaZ,5619190,5619234,5619190,44,466,utRho17
2022,ygbA,5713656,5713656,5713612,44,74,utRho17
2023,ygbE,5746784,5746784,5746674,110,2312,utRho17
2024,ygbI,5722882,5722882,5722528,354,312,utRho17
2025,ygbK,5724394,5724670,5724394,276,532,utRho17
2026,ygbL,5727074,5727186,5727074,112,104,utRho17
2027,ygbN,5729814,5730202,5729814,388,710,utRho17
2028,ygcG,5811210,5811422,5811210,212,40,utRho17
2029,ygcN,5785144,5785314,5785144,170,292,utRho17
2030,ygcU,5799214,5799214,5798836,378,198,utRho17
2031,ygcW,5800942,5800942,5800546,396,0,utRho17
2032,ygdD,5883442,5883442,5883262,180,494,utRho17
2033,ygdG,5861746,5861930,5861746,184,1802,utRho17
2034,ygdI,5886526,5886526,5886290,236,126,utRho17
2035,ygdQ,5940784,5940840,5940784,56,184,utRho17
2036,ygdR,5942494,5942542,5942494,48,100,utRho17
2037,ygeA,5961606,5961606,5961270,336,200,utRho17
2038,ygeH,5983758,5984188,5983758,430,988,utRho17
2039,ygeI,5987162,5987276,5987162,114,4696,utRho17
2040,ygeR,6000078,6000078,5999782,296,544,utRho17
2041,ygeV,6011694,6011694,6011572,122,68,utRho17
2042,ygeW,6012234,6012524,6012234,290,532,utRho17
2043,ygfB,6110946,6110946,6110888,58,216,utRho17
2044,ygfK,6031984,6032120,6031984,136,118,utRho17
2045,ygfS,6058328,6058328,6058024,304,152,utRho17
2046,ygfZ,6082564,6082626,6082564,62,236,utRho17
2047,yggC,6149512,6149512,6149378,134,84,utRho17
2048,yggE,6136370,6136370,6136160,210,426,utRho17
2049,yggI,6179176,6179510,6179176,334,1560,utRho17
2050,yggL,6204508,6204508,6204266,242,92,utRho17
2051,yggM,6199514,6199514,6199130,384,92,utRho17
2052,yggN,6203596,6203596,6203246,350,848,utRho17
2053,yggX,18623958,18624558,18623958,600,270,utRho17
2054,yghA,6298966,6299324,6298966,358,84,utRho17
2055,yghB,6307058,6307126,6307058,68,338,utRho17
2056,yghD,6222614,6222614,6222252,362,684,utRho17
2057,yghF,6225798,6225798,6225840,42,146,utRho17
2058,yghJ,6238640,6238640,6238224,416,44,utRho17
2059,yghQ,6265186,6265186,6264816,370,356,utRho17
2060,yghT,6267830,6268262,6267830,432,494,utRho17
2061,yghU,6277400,6277454,6277400,54,100,utRho17
2062,yghW,6293506,6293506,6293474,32,0,utRho17
2063,yghZ,6295562,6295794,6295562,232,528,utRho17
2064,ygiD,6365122,6365122,6364868,254,2968,utRho17
2065,ygiH,6409066,6409388,6409066,322,582,utRho17
2066,ygiL,6370622,6370828,6370622,206,378,utRho17
2067,ygiM,6402084,6402414,6402084,330,560,utRho17
2068,ygiN,6346156,6346284,6346156,128,1148,utRho17
2069,ygiQ,6322620,6322620,6322292,328,1586,utRho17
2070,ygiS,6335462,6335462,6335436,26,94,utRho17
2071,ygiV,6338582,6338582,6338462,120,212,utRho17
2072,ygiW,6339774,6339774,6339352,422,1562,utRho17
2073,ygiZ,6344506,6344506,6344422,84,16,utRho17
2074,ygjH,6442528,6442528,6442494,34,16,utRho17
2075,ygjI,6452140,6452468,6452140,328,118,utRho17
2076,ygjQ,6472730,6473080,6472730,350,1216,utRho17
2077,ygjR,6474564,6474586,6474564,22,0,utRho17
2078,ygjV,6483638,6483638,6483488,150,72,utRho17
2079,yhaB,6535632,6535708,6535632,76,0,utRho17
2080,yhaH,6504498,6504608,6504498,110,370,utRho17
2081,yhaI,6505400,6505822,6505400,422,526,utRho17
2082,yhaJ,6508560,6508560,6508428,132,214,utRho17
2083,yhaK,6508538,6508638,6508538,100,146,utRho17
2084,yhbQ,6599878,6599932,6599878,54,772,utRho17
2085,yhbT,6602736,6602736,6602552,184,506,utRho17
2086,yhbU,6602558,6602970,6602558,412,608,utRho17
2087,yhbX,6643302,6643302,6643226,76,0,utRho17
2088,yhbY,6655518,6655580,6655518,62,586,utRho17
2089,yhcA,6723956,6724224,6723956,268,744,utRho17
2090,yhcB,6760364,6760382,6760364,18,42,utRho17
2091,yhcC,6708470,6708470,6708100,370,2460,utRho17
2092,yhcF,6733440,6733852,6733440,412,2672,utRho17
2093,yhcH,6739124,6739124,6738956,168,896,utRho17
2094,yhcM,6760312,6760312,6759994,318,68,utRho17
2095,yhcN,6770812,6771076,6770812,264,278,utRho17
2096,yhcO,6772606,6772606,6772258,348,152,utRho17
2097,yhdH,6806560,6806968,6806560,408,550,utRho17
2098,yhdJ,6823234,6823306,6823234,72,0,utRho17
2099,yhdN,6879092,6879092,6879018,74,810,utRho17
2100,yhdT,6814702,6814750,6814702,48,120,utRho17
2101,yhdU,6824994,6825242,6824994,248,354,utRho17
2102,yhdV,6836392,6836780,6836392,388,1492,utRho17
2103,yhdW,6837944,6838298,6837944,354,124,utRho17
2104,yheO,6953082,6953082,6952880,202,438,utRho17
2105,yheV,6957970,6957970,6957584,386,348,utRho17
2106,yhfA,6971902,6971902,6971636,266,606,utRho17
2107,yhfG,6983294,6983294,6983240,54,1026,utRho17
2108,yhfL,6998622,6998896,6998622,274,568,utRho17
2109,yhfY,7023244,7023244,7022844,400,0,utRho17
2110,yhgA,7086294,7086334,7086294,40,6,utRho17
2111,yhgE,7065176,7065176,7064878,298,816,utRho17
2112,yhgF,7074352,7074770,7074352,418,7864,utRho17
2113,yhhA,7173458,7173886,7173458,428,640,utRho17
2114,yhhI,7248346,7248756,7248346,410,40,utRho17
2115,yhhJ,7253696,7253696,7253606,90,328,utRho17
2116,yhhM,7211588,7211588,7211220,368,874,utRho17
2117,yhhN,7211150,7211502,7211150,352,624,utRho17
2118,yhhQ,7218238,7218434,7218238,196,290,utRho17
2119,yhhT,7223682,7223730,7223682,48,50,utRho17
2120,yhhX,7162032,7162032,7161610,422,2,utRho17
2121,yhhY,7162222,7162276,7162222,54,38,utRho17
2122,yhhZ,7163516,7163726,7163516,210,344,utRho17
2123,yhiD,7312220,7312220,7311804,416,101984,utRho17
2124,yhiJ,7265190,7265190,7265180,10,90,utRho17
2125,yhiM,7269270,7269682,7269270,412,2026,utRho17
2126,yhiN,7275000,7275000,7274820,180,780,utRho17
2127,yhjA,7338522,7338522,7338376,146,78,utRho17
2128,yhjB,7344090,7344090,7343788,302,1040,utRho17
2129,yhjC,7344272,7344684,7344272,412,208,utRho17
2130,yhjD,7346660,7346724,7346660,64,160,utRho17
2131,yhjE,7349274,7349572,7349274,298,1200,utRho17
2132,yhjG,7356824,7356824,7356730,94,120,utRho17
2133,yhjH,7358458,7358458,7358374,84,786,utRho17
2134,yhjJ,7364032,7364032,7363880,152,328,utRho17
2135,yhjK,7371296,7371296,7371158,138,140,utRho17
2136,yhjR,7392750,7392750,7392370,380,52,utRho17
2137,yhjV,7400796,7401126,7400796,330,2656,utRho17
2138,yhjX,7424194,7424194,7424014,180,260,utRho17
2139,yhjY,7425966,7425966,7425868,98,100,utRho17
2140,yiaB,7455654,7455654,7455496,158,410,utRho17
2141,yiaD,7432712,7433094,7432712,382,1242,utRho17
2142,yiaF,7438194,7438194,7438088,106,962,utRho17
2143,yiaG,7438862,7438956,7438862,94,434,utRho17
2144,yiaJ,7485236,7485236,7485064,172,946,utRho17
2145,yiaK,7485348,7485466,7485348,118,182,utRho17
2146,yiaT,7503924,7503924,7503736,188,0,utRho17
2147,yiaU,7503792,7503984,7503792,192,76,utRho17
2148,yiaY,7515856,7515856,7515654,202,432,utRho17
2149,yibF,7523950,7523950,7523910,40,38,utRho17
2150,yibG,7536128,7536354,7536128,226,64,utRho17
2151,yibL,7553194,7553330,7553194,136,180,utRho17
2152,yibN,7570112,7570112,7570030,82,86,utRho17
2153,yibT,7552848,7552848,7552760,88,1062,utRho17
2154,yicC,7633290,7633352,7633290,62,94,utRho17
2155,yicH,7660862,7660914,7660862,52,18,utRho17
2156,yicJ,7673328,7673328,7671858,1470,12662,utRho17
2157,yicN,7685018,7685018,7684804,214,1228,utRho17
2158,yicO,7687914,7687914,7687578,336,370,utRho17
2159,yicR,15250308,15250308,15250236,72,0,utRho17
2160,yidB,7755230,7755230,7754930,300,130,utRho17
2161,yidE,7732780,7732780,7732546,234,572,utRho17
2162,yidF,7711580,7711580,7711222,358,428,utRho17
2163,yidQ,7735088,7735456,7735088,368,1212,utRho17
2164,yidR,7738824,7738824,7738618,206,158,utRho17
2165,yieE,7787658,7787738,7787658,80,912,utRho17
2166,yieH,7793314,7793548,7793314,234,314,utRho17
2167,yieK,7798928,7798928,7798786,142,14,utRho17
2168,yifB,7900350,7900350,7899998,352,194,utRho17
2169,yifL,7988984,7989044,7988984,60,2068,utRho17
2170,yigF,8005750,8005750,8005598,152,17424,utRho17
2171,yigI,8009448,8009448,8009394,54,488,utRho17
2172,yigM,8022100,8022152,8022100,52,212,utRho17
2173,yihA,8101970,8101970,8101458,512,202,utRho17
2174,yihD,8084098,8084138,8084098,40,36,utRho17
2175,yihF,8088110,8088398,8088110,288,326,utRho17
2176,yihG,8093304,8093304,8093204,100,84,utRho17
2177,yihI,8102616,8102694,8102616,78,4,utRho17
2178,yihL,8120506,8120894,8120506,388,238,utRho17
2179,yihN,8124332,8124494,8124332,162,534,utRho17
2180,yihO,8131942,8131942,8131532,410,322,utRho17
2181,yihQ,8138892,8138892,8138552,340,102,utRho17
2182,yihV,8147064,8147478,8147064,414,412,utRho17
2183,yihX,8151096,8151106,8151096,10,140,utRho17
2184,yiiE,8158192,8158582,8158192,390,718,utRho17
2185,yiiF,8159124,8159502,8159124,378,1308,utRho17
2186,yiiG,8173762,8174004,8173762,242,32,utRho17
2187,yiiM,8205506,8205644,8205506,138,2424,utRho17
2188,yiiQ,8224624,8224624,8224428,196,206,utRho17
2189,yiiS,8225738,8225934,8225738,196,380,utRho17
2190,yijE,8272178,8272216,8272178,38,214,utRho17
2191,yijF,8275728,8275728,8275314,414,1348,utRho17
2192,yijO,8296858,8296858,8296634,224,750,utRho17
2193,yjaA,8426240,8426468,8426240,228,182740,utRho17
2194,yjaB,8428312,8428312,8428246,66,672,utRho17
2195,yjaG,8398746,8399008,8398746,262,802,utRho17
2196,yjaH,8401022,8401132,8401022,110,324,utRho17
2197,yjaZ,8379506,8379572,8379506,66,62,utRho17
2198,yjbB,8455204,8455462,8455204,258,0,utRho17
2199,yjbE,16943432,16943624,16943432,192,508,utRho17
2200,yjbL,8520318,8520642,8520318,324,424,utRho17
2201,yjbQ,8540428,8540476,8540428,48,72,utRho17
2202,yjcB,8550328,8550328,8550082,246,378,utRho17
2203,yjcC,8550836,8550942,8550836,106,306,utRho17
2204,yjcD,8556628,8556958,8556628,330,168,utRho17
2205,yjcE,8559658,8559960,8559658,302,420,utRho17
2206,yjcF,8566212,8566212,8566150,62,30,utRho17
2207,yjcO,8594660,8594660,8594250,410,222,utRho17
2208,yjdA,8654128,8654270,8654128,142,0,utRho17
2209,yjdC,8726660,8726660,8726616,44,16,utRho17
2210,yjdK,8704780,8705168,8704780,388,3446,utRho17
2211,yjdL,8713034,8713034,8712822,212,36,utRho17
2212,yjdM,8653672,8653672,8653468,204,996,utRho17
2213,yjeF,8787354,8788132,8787354,778,92936,utRho17
2214,yjeI,8745522,8745618,8745522,96,0,utRho17
2215,yjeJ,8748806,8748806,8748468,338,646,utRho17
2216,yjeV,8785472,8785784,8785472,312,3070,utRho17
2217,yjfP,8833512,8833904,8833512,392,198,utRho17
2218,yjfY,8849656,8849656,8849582,74,218,utRho17
2219,yjfZ,8855052,8855052,8854844,208,138,utRho17
2220,yjgA,8916162,8916162,8915730,432,470,utRho17
2221,yjgL,8950802,8950874,8950802,72,60,utRho17
2222,yjgM,8959342,8959342,8959074,268,42,utRho17
2223,yjgN,8959132,8959460,8959132,328,42,utRho17
2224,yjgR,8980170,8980170,8980126,44,732,utRho17
2225,yjgZ,9002116,9002520,9002116,404,7240,utRho17
2226,yjhB,9007764,9008116,9007764,352,666,utRho17
2227,yjhG,9048452,9048452,9048188,264,12716,utRho17
2228,yjhU,9041080,9041080,9040648,432,1064,utRho17
2229,yjiA,9178096,9178096,9177730,366,3710,utRho17
2230,yjiJ,9125364,9125364,9125350,14,124,utRho17
2231,yjiK,9127270,9127270,9127422,152,316,utRho17
2232,yjiL,9129604,9129604,9129378,226,20,utRho17
2233,yjiS,9143410,9143502,9143410,92,322,utRho17
2234,yjiY,9182734,9182734,9182558,176,4926,utRho17
2235,yjjA,9200674,9200674,9200378,296,2438,utRho17
2236,yjjB,18408708,18408708,18407800,908,2100,utRho17
2237,yjjJ,9243314,9243538,9243314,224,44,utRho17
2238,yjjK,9261132,9261132,9261044,88,1122,utRho17
2239,yjjL,9189764,9189764,9189444,320,1296,utRho17
2240,yjjM,9191894,9191894,9191702,192,178,utRho17
2241,yjjP,9206068,9206068,9205716,352,16424,utRho17
2242,yjjQ,9206638,9206954,9206638,316,9708,utRho17
2243,yjjX,9267798,9267798,9267490,308,1666,utRho17
2244,yjjY,9280716,9280804,9280716,88,488,utRho17
2245,yjjZ,9211554,9211608,9211554,54,55996,utRho17
2246,yjtD,9281676,9281884,9281676,208,144,utRho17
2247,ykfB,532454,532454,532174,280,13948,utRho17
2248,ykfI,527636,527636,527338,298,2776,utRho17
2249,ykgB,637050,637050,636638,412,378,utRho17
2250,ykgC,640430,640430,640002,428,98,utRho17
2251,ykgD,640232,640454,640232,222,0,utRho17
2252,ykgE,642962,643216,642962,254,514,utRho17
2253,ykgJ,608524,608524,608364,160,568,utRho17
2254,ykgL,623878,624224,623878,346,996,utRho17
2255,ykgM,625610,625610,625554,56,200,utRho17
2256,ykgR,626570,626570,626484,86,2,utRho17
2257,ylaC,958576,958576,958502,74,2500,utRho17
2258,yliE,1745938,1745958,1745938,20,52,utRho17
2259,ymcE,2103660,2103694,2103660,34,0,utRho17
2260,ymdA,2210450,2210828,2210450,378,132,utRho17
2261,ymdB,2211428,2211640,2211428,212,0,utRho17
2262,ymfD,2395322,2395322,2395064,258,832,utRho17
2263,ymfI,2402880,2402994,2402880,114,0,utRho17
2264,ymfJ,2404518,2404518,2404168,350,276,utRho17
2265,ymfK,2406176,2406176,2405866,310,34,utRho17
2266,ymfT,2405766,2406048,2405766,282,64,utRho17
2267,ymgE,2489110,2489456,2489110,346,1068,utRho17
2268,ymgF,2437628,2437966,2437628,338,158,utRho17
2269,ymiA,2670112,2670320,2670112,208,482,utRho17
2270,ymjA,2715620,2715620,2715336,284,1030,utRho17
2271,ynaI,2791946,2791946,2791844,102,334,utRho17
2272,ynaK,2850438,2850754,2850438,316,114,utRho17
2273,ynbA,2954924,2955242,2954924,318,492,utRho17
2274,yncD,3046552,3046552,3046130,422,60,utRho17
2275,yncE,3046454,3046614,3046454,160,8,utRho17
2276,yncG,3052456,3052494,3052456,38,772,utRho17
2277,yncL,3034492,3034492,3034388,104,216,utRho17
2278,yneE,3218364,3218364,3218044,320,120,utRho17
2279,yneF,3223748,3223748,3223708,40,2,utRho17
2280,yneJ,3229560,3229608,3229560,48,172,utRho17
2281,yneK,3231100,3231526,3231100,426,442,utRho17
2282,yneM,3245176,3245292,3245176,116,288,utRho17
2283,ynfA,3311398,3311398,3311346,52,112,utRho17
2284,ynfB,3311418,3311616,3311418,198,556,utRho17
2285,ynfC,3315094,3315094,3314914,180,98,utRho17
2286,ynfD,3314828,3315130,3314828,302,98,utRho17
2287,ynfE,3316006,3316138,3316006,132,120,utRho17
2288,ynfK,3334670,3334670,3334438,232,360,utRho17
2289,ynfL,3339304,3339304,3339184,120,0,utRho17
2290,ynfM,3339260,3339398,3339260,138,0,utRho17
2291,ynfN,3276598,3276598,3276218,380,78,utRho17
2292,ynfO,3273454,3273512,3273454,58,244,utRho17
2293,ynhG,3517890,3517890,3517450,440,138,utRho17
2294,yniA,3615158,3615592,3615158,434,336,utRho17
2295,yniB,3618526,3618526,3618466,60,52,utRho17
2296,yniC,3618652,3618760,3618652,108,34,utRho17
2297,yniD,3610202,3610330,3610202,128,258,utRho17
2298,ynjE,3678880,3678934,3678880,54,0,utRho17
2299,ynjF,3683222,3683222,3682806,416,442,utRho17
2300,ynjH,3684376,3684376,3684270,106,164,utRho17
2301,ynjI,3690022,3690022,3689742,280,146,utRho17
2302,yoaB,3786642,3786734,3786642,92,298,utRho17
2303,yoaC,3787932,3788146,3787932,214,156,utRho17
2304,yoaE,3803544,3803544,3803170,374,610,utRho17
2305,yoaF,3755444,3755444,3755064,380,1208,utRho17
2306,yoaH,3789866,3789866,3789462,404,964,utRho17
2307,yobB,3850418,3850880,3850418,462,838,utRho17
2308,yobF,3815586,3815586,3815182,404,324,utRho17
2309,yobH,3817800,3817850,3817800,50,676,utRho17
2310,yodB,4084352,4084736,4084352,384,974,utRho17
2311,yodC,4057008,4057008,4056740,268,330,utRho17
2312,yohC,4451358,4451358,4451262,96,140,utRho17
2313,yohD,4451526,4451602,4451526,76,26,utRho17
2314,yohJ,4460986,4461248,4460986,262,126,utRho17
2315,yohO,4431172,4431314,4431172,142,4,utRho17
2316,yojI,4617282,4617282,4617230,52,0,utRho17
2317,ypdI,4988988,4989396,4988988,408,80,utRho17
2318,ypfG,5165786,5165786,5165554,232,166,utRho17
2319,ypfM,5182140,5182140,5181732,408,1834,utRho17
2320,yphB,5349590,5349590,5349376,214,204,utRho17
2321,ypjA,5565644,5565644,5565452,192,1232,utRho17
2322,ypjB,5569636,5569636,5568858,778,16,utRho17
2323,ypjD,5495860,5495774,5495860,86,0,utRho17
2324,yqaE,5594170,5594170,5594056,114,802,utRho17
2325,yqcA,5846100,5846100,5845968,132,226,utRho17
2326,yqcE,5800944,5801184,5800944,240,90,utRho17
2327,yqeC,6030468,6030468,6030114,354,1384,utRho17
2328,yqeF,5971618,5971618,5971184,434,1250,utRho17
2329,yqeG,5971438,5971694,5971438,256,2236,utRho17
2330,yqeH,5975016,5975072,5975016,56,3574,utRho17
2331,yqeI,5976688,5977004,5976688,316,170,utRho17
2332,yqeK,5981140,5981140,5980720,420,2728,utRho17
2333,yqfA,6086728,6086728,6086296,432,564,utRho17
2334,yqgA,6219042,6219106,6219042,64,0,utRho17
2335,yqgB,6172500,6172500,6172102,398,2460,utRho17
2336,yqgE,6185768,6185874,6185768,106,442,utRho17
2337,yqhA,6299150,6299150,6298942,208,56,utRho17
2338,yqhC,6310768,6310768,6310436,332,620,utRho17
2339,yqhD,6310604,6310710,6310604,106,364,utRho17
2340,yqhH,6316842,6317254,6316842,412,794,utRho17
2341,yqiC,6369662,6369680,6369662,18,158,utRho17
2342,yqiJ,6384108,6384416,6384108,308,638,utRho17
2343,yqjA,6495096,6495546,6495096,450,6926,utRho17
2344,yqjF,6500932,6501124,6500932,192,886,utRho17
2345,yqjG,6501948,6502048,6501948,100,20,utRho17
2346,yqjH,6433078,6433078,6432982,96,0,utRho17
2347,yqjI,6433506,6433558,6433506,52,0,utRho17
2348,yraH,6574552,6574852,6574552,300,218,utRho17
2349,yraP,6592144,6592818,6592144,674,462,utRho17
2350,yraQ,6596414,6596414,6596276,138,52,utRho17
2351,yraR,6598024,6598024,6597692,332,580,utRho17
2352,yrbG,13360844,13361100,13360844,256,0,utRho17
2353,yrbL,6696842,6696904,6696842,62,1314,utRho17
2354,yrbN,6616172,6616172,6615866,306,3904,utRho17
2355,yrdB,6860176,6860176,6860046,130,92,utRho17
2356,yrfF,7052548,7052938,7052548,390,1156,utRho17
2357,yrhB,7169440,7169518,7169440,78,0,utRho17
2358,ysaB,7451804,7451804,7451424,380,604,utRho17
2359,ysgA,8032686,8032686,8032338,348,806,utRho17
2360,ytfB,8857638,8857638,8857434,204,502,utRho17
2361,ytfE,8864018,8864018,8863966,52,320,utRho17
2362,ytfF,8866296,8866296,8866130,166,402,utRho17
2363,ytfH,8868164,8868226,8868164,62,468,utRho17
2364,ytfI,8875234,8875414,8875234,180,130,utRho17
2365,ytfJ,8878572,8878572,8878524,48,164,utRho17
2366,ytfK,8879022,8879174,8879022,152,648,utRho17
2367,ytfL,8882642,8882642,8882430,212,268,utRho17
2368,ytfQ,8899634,8899924,8899634,290,112,utRho17
2369,ytjB,9249598,9249598,9249578,20,136,utRho17
2370,yzfA,8896588,8896588,8896490,98,16,utRho17
2371,zapA,6111102,6111224,6111102,122,2326,utRho17
2372,zapB,8236772,8237030,8236772,258,308,utRho17
2373,zapC,2011700,2011904,2011700,204,20,utRho17
2374,zinT,4082692,4082750,4082692,58,252,utRho17
2375,zipA,5062814,5062814,5062466,348,70,utRho17
2376,zitB,1569716,1569716,1569646,70,62,utRho17
2377,zntA,7212844,7212902,7212844,58,164,utRho17
2378,zntR,6878336,6878336,6878260,76,24,utRho17
2379,znuA,3885322,3885322,3885166,156,216,utRho17
2380,znuC,3885268,3885324,3885268,56,128,utRho17
2381,zraP,8403424,8403424,8403376,48,98,utRho17
2382,zraS,8403810,8403852,8403810,42,0,utRho17
2383,zupT,6364866,6365100,6364866,234,2958,utRho17
2384,zur,8520282,8520282,8520006,276,954,utRho17
2385,zwf,3872752,3872752,3872628,124,128,utRho17
0,C0343,2818676,2818728,2818676,52,22,utRho18
1,aaeB,6776526,6776526,6776376,150,232,utRho18
2,aaeR,6778762,6779040,6778762,278,504,utRho18
3,aaeX,6778860,6778860,6778674,186,586,utRho18
4,aat,1854920,1854920,1854864,56,52,utRho18
5,accA,416822,417242,416822,420,3032,utRho18
6,accB,6810280,6810872,6810280,592,5976,utRho18
7,accD,4868030,4868030,4867852,178,56,utRho18
8,aceB,8430804,8430956,8430804,152,222,utRho18
9,aceE,245938,246034,245938,96,196,utRho18
10,ackA,4826918,4826940,4826918,22,426,utRho18
11,acnA,2670848,2671662,2670848,814,370,utRho18
12,acnB,263038,263230,263038,192,322,utRho18
13,acpP,2303148,2303230,2303148,82,1030,utRho18
14,acpS,5402324,5402324,5401996,328,856,utRho18
15,acrA,971396,971396,971238,158,206,utRho18
16,acrB,969370,969370,968806,564,1646,utRho18
17,acrD,5174950,5175190,5174950,240,64,utRho18
18,acrE,6827404,6827728,6827404,324,444,utRho18
19,acrR,971398,971522,971398,124,0,utRho18
20,acrZ,1589502,1589546,1589502,44,60,utRho18
21,acs,8575190,8575190,8574742,448,814,utRho18
22,actP,8569870,8569870,8569804,66,0,utRho18
23,ada,4620854,4620854,4620810,44,0,utRho18
24,add,3404404,3404466,3404404,62,164,utRho18
25,ade,7687802,7687928,7687802,126,390,utRho18
26,adhE,2596826,2596826,2596242,584,0,utRho18
27,adhP,3107988,3107988,3107676,312,2314,utRho18
28,adiA,8681112,8681112,8681042,70,150,utRho18
29,adiC,8674404,8674404,8674062,342,704,utRho18
30,adiY,8676084,8676084,8675858,226,0,utRho18
31,adk,994278,994350,994278,72,1432,utRho18
32,adrA,807374,807406,807374,32,124,utRho18
33,aer,6438240,6438240,6438152,88,0,utRho18
34,aes,1000102,1000102,999946,156,750,utRho18
35,agaR,6557406,6557406,6557330,76,18,utRho18
36,agaS,6563778,6563952,6563778,174,186,utRho18
37,agp,2131118,2131170,2131118,52,62,utRho18
38,agrA,7296126,7296126,7296126,0,0,utRho18
39,agrB,7296588,7296588,7296588,0,0,utRho18
40,ahpC,1277386,1277890,1277386,504,690,utRho18
41,ahpF,1278004,1279506,1278004,1502,54278,utRho18
42,ahr,8992698,8992698,8992418,280,220,utRho18
43,aidB,8828494,8828550,8828494,56,0,utRho18
44,ais,4731512,4731512,4731240,272,76,utRho18
45,alaA,4814816,4815122,4814816,306,108,utRho18
46,alaC,4996798,4996798,4996590,208,0,utRho18
47,alaE,5598140,5598328,5598140,188,88,utRho18
48,alaS,5644180,5644180,5644022,158,4054,utRho18
49,alaW,5036612,5036612,5036462,150,0,utRho18
50,aldA,2976380,2976464,2976380,84,430,utRho18
51,aldB,7513070,7513070,7513022,48,618,utRho18
52,alkA,4295118,4295118,4295080,38,0,utRho18
53,alkB,4618890,4618890,4618682,208,140,utRho18
54,allA,1064780,1064902,1064780,122,66,utRho18
55,allD,1092822,1092822,1092726,96,0,utRho18
56,allE,1088112,1088112,1088092,20,92,utRho18
57,allS,1064600,1064600,1064442,158,266,utRho18
58,alr,8531178,8531564,8531178,386,2308,utRho18
59,alsE,8617334,8617334,8616956,378,368,utRho18
60,alsK,8615990,8615990,8615598,392,906,utRho18
61,alx,6476740,6477160,6476740,420,64,utRho18
62,amiA,5104482,5104704,5104482,222,48,utRho18
63,amiC,5898378,5898378,5898020,358,380,utRho18
64,amn,4110062,4110122,4110062,60,0,utRho18
65,ampC,8758006,8758006,8757888,118,108,utRho18
66,ampD,237362,237466,237362,104,348,utRho18
67,ampG,907372,907372,907090,282,402,utRho18
68,ampH,792726,792726,792574,152,68,utRho18
69,amyA,4012230,4012312,4012230,82,72,utRho18
70,anmK,3439346,3439346,3439204,142,36,utRho18
71,ansB,6201580,6201580,6201456,124,140,utRho18
72,ansP,3052040,3052040,3051960,80,150,utRho18
73,apaG,104068,104068,103212,856,4356,utRho18
74,apaH,102586,102586,102444,142,3856,utRho18
75,apbE,4623188,4623188,4623068,120,0,utRho18
76,appA,2081198,2081234,2081198,36,0,utRho18
77,appC,2075420,2075480,2075420,60,36,utRho18
78,appY,1167134,1167362,1167134,228,134,utRho18
79,apt,982620,982824,982620,204,98,utRho18
80,aqpZ,1832424,1832424,1832094,330,184,utRho18
81,araB,140150,140150,140096,54,0,utRho18
82,araC,140482,140774,140482,292,782,utRho18
83,araE,5964416,5964416,5964364,52,56,utRho18
84,araF,3972476,3972476,3972256,220,60,utRho18
85,araH,3967120,3967120,3967086,34,286,utRho18
86,araJ,825058,825058,824962,96,642,utRho18
87,arcA,9281602,9281602,9280612,990,5238,utRho18
88,arcB,6706098,6706098,6706050,48,258,utRho18
89,arcZ,6701154,6701154,6701154,0,0,utRho18
90,arfA,6877346,6877346,6877298,48,712,utRho18
91,argA,5898312,5898484,5898312,172,190,utRho18
92,argC,8309770,8310002,8309770,232,36,utRho18
93,argD,6980442,6980442,6980360,82,284,utRho18
94,argE,8310156,8310156,8309694,462,112,utRho18
95,argF,580680,580680,580610,70,0,utRho18
96,argG,6637124,6637274,6637124,150,160,utRho18
97,argI,8956688,8956688,8956622,66,362,utRho18
98,argO,6137672,6137672,6137616,56,306,utRho18
99,argP,6119460,6119506,6119460,46,460,utRho18
100,argR,6769204,6769406,6769204,202,146,utRho18
101,argS,3920002,3920124,3920002,122,68,utRho18
102,argT,4855698,4855698,4855582,116,42,utRho18
103,argU,1129406,1129446,1129406,40,2,utRho18
104,argW,4932616,4932618,4932616,2,54,utRho18
105,argX,7964728,7964750,7964728,22,72,utRho18
106,aroF,5482402,5482402,5482300,102,72,utRho18
107,aroG,1571182,1571266,1571182,84,204,utRho18
108,aroH,3576636,3576870,3576636,234,450,utRho18
109,aroK,7038760,7038760,7038128,632,748,utRho18
110,aroL,812560,812810,812560,250,838,utRho18
111,aroP,243342,243342,243102,240,82,utRho18
112,arpA,8445382,8445382,8444974,408,62,utRho18
113,arrS,7316108,7316108,7316108,0,0,utRho18
114,arsR,7297024,7297056,7297024,32,98,utRho18
115,artJ,1801252,1801252,1801150,102,30,utRho18
116,artP,1807686,1807686,1807468,218,1304,utRho18
117,ascF,5678858,5679048,5678858,190,0,utRho18
118,ascG,5678574,5678574,5678528,46,132,utRho18
119,aslB,7965562,7965916,7965562,354,2230,utRho18
120,asnA,7854258,7854310,7854258,52,224,utRho18
121,asnB,1398444,1398444,1398354,90,1464,utRho18
122,asnC,23562186,23562186,23562018,168,432,utRho18
123,asnS,1978088,1978088,1977970,118,8322,utRho18
124,asnT,4089082,4089098,4089082,16,272,utRho18
125,asnU,4119690,4119702,4119690,12,18,utRho18
126,asnV,4124504,4124520,4124504,16,260,utRho18
127,aspA,17473728,17473728,17473308,420,508,utRho18
128,aspC,1971486,1971486,1971418,68,482,utRho18
129,aspS,3901402,3901402,3901044,358,368,utRho18
130,aspT,7893560,7893744,7893560,184,276396,utRho18
131,aspV,473826,473862,473826,36,226,utRho18
132,asr,3342654,3342752,3342654,98,56,utRho18
133,astC,3664088,3664088,3663964,124,0,utRho18
134,astE,3654138,3654138,3653846,292,52,utRho18
135,atoD,4646824,4646894,4646824,70,776,utRho18
136,atpB,7844540,7844540,7844102,438,134,utRho18
137,atpC,7832118,7832118,7831944,174,1722,utRho18
138,atpI,7845050,7845050,7844880,170,0,utRho18
139,avtA,7479348,7479410,7479348,62,764,utRho18
140,azoR,2965982,2965982,2965720,262,274,utRho18
141,azuC,3976002,3976002,3975918,84,70,utRho18
142,bacA,6408350,6408350,6408262,88,420,utRho18
143,bamA,394052,395856,394052,1804,540,utRho18
144,bamB,5277950,5277950,5277304,646,496,utRho18
145,bamC,5198028,5198028,5197730,298,508,utRho18
146,bamD,5471922,5472292,5471922,370,4114,utRho18
147,bamE,5506972,5507210,5506972,238,618,utRho18
148,basS,8666954,8666954,8666544,410,954,utRho18
149,bax,7474468,7474468,7474354,114,140,utRho18
150,bcp,5200874,5200956,5200874,82,968,utRho18
151,bcsB,7385346,7385346,7385214,132,0,utRho18
152,bcsE,7392644,7392916,7392644,272,52,utRho18
153,bdcA,8948128,8948128,8948106,22,1674,utRho18
154,bdcR,8948192,8948248,8948192,56,862,utRho18
155,bdm,3112680,3112680,3112560,120,118,utRho18
156,betA,654522,654522,654494,28,34,utRho18
157,betI,658722,658722,658668,54,30,utRho18
158,betT,658842,658926,658842,84,106,utRho18
159,bfr,6933498,6933498,6933450,48,16,utRho18
160,bglG,23440182,23440182,23439402,780,216,utRho18
161,bglX,4444240,4444240,4443978,262,52,utRho18
162,bhsA,2337962,2338146,2337962,184,108,utRho18
163,bioA,1618584,1618584,1618514,70,4,utRho18
164,bioB,1618604,1618688,1618604,84,0,utRho18
165,bioH,7089716,7089716,7089688,28,100,utRho18
166,bisC,7433026,7433026,7432788,238,56,utRho18
167,blc,8755490,8755490,8755444,46,0,utRho18
168,blr,3409024,3409102,3409024,78,222,utRho18
169,bluF,2431226,2431226,2430950,276,60,utRho18
170,bluR,2428226,2428226,2428118,108,112,utRho18
171,bolA,908698,908944,908698,246,56,utRho18
172,borD,1157842,1157842,1157786,56,78,utRho18
173,brnQ,838976,839182,838976,206,936,utRho18
174,bssR,1756492,1756496,1756492,4,0,utRho18
175,bssS,2242116,2242116,2241910,206,222,utRho18
176,btuB,8326798,8327278,8326798,480,2790,utRho18
177,cadB,8720212,8720212,8720062,150,62,utRho18
178,cadC,8723926,8723926,8723868,58,0,utRho18
179,caiE,70998,70998,70742,256,240,utRho18
180,caiF,68436,68600,68436,164,490,utRho18
181,caiT,84074,84074,83862,212,58,utRho18
182,can,285406,285406,285340,66,116,utRho18
183,carA,59102,59302,59102,200,150,utRho18
184,carB,61550,61634,61550,84,50,utRho18
185,cas2,5757830,5757830,5757706,124,248,utRho18
186,casA,5768638,5768638,5768276,362,0,utRho18
187,cbl,4121882,4121882,4121828,54,1466,utRho18
188,cbpA,2128074,2128074,2127550,524,640,utRho18
189,cbrA,7738628,7738754,7738628,126,204,utRho18
190,cbrB,7794958,7795012,7794958,54,250,utRho18
191,ccmH,4585242,4585242,4584820,422,140,utRho18
192,cdaR,364894,364926,364894,32,88,utRho18
193,cdd,4463638,4463688,4463638,50,0,utRho18
194,cdh,8219814,8219860,8219814,46,792,utRho18
195,cdsA,391110,391354,391110,244,446,utRho18
196,cedA,3627484,3627484,3627326,158,566,utRho18
197,cfa,3482402,3482826,3482402,424,734,utRho18
198,chaC,2544844,2544972,2544844,128,150,utRho18
199,chbB,3643452,3643452,3643238,214,100,utRho18
200,chbG,3634624,3634624,3634270,354,170,utRho18
201,cheW,3946924,3946924,3946678,246,584,utRho18
202,chiA,6939792,6939792,6939706,86,82,utRho18
203,chiP,1416472,1416668,1416472,196,0,utRho18
204,cho,3646984,3647030,3646984,46,220,utRho18
205,chpS,8896804,8896894,8896804,90,108,utRho18
206,cirA,4493884,4493884,4493538,346,124,utRho18
207,citC,1304078,1304078,1303712,366,76,utRho18
208,citT,1293264,1293264,1293160,104,0,utRho18
209,clcA,350104,350214,350104,110,0,utRho18
210,clpA,1846160,1846528,1846160,368,68,utRho18
211,clpB,5468410,5468410,5468346,64,622,utRho18
212,clpP,913154,913354,913154,200,140,utRho18
213,clpS,1845500,1845826,1845500,326,66,utRho18
214,clpX,914404,914852,914404,448,1642,utRho18
215,clsA,2617346,2617346,2617290,56,238,utRho18
216,clsC,2212584,2212710,2212584,126,166,utRho18
217,cmk,1922330,1922402,1922330,72,0,utRho18
218,cnu,3409522,3409898,3409522,376,930,utRho18
219,coaA,8350214,8350214,8350052,162,740,utRho18
220,cobC,1340092,1340092,1339814,278,204,utRho18
221,cobT,4129202,4129202,4128934,268,144,utRho18
222,cobU,4131944,4131944,4131528,416,514,utRho18
223,codB,709768,709844,709768,76,410,utRho18
224,comR,2337726,2337726,2337664,62,0,utRho18
225,copA,1022822,1022822,1022758,64,52,utRho18
226,corA,8002388,8002852,8002388,464,16836,utRho18
227,cpdB,8873258,8873258,8873130,128,210,utRho18
228,cptB,6082198,6082198,6082140,58,104,utRho18
229,cpxA,8210202,8210202,8209950,252,242,utRho18
230,cpxP,8211570,8211640,8211570,70,180,utRho18
231,cpxR,8211372,8211372,8211340,32,0,utRho18
232,cra,175894,176056,175894,162,120,utRho18
233,crcB,1316016,1316016,1315876,140,250,utRho18
234,creA,9270486,9271042,9270486,556,910,utRho18
235,creD,9276320,9276356,9276320,36,474,utRho18
236,crl,515620,515658,515620,38,1028,utRho18
237,crp,6971906,6972240,6971906,334,2486,utRho18
238,crr,5070960,5071668,5070960,708,1826,utRho18
239,csdA,5886414,5886674,5886414,260,160,utRho18
240,csgB,2207718,2207902,2207718,184,0,utRho18
241,csgD,2206688,2206688,2206392,296,254,utRho18
242,csgG,2203510,2203510,2203368,142,156,utRho18
243,csiD,5577854,5577970,5577854,116,120,utRho18
244,csiE,5330802,5330870,5330802,68,174,utRho18
245,csiR,5590942,5591348,5590942,406,162,utRho18
246,cspA,7439778,7440098,7439778,320,11066,utRho18
247,cspB,3283430,3283430,3283108,322,40,utRho18
248,cspC,3815018,3815018,3814870,148,1206,utRho18
249,cspD,1845352,1845352,1845180,172,6548,utRho18
250,cspE,1314294,1314584,1314294,290,140,utRho18
251,cspF,3283380,3283710,3283380,330,8,utRho18
252,cspG,2102610,2102922,2102610,312,602,utRho18
253,cspH,2102746,2102746,2102350,396,0,utRho18
254,cspI,3277624,3277624,3277334,290,0,utRho18
255,csrA,5638746,5638746,5638292,454,686,utRho18
256,csrB,5849048,5849048,5849048,0,0,utRho18
257,csrC,8102072,8102072,8102072,0,0,utRho18
258,csrD,6806850,6806850,6806664,186,146,utRho18
259,cstA,1259710,1259788,1259710,78,0,utRho18
260,cueO,274090,274166,274090,76,0,utRho18
261,cueR,1027948,1027986,1027948,38,0,utRho18
262,curA,3037784,3038054,3037784,270,684,utRho18
263,cusC,1191146,1191200,1191146,54,206,utRho18
264,cusR,1190924,1190924,1190886,38,248,utRho18
265,cutA,8730784,8730784,8730712,72,1484,utRho18
266,cutC,3918534,3918534,3917920,614,756,utRho18
267,cvpA,4861600,4861600,4861526,74,98,utRho18
268,cvrA,2484328,2484328,2484142,186,154,utRho18
269,cyaA,7981548,7982306,7981548,758,1012,utRho18
270,cyaR,4334228,4334224,4334228,4,52,utRho18
271,cyaY,7988166,7988166,7988118,48,82,utRho18
272,cybB,2981522,2981804,2981522,282,714,utRho18
273,cycA,8859560,8859728,8859560,168,1222,utRho18
274,cydA,1542340,1542916,1542340,576,18,utRho18
275,cydC,1858800,1858800,1858390,410,36,utRho18
276,cydD,1862062,1862062,1861924,138,32,utRho18
277,cydX,1548300,1548392,1548300,92,440,utRho18
278,cynR,717418,717418,717380,38,32,utRho18
279,cynT,1435092,1435196,1435092,104,0,utRho18
280,cyoA,903306,903306,903220,86,1966,utRho18
281,cyoE,895540,895540,895410,130,84,utRho18
282,cysB,2667576,2667710,2667576,134,182,utRho18
283,cysC,5748056,5748056,5747984,72,424,utRho18
284,cysD,5752736,5752736,5752658,78,16,utRho18
285,cysE,7565362,7565362,7565124,238,1870,utRho18
286,cysG,6995508,6995656,6995508,148,714,utRho18
287,cysJ,5783928,5783928,5783796,132,1604,utRho18
288,cysK,5064688,5064818,5064688,130,590,utRho18
289,cysP,5087114,5087114,5087056,58,444,utRho18
290,cysS,1109154,1109222,1109154,68,184,utRho18
291,cysT,3984100,3984100,3983974,126,608,utRho18
292,cysZ,5062766,5062926,5062766,160,0,utRho18
293,cytR,8249018,8249018,8248912,106,0,utRho18
294,dacA,1328002,1328002,1327926,76,244,utRho18
295,dacB,6657714,6657926,6657714,212,174,utRho18
296,dacC,1761306,1761454,1761306,148,680,utRho18
297,dadA,2475018,2475142,2475018,124,0,utRho18
298,dam,7032504,7032504,7031826,678,1404,utRho18
299,damX,7035200,7035200,7034612,588,140,utRho18
300,dapA,5199568,5199568,5199520,48,0,utRho18
301,dapB,56576,56748,56576,172,450,utRho18
302,dapD,371954,371954,371894,60,224,utRho18
303,dapE,5183120,5183214,5183120,94,1044,utRho18
304,dcp,3254844,3254844,3254760,84,42,utRho18
305,dcrB,7219534,7219910,7219534,376,484,utRho18
306,dctA,7366996,7366996,7366894,102,686,utRho18
307,dcuA,8733686,8733686,8733546,140,0,utRho18
308,dcuB,8698182,8698182,8697488,694,3526,utRho18
309,dcuC,1312166,1312166,1311936,230,488,utRho18
310,dcuD,6749166,6749738,6749166,572,254,utRho18
311,dcuR,8701130,8701130,8700068,1062,558,utRho18
312,dcuS,8703370,8703370,8703324,46,836,utRho18
313,dcyD,3999016,3999016,3998960,56,0,utRho18
314,ddpX,3126498,3126498,3126152,346,782,utRho18
315,deaD,6615818,6615818,6615720,98,1086,utRho18
316,dedA,4869880,4869880,4869482,398,4372,utRho18
317,dedD,4863750,4863750,4863368,382,0,utRho18
318,def,6867300,6867380,6867300,80,128,utRho18
319,degP,361690,361768,361690,78,0,utRho18
320,degQ,6761308,6761486,6761308,178,2292,utRho18
321,deoB,9239134,9239206,9239134,72,18,utRho18
322,deoC,9233358,9234646,9233358,1288,746,utRho18
323,dfp,7625406,7625462,7625406,56,0,utRho18
324,dgcZ,3247758,3247758,3247700,58,0,utRho18
325,dgkA,8512914,8513274,8512914,360,546,utRho18
326,dgt,358392,358474,358392,82,766,utRho18
327,dhaK,2501888,2501888,2501676,212,130,utRho18
328,dhaR,2502006,2502132,2502006,126,96,utRho18
329,dicB,3299194,3299218,3299194,24,0,utRho18
330,dicC,3295752,3295752,3295700,52,0,utRho18
331,dinB,501760,501796,501760,36,0,utRho18
332,dinD,7635398,7635520,7635398,122,272,utRho18
333,dinG,1666146,1666140,1666146,6,0,utRho18
334,dinI,2243018,2243018,2242974,44,188,utRho18
335,dinJ,493230,493230,493004,226,124,utRho18
336,dinQ,7295964,7295964,7295576,388,920,utRho18
337,djlA,114536,114728,114536,192,186,utRho18
338,dkgA,6313142,6313246,6313142,104,168,utRho18
339,dkgB,458196,458334,458196,138,0,utRho18
340,dksA,321502,321502,321208,294,1642,utRho18
341,dld,4444164,4444370,4444164,206,124,utRho18
342,dmlA,3763424,3763824,3763424,400,412,utRho18
343,dmlR,3763710,3763710,3763618,92,132,utRho18
344,dmsA,1881646,1881918,1881646,272,0,utRho18
345,dnaA,7767922,7767922,7767458,464,1754,utRho18
346,dnaB,8528566,8528628,8528566,62,138,utRho18
347,dnaK,24096,24326,24096,230,4584,utRho18
348,dnaN,7765466,7765466,7764642,824,1112,utRho18
349,dnaQ,471868,472134,471868,266,1820,utRho18
350,dnaT,18406460,18406460,18406068,392,6048,utRho18
351,dnaX,984112,984184,984112,72,1092,utRho18
352,dosP,3131486,3131486,3131466,20,178,utRho18
353,dpiB,1303968,1304470,1303968,502,38,utRho18
354,dppA,7415740,7415740,7415410,330,2450,utRho18
355,dps,1697900,1697900,1697822,78,18,utRho18
356,dsbA,8086754,8086836,8086754,82,792,utRho18
357,dsbB,2466294,2466294,2466060,234,188,utRho18
358,dsbC,6079266,6079266,6077644,1622,1168,utRho18
359,dsbG,1277600,1277600,1277146,454,216,utRho18
360,dsdA,4958242,4958404,4958242,162,194,utRho18
361,dsdC,4955492,4955492,4955258,234,86,utRho18
362,dsdX,4955642,4955694,4955642,52,46,utRho18
363,dsrA,4050626,4050626,4050626,0,0,utRho18
364,dsrB,4049686,4049686,4049646,40,346,utRho18
365,dtpD,1485340,1485340,1485112,228,240,utRho18
366,dusA,8523200,8523338,8523200,138,2360,utRho18
367,dusB,6820492,6820560,6820492,68,108,utRho18
368,dusC,4460790,4460790,4460770,20,0,utRho18
369,dut,7627704,7627864,7627704,160,482,utRho18
370,dxr,386670,387042,386670,372,456,utRho18
371,ebgA,6445102,6445266,6445102,164,300,utRho18
372,ebgR,6442874,6442932,6442874,58,146,utRho18
373,ecnB,8753018,8753106,8753018,88,758,utRho18
374,eco,4607594,4607810,4607594,216,0,utRho18
375,ecpA,621594,621594,621342,252,498,utRho18
376,ecpB,620238,620238,620052,186,242,utRho18
377,ecpR,622964,622964,622672,292,148,utRho18
378,eda,3866218,3866218,3865512,706,0,utRho18
379,edd,3869426,3869426,3869208,218,116,utRho18
380,efeO,2164308,2164486,2164308,178,0,utRho18
381,efeU_1,2162614,2162712,2162614,98,214,utRho18
382,efp,8751134,8751398,8751134,264,1820,utRho18
383,elaA,4763372,4763372,4763086,286,180,utRho18
384,elaD,4765308,4765426,4765308,118,0,utRho18
385,elfA,1995530,1995736,1995530,206,0,utRho18
386,elfD,1996642,1996980,1996642,338,110,utRho18
387,emrD,7707690,7707844,7707690,154,148,utRho18
388,emrK,4966896,4966896,4966678,218,0,utRho18
389,emrY,4964668,4964668,4964352,316,282,utRho18
390,emtA,2486250,2486360,2486250,110,26,utRho18
391,endA,12361100,12361388,12361100,288,172,utRho18
392,eno,5817692,5817692,5815882,1810,5734,utRho18
393,entC,1249662,1249770,1249662,108,0,utRho18
394,entD,1220508,1220508,1220158,350,10,utRho18
395,entH,1258584,1258600,1258584,16,18,utRho18
396,entS,1244506,1244600,1244506,94,212,utRho18
397,envR,6827266,6827266,6826930,336,0,utRho18
398,epd,12295292,12295292,12294764,528,132,utRho18
399,epmA,8765236,8765286,8765236,50,56,utRho18
400,epmB,8751406,8751406,8751314,92,970,utRho18
401,eptB,7421162,7421162,7420950,212,130,utRho18
402,eptC,8300622,8300622,8300530,92,882,utRho18
403,erfK,4126708,4126708,4126646,62,172,utRho18
404,erpA,353122,353220,353122,98,58,utRho18
405,esrE,8039956,8039956,8039956,0,0,utRho18
406,essD,1153746,1154796,1153746,1050,2188,utRho18
407,etk,2088606,2088606,2088420,186,2062,utRho18
408,evgA,4967262,4967510,4967262,248,116,utRho18
409,exbB,6304028,6304028,6303968,60,0,utRho18
410,exbD,6302780,6302780,6302486,294,296,utRho18
411,exuR,6493016,6493304,6493016,288,326,utRho18
412,exuT,6490004,6490208,6490004,204,0,utRho18
413,fabA,2032996,2032996,2032940,56,0,utRho18
414,fabB,4883282,4883282,4883210,72,4,utRho18
415,fabH,2297032,2297518,2297032,486,2618,utRho18
416,fabI,2702236,2702236,2702078,158,64,utRho18
417,fadB,8062026,8062026,8061942,84,0,utRho18
418,fadD,3779614,3779614,3779492,122,0,utRho18
419,fadE,486812,486812,486606,206,136,utRho18
420,fadH,6463248,6463330,6463248,82,502,utRho18
421,fadI,4921022,4921022,4920938,84,218,utRho18
422,fadL,4922410,4922600,4922410,190,160,utRho18
423,fadM,928720,928804,928720,84,0,utRho18
424,fadR,2469810,2469876,2469810,66,0,utRho18
425,fbaB,4357334,4357334,4357128,206,140,utRho18
426,fdhE,8162722,8162722,8162456,266,1840,utRho18
427,fdhF,8598814,8598814,8598732,82,378,utRho18
428,fdnG,3094744,3094802,3094744,58,0,utRho18
429,fdrA,1093012,1093360,1093012,348,184,utRho18
430,feaB,2894994,2895038,2894994,44,0,utRho18
431,feaR,2894734,2894734,2894566,168,0,utRho18
432,fecA,9033454,9033454,9033354,100,0,utRho18
433,fecE,9023288,9023288,9022914,374,1408,utRho18
434,fecI,9036564,9036564,9036470,94,390,utRho18
435,feoA,7080114,7080326,7080114,212,278,utRho18
436,fepA,1225334,1225334,1224988,346,6,utRho18
437,fepB,1249454,1249454,1249020,434,174,utRho18
438,fepD,1244468,1244468,1244378,90,0,utRho18
439,fes,1225374,1225630,1225374,256,52,utRho18
440,ffh,5495706,5495706,5495590,116,376,utRho18
441,ffs,952576,952848,952576,272,1260,utRho18
442,fhuA,334884,334968,334884,84,466,utRho18
443,fhuE,2323294,2323294,2323102,192,26,utRho18
444,fhuF,9211504,9211504,9211326,178,50930,utRho18
445,fic,6983296,6983296,6982926,370,2028,utRho18
446,fieF,8212864,8212938,8212864,74,0,utRho18
447,fimA,9085388,9086230,9085388,842,1250,utRho18
448,fimB,9081334,9081914,9081334,580,2940,utRho18
449,fimE,9083742,9084074,9083742,332,1986,utRho18
450,fimZ,1129214,1129214,1128960,254,0,utRho18
451,fiu,1683296,1683296,1683062,234,60,utRho18
452,fixA,84650,84806,84650,156,0,utRho18
453,fkpA,6955050,6955050,6954838,212,3016,utRho18
454,fldA,2846084,2846084,2845860,224,2436,utRho18
455,fldB,6079644,6079710,6079644,66,226,utRho18
456,flgA,2261770,2261770,2261726,44,734,utRho18
457,flgB,2261986,2262036,2261986,50,16,utRho18
458,flgK,2276702,2276756,2276702,54,306,utRho18
459,flgM,2260330,2260330,2260256,74,214,utRho18
460,flgN,2259828,2259828,2259660,168,22,utRho18
461,flhB,3932432,3932432,3932382,50,52,utRho18
462,flhC,3955864,3955864,3955688,176,132,utRho18
463,flhD,3957154,3957154,3956394,760,1870,utRho18
464,fliA,4003638,4003638,4003578,60,84,utRho18
465,fliC,4007352,4007352,4007212,140,76,utRho18
466,fliD,4007634,4007744,4007634,110,608,utRho18
467,fliE,4026186,4026186,4026028,158,674,utRho18
468,fliF,4026292,4026458,4026292,166,494,utRho18
469,fliL,4039168,4039236,4039168,68,84,utRho18
470,flk,4875824,4875900,4875824,76,366,utRho18
471,flu,4142634,4143078,4142634,444,144,utRho18
472,flxA,3292776,3292810,3292776,34,96,utRho18
473,fnr,2799104,2799104,2799052,52,52,utRho18
474,fnrS,2818258,2818258,2818258,0,0,utRho18
475,focA,1909628,1909628,1908932,696,1906,utRho18
476,folA,99598,99646,99598,48,128,utRho18
477,folB,6409296,6409296,6409178,118,0,utRho18
478,folD,1115562,1115562,1115482,80,304,utRho18
479,folE,4487696,4487696,4487304,392,2054,utRho18
480,fpr,8228998,8228998,8228944,54,118,utRho18
481,frc,4986878,4986878,4986508,370,324,utRho18
482,frdA,8764824,8764824,8764636,188,128,utRho18
483,frdD,8758948,8758948,8758732,216,3112,utRho18
484,fre,8052886,8053054,8052886,168,1074,utRho18
485,frlA,6999518,6999820,6999518,302,282,utRho18
486,frr,385624,385744,385624,120,726,utRho18
487,frsA,513004,513054,513004,50,150,utRho18
488,fruB,4527194,4527194,4526990,204,84,utRho18
489,frvR,8179804,8179804,8179710,94,32,utRho18
490,fryA,5008986,5008986,5008970,16,276,utRho18
491,fsaA,1727060,1727284,1727060,224,390,utRho18
492,fsr,1009710,1009710,1009392,318,454,utRho18
493,ftnA,3977364,3977432,3977364,68,0,utRho18
494,ftnB,3973550,3973850,3973550,300,372,utRho18
495,ftsA,207122,207964,207122,842,904,utRho18
496,ftsB,5745802,5745802,5745640,162,1064,utRho18
497,ftsH,6654204,6654204,6653870,334,636,utRho18
498,ftsK,1865858,1866448,1865858,590,942,utRho18
499,ftsL,181376,182064,181376,688,1420,utRho18
500,ftsP,6325732,6325732,6325338,394,186,utRho18
501,ftsQ,205484,206310,205484,826,946,utRho18
502,ftsX,7204512,7204512,7204172,340,404,utRho18
503,ftsZ,209272,210610,209272,1338,504,utRho18
504,fucA,5867708,5867708,5867376,332,2454,utRho18
505,fucP,5868238,5868470,5868238,232,390,utRho18
506,fumA,6753760,6753760,6753508,252,4456,utRho18
507,fumB,8694696,8694696,8694652,44,278,utRho18
508,fumC,3373418,3373418,3373176,242,0,utRho18
509,fur,2842892,2842892,2842584,308,2840,utRho18
510,fusA,6947370,6947370,6947028,342,15250,utRho18
511,fxsA,8737206,8737328,8737206,122,1222,utRho18
512,gabD,5581824,5582546,5581824,722,2408,utRho18
513,gadA,7335214,7335214,7335160,54,48,utRho18
514,gadB,3144144,3144144,3144090,54,248,utRho18
515,gadC,3141168,3141168,3140978,190,330,utRho18
516,gadE,7315600,7316732,7315600,1132,792,utRho18
517,gadW,7329562,7329562,7329236,326,80,utRho18
518,gadX,14663356,14663356,14663240,116,1260,utRho18
519,gadY,7329728,7329728,7329728,0,0,utRho18
520,galE,1584354,1584354,1584110,244,0,utRho18
521,galF,4228702,4228702,4228654,48,0,utRho18
522,galM,1577796,1577796,1577674,122,28,utRho18
523,galP,6176510,6176568,6176510,58,0,utRho18
524,galR,5953138,5953198,5953138,60,0,utRho18
525,galS,4483420,4483420,4483336,84,0,utRho18
526,galU,2582810,2582914,2582810,104,360,utRho18
527,gapA,3724480,3725542,3724480,1062,5120,utRho18
528,garP,6549868,6549868,6549814,54,156,utRho18
529,gatY,4354468,4354468,4354408,60,50,utRho18
530,gatZ,4352864,4352864,4352642,222,13866,utRho18
531,gcd,282558,282558,282450,108,32,utRho18
532,gcl,1067814,1067832,1067814,18,0,utRho18
533,gcvA,5885278,5885278,5885134,144,0,utRho18
534,gcvB,5885392,5885392,5885392,0,0,utRho18
535,gcvR,5199758,5199812,5199758,54,336,utRho18
536,gcvT,6101544,6101544,6101334,210,1738,utRho18
537,gdhA,3684616,3684742,3684616,126,0,utRho18
538,gfcA,2099668,2099668,2099488,180,1296,utRho18
539,gfcD,2096236,2096236,2095890,346,1710,utRho18
540,ghrA,2195648,2195772,2195648,124,8,utRho18
541,ghrB,7434378,7434620,7434378,242,2922,utRho18
542,glcA,6242728,6242728,6242558,170,716,utRho18
543,glcC,6256412,6256544,6256412,132,232,utRho18
544,glcD,6256152,6256152,6256042,110,212,utRho18
545,gldA,8278092,8278092,8278070,22,0,utRho18
546,glgA,7136784,7136784,7136066,718,4504,utRho18
547,glgB,7147314,7147314,7147004,310,234,utRho18
548,glgC,7139142,7139142,7138656,486,1078,utRho18
549,glgP,7133546,7133546,7133162,384,2266,utRho18
550,glgS,6384024,6384024,6383878,146,44,utRho18
551,glgX,7142838,7142838,7142638,200,148,utRho18
552,glk,5018922,5018922,5018852,70,8,utRho18
553,glmS,7827622,7827622,7827336,286,1314,utRho18
554,glmU,7830652,7830652,7830400,252,142,utRho18
555,glmY,10765360,10765360,10765360,0,0,utRho18
556,glmZ,7972864,7972864,7972864,0,0,utRho18
557,glnA,16232888,16232888,16232136,752,96,utRho18
558,glnB,5375052,5375052,5374816,236,522,utRho18
559,glnD,377310,377310,377300,10,10,utRho18
560,glnE,6399602,6399602,6399282,320,116,utRho18
561,glnH,1696396,1696396,1696008,388,316,utRho18
562,glnK,945112,945196,945112,84,84,utRho18
563,glnL,8112742,8112742,8112678,64,0,utRho18
564,glnQ,1693262,1693262,1692926,336,312,utRho18
565,glnS,1411998,1412186,1411998,188,982,utRho18
566,gloA,3455602,3455674,3455602,72,66,utRho18
567,gloB,469852,469852,469564,288,952,utRho18
568,glpA,4705166,4705294,4705166,128,0,utRho18
569,glpD,7123942,7124026,7123942,84,74,utRho18
570,glpE,7123698,7123698,7123646,52,104,utRho18
571,glpF,8236322,8236322,8236180,142,880,utRho18
572,glpG,7122960,7122960,7122904,56,94,utRho18
573,glpR,7121782,7121782,7121210,572,1226,utRho18
574,glpT,4704902,4704902,4704748,154,264,utRho18
575,glpX,8231212,8231212,8231158,54,9378,utRho18
576,glrK,5382246,5382246,5382196,50,1126,utRho18
577,gltA,1509534,1509534,1508936,598,5144,utRho18
578,gltB,6709018,6709264,6709018,246,556,utRho18
579,gltI,1375792,1375792,1375494,298,1888,utRho18
580,gltP,8588536,8588962,8588536,426,1998,utRho18
581,gltS,7657382,7657382,7657330,52,882,utRho18
582,gltX,5041568,5041568,5041344,224,162,utRho18
583,gluQ,320286,320286,320224,62,578,utRho18
584,glyA,5371148,5371148,5371014,134,0,utRho18
585,glyQ,7450708,7450708,7450636,72,352,utRho18
586,glyS,7448990,7448990,7448794,196,994,utRho18
587,glyU,5998128,5998128,5998114,14,62,utRho18
588,glyV,8784626,8784720,8784626,94,306,utRho18
589,glyW,3984360,3984360,3984234,126,72,utRho18
590,gmhB,445612,445666,445612,54,0,utRho18
591,gmk,7642776,7642856,7642776,80,166,utRho18
592,gmr,2693686,2693686,2693484,202,730,utRho18
593,gnd,4202648,4202648,4202536,112,348,utRho18
594,gnsB,3275692,3275692,3275564,128,0,utRho18
595,gntK,14310580,14310580,14310368,212,1092,utRho18
596,gntP,9102668,9102668,9102592,76,388,utRho18
597,gntR,7157760,7157760,7157452,308,436,utRho18
598,gntT,7092810,7093118,7092810,308,1372,utRho18
599,gntU,7154170,7154170,7154122,48,70,utRho18
600,gntX,7089334,7089764,7089334,430,302,utRho18
601,gor,7292224,7292598,7292224,374,564,utRho18
602,gpmA,1575340,1575340,1575190,150,0,utRho18
603,gpmM,7570374,7570520,7570374,146,6,utRho18
604,gpsA,7567620,7567620,7567322,298,8004,utRho18
605,gpt,511828,511954,511828,126,998,utRho18
606,grcA,5433046,5433046,5432898,148,752,utRho18
607,greA,6657728,6657728,6657430,298,1282,utRho18
608,greB,7073488,7073624,7073488,136,18,utRho18
609,groL,8741566,8742050,8741566,484,6422,utRho18
610,groS,8741232,8741376,8741232,144,14498,utRho18
611,grpE,5501494,5501494,5501416,78,198,utRho18
612,grxA,1781552,1781552,1781506,46,22,utRho18
613,grxB,2248206,2248206,2248108,98,748,utRho18
614,grxC,7569152,7569152,7568884,268,3172,utRho18
615,grxD,3468324,3468324,3468202,122,796,utRho18
616,gspA,6911268,6911268,6910796,472,24,utRho18
617,gspC,6910964,6911156,6910964,192,10,utRho18
618,gss,6277220,6277220,6277044,176,96,utRho18
619,gstA,3428654,3428754,3428654,100,0,utRho18
620,gstB,1761038,1761038,1760960,78,72,utRho18
621,guaB,5268214,5268214,5268140,74,16,utRho18
622,gudD,5839026,5839026,5838770,256,222,utRho18
623,gyrA,4678914,4678914,4678840,74,0,utRho18
624,gyrB,7760300,7760300,7760238,62,86,utRho18
625,hcaE,5337964,5338064,5337964,100,1722,utRho18
626,hcaR,5337928,5337928,5337792,136,2600,utRho18
627,hcaT,5336106,5336106,5335692,414,964,utRho18
628,hchA,4071260,4071670,4071260,410,0,utRho18
629,hcp,1828258,1828258,1827628,630,1108,utRho18
630,hcr,1824400,1824400,1824300,100,40,utRho18
631,hdeA,7313582,7313582,7313480,102,70,utRho18
632,hdeD,7313920,7313990,7313920,70,316,utRho18
633,hdfR,7896320,7896320,7895934,386,362,utRho18
634,hdhA,3396244,3396244,3396080,164,16,utRho18
635,helD,2048876,2048942,2048876,66,0,utRho18
636,hemA,2527166,2527428,2527166,262,0,utRho18
637,hemB,779722,779722,779454,268,1204,utRho18
638,hemF,5106410,5106450,5106410,40,44,utRho18
639,hemH,996062,996110,996062,48,710,utRho18
640,hemL,349882,349882,349764,118,24,utRho18
641,hemN,8103886,8104090,8103886,204,146,utRho18
642,hepA,127176,127176,126528,648,2398,utRho18
643,hflD,2385372,2385372,2385262,110,114,utRho18
644,hfq,8799602,8800576,8799602,974,19196,utRho18
645,hha,961006,961006,960616,390,242,utRho18
646,hicA,3018442,3018572,3018442,130,42,utRho18
647,higA,6468682,6468682,6468288,394,1510,utRho18
648,higB,6468960,6468960,6468910,50,0,utRho18
649,hinT,2323642,2323770,2323642,128,0,utRho18
650,hipB,3184964,3184964,3184884,80,68,utRho18
651,hisB,4186720,4186936,4186720,216,610,utRho18
652,hisJ,4853674,4853674,4853576,98,138,utRho18
653,hisL,8359856,8359984,8359856,128,168,utRho18
654,hisS,5281284,5281284,5281150,134,312,utRho18
655,hlpA,400910,400964,400910,54,312,utRho18
656,hlyE,2460932,2460932,2460788,144,598,utRho18
657,hmp,5371594,5371670,5371594,76,8,utRho18
658,hns,2585916,2585916,2585844,72,304,utRho18
659,hofM,7045856,7045856,7045502,354,206,utRho18
660,hokA,7441620,7441620,7441200,420,1908,utRho18
661,hokC,33902,33902,33806,96,264,utRho18
662,hokE,1215462,1215672,1215462,210,136,utRho18
663,holC,8968546,8968546,8968560,14,626,utRho18
664,holD,9215562,9215606,9215562,44,0,utRho18
665,holE,3850040,3850216,3850040,176,2582,utRho18
666,hpt,282720,282862,282720,142,326,utRho18
667,hrpB,324150,324210,324150,60,44,utRho18
668,hscB,5319048,5319048,5318934,114,4264,utRho18
669,hscC,1367188,1367188,1366786,402,984,utRho18
670,hsdS,9163004,9163004,9162924,80,222,utRho18
671,hslJ,2883560,2883560,2883486,74,268,utRho18
672,hslO,7059344,7059548,7059344,204,8070,utRho18
673,hslR,7058220,7058696,7058220,476,2006,utRho18
674,hslV,8244708,8244708,8244574,134,458,utRho18
675,hsrA,7881412,7881412,7881224,188,260,utRho18
676,htgA,21286,21660,21286,374,14798,utRho18
677,htpG,989634,990240,989634,606,16512,utRho18
678,htpX,3825236,3825236,3825152,84,0,utRho18
679,htrE,311036,311036,310852,184,646,utRho18
680,htrL,7587668,7587668,7587366,302,286,utRho18
681,hupA,8400352,8400562,8400352,210,116,utRho18
682,hupB,1845220,1845804,1845220,584,532,utRho18
683,hyaA,2063968,2064278,2063968,310,16,utRho18
684,hybO,6292726,6292726,6292522,204,8272,utRho18
685,hycA,5700922,5700922,5700870,52,2,utRho18
686,hycI,5686204,5686204,5686086,118,944,utRho18
687,hydN,5676264,5676264,5676210,54,0,utRho18
688,hyfA,5202342,5202402,5202342,60,0,utRho18
689,hypA,11402508,11402588,11402508,80,88,utRho18
690,hypB,11403356,11404004,11403356,648,180,utRho18
691,hypF,5676210,5676210,5674850,1360,1574,utRho18
692,hypT,9116634,9116634,9116578,56,22,utRho18
693,hyuA,6019660,6020056,6019660,396,484,utRho18
694,iaaA,1733074,1733136,1733074,62,58,utRho18
695,iadA,9119074,9119074,9119052,22,854,utRho18
696,iap,5753072,5753162,5753072,90,42,utRho18
697,ibaG,6673966,6673966,6673606,360,232,utRho18
698,ibpA,7735036,7735036,7734844,192,3962,utRho18
699,ibpB,7733962,7733962,7733794,168,13252,utRho18
700,icd,2389922,2390246,2389922,324,450,utRho18
701,iclR,8447304,8447304,8447256,48,0,utRho18
702,idi,6065876,6066130,6065876,254,156,utRho18
703,idnD,8988870,8988870,8988812,58,52,utRho18
704,idnK,8989194,8989246,8989194,52,40,utRho18
705,ihfA,3591442,3591442,3591104,338,784,utRho18
706,ihfB,1927498,1927656,1927498,158,622,utRho18
707,ileS,43666,44782,43666,1116,3034,utRho18
708,ileX,6431194,6431196,6431194,2,54,utRho18
709,ilvA,15820940,15821324,15820940,384,880,utRho18
710,ilvC,7915824,7915940,7915824,116,52,utRho18
711,ilvE,15809552,15809936,15809552,384,764,utRho18
712,ilvI,170840,171260,170840,420,396,utRho18
713,ilvL,23701308,23701932,23701308,624,0,utRho18
714,ilvY,7915734,7915734,7915640,94,76,utRho18
715,inaA,4698998,4698998,4698944,54,264,utRho18
716,infA,1853370,1853370,1852886,484,770,utRho18
717,infC,3602692,3602692,3601276,1416,3614,utRho18
718,insA-5,3958452,3958452,3958430,22,62,utRho18
719,insA-7,9036758,9037054,9036758,296,1366,utRho18
720,insC-5,6372080,6372284,6372080,204,6332,utRho18
721,insEF-2,785238,785238,785820,582,2376,utRho18
722,insEF-4,2190310,2190310,2190892,582,2716,utRho18
723,insG,9007098,9007098,9006862,236,174,utRho18
724,insH-1,550596,550596,550234,362,10858,utRho18
725,insH-11,7306538,7306538,7306396,142,70,utRho18
726,insH-2,1151548,1151548,1151506,42,334,utRho18
727,insH-3,1378444,1378444,1378026,418,926,utRho18
728,insH-4,2791942,2792152,2791942,210,344,utRho18
729,insH-5,2857852,2857852,2857452,400,146,utRho18
730,insH-6,4135022,4135022,4134642,380,1178,utRho18
731,insH-7,4206186,4206186,4205822,364,2100,utRho18
732,insH-9,6260050,6260356,6260050,306,396,utRho18
733,insI-3,9017372,9017372,9017234,138,514,utRho18
734,insJ,7441188,7441360,7441188,172,612,utRho18
735,insK,7442130,7442308,7442130,178,42,utRho18
736,insL-1,30760,30890,30760,130,4160,utRho18
737,insL-2,1216112,1216130,1216112,18,170,utRho18
738,insL-3,5028644,5028662,5028644,18,210,utRho18
739,insN-1,540452,540484,540452,32,34,utRho18
740,intD,1132202,1132202,1131956,246,7196,utRho18
741,intR,2826520,2826520,2826470,50,244,utRho18
742,intS,4933026,4933090,4933026,64,3128,utRho18
743,intZ,5117386,5117542,5117386,156,1604,utRho18
744,iraD,9113152,9113986,9113152,834,336,utRho18
745,iraM,2424246,2424246,2424006,240,260,utRho18
746,iraP,802638,802772,802638,134,0,utRho18
747,iscA,5319924,5319924,5319772,152,834,utRho18
748,iscR,5324398,5324398,5324262,136,10848,utRho18
749,iscX,5313834,5313834,5313472,362,1840,utRho18
750,ispF,5743968,5743968,5743560,408,2546,utRho18
751,ispG,5283908,5283908,5283608,300,412,utRho18
752,ispU,389568,389806,389568,238,104,utRho18
753,isrA,2811502,2811502,2811618,116,68,utRho18
754,istr-1,7706384,7706384,7706384,0,0,utRho18
755,istr-2,7706514,7706514,7706514,0,0,utRho18
756,ivbL,15412092,15412092,15411952,140,624,utRho18
757,ivy,480638,480686,480638,48,4,utRho18
758,katE,3627628,3627734,3627628,106,586,utRho18
759,katG,8267624,8267670,8267624,46,34,utRho18
760,kbaZ,6557732,6557828,6557732,96,94,utRho18
761,kbl,7585154,7585154,7585102,52,1000,utRho18
762,kch,2621046,2621046,2620538,508,246,utRho18
763,kdgR,3820506,3820506,3820198,308,0,utRho18
764,kdpE,1443788,1443788,1443466,322,0,utRho18
765,kdpF,1457698,1457698,1457642,56,32,utRho18
766,kdsA,2535708,2536330,2535708,622,1972,utRho18
767,kdsC,6683438,6684546,6683438,1108,2596,utRho18
768,kduI,5968388,5968388,5968248,140,5906,utRho18
769,kefF,94160,94492,94160,332,1538,utRho18
770,kgtP,5451624,5451624,5451492,132,314,utRho18
771,kup,7862206,7862632,7862206,426,0,utRho18
772,lacI,735076,735076,735020,56,52,utRho18
773,lacZ,1465508,1465508,1465220,288,208,utRho18
774,ldcA,2486394,2486394,2486160,234,174,utRho18
775,ldhA,2885830,2885830,2885686,144,0,utRho18
776,ldrA,2538954,2538954,2538550,404,2286,utRho18
777,ldrB,2540024,2540024,2539620,404,968,utRho18
778,ldrC,2541092,2541092,2540690,402,554,utRho18
779,ldrD,7400544,7400544,7400174,370,1588,utRho18
780,lepA,5414392,5414392,5414248,144,164,utRho18
781,lepB,5410928,5410928,5410618,310,312,utRho18
782,leuD,159188,159188,158906,282,64,utRho18
783,leuE,3761600,3761600,3761518,82,28,utRho18
784,leuL,168048,168048,167416,632,172,utRho18
785,leuO,168308,168736,168308,428,188,utRho18
786,leuQ,9212864,9212864,9212802,62,130,utRho18
787,leuU,6644556,6644556,6644316,240,2184,utRho18
788,leuV,9212546,9212546,9212330,216,1092,utRho18
789,leuX,8992772,8992810,8992772,38,106,utRho18
790,lexA,8514174,8514230,8514174,56,286,utRho18
791,lhr,3456706,3458174,3456706,1468,2320,utRho18
792,ligA,5060402,5060402,5060352,50,0,utRho18
793,ligB,7642576,7642576,7642340,236,388,utRho18
794,lipA,1320602,1320602,1320432,170,364,utRho18
795,lipB,1324802,1324802,1324556,246,5214,utRho18
796,lit,2397032,2397390,2397032,358,1236,utRho18
797,livJ,7199524,7199524,7199316,208,722,utRho18
798,livK,7195510,7195510,7195120,390,210,utRho18
799,lldP,7554578,7554798,7554578,220,3836,utRho18
800,lnt,1381968,1381968,1381762,206,666,utRho18
801,loiP,6163784,6163826,6163784,42,0,utRho18
802,lolA,1874656,1874738,1874656,82,194,utRho18
803,lolB,2527112,2527112,2527000,112,0,utRho18
804,lolC,2350748,2350854,2350748,106,28,utRho18
805,lon,917630,917776,917630,146,300,utRho18
806,lpcA,486936,487086,486936,150,62,utRho18
807,lpd,255434,255824,255434,390,3292,utRho18
808,lplA,9248476,9248476,9248234,242,898,utRho18
809,lplT,5947878,5947878,5947724,154,58,utRho18
810,lpoA,6586422,6586800,6586422,378,88,utRho18
811,lpp,3514592,3514842,3514592,250,210,utRho18
812,lptA,6686598,6686760,6686598,162,588,utRho18
813,lptB,6686792,6687888,6686792,1096,1846,utRho18
814,lptD,114672,114672,114218,454,520,utRho18
815,lptF,8972244,8972436,8972244,192,76,utRho18
816,lpxC,213016,213114,213016,98,4384,utRho18
817,lpxD,401920,401942,401920,22,22,utRho18
818,lpxL,2233418,2233418,2233164,254,40,utRho18
819,lpxM,3880456,3880456,3880386,70,0,utRho18
820,lpxP,4991156,4991290,4991156,134,396,utRho18
821,lrhA,4813312,4813312,4813282,30,16,utRho18
822,lrp,1864656,1865190,1864656,534,1088,utRho18
823,lspA,50028,50414,50028,386,1392,utRho18
824,lsrA,3202920,3202980,3202920,60,0,utRho18
825,lsrR,3202514,3202514,3202482,32,0,utRho18
826,ltaE,1818640,1818640,1818588,52,0,utRho18
827,luxS,5630130,5630130,5629466,664,15974,utRho18
828,lysA,5957902,5957902,5957798,104,38,utRho18
829,lysC,8467232,8467232,8466466,766,784,utRho18
830,lysP,4497120,4497120,4497064,56,88,utRho18
831,lysR,5957900,5958042,5957900,142,98,utRho18
832,lysT,1561028,1561108,1561028,80,48,utRho18
833,lysU,8709610,8709610,8709434,176,290,utRho18
834,macB,1840188,1840694,1840188,506,718,utRho18
835,maeA,3111484,3111484,3111338,146,7730,utRho18
836,mak,820236,820288,820236,52,38,utRho18
837,malE,8492928,8492928,8492838,90,46,utRho18
838,malI,3398456,3398456,3398360,96,0,utRho18
839,malK,8493472,8493568,8493472,96,190,utRho18
840,malP,7105020,7105020,7104946,74,528,utRho18
841,malQ,7100798,7100798,7100140,658,262,utRho18
842,malS,14949880,14949988,14949880,108,44,utRho18
843,malT,7106048,7106170,7106048,122,184,utRho18
844,malX,3398626,3398710,3398626,84,0,utRho18
845,malZ,1689980,1690072,1689980,92,2288,utRho18
846,manA,3377102,3377152,3377102,50,56,utRho18
847,manX,3803866,3804096,3803866,230,152,utRho18
848,marC,3237882,3237882,3237816,66,186,utRho18
849,marR,3238186,3238240,3238186,54,354,utRho18
850,matP,2036918,2036970,2036918,52,0,utRho18
851,mazE,5822736,5822736,5822678,58,0,utRho18
852,mazG,5821720,5821720,5821370,350,2120,utRho18
853,mcbA,1684306,1684306,1684112,194,46,utRho18
854,mcbR,3040192,3040524,3040192,332,0,utRho18
855,mcrA,2420278,2420692,2420278,414,94,utRho18
856,mcrC,9156124,9156124,9155916,208,566,utRho18
857,mdaB,6344814,6345060,6344814,246,128,utRho18
858,mdfA,1767138,1767346,1767138,208,0,utRho18
859,mdh,6768940,6768940,6768536,404,188,utRho18
860,mdoB,9198988,9198988,9198882,106,5388,utRho18
861,mdoD,2993290,2993712,2993290,422,176,utRho18
862,mdoG,2218514,2218670,2218514,156,36,utRho18
863,mdtA,4307958,4308032,4307958,74,204,utRho18
864,mdtE,7318168,7318464,7318168,296,6690,utRho18
865,mdtK,3486538,3486914,3486538,376,1340,utRho18
866,mdtP,8602472,8602472,8602060,412,478,utRho18
867,melA,8683774,8683822,8683774,48,0,utRho18
868,melR,8683300,8683300,8683256,44,626,utRho18
869,menA,8240812,8240812,8240698,114,136,utRho18
870,menB,4753774,4753774,4753638,136,626,utRho18
871,mepH,3468714,3468870,3468714,156,18,utRho18
872,mepM,3883666,3883666,3883270,396,12,utRho18
873,mepS,4539840,4539958,4539840,118,452,utRho18
874,metA,8428318,8428560,8428318,242,332,utRho18
875,metB,8257272,8257344,8257272,72,348,utRho18
876,metC,6304150,6304472,6304150,322,230,utRho18
877,metE,8025768,8026106,8025768,338,1708,utRho18
878,metF,8265092,8265232,8265092,140,56,utRho18
879,metG,4388538,4388600,4388538,62,90,utRho18
880,metH,8447010,8447656,8447010,646,2004,utRho18
881,metJ,8257116,8257116,8256790,326,114,utRho18
882,metK,6173154,6173412,6173154,258,278,utRho18
883,metN,445428,445428,445290,138,60,utRho18
884,metR,8025710,8025710,8025632,78,0,utRho18
885,metT,1394326,1394326,1394266,60,258,utRho18
886,metY,19910250,19910250,19909734,516,474,utRho18
887,metZ,11789528,11789548,11789528,20,540,utRho18
888,mfd,2348056,2348056,2347928,128,62,utRho18
889,mglA,4478782,4478782,4478578,204,804,utRho18
890,mglB,4481132,4481132,4480696,436,11446,utRho18
891,mglC,4475918,4475918,4475506,412,704,utRho18
892,mgrB,3817584,3817584,3817532,52,66,utRho18
893,mgrR,3245828,3245828,3245828,0,0,utRho18
894,mgsA,2054082,2054082,2054030,52,0,utRho18
895,mgtL,8934560,8934862,8934560,302,76,utRho18
896,mhpA,737038,737222,737038,184,36,utRho18
897,mhpR,737072,737072,736840,232,18,utRho18
898,mhpT,750772,750918,750772,146,0,utRho18
899,miaA,8797964,8798504,8797964,540,5620,utRho18
900,micA,5629604,5629604,5629604,0,0,utRho18
901,micC,2874242,2874238,2874242,4,4,utRho18
902,micF,4626168,4626168,4626168,0,0,utRho18
903,micM,1014408,1014408,1014408,0,0,utRho18
904,minE,2449422,2449422,2449090,332,1760,utRho18
905,mioC,7852950,7852950,7852910,40,0,utRho18
906,mipA,3733012,3733012,3732944,68,2728,utRho18
907,mlaA,4930270,4930270,4930014,256,128,utRho18
908,mlc,3337206,3337206,3337128,78,28,utRho18
909,mlrA,4429498,4429732,4429498,234,242,utRho18
910,mltA,5894546,5894546,5894356,190,88,utRho18
911,mltD,468050,468050,467910,140,0,utRho18
912,mltF,5391534,5391602,5391534,68,38,utRho18
913,mmuP,550238,550650,550238,412,11776,utRho18
914,mngA,1531622,1531968,1531622,346,350,utRho18
915,mngR,1531852,1531852,1531750,102,296,utRho18
916,mnmG,7851348,7851348,7851266,82,3592,utRho18
917,mntH,5025470,5025470,5025412,58,0,utRho18
918,mntP,3810918,3811376,3810918,458,2030,utRho18
919,mntR,1706160,1706366,1706160,206,0,utRho18
920,mntS,1706128,1706128,1705994,134,0,utRho18
921,moaA,1633654,1634088,1633654,434,1388,utRho18
922,moaB,1635954,1636110,1635954,156,614,utRho18
923,mobA,8084242,8084242,8083998,244,384,utRho18
924,mocA,6030112,6030320,6030112,208,862,utRho18
925,modA,1589990,1590178,1589990,188,0,utRho18
926,moeA,1732788,1732788,1732728,60,0,utRho18
927,mokB,2984610,2984610,2984258,352,456,utRho18
928,molR_1,4392888,4392948,4392888,60,0,utRho18
929,motA,3954604,3954604,3954278,326,148,utRho18
930,mpaA,2781278,2781278,2781196,82,26,utRho18
931,mpl,8911456,8911570,8911456,114,0,utRho18
932,mppA,2786108,2786454,2786108,346,74,utRho18
933,mprA,5621494,5621540,5621494,46,600,utRho18
934,mqo,4613848,4613848,4613508,340,648,utRho18
935,mqsA,6336742,6336742,6336492,250,554,utRho18
936,mqsR,6337306,6337306,6337088,218,680,utRho18
937,mraZ,179192,179268,179192,76,0,utRho18
938,mrcA,7045652,7045742,7045652,90,50,utRho18
939,mrcB,329442,329460,329442,18,0,utRho18
940,mreB,13605424,13605424,13604348,1076,1048,utRho18
941,mreD,6798166,6798166,6797750,416,192,utRho18
942,mrp,4388360,4388360,4388336,24,76,utRho18
943,mscK,972984,973072,972984,88,134,utRho18
944,mscL,6876002,6876048,6876002,46,714,utRho18
945,mscS,6139742,6139742,6139614,128,158,utRho18
946,msrA,8884522,8884522,8884352,170,252,utRho18
947,msrB,3725168,3725168,3724858,310,0,utRho18
948,msyB,2228426,2228426,2228362,64,100,utRho18
949,mtfA,4087236,4087302,4087236,66,804,utRho18
950,mtgA,6699662,6699662,6699618,44,1110,utRho18
951,mtlA,30177504,30178248,30177504,744,3736,utRho18
952,mtn,358366,358366,358306,60,1124,utRho18
953,mtr,6611864,6611864,6611634,230,114,utRho18
954,mug,6430992,6430992,6430946,46,388,utRho18
955,murQ,5091466,5091546,5091466,80,0,utRho18
956,murR,5091586,5091586,5091218,368,0,utRho18
957,mutH,5939164,5939324,5939164,160,12,utRho18
958,mutL,8794092,8794824,8794092,732,10284,utRho18
959,mutM,7622554,7622554,7622304,250,820,utRho18
960,mutS,5714038,5714186,5714038,148,578,utRho18
961,mutY,18617466,18618078,18617466,612,636,utRho18
962,nac,4123956,4123956,4123866,90,164,utRho18
963,nadA,1564122,1564170,1564122,48,130,utRho18
964,nadB,5420714,5420840,5420714,126,122,utRho18
965,nadC,237326,237326,237290,36,262,utRho18
966,nadE,3644604,3644916,3644604,312,350,utRho18
967,nadK,5501526,5501662,5501526,136,6,utRho18
968,nagA,1406350,1406350,1405502,848,5572,utRho18
969,nagB,1407416,1407416,1407222,194,64,utRho18
970,nagC,1404016,1404016,1403188,828,260,utRho18
971,nagE,1407680,1407888,1407680,208,56,utRho18
972,nagK,2357080,2357186,2357080,106,132,utRho18
973,nanA,6747240,6747240,6747152,88,108,utRho18
974,nanC,9079856,9079856,9079002,854,1706,utRho18
975,nanR,6749406,6749406,6748978,428,388,utRho18
976,nanS,9075406,9075406,9075188,218,426,utRho18
977,napF,4607390,4607390,4606994,396,208,utRho18
978,narG,2559614,2559728,2559614,114,338,utRho18
979,narK,2555642,2555914,2555642,272,366,utRho18
980,narP,4580844,4581000,4580844,156,324,utRho18
981,narQ,5171154,5171462,5171154,308,306,utRho18
982,narU,3088326,3088326,3088120,206,218,utRho18
983,narW,3077374,3077374,3074618,2756,684,utRho18
984,narX,2555554,2555554,2555236,318,590,utRho18
985,narZ,3085380,3085380,3085180,200,0,utRho18
986,ndh,2331984,2332170,2331984,186,254,utRho18
987,ndk,5289920,5289920,5289728,192,156,utRho18
988,nemR,6904084,6904092,6904084,8,664,utRho18
989,nepI,7683542,7683542,7683478,64,132,utRho18
990,nfo,4501612,4501680,4501612,68,130,utRho18
991,nfsB,1210906,1210906,1210848,58,42,utRho18
992,nfuA,7090916,7091248,7090916,332,624,utRho18
993,nhaA,34634,34978,34634,344,628,utRho18
994,nhaB,2469534,2469534,2469434,100,94,utRho18
995,nhoA,3067926,3068048,3067926,122,38,utRho18
996,nikA,7226878,7227334,7226878,456,3758,utRho18
997,nikR,7237074,7237176,7237074,102,744,utRho18
998,nirB,6987974,6988022,6987974,48,176,utRho18
999,nlpA,7680034,7680034,7679986,48,60,utRho18
1000,nlpC,3585654,3585654,3585462,192,94,utRho18
1001,nlpD,5737658,5737658,5737506,152,298,utRho18
1002,nlpI,6618080,6618080,6617848,232,0,utRho18
1003,nmpC,1153740,1153740,1153650,90,146,utRho18
1004,nohA,3273206,3273206,3272734,472,428,utRho18
1005,norR,5664614,5664614,5664578,36,0,utRho18
1006,norV,5664878,5664952,5664878,74,44,utRho18
1007,nrdA,4689510,4689730,4689510,220,3042,utRho18
1008,nrdD,8925676,8925676,8925320,356,9052,utRho18
1009,nrdH,5601312,5601446,5601312,134,154,utRho18
1010,nrdR,865954,866004,865954,50,62,utRho18
1011,nrfA,8575342,8575528,8575342,186,0,utRho18
1012,nsrR,8812088,8812380,8812088,292,5952,utRho18
1013,nudB,3897348,3897348,3897264,84,0,utRho18
1014,nudC,8393428,8393806,8393428,378,130,utRho18
1015,nudE,7052658,7052658,7052298,360,382,utRho18
1016,nudG,3682876,3682980,3682876,104,60,utRho18
1017,nudI,4729050,4729108,4729050,58,0,utRho18
1018,nudJ,2388874,2388874,2388576,298,190,utRho18
1019,nuoA,4810670,4810670,4810144,526,5768,utRho18
1020,nuoN,4783434,4783434,4783010,424,1256,utRho18
1021,nupC,5026018,5026084,5026018,66,0,utRho18
1022,nupG,6211302,6211428,6211302,126,144,utRho18
1023,ogrK,4335096,4335096,4335040,56,0,utRho18
1024,ogt,2800568,2800568,2800472,96,104,utRho18
1025,ohsC,5401036,5401040,5401036,4,62,utRho18
1026,ompA,2040382,2040382,2040106,276,19358,utRho18
1027,ompC,4625774,4625774,4625498,276,488,utRho18
1028,ompF,1974184,1974184,1973964,220,262,utRho18
1029,ompL,8128958,8128958,8128590,368,274,utRho18
1030,ompN,2874158,2874158,2873786,372,4,utRho18
1031,ompR,7073510,7073510,7073168,342,0,utRho18
1032,ompT,1171330,1171330,1171266,64,304,utRho18
1033,ompW,2627982,2628040,2627982,58,68,utRho18
1034,ompX,1700418,1700900,1700418,482,1862,utRho18
1035,omrA,5952378,5952378,5952378,0,0,utRho18
1036,omrB,5952770,5952770,5952770,0,0,utRho18
1037,oppA,2602170,2602364,2602170,194,3932,utRho18
1038,orn,8783168,8783208,8783168,40,0,utRho18
1039,osmB,2686952,2686952,2686656,296,878,utRho18
1040,osmC,3113192,3113250,3113192,58,492,utRho18
1041,osmE,3644566,3644566,3644512,54,58,utRho18
1042,osmF,4439046,4439046,4438962,84,1730,utRho18
1043,osmY,9222306,9222792,9222306,486,1744,utRho18
1044,otsA,3963302,3963302,3963224,78,240,utRho18
1045,otsB,3964930,3964930,3964774,156,414,utRho18
1046,oxc,4984288,4984288,4983900,388,980,utRho18
1047,oxyR,8316914,8316980,8316914,66,872,utRho18
1048,oxyS,8316788,8316788,8316788,0,0,utRho18
1049,paaA,2907730,2907854,2907730,124,16,utRho18
1050,paaX,2927018,2927078,2927018,60,0,utRho18
1051,paaZ,2907340,2907340,2907284,56,0,utRho18
1052,pabA,6981702,6981702,6981658,44,118,utRho18
1053,pabB,3789256,3789610,3789256,354,298,utRho18
1054,pabC,2306186,2306600,2306186,414,2030,utRho18
1055,pagP,1313052,1313114,1313052,62,22,utRho18
1056,panB,299260,299260,299202,58,5984,utRho18
1057,panC,297840,297840,297590,250,480,utRho18
1058,panD,293490,293490,293388,102,66,utRho18
1059,panZ,7195656,7195968,7195656,312,282,utRho18
1060,parC,6332060,6332060,6331946,114,556,utRho18
1061,patA,6438916,6438988,6438916,72,120,utRho18
1062,patD,3030830,3031156,3030830,326,288,utRho18
1063,pbpC,5294986,5294986,5294650,336,148,utRho18
1064,pbpG,4450132,4450132,4449740,392,144,utRho18
1065,pck,7065358,7065636,7065358,278,2582,utRho18
1066,pcnB,318782,318782,318252,530,406,utRho18
1067,pdhR,244068,244184,244068,116,0,utRho18
1068,pdxB,4875768,4875768,4875702,66,156,utRho18
1069,pdxH,3436068,3436068,3436014,54,272,utRho18
1070,pdxJ,5403626,5403626,5403458,168,90,utRho18
1071,pdxK,5074638,5074638,5074474,164,52,utRho18
1072,pepA,8972278,8972278,8971902,376,144,utRho18
1073,pepD,511618,511618,511432,186,2444,utRho18
1074,pepN,1981182,1981244,1981182,62,120,utRho18
1075,pepQ,8062294,8062322,8062294,28,56,utRho18
1076,pepT,2371646,2371688,2371646,42,182,utRho18
1077,pfkA,8214948,8215104,8214948,156,176,utRho18
1078,pfkB,3612646,3612740,3612646,94,0,utRho18
1079,pflA,1902456,1902456,1902160,296,12,utRho18
1080,pflB,1907850,1907850,1907108,742,1066,utRho18
1081,pflD,8287716,8287990,8287716,274,56,utRho18
1082,pgaA,2185046,2185046,2184578,468,92,utRho18
1083,pgi,8467444,8467516,8467444,72,10,utRho18
1084,pgk,12291428,12291428,12290488,940,2600,utRho18
1085,pgl,1597078,1597172,1597078,94,0,utRho18
1086,pgpB,2678324,2678660,2678324,336,370,utRho18
1087,pgpC,5397276,5397276,5397100,176,116,utRho18
1088,pgrR,2783744,2783982,2783744,238,294,utRho18
1089,pheL,5475158,5475198,5475158,40,164,utRho18
1090,pheM,7197204,7197204,7197080,124,0,utRho18
1091,pheP,1203858,1203918,1203858,60,238,utRho18
1092,pheU,8725254,8725254,8725252,2,4,utRho18
1093,pheV,6220730,6220732,6220730,2,4,utRho18
1094,phnC,8650412,8650412,8650330,82,188,utRho18
1095,phoA,803414,803494,803414,80,226,utRho18
1096,phoB,834202,834284,834202,82,0,utRho18
1097,phoE,520316,520316,520200,116,562,utRho18
1098,phoH,2169730,2169984,2169730,254,486,utRho18
1099,phoP,2381016,2381016,2380894,122,2046,utRho18
1100,phoQ,2379880,2379880,2379552,328,1172,utRho18
1101,phoU,7815330,7815330,7815156,174,298,utRho18
1102,phr,1478842,1479014,1478842,172,54,utRho18
1103,pinE,2419054,2419370,2419054,316,370,utRho18
1104,pinQ,3267168,3267244,3267168,76,180,utRho18
1105,pinR,2867424,2867424,2867348,76,202,utRho18
1106,pitA,7275224,7275284,7275224,60,96,utRho18
1107,pitB,6272806,6272806,6272742,64,102,utRho18
1108,pka,5439862,5439906,5439862,44,246,utRho18
1109,plaP,4174476,4174476,4174124,352,516,utRho18
1110,pldA,8009628,8009724,8009628,96,1138,utRho18
1111,pldB,8018028,8018340,8018028,312,2404,utRho18
1112,plsB,8513196,8513196,8512932,264,456,utRho18
1113,pmbA,8915890,8915918,8915890,28,98,utRho18
1114,pmrD,4747148,4747148,4747076,72,32,utRho18
1115,pncB,1980828,1980828,1980712,116,0,utRho18
1116,pncC,5648788,5648788,5648692,96,0,utRho18
1117,pnp,6622652,6622652,6622336,316,94,utRho18
1118,pntA,3355950,3355950,3355806,144,40,utRho18
1119,pntB,3353096,3353096,3352720,376,244,utRho18
1120,polA,8093880,8093932,8093880,52,248,utRho18
1121,polB,131606,131606,131560,46,0,utRho18
1122,potD,2365700,2365700,2365658,42,0,utRho18
1123,potE,1436688,1436688,1436530,158,64,utRho18
1124,potF,1787268,1787568,1787268,300,486,utRho18
1125,poxB,1822152,1822152,1822098,54,226,utRho18
1126,ppa,8899372,8899372,8899304,68,132,utRho18
1127,ppc,8306380,8306380,8306196,184,942,utRho18
1128,ppdA,5928440,5928440,5928354,86,1800,utRho18
1129,ppdD,235410,235410,235098,312,30,utRho18
1130,pphA,3846770,3846770,3845938,832,5024,utRho18
1131,pphB,5719474,5719520,5719474,46,160,utRho18
1132,ppiA,6984898,6984898,6984594,304,332,utRho18
1133,ppiC,7919682,7919682,7919626,56,328,utRho18
1134,ppiD,923638,923830,923638,192,150,utRho18
1135,ppk,5245748,5246088,5245748,340,550,utRho18
1136,pppA,6228958,6228958,6228704,254,88,utRho18
1137,ppsA,3574322,3574322,3574224,98,2,utRho18
1138,ppsR,3574678,3574890,3574678,212,14,utRho18
1139,pptA,3065716,3066104,3065716,388,374,utRho18
1140,pqiA,2023318,2024002,2023318,684,0,utRho18
1141,prc,3830054,3830054,3829632,422,7176,utRho18
1142,preT,4467978,4468066,4467978,88,1674,utRho18
1143,prfC,9218688,9218828,9218688,140,1776,utRho18
1144,prkB,6968622,6968980,6968622,358,1592,utRho18
1145,prlC,7290476,7290476,7290364,112,150,utRho18
1146,prlF,6553944,6554004,6553944,60,446,utRho18
1147,proB,520432,520776,520432,344,628,utRho18
1148,proC,811372,811372,811288,84,0,utRho18
1149,proK,7417388,7417388,7417384,4,0,utRho18
1150,proL,4572414,4572422,4572414,8,14,utRho18
1151,proP,8660640,8661004,8660640,364,520,utRho18
1152,proS,437674,437674,437550,124,1384,utRho18
1153,proV,5609126,5609630,5609126,504,1058,utRho18
1154,prpB,697292,697364,697292,72,68,utRho18
1155,prpR,696942,696942,696886,56,0,utRho18
1156,prs,2524354,2524354,2523750,604,38682,utRho18
1157,psd,8781276,8781276,8780720,556,290,utRho18
1158,psiE,8480600,8480650,8480600,50,0,utRho18
1159,pspA,2736076,2736158,2736076,82,0,utRho18
1160,pspF,2736080,2736080,2735824,256,72,utRho18
1161,pspG,8525632,8525680,8525632,48,32,utRho18
1162,pssA,5445156,5445454,5445156,298,4192,utRho18
1163,pstB,7817112,7817112,7816732,380,292,utRho18
1164,pstC,7821084,7821084,7820796,288,44,utRho18
1165,pstS,23469408,23469408,23469150,258,336,utRho18
1166,psuG,4517114,4517114,4516734,380,4624,utRho18
1167,psuT,4514992,4514992,4514670,322,92,utRho18
1168,pth,2517084,2517084,2517026,58,0,utRho18
1169,ptrA,5918022,5918022,5917768,254,0,utRho18
1170,ptrB,3857730,3857730,3857678,52,2624,utRho18
1171,ptsG,2315252,2315738,2315252,486,3208,utRho18
1172,ptsH,5066996,5067528,5066996,532,3624,utRho18
1173,purA,8809328,8809374,8809328,46,0,utRho18
1174,purC,5195562,5195562,5195236,326,0,utRho18
1175,purD,8411972,8411972,8411862,110,100,utRho18
1176,purE,1106284,1106284,1106200,84,952,utRho18
1177,purH,8415254,8415254,8415064,190,64,utRho18
1178,purL,5391178,5391178,5391086,92,672,utRho18
1179,purM,5242306,5242394,5242306,88,0,utRho18
1180,purR,3475378,3475688,3475378,310,970,utRho18
1181,purT,3861438,3861762,3861438,324,62,utRho18
1182,purU,2577512,2577512,2577248,264,734,utRho18
1183,putA,2157850,2157850,2157764,86,28,utRho18
1184,putP,2158336,2158610,2158336,274,718,utRho18
1185,puuA,2721936,2721936,2721816,120,0,utRho18
1186,puuC,2725456,2725486,2725456,30,0,utRho18
1187,puuD,2722104,2722240,2722104,136,0,utRho18
1188,puuP,2718746,2718746,2718374,372,886,utRho18
1189,pykA,3874988,3875298,3874988,310,532,utRho18
1190,pykF,3510934,3511396,3510934,462,1090,utRho18
1191,pyrC,2245286,2245286,2245214,72,0,utRho18
1192,pyrD,2009464,2009536,2009464,72,76,utRho18
1193,pyrE,7631970,7631970,7631536,434,408,utRho18
1194,pyrF,2683740,2683842,2683740,102,84,utRho18
1195,pyrG,5819594,5819594,5819332,262,2192,utRho18
1196,pyrH,383624,383710,383624,86,1000,utRho18
1197,pyrL,8945490,8945490,8945066,424,462,utRho18
1198,qmcA,1031646,1031646,1031546,100,452,utRho18
1199,qor,8528608,8528608,8528462,146,76,utRho18
1200,qseB,6339502,6339656,6339502,154,248,utRho18
1201,queA,849970,850022,849970,52,482,utRho18
1202,queE,5811212,5811212,5810836,376,276,utRho18
1203,queF,5850642,5850696,5850642,54,38,utRho18
1204,queG,8788184,8788184,8788134,50,38484,utRho18
1205,racC,2835630,2835630,2835526,104,0,utRho18
1206,racR,2840898,2840898,2840482,416,96,utRho18
1207,raiA,5474208,5474308,5474208,100,134,utRho18
1208,rarD,8008594,8008594,8008356,238,578,utRho18
1209,ravA,7862256,7862256,7862186,70,0,utRho18
1210,rayT,495088,495274,495088,186,280,utRho18
1211,rbn,4763162,4763216,4763162,54,0,utRho18
1212,rbsD,7866644,7866702,7866644,58,0,utRho18
1213,rcnA,4371654,4371834,4371654,180,148,utRho18
1214,rcnB,4373768,4373920,4373768,152,152,utRho18
1215,rcnR,4371806,4371806,4371592,214,234,utRho18
1216,rcsA,4047672,4047936,4047672,264,1394,utRho18
1217,rcsB,4631390,4632354,4631390,964,964,utRho18
1218,rcsC,4640162,4640162,4639656,506,38,utRho18
1219,rcsD,4626904,4626976,4626904,72,90,utRho18
1220,rdgB,6193240,6193362,6193240,122,818,utRho18
1221,rdlA,2538646,2538646,2538646,0,0,utRho18
1222,rdlB,2539712,2539716,2539712,4,30,utRho18
1223,rdlC,2540782,2540786,2540782,4,0,utRho18
1224,rdlD,7400272,7400272,7400272,0,0,utRho18
1225,rdoA,8084782,8084830,8084782,48,0,utRho18
1226,recA,11295276,11295276,11295076,200,464,utRho18
1227,recC,5925014,5925014,5924856,158,370,utRho18
1228,recF,7763722,7763722,7762442,1280,6350,utRho18
1229,recN,5503518,5503590,5503518,72,54,utRho18
1230,recQ,8011666,8011728,8011666,62,0,utRho18
1231,relA,5828554,5828554,5827302,1252,412,utRho18
1232,relB,3291806,3291806,3291744,62,0,utRho18
1233,rem,3289950,3289950,3289804,146,0,utRho18
1234,rep,7921294,7921354,7921294,60,0,utRho18
1235,rfaD,7587730,7587974,7587730,244,592,utRho18
1236,rfaE,6393852,6393852,6393506,346,10,utRho18
1237,rfaH,8049930,8049930,8049642,288,1828,utRho18
1238,rfbX,4219436,4219436,4219168,268,800,utRho18
1239,rfe,7935600,7935832,7935600,232,56,utRho18
1240,rhaB,8194944,8194944,8194896,48,102,utRho18
1241,rhaD,8188770,8188770,8188544,226,0,utRho18
1242,rhaS,8195422,8195472,8195422,50,0,utRho18
1243,rhaT,8201132,8201132,8201050,82,102,utRho18
1244,rhlE,1661566,1661744,1661566,178,194,utRho18
1245,rhoL,47593944,47594772,47593944,828,72840,utRho18
1246,rhsB,7238006,7238384,7238006,378,1024,utRho18
1247,rhsC,1458758,1459166,1458758,408,0,utRho18
1248,rhsD,1046132,1046522,1046132,390,128,utRho18
1249,rhtA,1700608,1700608,1700194,414,368,utRho18
1250,rhtC,8015478,8015514,8015478,36,664,utRho18
1251,ribA,2678468,2678468,2678320,148,328,utRho18
1252,ribC,3486916,3486916,3486484,432,2428,utRho18
1253,ribE,869008,869294,869008,286,3294,utRho18
1254,ribF,42766,42814,42766,48,0,utRho18
1255,ridA,8941892,8941892,8941826,66,102,utRho18
1256,rihA,1369204,1369204,1368824,380,3486,utRho18
1257,rihB,4510504,4510504,4510372,132,346,utRho18
1258,rimJ,2251044,2251124,2251044,80,152,utRho18
1259,rimK,1783752,1783934,1783752,182,614,utRho18
1260,rimL,2997486,2997876,2997486,390,220,utRho18
1261,rimO,1756140,1756140,1756070,70,56,utRho18
1262,rimP,6636350,6636350,6636012,338,532,utRho18
1263,rlmA,3814172,3814172,3814120,52,1296,utRho18
1264,rlmD,5830086,5830086,5830000,86,176,utRho18
1265,rlmE,6655520,6655520,6655328,192,804,utRho18
1266,rlmF,1684384,1684664,1684384,280,62,utRho18
1267,rlmG,6471784,6471784,6471750,34,38,utRho18
1268,rlmI,2060002,2060002,2059938,64,172,utRho18
1269,rlmJ,7290700,7290770,7290700,70,158,utRho18
1270,rlmL,2015344,2015688,2015344,344,1846,utRho18
1271,rlpA,1330444,1330444,1330380,64,32,utRho18
1272,rluA,120900,120900,120692,208,588,utRho18
1273,rluF,8460324,8460708,8460324,384,74,utRho18
1274,rmf,2031006,2031430,2031006,424,1206,utRho18
1275,rna,1290068,1290068,1290006,62,98,utRho18
1276,rnb,2698258,2698258,2697824,434,2492,utRho18
1277,rnc,10816892,10816892,10816252,640,5832,utRho18
1278,rnd,3776122,3776122,3775982,140,64,utRho18
1279,rne,2289746,2289746,2288734,1012,5200,utRho18
1280,rnhA,472082,472082,472004,78,420,utRho18
1281,rnk,1288360,1288360,1287934,426,116,utRho18
1282,rnlA,5531788,5531836,5531788,48,510,utRho18
1283,rnlB,5533414,5533968,5533414,554,838,utRho18
1284,rnpB,19623552,19623552,19623552,0,0,utRho18
1285,rob,9270706,9270706,9270620,86,186,utRho18
1286,rodZ,5285868,5285868,5285688,180,0,utRho18
1287,rpe,7030306,7030306,7030118,188,272,utRho18
1288,rph,15266320,15266320,15266196,124,160,utRho18
1289,rpiA,6118706,6118706,6118650,56,1098,utRho18
1290,rpiB,8626514,8626700,8626514,186,172,utRho18
1291,rpiR,8626274,8626274,8625982,292,130,utRho18
1292,rplJ,8359246,8359992,8359246,746,9842,utRho18
1293,rplK,8356708,8356894,8356708,186,1172,utRho18
1294,rplM,6757344,6757344,6757302,42,7540,utRho18
1295,rplN,6896444,6896444,6896298,146,15114,utRho18
1296,rplS,5489284,5489284,5489060,224,6142,utRho18
1297,rplT,7199052,7199052,7198996,56,1380,utRho18
1298,rplU,6667036,6667036,6666902,134,0,utRho18
1299,rplY,4564866,4565034,4564866,168,0,utRho18
1300,rpmA,6666450,6666450,6666238,212,852,utRho18
1301,rpmB,15247980,15247980,15246696,1284,46900,utRho18
1302,rpmE,8253816,8254026,8253816,210,708,utRho18
1303,rpmF,2294676,2294734,2294676,58,15310,utRho18
1304,rpmH,7768130,7768672,7768130,542,4876,utRho18
1305,rpmI,3600854,3600854,3599998,856,16430,utRho18
1306,rpoB,8362126,8362490,8362126,364,380,utRho18
1307,rpoD,6424946,6426094,6424946,1148,26150,utRho18
1308,rpoE,5420372,5420372,5420024,348,0,utRho18
1309,rpoH,7202006,7202006,7201566,440,3140,utRho18
1310,rpoN,6689324,6689434,6689324,110,178,utRho18
1311,rpoS,5736236,5736236,5735102,1134,3132,utRho18
1312,rpoZ,7644154,7644212,7644154,58,168,utRho18
1313,rppH,5937986,5937986,5937954,32,0,utRho18
1314,rprA,3540744,3540744,3540744,0,0,utRho18
1315,rpsA,1923434,1923990,1923434,556,115560,utRho18
1316,rpsF,8850050,8850236,8850050,186,21822,utRho18
1317,rpsI,6756580,6756580,6756414,166,7374,utRho18
1318,rpsJ,6906884,6906884,6906540,344,8400,utRho18
1319,rpsL,6949242,6949242,6949104,138,1392,utRho18
1320,rpsM,6885130,6885130,6884942,188,2500,utRho18
1321,rpsO,13247144,13247144,13246736,408,1752,utRho18
1322,rpsP,5492508,5492508,5492370,138,472,utRho18
1323,rpsT,42420,42420,42156,264,684,utRho18
1324,rpsU,12842584,12843124,12842584,540,4912,utRho18
1325,rraA,8238716,8238716,8238660,56,140,utRho18
1326,rraB,8956768,8956946,8956768,178,250,utRho18
1327,rrsA,8070478,8071062,8070478,584,11600,utRho18
1328,rrsB,16665468,16666636,16665468,1168,24888,utRho18
1329,rrsC,7883032,7883616,7883032,584,10388,utRho18
1330,rrsD,6858094,6858094,6857524,570,1296,utRho18
1331,rrsE,8415726,8416294,8415726,568,2674,utRho18
1332,rrsG,5462896,5462896,5462314,582,8842,utRho18
1333,rrsH,446970,447542,446970,572,3680,utRho18
1334,rsd,8393908,8393908,8393616,292,296,utRho18
1335,rseA,5419264,5419264,5418808,456,80,utRho18
1336,rseP,392940,393092,392940,152,0,utRho18
1337,rseX,4067298,4067298,4067298,0,0,utRho18
1338,rsfS,1338144,1338144,1338072,72,190,utRho18
1339,rsgA,8783132,8783132,8783018,114,72,utRho18
1340,rsmA,105176,105176,104860,316,924,utRho18
1341,rsmB,6869982,6870414,6869982,432,530,utRho18
1342,rsmC,9215736,9215736,9215400,336,210,utRho18
1343,rsmD,7208594,7208786,7208594,192,0,utRho18
1344,rsmE,6182036,6182268,6182036,232,866,utRho18
1345,rsmG,7847512,7847512,7847360,152,1932,utRho18
1346,rsmH,180020,180188,180020,168,122,utRho18
1347,rsmI,6587106,6587106,6586670,436,462,utRho18
1348,rssA,2578212,2578412,2578212,200,496,utRho18
1349,rssB,2580440,2580484,2580440,44,118,utRho18
1350,rstA,3364276,3364300,3364276,24,0,utRho18
1351,rsuA,4561096,4561096,4560966,130,344,utRho18
1352,rsxA,3411510,3411534,3411510,24,88,utRho18
1353,rtcA,7114004,7114004,7113698,306,920,utRho18
1354,rtcB,7116214,7116214,7116158,56,62,utRho18
1355,rtn,4541356,4541452,4541356,96,2,utRho18
1356,rutA,2148052,2148052,2148022,30,16,utRho18
1357,rutG,2140090,2140090,2139678,412,88,utRho18
1358,rutR,2148226,2148484,2148226,258,396,utRho18
1359,ruvA,7784096,7784096,7783904,192,200,utRho18
1360,ruvB,7782176,7782176,7781424,752,1380,utRho18
1361,ruvC,3894878,3894878,3894752,126,162,utRho18
1362,rybB,1776114,1776114,1776114,0,0,utRho18
1363,rydB,3529860,3529860,3529322,538,440,utRho18
1364,rydC,2983012,2983012,2983012,0,0,utRho18
1365,ryfA,5307398,5307710,5307398,312,224,utRho18
1366,ryfD,5468590,5468590,5468590,0,0,utRho18
1367,ryhB,7162032,7162032,7162032,0,0,utRho18
1368,ryjA,8556132,8556132,8556132,0,0,utRho18
1369,ryjB,9055954,9055954,9055954,0,0,utRho18
1370,sad,3229598,3229598,3229406,192,254,utRho18
1371,safA,3168056,3168056,3167918,138,336,utRho18
1372,sanA,4465368,4465756,4465368,388,232,utRho18
1373,sapF,2705314,2705314,2705268,46,92,utRho18
1374,sbcB,4165456,4165512,4165456,56,0,utRho18
1375,sbcC,831694,831694,831506,188,0,utRho18
1376,sbcD,833954,833954,833904,50,86,utRho18
1377,sbmA,793106,793278,793106,172,634,utRho18
1378,sbmC,4162650,4162650,4162524,126,28,utRho18
1379,sdaA,3793618,3793864,3793618,246,184,utRho18
1380,sdaC,5856070,5856458,5856070,388,2388,utRho18
1381,sdhC,1509916,1510354,1509916,438,26562,utRho18
1382,sdhD,1510808,1511120,1510808,312,6066,utRho18
1383,sdiA,3993834,3993834,3993664,170,16,utRho18
1384,secE,8354354,8354716,8354354,362,144,utRho18
1385,secG,6645180,6645180,6645010,170,1492,utRho18
1386,selA,7522594,7522594,7522498,96,1394,utRho18
1387,selB,7519850,7519850,7519722,128,284,utRho18
1388,selC,7672396,7672444,7672396,48,606,utRho18
1389,selD,3696058,3696058,3696016,42,710,utRho18
1390,seqA,1425884,1425974,1425884,90,306,utRho18
1391,serA,6117098,6117098,6116820,278,170,utRho18
1392,serB,9249712,9249790,9249712,78,132,utRho18
1393,serC,3830380,3830612,3830380,232,328,utRho18
1394,serS,1878730,1878856,1878730,126,1050,utRho18
1395,serT,2063438,2063438,2063424,14,0,utRho18
1396,serU,4087124,4087124,4087114,10,162,utRho18
1397,serV,5637394,5637394,5637290,104,314,utRho18
1398,serW,1852014,1852014,1851942,72,326,utRho18
1399,serX,2195352,2195352,2195304,48,98,utRho18
1400,setB,4527426,4527726,4527426,300,54,utRho18
1401,setC,7673488,7673906,7673488,418,1480,utRho18
1402,sfmA,1116124,1116424,1116124,300,0,utRho18
1403,sfmC,1117606,1117948,1117606,342,80,utRho18
1404,sfsA,323030,323030,322972,58,312,utRho18
1405,sfsB,6669592,6669818,6669592,226,956,utRho18
1406,sgrR,154676,154676,154598,78,108,utRho18
1407,sgrS,154734,154734,154734,0,0,utRho18
1408,shiA,4107068,4107286,4107068,218,102,utRho18
1409,sibA,4306622,4306622,4306622,0,0,utRho18
1410,sibB,4307292,4307292,4307292,0,0,utRho18
1411,sibC,6113702,6113702,6113702,0,0,utRho18
1412,sibD,6389730,6389730,6389730,0,0,utRho18
1413,sibE,6390480,6390480,6390480,0,0,utRho18
1414,sixA,4913998,4913998,4913624,374,66,utRho18
1415,slp,7307872,7307922,7307872,50,154,utRho18
1416,slt,9261400,9261466,9261400,66,0,utRho18
1417,slyA,3442028,3442028,3441648,380,254,utRho18
1418,slyB,3439496,3439752,3439496,256,86,utRho18
1419,slyD,6957398,6957398,6956994,404,674,utRho18
1420,slyX,6954862,6955280,6954862,418,2884,utRho18
1421,smf,6867372,6867372,6867120,252,194,utRho18
1422,smpB,5509534,5509792,5509534,258,760,utRho18
1423,smrA,2811872,2811958,2811872,86,202,utRho18
1424,smrB,4896872,4897212,4896872,340,582,utRho18
1425,smtA,1946808,1947074,1946808,266,26,utRho18
1426,sodA,8201518,8201620,8201518,102,1984,utRho18
1427,sodB,3470646,3470756,3470646,110,838,utRho18
1428,sodC,3449358,3449358,3449310,48,26,utRho18
1429,sohB,2658568,2658664,2658568,96,362,utRho18
1430,sokB,2984232,2984238,2984232,6,58,utRho18
1431,solA,2241218,2241218,2241172,46,44,utRho18
1432,soxR,8554894,8554938,8554894,44,0,utRho18
1433,soxS,8554846,8554846,8554766,80,0,utRho18
1434,speA,6172096,6172096,6171822,274,170,utRho18
1435,speB,6167892,6167892,6167594,298,500,utRho18
1436,speC,6218350,6218350,6218310,40,18,utRho18
1437,spf,8099798,8099798,8099798,0,0,utRho18
1438,sppA,3697422,3697674,3697422,252,318,utRho18
1439,spy,3651376,3651376,3651250,126,80,utRho18
1440,sra,3112092,3112092,3111926,166,36,utRho18
1441,sraB,2293178,2293178,2293178,0,0,utRho18
1442,sraC,3846132,3846132,3846132,0,0,utRho18
1443,srlA,5651582,5651664,5651582,82,60,utRho18
1444,srlR,5657720,5658094,5657720,374,1582,utRho18
1445,srmB,5425752,5425792,5425752,40,16,utRho18
1446,sroA,151216,151216,151216,0,0,utRho18
1447,sroG,6369436,6369436,6369436,0,0,utRho18
1448,sroH,8380974,8380974,8380974,0,0,utRho18
1449,ssb,8548022,8548250,8548022,228,326,utRho18
1450,sseA,5304782,5304988,5304782,206,4030,utRho18
1451,sspA,6755138,6755138,6754840,298,710,utRho18
1452,ssrA,5511014,5511186,5511014,172,196,utRho18
1453,ssrS,12223036,12223932,12223036,896,8680,utRho18
1454,sstT,6479726,6479888,6479726,162,64,utRho18
1455,ssuB,1988282,1988282,1988088,194,268,utRho18
1456,ssuE,1995126,1995126,1995024,102,0,utRho18
1457,sthA,8321604,8321604,8321580,24,1276,utRho18
1458,stpA,5597156,5597156,5596990,166,104,utRho18
1459,sucA,3034344,3034824,3034344,480,3928,utRho18
1460,sufA,3528836,3528836,3528772,64,0,utRho18
1461,sufE,3518962,3518962,3518580,382,374,utRho18
1462,sugE,8753588,8753750,8753588,162,1160,utRho18
1463,sulA,2041894,2041894,2041838,56,1904,utRho18
1464,syd,5850738,5850738,5850560,178,128,utRho18
1465,symE,9159834,9159834,9159680,154,520,utRho18
1466,symR,9159670,9159670,9159670,0,0,utRho18
1467,tabA,8949566,8949724,8949566,158,86,utRho18
1468,talA,5157140,5157332,5157140,192,104,utRho18
1469,talB,16382,16476,16382,94,3878,utRho18
1470,tam,3214442,3214692,3214442,250,390,utRho18
1471,tamA,8884540,8884764,8884540,224,292,utRho18
1472,tar,3945432,3945432,3945382,50,12,utRho18
1473,tas,5943138,5943194,5943138,56,1710,utRho18
1474,tatA,16087636,16087780,16087636,144,372,utRho18
1475,tatE,1317742,1317894,1317742,152,114,utRho18
1476,tauA,770410,770464,770410,54,46,utRho18
1477,tdcA,6534186,6534186,6534130,56,0,utRho18
1478,tdcG,6519652,6519652,6519298,354,970,utRho18
1479,tdcR,6534380,6534760,6534380,380,0,utRho18
1480,tdk,2586986,2587054,2586986,68,42,utRho18
1481,tehA,3001072,3001146,3001072,74,0,utRho18
1482,tesA,1039898,1039898,1039530,368,296,utRho18
1483,tesB,950402,950402,950322,80,46,utRho18
1484,tfaE,2418532,2418532,2418238,294,594,utRho18
1485,tfaQ,3269912,3269912,3269770,142,160,utRho18
1486,tff,379424,379256,379424,168,124,utRho18
1487,tgt,852110,852274,852110,164,0,utRho18
1488,thiD,4369346,4369346,4369032,314,226,utRho18
1489,thiI,882936,883098,882936,162,244,utRho18
1490,thiM,4370902,4370902,4370602,300,918,utRho18
1491,thiQ,146170,146170,145854,316,1692,utRho18
1492,thrL,592,760,592,168,32,utRho18
1493,thrS,7210932,7210932,7210280,652,292,utRho18
1494,thrU,8350762,8350776,8350762,14,198,utRho18
1495,thrV,6847414,6847414,6847310,104,393332,utRho18
1496,thrW,525682,525742,525682,60,1586,utRho18
1497,thyA,5930696,5930696,5930310,386,1762,utRho18
1498,tig,909986,910266,909986,280,842,utRho18
1499,tisB,7706674,7707106,7706674,432,1270,utRho18
1500,tktA,6163414,6163414,6163270,144,172,utRho18
1501,tktB,5158616,5159272,5158616,656,1320,utRho18
1502,tldD,6784368,6784368,6784056,312,0,utRho18
1503,tmcA,5191876,5191876,5191718,158,60,utRho18
1504,tnaC,15553644,15553740,15553644,96,1520,utRho18
1505,tolB,1555074,1555480,1555074,406,478,utRho18
1506,tolC,6356008,6356230,6356008,222,480,utRho18
1507,tomB,961588,961588,961416,172,1520,utRho18
1508,tonB,2622108,2622178,2622108,70,126,utRho18
1509,topA,2661578,2662096,2661578,518,244,utRho18
1510,torC,2116112,2116168,2116112,56,186,utRho18
1511,torR,2115968,2115968,2115908,60,284,utRho18
1512,torS,2112364,2112364,2112356,8,0,utRho18
1513,torT,2112414,2112522,2112414,108,0,utRho18
1514,tpiA,8223138,8223138,8223014,124,804,utRho18
1515,tppB,3425342,3425538,3425342,196,4908,utRho18
1516,tpr,2574376,2574376,2574376,0,0,utRho18
1517,tpx,2777688,2777688,2777622,66,312,utRho18
1518,tqsA,3347780,3347826,3347780,46,248,utRho18
1519,treA,2494850,2494850,2494752,98,766,utRho18
1520,treB,8932420,8932420,8932360,60,160,utRho18
1521,treF,7339102,7339184,7339102,82,140,utRho18
1522,treR,8934694,8934694,8934492,202,50,utRho18
1523,trg,2984878,2984940,2984878,62,0,utRho18
1524,trkG,2847342,2847564,2847342,222,172,utRho18
1525,trmA,8326590,8326590,8326540,50,30,utRho18
1526,trpA,2634678,2634678,2634444,234,406,utRho18
1527,trpC,2639888,2639888,2639570,318,204,utRho18
1528,trpL,5292432,5292432,5292328,104,88,utRho18
1529,trpR,9265408,9265520,9265408,112,516,utRho18
1530,trpS,7027394,7027394,7027276,118,2162,utRho18
1531,trpT,7893560,7893914,7893560,354,278408,utRho18
1532,trxA,7931294,7931522,7931294,228,570,utRho18
1533,trxB,1864156,1864156,1864100,56,0,utRho18
1534,trxC,5437350,5437470,5437350,120,152,utRho18
1535,tsaD,6421256,6421256,6421086,170,134,utRho18
1536,tsgA,6985038,6985136,6985038,98,268,utRho18
1537,tsr,9182824,9183314,9182824,490,2060,utRho18
1538,tsx,864490,864490,864026,464,948,utRho18
1539,ttcA,2823970,2823970,2823896,74,2364,utRho18
1540,ttdA,6412848,6412926,6412848,78,0,utRho18
1541,ttdR,6412760,6412760,6412512,248,300,utRho18
1542,tufA,6943448,6943448,6942658,790,169020,utRho18
1543,tus,3368346,3368518,3368346,172,378,utRho18
1544,tusA,7218040,7218040,7217992,48,204,utRho18
1545,tusB,6950218,6950218,6949930,288,158,utRho18
1546,tynA,2902996,2902996,2902698,298,0,utRho18
1547,typA,8116460,8116814,8116460,354,4196,utRho18
1548,tyrB,8534164,8534228,8534164,64,1806,utRho18
1549,tyrP,3979004,3979362,3979004,358,542,utRho18
1550,tyrR,2773384,2773440,2773384,56,50,utRho18
1551,tyrS,3434566,3434566,3434444,122,0,utRho18
1552,tyrT,2575330,2575330,2575244,86,652,utRho18
1553,uacT,6062378,6062734,6062378,356,620,utRho18
1554,ubiC,8504886,8505012,8504886,126,0,utRho18
1555,ubiD,8049618,8049976,8049618,358,1856,utRho18
1556,ubiE,8037494,8037710,8037494,216,122,utRho18
1557,ubiG,4679078,4679134,4679078,56,0,utRho18
1558,ucpA,5089342,5089342,5089246,96,0,utRho18
1559,udp,8032782,8032862,8032782,80,0,utRho18
1560,ugd,4199470,4199470,4199226,244,0,utRho18
1561,ugpB,7184852,7184852,7184650,202,1372,utRho18
1562,ugpQ,7176600,7176600,7176226,374,194,utRho18
1563,uhpT,7694396,7694396,7694334,62,172,utRho18
1564,uidA,3392304,3392304,3392142,162,38,utRho18
1565,uidC,3386012,3386012,3385702,310,62,utRho18
1566,uidR,3394150,3394150,3394104,46,0,utRho18
1567,ulaA,8839854,8839960,8839854,106,456,utRho18
1568,ulaG,8839350,8839350,8839250,100,20,utRho18
1569,ulaR,8837124,8837124,8836906,218,86,utRho18
1570,umpG,5741372,5741372,5740548,824,640,utRho18
1571,umpH,1400704,1400704,1400652,52,200,utRho18
1572,umuD,2461476,2461534,2461476,58,0,utRho18
1573,ung,5433476,5433508,5433476,32,114,utRho18
1574,uof,2843316,2843316,2842900,416,3204,utRho18
1575,upp,5241818,5241818,5241744,74,292,utRho18
1576,usg,4873780,4873780,4873298,482,480,utRho18
1577,ushA,1009772,1009828,1009772,56,28,utRho18
1578,uspA,7279966,7280222,7279966,256,524,utRho18
1579,uspB,7279696,7279696,7279440,256,354,utRho18
1580,uspC,3959172,3959506,3959172,334,58,utRho18
1581,uspE,2797318,2797318,2797244,74,0,utRho18
1582,uspF,2871282,2871282,2871238,44,60,utRho18
1583,uspG,1283806,1283806,1283734,72,744,utRho18
1584,uvrA,8547872,8547872,8547742,130,376,utRho18
1585,uvrB,1626304,1627052,1626304,748,1188,utRho18
1586,uvrC,3989758,3989758,3989412,346,472,utRho18
1587,uvrD,7995814,7995966,7995814,152,954,utRho18
1588,uvrY,3990812,3990812,3990718,94,60,utRho18
1589,uxaB,3221474,3221474,3221360,114,0,utRho18
1590,uxaC,6489714,6489714,6489482,232,148,utRho18
1591,uxuA,9103036,9103272,9103036,236,1098,utRho18
1592,uxuR,9108916,9109152,9108916,236,512,utRho18
1593,valS,8967854,8967854,8967674,180,304,utRho18
1594,valU,5041848,5041862,5041848,14,0,utRho18
1595,valV,3492830,3492870,3492830,40,448,utRho18
1596,ves,3649968,3649968,3649874,94,10,utRho18
1597,waaA,7616512,7617080,7616512,568,838,utRho18
1598,waaH,7580298,7580298,7580162,136,284,utRho18
1599,waaQ,7616476,7616476,7616196,280,188,utRho18
1600,waaU,7598996,7598996,7598624,372,312,utRho18
1601,waaY,7602272,7602272,7601930,342,3492,utRho18
1602,wbbH,4214888,4214888,4214452,436,326,utRho18
1603,wbbK,4209212,4209212,4209018,194,132,utRho18
1604,wcaM,4231868,4231868,4231792,76,70,utRho18
1605,wrbA,2135516,2135516,2135416,100,148,utRho18
1606,wza,4275166,4275166,4274486,680,432,utRho18
1607,wzxC,4240674,4240674,4240316,358,58,utRho18
1608,wzzB,4196950,4196950,4196602,348,128,utRho18
1609,xanP,7657642,7657890,7657642,248,552,utRho18
1610,xanQ,6048520,6048702,6048520,182,0,utRho18
1611,xapA,5049820,5049820,5049756,64,44,utRho18
1612,xapR,10090252,10090252,10089908,344,128,utRho18
1613,xdhA,6000514,6000690,6000514,176,572,utRho18
1614,xerD,6079702,6079702,6079486,216,496,utRho18
1615,xseA,5268394,5268464,5268394,70,4,utRho18
1616,xseB,882746,882746,882686,60,124,utRho18
1617,xthA,3664798,3664856,3664798,58,0,utRho18
1618,xylA,7461614,7461614,7461530,84,6744,utRho18
1619,xylE,8484540,8484540,8484508,32,0,utRho18
1620,xylF,7462138,7462262,7462138,124,370,utRho18
1621,xylR,7469812,7469958,7469812,146,0,utRho18
1622,yaaA,13230,13230,12918,312,238,utRho18
1623,yaaI,23876,23876,23572,304,322,utRho18
1624,yaaJ,16034,16034,15918,116,214,utRho18
1625,yaaU,91184,91614,91184,430,168,utRho18
1626,yaaW,23084,23084,22712,372,684,utRho18
1627,yaaX,10060,10468,10060,408,70,utRho18
1628,yabI,142542,142702,142542,160,310,utRho18
1629,yacC,273880,273880,273834,46,1248,utRho18
1630,yacH,262932,262932,262520,412,98,utRho18
1631,yacL,268678,268776,268678,98,356,utRho18
1632,yadD,293796,293936,293796,140,274,utRho18
1633,yadE,289930,290162,289930,232,380,utRho18
1634,yadN,314110,314110,313766,344,582,utRho18
1635,yadS,355572,355572,355248,324,3442,utRho18
1636,yadV,312470,312470,312402,68,310,utRho18
1637,yaeF,434270,434270,434006,264,188,utRho18
1638,yaeP,428374,428374,428250,124,558,utRho18
1639,yaeQ,428176,428582,428176,406,1194,utRho18
1640,yaeR,423716,423754,423716,38,0,utRho18
1641,yafC,462166,462166,461762,404,406,utRho18
1642,yafD,462128,462244,462128,116,450,utRho18
1643,yafK,491986,491986,491610,376,1096,utRho18
1644,yafL,493282,493424,493282,142,122,utRho18
1645,yafN,503938,504010,503938,72,156,utRho18
1646,yafS,469568,469632,469568,64,390,utRho18
1647,yafT,474470,474670,474470,200,92,utRho18
1648,yafV,480432,480432,480378,54,392,utRho18
1649,yafZ,536052,536052,536010,42,146,utRho18
1650,yagE,564446,564556,564446,110,138,utRho18
1651,yagG,570414,570790,570414,376,332,utRho18
1652,yagI,578384,578384,578324,60,198,utRho18
1653,yagK,586236,586236,585896,340,3870,utRho18
1654,yagL,588062,588062,587836,226,876,utRho18
1655,yagN,591342,591342,591158,184,190,utRho18
1656,yahA,663746,664742,663746,996,2500,utRho18
1657,yahC,670136,670136,670044,92,1742,utRho18
1658,yahE,671478,671850,671478,372,612,utRho18
1659,yahM,690504,690808,690504,304,396,utRho18
1660,yahN,692872,692872,692674,198,1032,utRho18
1661,yahO,692864,692968,692864,104,448,utRho18
1662,yaiE,816296,816354,816296,58,210,utRho18
1663,yaiI,811396,811528,811396,132,36,utRho18
1664,yaiO,761946,761946,761684,262,228,utRho18
1665,yaiP,767970,767970,767870,100,4,utRho18
1666,yaiS,769660,769660,769232,428,308,utRho18
1667,yaiV,788922,788922,788922,0,0,utRho18
1668,yaiY,799094,799094,798666,428,118,utRho18
1669,yaiZ,798888,799186,798888,298,422,utRho18
1670,yajC,854410,854574,854410,164,322,utRho18
1671,yajD,860938,861210,860938,272,520,utRho18
1672,yajI,866068,866068,865702,366,282,utRho18
1673,yajL,887496,887496,887282,214,420,utRho18
1674,yajQ,889316,889366,889316,50,72,utRho18
1675,yajR,893374,893374,893332,42,256,utRho18
1676,ybaB,987418,988152,987418,734,2608,utRho18
1677,ybaL,1006590,1006590,1006476,114,278,utRho18
1678,ybaM,980648,980648,980542,106,162,utRho18
1679,ybaN,981436,981764,981436,328,492,utRho18
1680,ybaO,936704,936766,936704,62,0,utRho18
1681,ybaP,1016568,1016568,1016160,408,748,utRho18
1682,ybaQ,1016348,1016436,1016348,88,74,utRho18
1683,ybaS,1023146,1023282,1023146,136,360,utRho18
1684,ybaV,927504,927874,927504,370,52,utRho18
1685,ybaY,950490,950758,950490,268,274,utRho18
1686,ybbB,1062724,1062724,1062452,272,130,utRho18
1687,ybbJ,1030154,1030154,1029718,436,1038,utRho18
1688,ybbL,1031784,1031838,1031784,54,82,utRho18
1689,ybbN,1037136,1037136,1036558,578,1130,utRho18
1690,ybbO,1038658,1038658,1038298,360,472,utRho18
1691,ybbY,1080718,1081130,1080718,412,352,utRho18
1692,ybcH,1176140,1176140,1175962,178,256,utRho18
1693,ybcI,1113264,1113264,1113106,158,1754,utRho18
1694,ybcJ,1114050,1114050,1113746,304,660,utRho18
1695,ybcK,1137502,1137804,1137502,302,324,utRho18
1696,ybcL,1141690,1141786,1141690,96,2,utRho18
1697,ybcN,1144628,1144932,1144628,304,256,utRho18
1698,ybcQ,1147548,1147912,1147548,364,2262,utRho18
1699,ybcW,1159610,1159760,1159610,150,60,utRho18
1700,ybdD,1263982,1264364,1263982,382,396,utRho18
1701,ybdF,1212106,1212106,1211772,334,362,utRho18
1702,ybdH,1267048,1267048,1266954,94,168,utRho18
1703,ybdJ,1212822,1212822,1212398,424,236,utRho18
1704,ybdK,1215122,1215122,1214766,356,1858,utRho18
1705,ybdL,1267114,1267172,1267114,58,172,utRho18
1706,ybdM,1271110,1271110,1270752,358,88,utRho18
1707,ybdN,1273372,1273372,1273138,234,130,utRho18
1708,ybdR,1283844,1284176,1283844,332,1000,utRho18
1709,ybeD,1325412,1325412,1325284,128,208,utRho18
1710,ybeF,1323090,1323090,1322756,334,1324,utRho18
1711,ybeL,1349986,1350036,1349986,50,196,utRho18
1712,ybeQ,1353412,1353412,1353094,318,224,utRho18
1713,ybeR,1353120,1353422,1353120,302,224,utRho18
1714,ybeT,1358832,1358832,1358812,20,0,utRho18
1715,ybeU,1358924,1359016,1358924,92,0,utRho18
1716,ybeZ,1386938,1386938,1386834,104,3182,utRho18
1717,ybfA,1458074,1458268,1458074,194,24,utRho18
1718,ybfE,1423878,1423878,1423796,82,350,utRho18
1719,ybfF,1425692,1425692,1425604,88,74,utRho18
1720,ybfH,1433282,1433282,1433194,88,60,utRho18
1721,ybgA,1477840,1478002,1477840,162,58,utRho18
1722,ybgC,1549288,1549504,1549288,216,28,utRho18
1723,ybgD,1505916,1505916,1505590,326,5668,utRho18
1724,ybgI,1485238,1485654,1485238,416,0,utRho18
1725,ybgO,1498370,1498370,1497964,406,0,utRho18
1726,ybgS,1570992,1570992,1570634,358,120,utRho18
1727,ybhA,1597184,1597184,1596862,322,0,utRho18
1728,ybhB,1616070,1616070,1615818,252,80,utRho18
1729,ybhC,1614642,1614642,1614562,80,1288,utRho18
1730,ybhD,1601418,1601418,1601276,142,80,utRho18
1731,ybhH,1601104,1601518,1601104,414,180,utRho18
1732,ybhK,1633384,1633384,1633294,90,170,utRho18
1733,ybhM,1641556,1641586,1641556,30,56,utRho18
1734,ybhN,1645296,1645296,1644996,300,232,utRho18
1735,ybhQ,1649202,1649260,1649202,58,412,utRho18
1736,ybiA,1665920,1665920,1665900,20,0,utRho18
1737,ybiI,1676968,1676968,1676912,56,434,utRho18
1738,ybiO,1691328,1691328,1690960,368,2216,utRho18
1739,ybiP,1705252,1705252,1705194,58,364,utRho18
1740,ybiS,1711572,1711572,1711488,84,130,utRho18
1741,ybiT,1711894,1711926,1711894,32,0,utRho18
1742,ybiU,1718212,1718212,1718122,90,94,utRho18
1743,ybiV,1720176,1720176,1720056,120,48,utRho18
1744,ybiW,1725566,1725566,1725212,354,2750,utRho18
1745,ybiX,1678548,1678548,1678414,134,162,utRho18
1746,ybjC,1781784,1781826,1781784,42,22,utRho18
1747,ybjE,1830154,1830154,1829714,440,506,utRho18
1748,ybjG,1767016,1767016,1766776,240,2324,utRho18
1749,ybjL,1779882,1779882,1779638,244,172,utRho18
1750,ybjM,1779770,1780178,1779770,408,790,utRho18
1751,ybjO,1795704,1795978,1795704,274,146,utRho18
1752,ybjP,1809046,1809046,1808934,112,0,utRho18
1753,ybjQ,1809034,1809186,1809034,152,30,utRho18
1754,ybjS,1813796,1813796,1813506,290,70,utRho18
1755,ybjX,1838206,1838206,1838168,38,0,utRho18
1756,ycaD,1891438,1891742,1891438,304,52,utRho18
1757,ycaI,1928210,1928640,1928210,430,168,utRho18
1758,ycaK,1899094,1899336,1899094,242,346,utRho18
1759,ycaL,1920264,1920528,1920264,264,0,utRho18
1760,ycaM,1894240,1894458,1894240,218,34,utRho18
1761,ycaR,1941284,1941346,1941284,62,1632,utRho18
1762,ycbB,1961862,1962094,1961862,232,312,utRho18
1763,ycbJ,1943344,1943504,1943344,160,0,utRho18
1764,ycbK,1966046,1966150,1966046,104,568,utRho18
1765,ycbZ,2036920,2036920,2036598,322,66,utRho18
1766,yccA,2062886,2062886,2062836,50,140,utRho18
1767,yccF,2048730,2048730,2048696,34,0,utRho18
1768,yccS,2047988,2047988,2047766,222,276,utRho18
1769,yccT,2055674,2055674,2055546,128,184,utRho18
1770,yccX,2059960,2060128,2059960,168,526,utRho18
1771,ycdT,2185682,2185752,2185682,70,0,utRho18
1772,ycdU,2191266,2191686,2191266,420,172,utRho18
1773,ycdZ,2200504,2200592,2200504,88,198,utRho18
1774,yceA,2233544,2233614,2233544,70,84,utRho18
1775,yceD,2293298,2293588,2293298,290,3450,utRho18
1776,yceF,2293522,2293522,2293190,332,2466,utRho18
1777,yceH,2252154,2252314,2252154,160,452,utRho18
1778,yceI,2237282,2237282,2236952,330,1074,utRho18
1779,yceJ,2238142,2238142,2238092,50,84,utRho18
1780,yceM,2253208,2253612,2253208,404,372,utRho18
1781,yceO,2239264,2239264,2238894,370,812,utRho18
1782,yceQ,2288760,2289004,2288760,244,2650,utRho18
1783,ycfD,2376540,2376540,2376480,60,54,utRho18
1784,ycfJ,2334814,2335198,2334814,384,284,utRho18
1785,ycfS,2340834,2340834,2340748,86,34,utRho18
1786,ycfT,2350658,2350658,2350330,328,4,utRho18
1787,ycfZ,2362760,2362760,2362534,226,296,utRho18
1788,ycgB,2474570,2474570,2474482,88,50,utRho18
1789,ycgG,2434614,2434656,2434614,42,122,utRho18
1790,ycgJ,2452956,2453200,2452956,244,32,utRho18
1791,ycgL,2455218,2455362,2455218,144,0,utRho18
1792,ycgN,2457366,2457660,2457366,294,80,utRho18
1793,ycgR,2489112,2489112,2489054,58,66,utRho18
1794,ycgV,2512222,2512222,2511904,318,882,utRho18
1795,ycgX,2426568,2426568,2426214,354,7476,utRho18
1796,ycgY,2490166,2490320,2490166,154,170,utRho18
1797,ycgZ,2431504,2431578,2431504,74,58,utRho18
1798,ychE,2596904,2597196,2596904,292,122,utRho18
1799,ychF,2515764,2515764,2515624,140,136,utRho18
1800,ychH,2517476,2517582,2517476,106,576,utRho18
1801,ychJ,2578354,2578354,2578264,90,192,utRho18
1802,ychN,2547310,2547310,2547198,112,0,utRho18
1803,ychO,2547520,2547850,2547520,330,128,utRho18
1804,ychQ,2533798,2533848,2533798,50,84,utRho18
1805,yciA,2624828,2624828,2624492,336,208,utRho18
1806,yciB,2626110,2626110,2625780,330,1004,utRho18
1807,yciC,2627396,2627396,2627326,70,0,utRho18
1808,yciE,2630794,2630794,2630448,346,148,utRho18
1809,yciG,5264368,5264368,5264140,228,0,utRho18
1810,yciI,2621784,2621784,2621730,54,114,utRho18
1811,yciN,2661606,2661606,2661336,270,0,utRho18
1812,yciS,2680270,2680486,2680270,216,108,utRho18
1813,yciT,2689088,2689088,2688692,396,1334,utRho18
1814,yciU,2614718,2614718,2614300,418,1470,utRho18
1815,yciV,2646376,2646440,2646376,64,44,utRho18
1816,yciW,2700472,2700472,2700214,258,2804,utRho18
1817,yciZ,2689276,2689276,2689218,58,1138,utRho18
1818,ycjD,2703792,2703792,2703520,272,26,utRho18
1819,ycjG,2777748,2777860,2777748,112,64,utRho18
1820,ycjM,2740006,2740432,2740006,426,132,utRho18
1821,ycjW,2767982,2767982,2767922,60,0,utRho18
1822,ycjX,2768138,2768234,2768138,96,62,utRho18
1823,ycjY,5568288,5568288,5567460,828,588,utRho18
1824,ydaE,2836438,2836438,2836016,422,596,utRho18
1825,ydaN,2816048,2816100,2816048,52,70,utRho18
1826,ydaS,2840340,2840730,2840340,390,62,utRho18
1827,ydbC,2948376,2948442,2948376,66,0,utRho18
1828,ydbD,2950132,2950288,2950132,156,0,utRho18
1829,ydbH,2885800,2886102,2885800,302,170,utRho18
1830,ydbJ,2881712,2882116,2881712,404,662,utRho18
1831,ydbK,2881692,2881692,2881568,124,198,utRho18
1832,ydcA,2983294,2983354,2983294,60,180,utRho18
1833,ydcF,2974404,2974470,2974404,66,66,utRho18
1834,ydcI,2990268,2990268,2990142,126,58,utRho18
1835,ydcJ,2990266,2990576,2990266,310,0,utRho18
1836,ydcK,3001280,3001280,3000898,382,100,utRho18
1837,ydcL,3004646,3004914,3004646,268,82,utRho18
1838,ydcN,3012308,3012344,3012308,36,546,utRho18
1839,ydcP,3013508,3013562,3013508,54,80,utRho18
1840,ydcR,3019956,3020006,3019956,50,58,utRho18
1841,ydcS,3022906,3023308,3022906,402,404,utRho18
1842,ydcX,3034442,3034778,3034442,336,640,utRho18
1843,ydcY,3035220,3035296,3035220,76,0,utRho18
1844,ydcZ,3036750,3036750,3036662,88,742,utRho18
1845,yddB,3155332,3155332,3155238,94,186,utRho18
1846,yddE,3071738,3071738,3071716,22,0,utRho18
1847,yddG,3094410,3094410,3094338,72,40,utRho18
1848,yddJ,3089732,3089732,3089438,294,282,utRho18
1849,yddW,3137704,3137704,3137646,58,44,utRho18
1850,ydeA,3233910,3234056,3233910,146,346,utRho18
1851,ydeE,3242528,3242664,3242528,136,202,utRho18
1852,ydeI,3249118,3249118,3248994,124,158,utRho18
1853,ydeJ,3249376,3249546,3249376,170,0,utRho18
1854,ydeN,3165458,3165458,3165048,410,408,utRho18
1855,ydeP,3173328,3173328,3172972,356,378,utRho18
1856,ydeR,3176596,3176596,3176592,4,378,utRho18
1857,ydfA,3296872,3297016,3296872,144,0,utRho18
1858,ydfG,3254982,3255034,3254982,52,0,utRho18
1859,ydfH,3256652,3256704,3256652,52,78,utRho18
1860,ydfK,3265446,3266144,3265446,698,4060,utRho18
1861,ydgA,3379588,3379704,3379588,116,0,utRho18
1862,ydgC,3364124,3364124,3364060,64,16,utRho18
1863,ydgD,3343906,3343920,3343906,14,0,utRho18
1864,ydgH,3356754,3356854,3356754,100,0,utRho18
1865,ydgJ,3408798,3408798,3408616,182,358,utRho18
1866,ydgK,3410414,3410500,3410414,86,692,utRho18
1867,ydhB,3479618,3479618,3479596,22,56,utRho18
1868,ydhC,3479698,3479822,3479698,124,22,utRho18
1869,ydhF,3451310,3451310,3451264,46,0,utRho18
1870,ydhI,3441996,3442050,3441996,54,0,utRho18
1871,ydhL,3451864,3451864,3451840,24,258,utRho18
1872,ydhQ,3492404,3492404,3492254,150,0,utRho18
1873,ydhS,3494136,3494262,3494136,126,1552,utRho18
1874,ydhT,3499138,3499138,3499118,20,76,utRho18
1875,ydhY,3509284,3509284,3508954,330,176,utRho18
1876,ydhZ,3510418,3510418,3510282,136,248,utRho18
1877,ydiE,3579206,3579226,3579206,20,0,utRho18
1878,ydiH,3530582,3530582,3530406,176,48,utRho18
1879,ydiM,3541852,3542142,3541852,290,132,utRho18
1880,ydiN,3544818,3545024,3544818,206,0,utRho18
1881,ydiP,3558656,3558656,3558602,54,224,utRho18
1882,ydiU,3582508,3582508,3582488,20,636,utRho18
1883,ydiV,3584174,3584174,3584040,134,328,utRho18
1884,ydiY,3612500,3612500,3612166,334,206,utRho18
1885,ydjA,3697400,3697400,3697352,48,242,utRho18
1886,ydjE,3708082,3708082,3707958,124,54,utRho18
1887,ydjF,3709848,3709848,3709708,140,0,utRho18
1888,ydjM,3620340,3620422,3620340,82,0,utRho18
1889,ydjO,3626696,3626696,3626288,408,454,utRho18
1890,ydjX,3666434,3666802,3666434,368,1300,utRho18
1891,yeaE,3731448,3731448,3731272,176,80,utRho18
1892,yeaG,3733530,3733816,3733530,286,24,utRho18
1893,yeaI,3740486,3740770,3740486,284,108,utRho18
1894,yeaJ,3743874,3744082,3743874,208,36,utRho18
1895,yeaL,3748646,3748704,3748646,58,432,utRho18
1896,yeaM,3751296,3751296,3751152,144,96,utRho18
1897,yeaN,3750926,3751346,3750926,420,100,utRho18
1898,yeaO,3753554,3753818,3753554,264,434,utRho18
1899,yeaP,3755314,3755430,3755314,116,456,utRho18
1900,yeaQ,3758780,3758780,3758510,270,486,utRho18
1901,yeaR,3759988,3759988,3759896,92,10,utRho18
1902,yeaY,3781122,3781122,3781064,58,24,utRho18
1903,yebB,3892220,3892502,3892220,282,418,utRho18
1904,yebC,3896370,3896370,3896302,68,160,utRho18
1905,yebE,3859464,3859464,3859414,50,172,utRho18
1906,yebG,3861530,3861530,3861494,36,2,utRho18
1907,yebK,3873180,3873304,3873180,124,168,utRho18
1908,yebQ,3820314,3820552,3820314,238,0,utRho18
1909,yebS,3832238,3832516,3832238,278,4,utRho18
1910,yebV,3843430,3843560,3843430,130,0,utRho18
1911,yebW,3843914,3844242,3843914,328,962,utRho18
1912,yecC,3995646,3995646,3995628,18,0,utRho18
1913,yecD,3901272,3901664,3901272,392,202,utRho18
1914,yecF,3991434,3991636,3991434,202,228,utRho18
1915,yecH,3979304,3979304,3978980,324,604,utRho18
1916,yecJ,3975604,3975604,3975516,88,0,utRho18
1917,yecM,3919968,3919968,3919692,276,248,utRho18
1918,yecR,3976400,3976444,3976400,44,24,utRho18
1919,yecT,3923862,3923944,3923862,82,54,utRho18
1920,yedD,4016522,4016522,4016180,342,394,utRho18
1921,yedE,4016310,4016554,4016310,244,224,utRho18
1922,yedI,4058922,4058922,4058732,190,136,utRho18
1923,yedJ,4066446,4066446,4066158,288,400,utRho18
1924,yedV,4076404,4076404,4076304,100,340,utRho18
1925,yedX,4077680,4077912,4077680,232,0,utRho18
1926,yedY,4078572,4078956,4078572,384,558,utRho18
1927,yeeA,4161322,4161322,4161182,140,64,utRho18
1928,yeeE,4171104,4171104,4171050,54,0,utRho18
1929,yeeJ,4089526,4089822,4089526,296,602,utRho18
1930,yeeN,4113508,4113716,4113508,208,234,utRho18
1931,yeeO,4119444,4119444,4119692,248,106,utRho18
1932,yeeX,4158834,4158834,4158722,112,430,utRho18
1933,yeeZ,4178422,4178422,4178256,166,48,utRho18
1934,yefM,4179466,4179466,4179426,40,0,utRho18
1935,yegD,4295288,4295348,4295288,60,44,utRho18
1936,yegH,4275726,4275804,4275726,78,344,utRho18
1937,yegI,4302154,4302154,4301970,184,0,utRho18
1938,yegJ,4302032,4302370,4302032,338,12,utRho18
1939,yegQ,4331182,4331336,4331182,154,1368,utRho18
1940,yegR,4336698,4336698,4336612,86,268,utRho18
1941,yegS,4337086,4337424,4337086,338,110,utRho18
1942,yegT,4357562,4357642,4357562,80,614,utRho18
1943,yegX,4367640,4367640,4367302,338,734,utRho18
1944,yehA,4376944,4376944,4376828,116,232,utRho18
1945,yehE,4385818,4385818,4385592,226,0,utRho18
1946,yehK,4407568,4407944,4407568,376,76,utRho18
1947,yehL,4408804,4409192,4408804,388,0,utRho18
1948,yeiB,4486146,4486146,4485934,212,100,utRho18
1949,yeiE,4499422,4499422,4499236,186,84,utRho18
1950,yeiG,4487776,4487820,4487776,44,0,utRho18
1951,yeiH,4499332,4499434,4499332,102,100,utRho18
1952,yeiI,4503306,4503400,4503306,94,48,utRho18
1953,yeiL,4510580,4510710,4510580,130,46,utRho18
1954,yeiP,4530834,4530900,4530834,66,468,utRho18
1955,yeiQ,4532328,4532490,4532328,162,296,utRho18
1956,yeiR,4535484,4535658,4535484,174,138,utRho18
1957,yeiW,4530840,4530840,4530590,250,766,utRho18
1958,yejA,4544624,4544728,4544624,104,10,utRho18
1959,yejG,4556892,4556892,4556474,418,3788,utRho18
1960,yejH,4561244,4561264,4561244,20,0,utRho18
1961,yejK,4568218,4568218,4567894,324,0,utRho18
1962,yejO,4578352,4578352,4577800,552,1578,utRho18
1963,yfaD,4713380,4713808,4713380,428,1144,utRho18
1964,yfaE,4696676,4697028,4696676,352,2026,utRho18
1965,yfaL,4688568,4688568,4688338,230,66,utRho18
1966,yfaP,4656398,4656398,4656286,112,0,utRho18
1967,yfaU,4717892,4717892,4717690,202,98,utRho18
1968,yfaY,4727310,4727310,4727266,44,250,utRho18
1969,yfaZ,4728744,4728744,4728550,194,0,utRho18
1970,yfbK,4771810,4771810,4771444,366,326,utRho18
1971,yfbL,4771500,4771720,4771500,220,198,utRho18
1972,yfbN,4777174,4777174,4776852,322,254,utRho18
1973,yfbO,4776916,4777162,4776916,246,222,utRho18
1974,yfbP,4777990,4778232,4777990,242,7236,utRho18
1975,yfbR,4817662,4817724,4817662,62,114,utRho18
1976,yfcI,4847424,4847424,4847078,346,848,utRho18
1977,yfcJ,4880482,4880482,4880240,242,766,utRho18
1978,yfcL,4888502,4888502,4888338,164,92,utRho18
1979,yfcV,4911642,4911642,4911292,350,868,utRho18
1980,yfcZ,4921958,4921958,4921868,90,52,utRho18
1981,yfdF,4925604,4926024,4925604,420,5980,utRho18
1982,yfdG,4935474,4935710,4935474,236,0,utRho18
1983,yfdP,4946844,4947040,4946844,196,282,utRho18
1984,yfdX,4988866,4988866,4988804,62,0,utRho18
1985,yfdY,4990672,4990672,4990584,88,372,utRho18
1986,yfeA,5035784,5035784,5035664,120,11130,utRho18
1987,yfeC,5036668,5036934,5036668,266,328,utRho18
1988,yfeH,5053818,5053892,5053818,74,78,utRho18
1989,yfeK,5074630,5074684,5074630,54,74,utRho18
1990,yfeO,5018906,5019260,5018906,354,326,utRho18
1991,yfeR,5054078,5054078,5053712,366,78,utRho18
1992,yfeX,5101356,5101356,5101090,266,378,utRho18
1993,yfeY,5102486,5102486,5102432,54,38,utRho18
1994,yfeZ,5103842,5103842,5103452,390,82,utRho18
1995,yffO,5123804,5124222,5123804,418,268,utRho18
1996,yffQ,5126778,5127154,5126778,376,140,utRho18
1997,yffS,5128800,5128986,5128800,186,18,utRho18
1998,yfgC,5232052,5232188,5232052,136,222,utRho18
1999,yfgF,5258062,5258062,5257876,186,492,utRho18
2000,yfgG,5258170,5258580,5258170,410,652,utRho18
2001,yfgH,5259344,5259584,5259344,240,160,utRho18
2002,yfgM,5278866,5278866,5278566,300,728,utRho18
2003,yfhH,5397414,5397518,5397414,104,14,utRho18
2004,yfhM,5304648,5304648,5304574,74,158,utRho18
2005,yfhR,5328408,5328726,5328408,318,10822,utRho18
2006,yfiC,5425610,5425610,5425528,82,0,utRho18
2007,yfiE,5430688,5430688,5430640,48,446,utRho18
2008,yfiL,5482630,5482720,5482630,90,0,utRho18
2009,yfiM,5448066,5448358,5448066,292,7716,utRho18
2010,yfiR,5483354,5483750,5483354,396,296,utRho18
2011,yfjH,5517326,5517326,5517200,126,100,utRho18
2012,yfjI,5517710,5517970,5517710,260,202,utRho18
2013,yfjJ,5521014,5521094,5521014,80,84,utRho18
2014,yfjM,5531970,5531970,5531552,418,5636,utRho18
2015,yfjP,5535080,5535420,5535080,340,728,utRho18
2016,yfjW,5546570,5546636,5546570,66,0,utRho18
2017,yfjX,5551776,5551838,5551776,62,0,utRho18
2018,ygaC,5601180,5601180,5599988,1192,1572,utRho18
2019,ygaM,5600242,5600292,5600242,50,470,utRho18
2020,ygaU,5593628,5593628,5593572,56,94,utRho18
2021,ygaZ,5619190,5619234,5619190,44,132,utRho18
2022,ygbA,5713656,5713656,5713612,44,52,utRho18
2023,ygbE,5746784,5746784,5746674,110,1482,utRho18
2024,ygbI,5722882,5722882,5722528,354,16,utRho18
2025,ygbK,5724394,5724670,5724394,276,1000,utRho18
2026,ygbL,5727074,5727186,5727074,112,0,utRho18
2027,ygbN,5729814,5730202,5729814,388,944,utRho18
2028,ygcG,5811210,5811422,5811210,212,0,utRho18
2029,ygcN,5785144,5785314,5785144,170,202,utRho18
2030,ygcU,5799214,5799214,5798836,378,120,utRho18
2031,ygcW,5800942,5800942,5800546,396,0,utRho18
2032,ygdD,5883442,5883442,5883262,180,66,utRho18
2033,ygdG,5861746,5861930,5861746,184,2504,utRho18
2034,ygdI,5886526,5886526,5886290,236,58,utRho18
2035,ygdQ,5940784,5940840,5940784,56,146,utRho18
2036,ygdR,5942494,5942542,5942494,48,0,utRho18
2037,ygeA,5961606,5961606,5961270,336,0,utRho18
2038,ygeH,5983758,5984188,5983758,430,1292,utRho18
2039,ygeI,5987162,5987276,5987162,114,4554,utRho18
2040,ygeR,6000078,6000078,5999782,296,976,utRho18
2041,ygeV,6011694,6011694,6011572,122,0,utRho18
2042,ygeW,6012234,6012524,6012234,290,706,utRho18
2043,ygfB,6110946,6110946,6110888,58,306,utRho18
2044,ygfK,6031984,6032120,6031984,136,276,utRho18
2045,ygfS,6058328,6058328,6058024,304,26,utRho18
2046,ygfZ,6082564,6082626,6082564,62,562,utRho18
2047,yggC,6149512,6149512,6149378,134,120,utRho18
2048,yggE,6136370,6136370,6136160,210,758,utRho18
2049,yggI,6179176,6179510,6179176,334,608,utRho18
2050,yggL,6204508,6204508,6204266,242,168,utRho18
2051,yggM,6199514,6199514,6199130,384,624,utRho18
2052,yggN,6203596,6203596,6203246,350,142,utRho18
2053,yggX,18623958,18624558,18623958,600,630,utRho18
2054,yghA,6298966,6299324,6298966,358,204,utRho18
2055,yghB,6307058,6307126,6307058,68,248,utRho18
2056,yghD,6222614,6222614,6222252,362,336,utRho18
2057,yghF,6225798,6225798,6225840,42,318,utRho18
2058,yghJ,6238640,6238640,6238224,416,204,utRho18
2059,yghQ,6265186,6265186,6264816,370,248,utRho18
2060,yghT,6267830,6268262,6267830,432,344,utRho18
2061,yghU,6277400,6277454,6277400,54,52,utRho18
2062,yghW,6293506,6293506,6293474,32,0,utRho18
2063,yghZ,6295562,6295794,6295562,232,600,utRho18
2064,ygiD,6365122,6365122,6364868,254,1970,utRho18
2065,ygiH,6409066,6409388,6409066,322,342,utRho18
2066,ygiL,6370622,6370828,6370622,206,142,utRho18
2067,ygiM,6402084,6402414,6402084,330,244,utRho18
2068,ygiN,6346156,6346284,6346156,128,1092,utRho18
2069,ygiQ,6322620,6322620,6322292,328,1272,utRho18
2070,ygiS,6335462,6335462,6335436,26,124,utRho18
2071,ygiV,6338582,6338582,6338462,120,30,utRho18
2072,ygiW,6339774,6339774,6339352,422,816,utRho18
2073,ygiZ,6344506,6344506,6344422,84,146,utRho18
2074,ygjH,6442528,6442528,6442494,34,0,utRho18
2075,ygjI,6452140,6452468,6452140,328,0,utRho18
2076,ygjQ,6472730,6473080,6472730,350,898,utRho18
2077,ygjR,6474564,6474586,6474564,22,64,utRho18
2078,ygjV,6483638,6483638,6483488,150,8,utRho18
2079,yhaB,6535632,6535708,6535632,76,14,utRho18
2080,yhaH,6504498,6504608,6504498,110,672,utRho18
2081,yhaI,6505400,6505822,6505400,422,220,utRho18
2082,yhaJ,6508560,6508560,6508428,132,122,utRho18
2083,yhaK,6508538,6508638,6508538,100,70,utRho18
2084,yhbQ,6599878,6599932,6599878,54,212,utRho18
2085,yhbT,6602736,6602736,6602552,184,576,utRho18
2086,yhbU,6602558,6602970,6602558,412,678,utRho18
2087,yhbX,6643302,6643302,6643226,76,0,utRho18
2088,yhbY,6655518,6655580,6655518,62,532,utRho18
2089,yhcA,6723956,6724224,6723956,268,868,utRho18
2090,yhcB,6760364,6760382,6760364,18,92,utRho18
2091,yhcC,6708470,6708470,6708100,370,1032,utRho18
2092,yhcF,6733440,6733852,6733440,412,1698,utRho18
2093,yhcH,6739124,6739124,6738956,168,542,utRho18
2094,yhcM,6760312,6760312,6759994,318,196,utRho18
2095,yhcN,6770812,6771076,6770812,264,88,utRho18
2096,yhcO,6772606,6772606,6772258,348,60,utRho18
2097,yhdH,6806560,6806968,6806560,408,258,utRho18
2098,yhdJ,6823234,6823306,6823234,72,0,utRho18
2099,yhdN,6879092,6879092,6879018,74,610,utRho18
2100,yhdT,6814702,6814750,6814702,48,26,utRho18
2101,yhdU,6824994,6825242,6824994,248,124,utRho18
2102,yhdV,6836392,6836780,6836392,388,1242,utRho18
2103,yhdW,6837944,6838298,6837944,354,132,utRho18
2104,yheO,6953082,6953082,6952880,202,788,utRho18
2105,yheV,6957970,6957970,6957584,386,190,utRho18
2106,yhfA,6971902,6971902,6971636,266,968,utRho18
2107,yhfG,6983294,6983294,6983240,54,1180,utRho18
2108,yhfL,6998622,6998896,6998622,274,24,utRho18
2109,yhfY,7023244,7023244,7022844,400,0,utRho18
2110,yhgA,7086294,7086334,7086294,40,134,utRho18
2111,yhgE,7065176,7065176,7064878,298,210,utRho18
2112,yhgF,7074352,7074770,7074352,418,6728,utRho18
2113,yhhA,7173458,7173886,7173458,428,344,utRho18
2114,yhhI,7248346,7248756,7248346,410,0,utRho18
2115,yhhJ,7253696,7253696,7253606,90,170,utRho18
2116,yhhM,7211588,7211588,7211220,368,1152,utRho18
2117,yhhN,7211150,7211502,7211150,352,800,utRho18
2118,yhhQ,7218238,7218434,7218238,196,484,utRho18
2119,yhhT,7223682,7223730,7223682,48,44,utRho18
2120,yhhX,7162032,7162032,7161610,422,112,utRho18
2121,yhhY,7162222,7162276,7162222,54,0,utRho18
2122,yhhZ,7163516,7163726,7163516,210,238,utRho18
2123,yhiD,7312220,7312220,7311804,416,71060,utRho18
2124,yhiJ,7265190,7265190,7265180,10,40,utRho18
2125,yhiM,7269270,7269682,7269270,412,1396,utRho18
2126,yhiN,7275000,7275000,7274820,180,306,utRho18
2127,yhjA,7338522,7338522,7338376,146,150,utRho18
2128,yhjB,7344090,7344090,7343788,302,750,utRho18
2129,yhjC,7344272,7344684,7344272,412,340,utRho18
2130,yhjD,7346660,7346724,7346660,64,62,utRho18
2131,yhjE,7349274,7349572,7349274,298,1042,utRho18
2132,yhjG,7356824,7356824,7356730,94,54,utRho18
2133,yhjH,7358458,7358458,7358374,84,336,utRho18
2134,yhjJ,7364032,7364032,7363880,152,418,utRho18
2135,yhjK,7371296,7371296,7371158,138,6,utRho18
2136,yhjR,7392750,7392750,7392370,380,388,utRho18
2137,yhjV,7400796,7401126,7400796,330,2458,utRho18
2138,yhjX,7424194,7424194,7424014,180,170,utRho18
2139,yhjY,7425966,7425966,7425868,98,34,utRho18
2140,yiaB,7455654,7455654,7455496,158,30,utRho18
2141,yiaD,7432712,7433094,7432712,382,668,utRho18
2142,yiaF,7438194,7438194,7438088,106,454,utRho18
2143,yiaG,7438862,7438956,7438862,94,392,utRho18
2144,yiaJ,7485236,7485236,7485064,172,204,utRho18
2145,yiaK,7485348,7485466,7485348,118,136,utRho18
2146,yiaT,7503924,7503924,7503736,188,0,utRho18
2147,yiaU,7503792,7503984,7503792,192,88,utRho18
2148,yiaY,7515856,7515856,7515654,202,488,utRho18
2149,yibF,7523950,7523950,7523910,40,104,utRho18
2150,yibG,7536128,7536354,7536128,226,196,utRho18
2151,yibL,7553194,7553330,7553194,136,338,utRho18
2152,yibN,7570112,7570112,7570030,82,392,utRho18
2153,yibT,7552848,7552848,7552760,88,636,utRho18
2154,yicC,7633290,7633352,7633290,62,34,utRho18
2155,yicH,7660862,7660914,7660862,52,96,utRho18
2156,yicJ,7673328,7673328,7671858,1470,10206,utRho18
2157,yicN,7685018,7685018,7684804,214,750,utRho18
2158,yicO,7687914,7687914,7687578,336,562,utRho18
2159,yicR,15250308,15250308,15250236,72,0,utRho18
2160,yidB,7755230,7755230,7754930,300,112,utRho18
2161,yidE,7732780,7732780,7732546,234,436,utRho18
2162,yidF,7711580,7711580,7711222,358,364,utRho18
2163,yidQ,7735088,7735456,7735088,368,1146,utRho18
2164,yidR,7738824,7738824,7738618,206,204,utRho18
2165,yieE,7787658,7787738,7787658,80,256,utRho18
2166,yieH,7793314,7793548,7793314,234,78,utRho18
2167,yieK,7798928,7798928,7798786,142,70,utRho18
2168,yifB,7900350,7900350,7899998,352,178,utRho18
2169,yifL,7988984,7989044,7988984,60,1718,utRho18
2170,yigF,8005750,8005750,8005598,152,13186,utRho18
2171,yigI,8009448,8009448,8009394,54,450,utRho18
2172,yigM,8022100,8022152,8022100,52,126,utRho18
2173,yihA,8101970,8101970,8101458,512,54,utRho18
2174,yihD,8084098,8084138,8084098,40,142,utRho18
2175,yihF,8088110,8088398,8088110,288,38,utRho18
2176,yihG,8093304,8093304,8093204,100,206,utRho18
2177,yihI,8102616,8102694,8102616,78,0,utRho18
2178,yihL,8120506,8120894,8120506,388,206,utRho18
2179,yihN,8124332,8124494,8124332,162,200,utRho18
2180,yihO,8131942,8131942,8131532,410,574,utRho18
2181,yihQ,8138892,8138892,8138552,340,102,utRho18
2182,yihV,8147064,8147478,8147064,414,266,utRho18
2183,yihX,8151096,8151106,8151096,10,120,utRho18
2184,yiiE,8158192,8158582,8158192,390,1084,utRho18
2185,yiiF,8159124,8159502,8159124,378,762,utRho18
2186,yiiG,8173762,8174004,8173762,242,0,utRho18
2187,yiiM,8205506,8205644,8205506,138,1176,utRho18
2188,yiiQ,8224624,8224624,8224428,196,224,utRho18
2189,yiiS,8225738,8225934,8225738,196,478,utRho18
2190,yijE,8272178,8272216,8272178,38,194,utRho18
2191,yijF,8275728,8275728,8275314,414,790,utRho18
2192,yijO,8296858,8296858,8296634,224,322,utRho18
2193,yjaA,8426240,8426468,8426240,228,286552,utRho18
2194,yjaB,8428312,8428312,8428246,66,350,utRho18
2195,yjaG,8398746,8399008,8398746,262,150,utRho18
2196,yjaH,8401022,8401132,8401022,110,470,utRho18
2197,yjaZ,8379506,8379572,8379506,66,100,utRho18
2198,yjbB,8455204,8455462,8455204,258,70,utRho18
2199,yjbE,16943432,16943624,16943432,192,236,utRho18
2200,yjbL,8520318,8520642,8520318,324,208,utRho18
2201,yjbQ,8540428,8540476,8540428,48,42,utRho18
2202,yjcB,8550328,8550328,8550082,246,310,utRho18
2203,yjcC,8550836,8550942,8550836,106,178,utRho18
2204,yjcD,8556628,8556958,8556628,330,340,utRho18
2205,yjcE,8559658,8559960,8559658,302,50,utRho18
2206,yjcF,8566212,8566212,8566150,62,60,utRho18
2207,yjcO,8594660,8594660,8594250,410,428,utRho18
2208,yjdA,8654128,8654270,8654128,142,0,utRho18
2209,yjdC,8726660,8726660,8726616,44,52,utRho18
2210,yjdK,8704780,8705168,8704780,388,3312,utRho18
2211,yjdL,8713034,8713034,8712822,212,0,utRho18
2212,yjdM,8653672,8653672,8653468,204,496,utRho18
2213,yjeF,8787354,8788132,8787354,778,76078,utRho18
2214,yjeI,8745522,8745618,8745522,96,192,utRho18
2215,yjeJ,8748806,8748806,8748468,338,496,utRho18
2216,yjeV,8785472,8785784,8785472,312,3546,utRho18
2217,yjfP,8833512,8833904,8833512,392,120,utRho18
2218,yjfY,8849656,8849656,8849582,74,422,utRho18
2219,yjfZ,8855052,8855052,8854844,208,264,utRho18
2220,yjgA,8916162,8916162,8915730,432,362,utRho18
2221,yjgL,8950802,8950874,8950802,72,108,utRho18
2222,yjgM,8959342,8959342,8959074,268,0,utRho18
2223,yjgN,8959132,8959460,8959132,328,0,utRho18
2224,yjgR,8980170,8980170,8980126,44,278,utRho18
2225,yjgZ,9002116,9002520,9002116,404,6524,utRho18
2226,yjhB,9007764,9008116,9007764,352,1552,utRho18
2227,yjhG,9048452,9048452,9048188,264,7818,utRho18
2228,yjhU,9041080,9041080,9040648,432,846,utRho18
2229,yjiA,9178096,9178096,9177730,366,2460,utRho18
2230,yjiJ,9125364,9125364,9125350,14,0,utRho18
2231,yjiK,9127270,9127270,9127422,152,316,utRho18
2232,yjiL,9129604,9129604,9129378,226,152,utRho18
2233,yjiS,9143410,9143502,9143410,92,262,utRho18
2234,yjiY,9182734,9182734,9182558,176,5088,utRho18
2235,yjjA,9200674,9200674,9200378,296,2250,utRho18
2236,yjjB,18408708,18408708,18407800,908,2724,utRho18
2237,yjjJ,9243314,9243538,9243314,224,0,utRho18
2238,yjjK,9261132,9261132,9261044,88,1440,utRho18
2239,yjjL,9189764,9189764,9189444,320,1112,utRho18
2240,yjjM,9191894,9191894,9191702,192,120,utRho18
2241,yjjP,9206068,9206068,9205716,352,12614,utRho18
2242,yjjQ,9206638,9206954,9206638,316,6394,utRho18
2243,yjjX,9267798,9267798,9267490,308,1004,utRho18
2244,yjjY,9280716,9280804,9280716,88,420,utRho18
2245,yjjZ,9211554,9211608,9211554,54,38454,utRho18
2246,yjtD,9281676,9281884,9281676,208,138,utRho18
2247,ykfB,532454,532454,532174,280,10184,utRho18
2248,ykfI,527636,527636,527338,298,1706,utRho18
2249,ykgB,637050,637050,636638,412,300,utRho18
2250,ykgC,640430,640430,640002,428,122,utRho18
2251,ykgD,640232,640454,640232,222,118,utRho18
2252,ykgE,642962,643216,642962,254,320,utRho18
2253,ykgJ,608524,608524,608364,160,364,utRho18
2254,ykgL,623878,624224,623878,346,1252,utRho18
2255,ykgM,625610,625610,625554,56,60,utRho18
2256,ykgR,626570,626570,626484,86,132,utRho18
2257,ylaC,958576,958576,958502,74,2146,utRho18
2258,yliE,1745938,1745958,1745938,20,0,utRho18
2259,ymcE,2103660,2103694,2103660,34,56,utRho18
2260,ymdA,2210450,2210828,2210450,378,282,utRho18
2261,ymdB,2211428,2211640,2211428,212,188,utRho18
2262,ymfD,2395322,2395322,2395064,258,950,utRho18
2263,ymfI,2402880,2402994,2402880,114,0,utRho18
2264,ymfJ,2404518,2404518,2404168,350,440,utRho18
2265,ymfK,2406176,2406176,2405866,310,0,utRho18
2266,ymfT,2405766,2406048,2405766,282,0,utRho18
2267,ymgE,2489110,2489456,2489110,346,1116,utRho18
2268,ymgF,2437628,2437966,2437628,338,48,utRho18
2269,ymiA,2670112,2670320,2670112,208,308,utRho18
2270,ymjA,2715620,2715620,2715336,284,278,utRho18
2271,ynaI,2791946,2791946,2791844,102,234,utRho18
2272,ynaK,2850438,2850754,2850438,316,38,utRho18
2273,ynbA,2954924,2955242,2954924,318,160,utRho18
2274,yncD,3046552,3046552,3046130,422,196,utRho18
2275,yncE,3046454,3046614,3046454,160,58,utRho18
2276,yncG,3052456,3052494,3052456,38,338,utRho18
2277,yncL,3034492,3034492,3034388,104,452,utRho18
2278,yneE,3218364,3218364,3218044,320,0,utRho18
2279,yneF,3223748,3223748,3223708,40,0,utRho18
2280,yneJ,3229560,3229608,3229560,48,106,utRho18
2281,yneK,3231100,3231526,3231100,426,214,utRho18
2282,yneM,3245176,3245292,3245176,116,252,utRho18
2283,ynfA,3311398,3311398,3311346,52,2,utRho18
2284,ynfB,3311418,3311616,3311418,198,390,utRho18
2285,ynfC,3315094,3315094,3314914,180,0,utRho18
2286,ynfD,3314828,3315130,3314828,302,0,utRho18
2287,ynfE,3316006,3316138,3316006,132,74,utRho18
2288,ynfK,3334670,3334670,3334438,232,408,utRho18
2289,ynfL,3339304,3339304,3339184,120,0,utRho18
2290,ynfM,3339260,3339398,3339260,138,0,utRho18
2291,ynfN,3276598,3276598,3276218,380,4,utRho18
2292,ynfO,3273454,3273512,3273454,58,112,utRho18
2293,ynhG,3517890,3517890,3517450,440,200,utRho18
2294,yniA,3615158,3615592,3615158,434,314,utRho18
2295,yniB,3618526,3618526,3618466,60,142,utRho18
2296,yniC,3618652,3618760,3618652,108,66,utRho18
2297,yniD,3610202,3610330,3610202,128,112,utRho18
2298,ynjE,3678880,3678934,3678880,54,144,utRho18
2299,ynjF,3683222,3683222,3682806,416,230,utRho18
2300,ynjH,3684376,3684376,3684270,106,26,utRho18
2301,ynjI,3690022,3690022,3689742,280,340,utRho18
2302,yoaB,3786642,3786734,3786642,92,212,utRho18
2303,yoaC,3787932,3788146,3787932,214,446,utRho18
2304,yoaE,3803544,3803544,3803170,374,886,utRho18
2305,yoaF,3755444,3755444,3755064,380,824,utRho18
2306,yoaH,3789866,3789866,3789462,404,502,utRho18
2307,yobB,3850418,3850880,3850418,462,600,utRho18
2308,yobF,3815586,3815586,3815182,404,382,utRho18
2309,yobH,3817800,3817850,3817800,50,388,utRho18
2310,yodB,4084352,4084736,4084352,384,780,utRho18
2311,yodC,4057008,4057008,4056740,268,368,utRho18
2312,yohC,4451358,4451358,4451262,96,82,utRho18
2313,yohD,4451526,4451602,4451526,76,134,utRho18
2314,yohJ,4460986,4461248,4460986,262,418,utRho18
2315,yohO,4431172,4431314,4431172,142,200,utRho18
2316,yojI,4617282,4617282,4617230,52,112,utRho18
2317,ypdI,4988988,4989396,4988988,408,106,utRho18
2318,ypfG,5165786,5165786,5165554,232,52,utRho18
2319,ypfM,5182140,5182140,5181732,408,1610,utRho18
2320,yphB,5349590,5349590,5349376,214,394,utRho18
2321,ypjA,5565644,5565644,5565452,192,576,utRho18
2322,ypjB,5569636,5569636,5568858,778,110,utRho18
2323,ypjD,5495860,5495774,5495860,86,92,utRho18
2324,yqaE,5594170,5594170,5594056,114,466,utRho18
2325,yqcA,5846100,5846100,5845968,132,168,utRho18
2326,yqcE,5800944,5801184,5800944,240,0,utRho18
2327,yqeC,6030468,6030468,6030114,354,1490,utRho18
2328,yqeF,5971618,5971618,5971184,434,1722,utRho18
2329,yqeG,5971438,5971694,5971438,256,2358,utRho18
2330,yqeH,5975016,5975072,5975016,56,2868,utRho18
2331,yqeI,5976688,5977004,5976688,316,160,utRho18
2332,yqeK,5981140,5981140,5980720,420,2402,utRho18
2333,yqfA,6086728,6086728,6086296,432,884,utRho18
2334,yqgA,6219042,6219106,6219042,64,48,utRho18
2335,yqgB,6172500,6172500,6172102,398,2634,utRho18
2336,yqgE,6185768,6185874,6185768,106,624,utRho18
2337,yqhA,6299150,6299150,6298942,208,102,utRho18
2338,yqhC,6310768,6310768,6310436,332,630,utRho18
2339,yqhD,6310604,6310710,6310604,106,234,utRho18
2340,yqhH,6316842,6317254,6316842,412,1112,utRho18
2341,yqiC,6369662,6369680,6369662,18,52,utRho18
2342,yqiJ,6384108,6384416,6384108,308,1268,utRho18
2343,yqjA,6495096,6495546,6495096,450,4554,utRho18
2344,yqjF,6500932,6501124,6500932,192,816,utRho18
2345,yqjG,6501948,6502048,6501948,100,86,utRho18
2346,yqjH,6433078,6433078,6432982,96,0,utRho18
2347,yqjI,6433506,6433558,6433506,52,0,utRho18
2348,yraH,6574552,6574852,6574552,300,134,utRho18
2349,yraP,6592144,6592818,6592144,674,938,utRho18
2350,yraQ,6596414,6596414,6596276,138,0,utRho18
2351,yraR,6598024,6598024,6597692,332,142,utRho18
2352,yrbG,13360844,13361100,13360844,256,0,utRho18
2353,yrbL,6696842,6696904,6696842,62,768,utRho18
2354,yrbN,6616172,6616172,6615866,306,3442,utRho18
2355,yrdB,6860176,6860176,6860046,130,30,utRho18
2356,yrfF,7052548,7052938,7052548,390,484,utRho18
2357,yrhB,7169440,7169518,7169440,78,0,utRho18
2358,ysaB,7451804,7451804,7451424,380,288,utRho18
2359,ysgA,8032686,8032686,8032338,348,864,utRho18
2360,ytfB,8857638,8857638,8857434,204,408,utRho18
2361,ytfE,8864018,8864018,8863966,52,232,utRho18
2362,ytfF,8866296,8866296,8866130,166,188,utRho18
2363,ytfH,8868164,8868226,8868164,62,490,utRho18
2364,ytfI,8875234,8875414,8875234,180,240,utRho18
2365,ytfJ,8878572,8878572,8878524,48,112,utRho18
2366,ytfK,8879022,8879174,8879022,152,270,utRho18
2367,ytfL,8882642,8882642,8882430,212,200,utRho18
2368,ytfQ,8899634,8899924,8899634,290,194,utRho18
2369,ytjB,9249598,9249598,9249578,20,130,utRho18
2370,yzfA,8896588,8896588,8896490,98,314,utRho18
2371,zapA,6111102,6111224,6111102,122,2716,utRho18
2372,zapB,8236772,8237030,8236772,258,316,utRho18
2373,zapC,2011700,2011904,2011700,204,4,utRho18
2374,zinT,4082692,4082750,4082692,58,328,utRho18
2375,zipA,5062814,5062814,5062466,348,0,utRho18
2376,zitB,1569716,1569716,1569646,70,94,utRho18
2377,zntA,7212844,7212902,7212844,58,0,utRho18
2378,zntR,6878336,6878336,6878260,76,128,utRho18
2379,znuA,3885322,3885322,3885166,156,212,utRho18
2380,znuC,3885268,3885324,3885268,56,196,utRho18
2381,zraP,8403424,8403424,8403376,48,0,utRho18
2382,zraS,8403810,8403852,8403810,42,0,utRho18
2383,zupT,6364866,6365100,6364866,234,1928,utRho18
2384,zur,8520282,8520282,8520006,276,742,utRho18
2385,zwf,3872752,3872752,3872628,124,420,utRho18
0,C0343,2818676,2818728,2818676,52,56,utRho19
1,aaeB,6776526,6776526,6776376,150,2,utRho19
2,aaeR,6778762,6779040,6778762,278,6,utRho19
3,aaeX,6778860,6778860,6778674,186,76,utRho19
4,aat,1854920,1854920,1854864,56,0,utRho19
5,accA,416822,417242,416822,420,964,utRho19
6,accB,6810280,6810872,6810280,592,4068,utRho19
7,accD,4868030,4868030,4867852,178,682,utRho19
8,aceB,8430804,8430956,8430804,152,170,utRho19
9,aceE,245938,246034,245938,96,248,utRho19
10,ackA,4826918,4826940,4826918,22,86,utRho19
11,acnA,2670848,2671662,2670848,814,3790,utRho19
12,acnB,263038,263230,263038,192,1272,utRho19
13,acpP,2303148,2303230,2303148,82,472,utRho19
14,acpS,5402324,5402324,5401996,328,512,utRho19
15,acrA,971396,971396,971238,158,116,utRho19
16,acrB,969370,969370,968806,564,3496,utRho19
17,acrD,5174950,5175190,5174950,240,20,utRho19
18,acrE,6827404,6827728,6827404,324,0,utRho19
19,acrR,971398,971522,971398,124,138,utRho19
20,acrZ,1589502,1589546,1589502,44,124,utRho19
21,acs,8575190,8575190,8574742,448,194,utRho19
22,actP,8569870,8569870,8569804,66,184,utRho19
23,ada,4620854,4620854,4620810,44,0,utRho19
24,add,3404404,3404466,3404404,62,0,utRho19
25,ade,7687802,7687928,7687802,126,0,utRho19
26,adhE,2596826,2596826,2596242,584,56,utRho19
27,adhP,3107988,3107988,3107676,312,2278,utRho19
28,adiA,8681112,8681112,8681042,70,0,utRho19
29,adiC,8674404,8674404,8674062,342,122,utRho19
30,adiY,8676084,8676084,8675858,226,12,utRho19
31,adk,994278,994350,994278,72,12,utRho19
32,adrA,807374,807406,807374,32,2,utRho19
33,aer,6438240,6438240,6438152,88,0,utRho19
34,aes,1000102,1000102,999946,156,30,utRho19
35,agaR,6557406,6557406,6557330,76,0,utRho19
36,agaS,6563778,6563952,6563778,174,0,utRho19
37,agp,2131118,2131170,2131118,52,0,utRho19
38,agrA,7296126,7296126,7296126,0,0,utRho19
39,agrB,7296588,7296588,7296588,0,0,utRho19
40,ahpC,1277386,1277890,1277386,504,4488,utRho19
41,ahpF,1278004,1279506,1278004,1502,364288,utRho19
42,ahr,8992698,8992698,8992418,280,8,utRho19
43,aidB,8828494,8828550,8828494,56,0,utRho19
44,ais,4731512,4731512,4731240,272,0,utRho19
45,alaA,4814816,4815122,4814816,306,2,utRho19
46,alaC,4996798,4996798,4996590,208,0,utRho19
47,alaE,5598140,5598328,5598140,188,858,utRho19
48,alaS,5644180,5644180,5644022,158,3860,utRho19
49,alaW,5036612,5036612,5036462,150,12,utRho19
50,aldA,2976380,2976464,2976380,84,924,utRho19
51,aldB,7513070,7513070,7513022,48,24,utRho19
52,alkA,4295118,4295118,4295080,38,106,utRho19
53,alkB,4618890,4618890,4618682,208,0,utRho19
54,allA,1064780,1064902,1064780,122,0,utRho19
55,allD,1092822,1092822,1092726,96,0,utRho19
56,allE,1088112,1088112,1088092,20,60,utRho19
57,allS,1064600,1064600,1064442,158,4,utRho19
58,alr,8531178,8531564,8531178,386,1692,utRho19
59,alsE,8617334,8617334,8616956,378,466,utRho19
60,alsK,8615990,8615990,8615598,392,122,utRho19
61,alx,6476740,6477160,6476740,420,24,utRho19
62,amiA,5104482,5104704,5104482,222,0,utRho19
63,amiC,5898378,5898378,5898020,358,0,utRho19
64,amn,4110062,4110122,4110062,60,0,utRho19
65,ampC,8758006,8758006,8757888,118,0,utRho19
66,ampD,237362,237466,237362,104,98,utRho19
67,ampG,907372,907372,907090,282,556,utRho19
68,ampH,792726,792726,792574,152,28,utRho19
69,amyA,4012230,4012312,4012230,82,0,utRho19
70,anmK,3439346,3439346,3439204,142,2,utRho19
71,ansB,6201580,6201580,6201456,124,4,utRho19
72,ansP,3052040,3052040,3051960,80,86,utRho19
73,apaG,104068,104068,103212,856,4304,utRho19
74,apaH,102586,102586,102444,142,5720,utRho19
75,apbE,4623188,4623188,4623068,120,72,utRho19
76,appA,2081198,2081234,2081198,36,62,utRho19
77,appC,2075420,2075480,2075420,60,0,utRho19
78,appY,1167134,1167362,1167134,228,0,utRho19
79,apt,982620,982824,982620,204,156,utRho19
80,aqpZ,1832424,1832424,1832094,330,80,utRho19
81,araB,140150,140150,140096,54,0,utRho19
82,araC,140482,140774,140482,292,1526,utRho19
83,araE,5964416,5964416,5964364,52,0,utRho19
84,araF,3972476,3972476,3972256,220,112,utRho19
85,araH,3967120,3967120,3967086,34,10,utRho19
86,araJ,825058,825058,824962,96,28,utRho19
87,arcA,9281602,9281602,9280612,990,13462,utRho19
88,arcB,6706098,6706098,6706050,48,0,utRho19
89,arcZ,6701154,6701154,6701154,0,0,utRho19
90,arfA,6877346,6877346,6877298,48,128,utRho19
91,argA,5898312,5898484,5898312,172,0,utRho19
92,argC,8309770,8310002,8309770,232,166,utRho19
93,argD,6980442,6980442,6980360,82,2,utRho19
94,argE,8310156,8310156,8309694,462,368,utRho19
95,argF,580680,580680,580610,70,0,utRho19
96,argG,6637124,6637274,6637124,150,40,utRho19
97,argI,8956688,8956688,8956622,66,2,utRho19
98,argO,6137672,6137672,6137616,56,68,utRho19
99,argP,6119460,6119506,6119460,46,2,utRho19
100,argR,6769204,6769406,6769204,202,52,utRho19
101,argS,3920002,3920124,3920002,122,66,utRho19
102,argT,4855698,4855698,4855582,116,22,utRho19
103,argU,1129406,1129446,1129406,40,0,utRho19
104,argW,4932616,4932618,4932616,2,0,utRho19
105,argX,7964728,7964750,7964728,22,34,utRho19
106,aroF,5482402,5482402,5482300,102,0,utRho19
107,aroG,1571182,1571266,1571182,84,166,utRho19
108,aroH,3576636,3576870,3576636,234,630,utRho19
109,aroK,7038760,7038760,7038128,632,1034,utRho19
110,aroL,812560,812810,812560,250,28,utRho19
111,aroP,243342,243342,243102,240,0,utRho19
112,arpA,8445382,8445382,8444974,408,106,utRho19
113,arrS,7316108,7316108,7316108,0,0,utRho19
114,arsR,7297024,7297056,7297024,32,0,utRho19
115,artJ,1801252,1801252,1801150,102,0,utRho19
116,artP,1807686,1807686,1807468,218,1978,utRho19
117,ascF,5678858,5679048,5678858,190,0,utRho19
118,ascG,5678574,5678574,5678528,46,0,utRho19
119,aslB,7965562,7965916,7965562,354,242,utRho19
120,asnA,7854258,7854310,7854258,52,12,utRho19
121,asnB,1398444,1398444,1398354,90,112,utRho19
122,asnC,23562186,23562186,23562018,168,12,utRho19
123,asnS,1978088,1978088,1977970,118,11646,utRho19
124,asnT,4089082,4089098,4089082,16,610,utRho19
125,asnU,4119690,4119702,4119690,12,4,utRho19
126,asnV,4124504,4124520,4124504,16,42,utRho19
127,aspA,17473728,17473728,17473308,420,328,utRho19
128,aspC,1971486,1971486,1971418,68,210,utRho19
129,aspS,3901402,3901402,3901044,358,98,utRho19
130,aspT,7893560,7893744,7893560,184,120474,utRho19
131,aspV,473826,473862,473826,36,10,utRho19
132,asr,3342654,3342752,3342654,98,210,utRho19
133,astC,3664088,3664088,3663964,124,46,utRho19
134,astE,3654138,3654138,3653846,292,6,utRho19
135,atoD,4646824,4646894,4646824,70,38,utRho19
136,atpB,7844540,7844540,7844102,438,130,utRho19
137,atpC,7832118,7832118,7831944,174,398,utRho19
138,atpI,7845050,7845050,7844880,170,0,utRho19
139,avtA,7479348,7479410,7479348,62,26,utRho19
140,azoR,2965982,2965982,2965720,262,406,utRho19
141,azuC,3976002,3976002,3975918,84,0,utRho19
142,bacA,6408350,6408350,6408262,88,60,utRho19
143,bamA,394052,395856,394052,1804,1176,utRho19
144,bamB,5277950,5277950,5277304,646,1778,utRho19
145,bamC,5198028,5198028,5197730,298,2974,utRho19
146,bamD,5471922,5472292,5471922,370,1288,utRho19
147,bamE,5506972,5507210,5506972,238,396,utRho19
148,basS,8666954,8666954,8666544,410,730,utRho19
149,bax,7474468,7474468,7474354,114,12,utRho19
150,bcp,5200874,5200956,5200874,82,4062,utRho19
151,bcsB,7385346,7385346,7385214,132,32,utRho19
152,bcsE,7392644,7392916,7392644,272,0,utRho19
153,bdcA,8948128,8948128,8948106,22,20,utRho19
154,bdcR,8948192,8948248,8948192,56,4,utRho19
155,bdm,3112680,3112680,3112560,120,90,utRho19
156,betA,654522,654522,654494,28,286,utRho19
157,betI,658722,658722,658668,54,4,utRho19
158,betT,658842,658926,658842,84,42,utRho19
159,bfr,6933498,6933498,6933450,48,172,utRho19
160,bglG,23440182,23440182,23439402,780,6,utRho19
161,bglX,4444240,4444240,4443978,262,0,utRho19
162,bhsA,2337962,2338146,2337962,184,2,utRho19
163,bioA,1618584,1618584,1618514,70,0,utRho19
164,bioB,1618604,1618688,1618604,84,4,utRho19
165,bioH,7089716,7089716,7089688,28,0,utRho19
166,bisC,7433026,7433026,7432788,238,4,utRho19
167,blc,8755490,8755490,8755444,46,4,utRho19
168,blr,3409024,3409102,3409024,78,202,utRho19
169,bluF,2431226,2431226,2430950,276,30,utRho19
170,bluR,2428226,2428226,2428118,108,0,utRho19
171,bolA,908698,908944,908698,246,0,utRho19
172,borD,1157842,1157842,1157786,56,58,utRho19
173,brnQ,838976,839182,838976,206,600,utRho19
174,bssR,1756492,1756496,1756492,4,0,utRho19
175,bssS,2242116,2242116,2241910,206,174,utRho19
176,btuB,8326798,8327278,8326798,480,2800,utRho19
177,cadB,8720212,8720212,8720062,150,2,utRho19
178,cadC,8723926,8723926,8723868,58,0,utRho19
179,caiE,70998,70998,70742,256,10,utRho19
180,caiF,68436,68600,68436,164,14,utRho19
181,caiT,84074,84074,83862,212,0,utRho19
182,can,285406,285406,285340,66,144,utRho19
183,carA,59102,59302,59102,200,14,utRho19
184,carB,61550,61634,61550,84,284,utRho19
185,cas2,5757830,5757830,5757706,124,118,utRho19
186,casA,5768638,5768638,5768276,362,0,utRho19
187,cbl,4121882,4121882,4121828,54,148,utRho19
188,cbpA,2128074,2128074,2127550,524,92,utRho19
189,cbrA,7738628,7738754,7738628,126,0,utRho19
190,cbrB,7794958,7795012,7794958,54,2,utRho19
191,ccmH,4585242,4585242,4584820,422,2,utRho19
192,cdaR,364894,364926,364894,32,0,utRho19
193,cdd,4463638,4463688,4463638,50,28,utRho19
194,cdh,8219814,8219860,8219814,46,8,utRho19
195,cdsA,391110,391354,391110,244,432,utRho19
196,cedA,3627484,3627484,3627326,158,52,utRho19
197,cfa,3482402,3482826,3482402,424,580,utRho19
198,chaC,2544844,2544972,2544844,128,14,utRho19
199,chbB,3643452,3643452,3643238,214,2,utRho19
200,chbG,3634624,3634624,3634270,354,0,utRho19
201,cheW,3946924,3946924,3946678,246,170,utRho19
202,chiA,6939792,6939792,6939706,86,0,utRho19
203,chiP,1416472,1416668,1416472,196,2,utRho19
204,cho,3646984,3647030,3646984,46,162,utRho19
205,chpS,8896804,8896894,8896804,90,4,utRho19
206,cirA,4493884,4493884,4493538,346,4,utRho19
207,citC,1304078,1304078,1303712,366,0,utRho19
208,citT,1293264,1293264,1293160,104,2,utRho19
209,clcA,350104,350214,350104,110,220,utRho19
210,clpA,1846160,1846528,1846160,368,140,utRho19
211,clpB,5468410,5468410,5468346,64,190,utRho19
212,clpP,913154,913354,913154,200,614,utRho19
213,clpS,1845500,1845826,1845500,326,0,utRho19
214,clpX,914404,914852,914404,448,3248,utRho19
215,clsA,2617346,2617346,2617290,56,118,utRho19
216,clsC,2212584,2212710,2212584,126,942,utRho19
217,cmk,1922330,1922402,1922330,72,112,utRho19
218,cnu,3409522,3409898,3409522,376,854,utRho19
219,coaA,8350214,8350214,8350052,162,42,utRho19
220,cobC,1340092,1340092,1339814,278,358,utRho19
221,cobT,4129202,4129202,4128934,268,0,utRho19
222,cobU,4131944,4131944,4131528,416,28,utRho19
223,codB,709768,709844,709768,76,8,utRho19
224,comR,2337726,2337726,2337664,62,0,utRho19
225,copA,1022822,1022822,1022758,64,0,utRho19
226,corA,8002388,8002852,8002388,464,5304,utRho19
227,cpdB,8873258,8873258,8873130,128,440,utRho19
228,cptB,6082198,6082198,6082140,58,0,utRho19
229,cpxA,8210202,8210202,8209950,252,1680,utRho19
230,cpxP,8211570,8211640,8211570,70,302,utRho19
231,cpxR,8211372,8211372,8211340,32,246,utRho19
232,cra,175894,176056,175894,162,40,utRho19
233,crcB,1316016,1316016,1315876,140,2,utRho19
234,creA,9270486,9271042,9270486,556,884,utRho19
235,creD,9276320,9276356,9276320,36,2,utRho19
236,crl,515620,515658,515620,38,3742,utRho19
237,crp,6971906,6972240,6971906,334,3846,utRho19
238,crr,5070960,5071668,5070960,708,13692,utRho19
239,csdA,5886414,5886674,5886414,260,2,utRho19
240,csgB,2207718,2207902,2207718,184,2,utRho19
241,csgD,2206688,2206688,2206392,296,4,utRho19
242,csgG,2203510,2203510,2203368,142,66,utRho19
243,csiD,5577854,5577970,5577854,116,1550,utRho19
244,csiE,5330802,5330870,5330802,68,162,utRho19
245,csiR,5590942,5591348,5590942,406,492,utRho19
246,cspA,7439778,7440098,7439778,320,620,utRho19
247,cspB,3283430,3283430,3283108,322,0,utRho19
248,cspC,3815018,3815018,3814870,148,434,utRho19
249,cspD,1845352,1845352,1845180,172,20648,utRho19
250,cspE,1314294,1314584,1314294,290,0,utRho19
251,cspF,3283380,3283710,3283380,330,0,utRho19
252,cspG,2102610,2102922,2102610,312,136,utRho19
253,cspH,2102746,2102746,2102350,396,0,utRho19
254,cspI,3277624,3277624,3277334,290,0,utRho19
255,csrA,5638746,5638746,5638292,454,2434,utRho19
256,csrB,5849048,5849048,5849048,0,0,utRho19
257,csrC,8102072,8102072,8102072,0,0,utRho19
258,csrD,6806850,6806850,6806664,186,430,utRho19
259,cstA,1259710,1259788,1259710,78,0,utRho19
260,cueO,274090,274166,274090,76,100,utRho19
261,cueR,1027948,1027986,1027948,38,78,utRho19
262,curA,3037784,3038054,3037784,270,10,utRho19
263,cusC,1191146,1191200,1191146,54,0,utRho19
264,cusR,1190924,1190924,1190886,38,36,utRho19
265,cutA,8730784,8730784,8730712,72,72,utRho19
266,cutC,3918534,3918534,3917920,614,234,utRho19
267,cvpA,4861600,4861600,4861526,74,0,utRho19
268,cvrA,2484328,2484328,2484142,186,58,utRho19
269,cyaA,7981548,7982306,7981548,758,1070,utRho19
270,cyaR,4334228,4334224,4334228,4,0,utRho19
271,cyaY,7988166,7988166,7988118,48,58,utRho19
272,cybB,2981522,2981804,2981522,282,50,utRho19
273,cycA,8859560,8859728,8859560,168,76,utRho19
274,cydA,1542340,1542916,1542340,576,558,utRho19
275,cydC,1858800,1858800,1858390,410,326,utRho19
276,cydD,1862062,1862062,1861924,138,2,utRho19
277,cydX,1548300,1548392,1548300,92,546,utRho19
278,cynR,717418,717418,717380,38,2,utRho19
279,cynT,1435092,1435196,1435092,104,0,utRho19
280,cyoA,903306,903306,903220,86,1104,utRho19
281,cyoE,895540,895540,895410,130,396,utRho19
282,cysB,2667576,2667710,2667576,134,606,utRho19
283,cysC,5748056,5748056,5747984,72,44,utRho19
284,cysD,5752736,5752736,5752658,78,0,utRho19
285,cysE,7565362,7565362,7565124,238,1796,utRho19
286,cysG,6995508,6995656,6995508,148,48,utRho19
287,cysJ,5783928,5783928,5783796,132,92,utRho19
288,cysK,5064688,5064818,5064688,130,156,utRho19
289,cysP,5087114,5087114,5087056,58,8,utRho19
290,cysS,1109154,1109222,1109154,68,44,utRho19
291,cysT,3984100,3984100,3983974,126,136,utRho19
292,cysZ,5062766,5062926,5062766,160,270,utRho19
293,cytR,8249018,8249018,8248912,106,60,utRho19
294,dacA,1328002,1328002,1327926,76,202,utRho19
295,dacB,6657714,6657926,6657714,212,0,utRho19
296,dacC,1761306,1761454,1761306,148,2,utRho19
297,dadA,2475018,2475142,2475018,124,114,utRho19
298,dam,7032504,7032504,7031826,678,1452,utRho19
299,damX,7035200,7035200,7034612,588,372,utRho19
300,dapA,5199568,5199568,5199520,48,0,utRho19
301,dapB,56576,56748,56576,172,30,utRho19
302,dapD,371954,371954,371894,60,554,utRho19
303,dapE,5183120,5183214,5183120,94,688,utRho19
304,dcp,3254844,3254844,3254760,84,134,utRho19
305,dcrB,7219534,7219910,7219534,376,8,utRho19
306,dctA,7366996,7366996,7366894,102,280,utRho19
307,dcuA,8733686,8733686,8733546,140,4,utRho19
308,dcuB,8698182,8698182,8697488,694,48,utRho19
309,dcuC,1312166,1312166,1311936,230,6,utRho19
310,dcuD,6749166,6749738,6749166,572,8,utRho19
311,dcuR,8701130,8701130,8700068,1062,656,utRho19
312,dcuS,8703370,8703370,8703324,46,6,utRho19
313,dcyD,3999016,3999016,3998960,56,0,utRho19
314,ddpX,3126498,3126498,3126152,346,6,utRho19
315,deaD,6615818,6615818,6615720,98,122,utRho19
316,dedA,4869880,4869880,4869482,398,8444,utRho19
317,dedD,4863750,4863750,4863368,382,40,utRho19
318,def,6867300,6867380,6867300,80,0,utRho19
319,degP,361690,361768,361690,78,0,utRho19
320,degQ,6761308,6761486,6761308,178,216,utRho19
321,deoB,9239134,9239206,9239134,72,4,utRho19
322,deoC,9233358,9234646,9233358,1288,394,utRho19
323,dfp,7625406,7625462,7625406,56,0,utRho19
324,dgcZ,3247758,3247758,3247700,58,0,utRho19
325,dgkA,8512914,8513274,8512914,360,676,utRho19
326,dgt,358392,358474,358392,82,10,utRho19
327,dhaK,2501888,2501888,2501676,212,236,utRho19
328,dhaR,2502006,2502132,2502006,126,0,utRho19
329,dicB,3299194,3299218,3299194,24,0,utRho19
330,dicC,3295752,3295752,3295700,52,0,utRho19
331,dinB,501760,501796,501760,36,0,utRho19
332,dinD,7635398,7635520,7635398,122,0,utRho19
333,dinG,1666146,1666140,1666146,6,0,utRho19
334,dinI,2243018,2243018,2242974,44,4,utRho19
335,dinJ,493230,493230,493004,226,2,utRho19
336,dinQ,7295964,7295964,7295576,388,358,utRho19
337,djlA,114536,114728,114536,192,4,utRho19
338,dkgA,6313142,6313246,6313142,104,1632,utRho19
339,dkgB,458196,458334,458196,138,0,utRho19
340,dksA,321502,321502,321208,294,676,utRho19
341,dld,4444164,4444370,4444164,206,22,utRho19
342,dmlA,3763424,3763824,3763424,400,162,utRho19
343,dmlR,3763710,3763710,3763618,92,4,utRho19
344,dmsA,1881646,1881918,1881646,272,0,utRho19
345,dnaA,7767922,7767922,7767458,464,1314,utRho19
346,dnaB,8528566,8528628,8528566,62,152,utRho19
347,dnaK,24096,24326,24096,230,2250,utRho19
348,dnaN,7765466,7765466,7764642,824,68,utRho19
349,dnaQ,471868,472134,471868,266,2340,utRho19
350,dnaT,18406460,18406460,18406068,392,384,utRho19
351,dnaX,984112,984184,984112,72,320,utRho19
352,dosP,3131486,3131486,3131466,20,110,utRho19
353,dpiB,1303968,1304470,1303968,502,0,utRho19
354,dppA,7415740,7415740,7415410,330,4258,utRho19
355,dps,1697900,1697900,1697822,78,478,utRho19
356,dsbA,8086754,8086836,8086754,82,2158,utRho19
357,dsbB,2466294,2466294,2466060,234,0,utRho19
358,dsbC,6079266,6079266,6077644,1622,1948,utRho19
359,dsbG,1277600,1277600,1277146,454,716,utRho19
360,dsdA,4958242,4958404,4958242,162,118,utRho19
361,dsdC,4955492,4955492,4955258,234,2,utRho19
362,dsdX,4955642,4955694,4955642,52,4,utRho19
363,dsrA,4050626,4050626,4050626,0,0,utRho19
364,dsrB,4049686,4049686,4049646,40,6,utRho19
365,dtpD,1485340,1485340,1485112,228,4,utRho19
366,dusA,8523200,8523338,8523200,138,516,utRho19
367,dusB,6820492,6820560,6820492,68,0,utRho19
368,dusC,4460790,4460790,4460770,20,0,utRho19
369,dut,7627704,7627864,7627704,160,1690,utRho19
370,dxr,386670,387042,386670,372,1912,utRho19
371,ebgA,6445102,6445266,6445102,164,0,utRho19
372,ebgR,6442874,6442932,6442874,58,54,utRho19
373,ecnB,8753018,8753106,8753018,88,52,utRho19
374,eco,4607594,4607810,4607594,216,4,utRho19
375,ecpA,621594,621594,621342,252,0,utRho19
376,ecpB,620238,620238,620052,186,0,utRho19
377,ecpR,622964,622964,622672,292,0,utRho19
378,eda,3866218,3866218,3865512,706,498,utRho19
379,edd,3869426,3869426,3869208,218,0,utRho19
380,efeO,2164308,2164486,2164308,178,132,utRho19
381,efeU_1,2162614,2162712,2162614,98,60,utRho19
382,efp,8751134,8751398,8751134,264,3154,utRho19
383,elaA,4763372,4763372,4763086,286,126,utRho19
384,elaD,4765308,4765426,4765308,118,0,utRho19
385,elfA,1995530,1995736,1995530,206,0,utRho19
386,elfD,1996642,1996980,1996642,338,0,utRho19
387,emrD,7707690,7707844,7707690,154,12,utRho19
388,emrK,4966896,4966896,4966678,218,2,utRho19
389,emrY,4964668,4964668,4964352,316,268,utRho19
390,emtA,2486250,2486360,2486250,110,0,utRho19
391,endA,12361100,12361388,12361100,288,0,utRho19
392,eno,5817692,5817692,5815882,1810,4574,utRho19
393,entC,1249662,1249770,1249662,108,2,utRho19
394,entD,1220508,1220508,1220158,350,52,utRho19
395,entH,1258584,1258600,1258584,16,0,utRho19
396,entS,1244506,1244600,1244506,94,40,utRho19
397,envR,6827266,6827266,6826930,336,0,utRho19
398,epd,12295292,12295292,12294764,528,312,utRho19
399,epmA,8765236,8765286,8765236,50,4,utRho19
400,epmB,8751406,8751406,8751314,92,976,utRho19
401,eptB,7421162,7421162,7420950,212,80,utRho19
402,eptC,8300622,8300622,8300530,92,46,utRho19
403,erfK,4126708,4126708,4126646,62,4,utRho19
404,erpA,353122,353220,353122,98,8,utRho19
405,esrE,8039956,8039956,8039956,0,0,utRho19
406,essD,1153746,1154796,1153746,1050,124,utRho19
407,etk,2088606,2088606,2088420,186,16,utRho19
408,evgA,4967262,4967510,4967262,248,0,utRho19
409,exbB,6304028,6304028,6303968,60,0,utRho19
410,exbD,6302780,6302780,6302486,294,200,utRho19
411,exuR,6493016,6493304,6493016,288,96,utRho19
412,exuT,6490004,6490208,6490004,204,0,utRho19
413,fabA,2032996,2032996,2032940,56,132,utRho19
414,fabB,4883282,4883282,4883210,72,64,utRho19
415,fabH,2297032,2297518,2297032,486,656,utRho19
416,fabI,2702236,2702236,2702078,158,2,utRho19
417,fadB,8062026,8062026,8061942,84,0,utRho19
418,fadD,3779614,3779614,3779492,122,0,utRho19
419,fadE,486812,486812,486606,206,0,utRho19
420,fadH,6463248,6463330,6463248,82,4,utRho19
421,fadI,4921022,4921022,4920938,84,6,utRho19
422,fadL,4922410,4922600,4922410,190,452,utRho19
423,fadM,928720,928804,928720,84,0,utRho19
424,fadR,2469810,2469876,2469810,66,0,utRho19
425,fbaB,4357334,4357334,4357128,206,882,utRho19
426,fdhE,8162722,8162722,8162456,266,1708,utRho19
427,fdhF,8598814,8598814,8598732,82,46,utRho19
428,fdnG,3094744,3094802,3094744,58,0,utRho19
429,fdrA,1093012,1093360,1093012,348,0,utRho19
430,feaB,2894994,2895038,2894994,44,0,utRho19
431,feaR,2894734,2894734,2894566,168,22,utRho19
432,fecA,9033454,9033454,9033354,100,80,utRho19
433,fecE,9023288,9023288,9022914,374,1268,utRho19
434,fecI,9036564,9036564,9036470,94,16,utRho19
435,feoA,7080114,7080326,7080114,212,570,utRho19
436,fepA,1225334,1225334,1224988,346,6,utRho19
437,fepB,1249454,1249454,1249020,434,2,utRho19
438,fepD,1244468,1244468,1244378,90,0,utRho19
439,fes,1225374,1225630,1225374,256,44,utRho19
440,ffh,5495706,5495706,5495590,116,1432,utRho19
441,ffs,952576,952848,952576,272,96,utRho19
442,fhuA,334884,334968,334884,84,42,utRho19
443,fhuE,2323294,2323294,2323102,192,290,utRho19
444,fhuF,9211504,9211504,9211326,178,734,utRho19
445,fic,6983296,6983296,6982926,370,464,utRho19
446,fieF,8212864,8212938,8212864,74,2,utRho19
447,fimA,9085388,9086230,9085388,842,504,utRho19
448,fimB,9081334,9081914,9081334,580,2130,utRho19
449,fimE,9083742,9084074,9083742,332,24,utRho19
450,fimZ,1129214,1129214,1128960,254,0,utRho19
451,fiu,1683296,1683296,1683062,234,2,utRho19
452,fixA,84650,84806,84650,156,56,utRho19
453,fkpA,6955050,6955050,6954838,212,3604,utRho19
454,fldA,2846084,2846084,2845860,224,4172,utRho19
455,fldB,6079644,6079710,6079644,66,0,utRho19
456,flgA,2261770,2261770,2261726,44,12,utRho19
457,flgB,2261986,2262036,2261986,50,2,utRho19
458,flgK,2276702,2276756,2276702,54,2,utRho19
459,flgM,2260330,2260330,2260256,74,42,utRho19
460,flgN,2259828,2259828,2259660,168,0,utRho19
461,flhB,3932432,3932432,3932382,50,246,utRho19
462,flhC,3955864,3955864,3955688,176,2,utRho19
463,flhD,3957154,3957154,3956394,760,354,utRho19
464,fliA,4003638,4003638,4003578,60,0,utRho19
465,fliC,4007352,4007352,4007212,140,0,utRho19
466,fliD,4007634,4007744,4007634,110,114,utRho19
467,fliE,4026186,4026186,4026028,158,6,utRho19
468,fliF,4026292,4026458,4026292,166,2,utRho19
469,fliL,4039168,4039236,4039168,68,0,utRho19
470,flk,4875824,4875900,4875824,76,0,utRho19
471,flu,4142634,4143078,4142634,444,2,utRho19
472,flxA,3292776,3292810,3292776,34,66,utRho19
473,fnr,2799104,2799104,2799052,52,0,utRho19
474,fnrS,2818258,2818258,2818258,0,0,utRho19
475,focA,1909628,1909628,1908932,696,186,utRho19
476,folA,99598,99646,99598,48,2,utRho19
477,folB,6409296,6409296,6409178,118,2,utRho19
478,folD,1115562,1115562,1115482,80,84,utRho19
479,folE,4487696,4487696,4487304,392,2990,utRho19
480,fpr,8228998,8228998,8228944,54,0,utRho19
481,frc,4986878,4986878,4986508,370,0,utRho19
482,frdA,8764824,8764824,8764636,188,4,utRho19
483,frdD,8758948,8758948,8758732,216,762,utRho19
484,fre,8052886,8053054,8052886,168,1788,utRho19
485,frlA,6999518,6999820,6999518,302,6,utRho19
486,frr,385624,385744,385624,120,1550,utRho19
487,frsA,513004,513054,513004,50,8,utRho19
488,fruB,4527194,4527194,4526990,204,18,utRho19
489,frvR,8179804,8179804,8179710,94,0,utRho19
490,fryA,5008986,5008986,5008970,16,4,utRho19
491,fsaA,1727060,1727284,1727060,224,4,utRho19
492,fsr,1009710,1009710,1009392,318,176,utRho19
493,ftnA,3977364,3977432,3977364,68,2,utRho19
494,ftnB,3973550,3973850,3973550,300,228,utRho19
495,ftsA,207122,207964,207122,842,1254,utRho19
496,ftsB,5745802,5745802,5745640,162,328,utRho19
497,ftsH,6654204,6654204,6653870,334,300,utRho19
498,ftsK,1865858,1866448,1865858,590,3164,utRho19
499,ftsL,181376,182064,181376,688,3550,utRho19
500,ftsP,6325732,6325732,6325338,394,406,utRho19
501,ftsQ,205484,206310,205484,826,1214,utRho19
502,ftsX,7204512,7204512,7204172,340,1116,utRho19
503,ftsZ,209272,210610,209272,1338,268,utRho19
504,fucA,5867708,5867708,5867376,332,28,utRho19
505,fucP,5868238,5868470,5868238,232,0,utRho19
506,fumA,6753760,6753760,6753508,252,10604,utRho19
507,fumB,8694696,8694696,8694652,44,0,utRho19
508,fumC,3373418,3373418,3373176,242,74,utRho19
509,fur,2842892,2842892,2842584,308,7380,utRho19
510,fusA,6947370,6947370,6947028,342,15168,utRho19
511,fxsA,8737206,8737328,8737206,122,256,utRho19
512,gabD,5581824,5582546,5581824,722,46384,utRho19
513,gadA,7335214,7335214,7335160,54,0,utRho19
514,gadB,3144144,3144144,3144090,54,8,utRho19
515,gadC,3141168,3141168,3140978,190,120,utRho19
516,gadE,7315600,7316732,7315600,1132,14,utRho19
517,gadW,7329562,7329562,7329236,326,126,utRho19
518,gadX,14663356,14663356,14663240,116,192,utRho19
519,gadY,7329728,7329728,7329728,0,0,utRho19
520,galE,1584354,1584354,1584110,244,40,utRho19
521,galF,4228702,4228702,4228654,48,164,utRho19
522,galM,1577796,1577796,1577674,122,3252,utRho19
523,galP,6176510,6176568,6176510,58,0,utRho19
524,galR,5953138,5953198,5953138,60,16,utRho19
525,galS,4483420,4483420,4483336,84,0,utRho19
526,galU,2582810,2582914,2582810,104,602,utRho19
527,gapA,3724480,3725542,3724480,1062,13820,utRho19
528,garP,6549868,6549868,6549814,54,230,utRho19
529,gatY,4354468,4354468,4354408,60,0,utRho19
530,gatZ,4352864,4352864,4352642,222,43642,utRho19
531,gcd,282558,282558,282450,108,0,utRho19
532,gcl,1067814,1067832,1067814,18,0,utRho19
533,gcvA,5885278,5885278,5885134,144,0,utRho19
534,gcvB,5885392,5885392,5885392,0,0,utRho19
535,gcvR,5199758,5199812,5199758,54,72,utRho19
536,gcvT,6101544,6101544,6101334,210,4046,utRho19
537,gdhA,3684616,3684742,3684616,126,0,utRho19
538,gfcA,2099668,2099668,2099488,180,16,utRho19
539,gfcD,2096236,2096236,2095890,346,184,utRho19
540,ghrA,2195648,2195772,2195648,124,0,utRho19
541,ghrB,7434378,7434620,7434378,242,1694,utRho19
542,glcA,6242728,6242728,6242558,170,462,utRho19
543,glcC,6256412,6256544,6256412,132,0,utRho19
544,glcD,6256152,6256152,6256042,110,2,utRho19
545,gldA,8278092,8278092,8278070,22,224,utRho19
546,glgA,7136784,7136784,7136066,718,3770,utRho19
547,glgB,7147314,7147314,7147004,310,722,utRho19
548,glgC,7139142,7139142,7138656,486,914,utRho19
549,glgP,7133546,7133546,7133162,384,1000,utRho19
550,glgS,6384024,6384024,6383878,146,64,utRho19
551,glgX,7142838,7142838,7142638,200,154,utRho19
552,glk,5018922,5018922,5018852,70,220,utRho19
553,glmS,7827622,7827622,7827336,286,5692,utRho19
554,glmU,7830652,7830652,7830400,252,0,utRho19
555,glmY,10765360,10765360,10765360,0,0,utRho19
556,glmZ,7972864,7972864,7972864,0,0,utRho19
557,glnA,16232888,16232888,16232136,752,1236,utRho19
558,glnB,5375052,5375052,5374816,236,152,utRho19
559,glnD,377310,377310,377300,10,0,utRho19
560,glnE,6399602,6399602,6399282,320,292,utRho19
561,glnH,1696396,1696396,1696008,388,670,utRho19
562,glnK,945112,945196,945112,84,2,utRho19
563,glnL,8112742,8112742,8112678,64,0,utRho19
564,glnQ,1693262,1693262,1692926,336,1530,utRho19
565,glnS,1411998,1412186,1411998,188,792,utRho19
566,gloA,3455602,3455674,3455602,72,66,utRho19
567,gloB,469852,469852,469564,288,3486,utRho19
568,glpA,4705166,4705294,4705166,128,0,utRho19
569,glpD,7123942,7124026,7123942,84,0,utRho19
570,glpE,7123698,7123698,7123646,52,0,utRho19
571,glpF,8236322,8236322,8236180,142,8,utRho19
572,glpG,7122960,7122960,7122904,56,244,utRho19
573,glpR,7121782,7121782,7121210,572,510,utRho19
574,glpT,4704902,4704902,4704748,154,6,utRho19
575,glpX,8231212,8231212,8231158,54,26,utRho19
576,glrK,5382246,5382246,5382196,50,6,utRho19
577,gltA,1509534,1509534,1508936,598,53062,utRho19
578,gltB,6709018,6709264,6709018,246,42,utRho19
579,gltI,1375792,1375792,1375494,298,2738,utRho19
580,gltP,8588536,8588962,8588536,426,1370,utRho19
581,gltS,7657382,7657382,7657330,52,130,utRho19
582,gltX,5041568,5041568,5041344,224,514,utRho19
583,gluQ,320286,320286,320224,62,142,utRho19
584,glyA,5371148,5371148,5371014,134,290,utRho19
585,glyQ,7450708,7450708,7450636,72,8,utRho19
586,glyS,7448990,7448990,7448794,196,2748,utRho19
587,glyU,5998128,5998128,5998114,14,0,utRho19
588,glyV,8784626,8784720,8784626,94,202,utRho19
589,glyW,3984360,3984360,3984234,126,78,utRho19
590,gmhB,445612,445666,445612,54,2,utRho19
591,gmk,7642776,7642856,7642776,80,48,utRho19
592,gmr,2693686,2693686,2693484,202,204,utRho19
593,gnd,4202648,4202648,4202536,112,314,utRho19
594,gnsB,3275692,3275692,3275564,128,0,utRho19
595,gntK,14310580,14310580,14310368,212,132,utRho19
596,gntP,9102668,9102668,9102592,76,20,utRho19
597,gntR,7157760,7157760,7157452,308,710,utRho19
598,gntT,7092810,7093118,7092810,308,22,utRho19
599,gntU,7154170,7154170,7154122,48,2,utRho19
600,gntX,7089334,7089764,7089334,430,6,utRho19
601,gor,7292224,7292598,7292224,374,692,utRho19
602,gpmA,1575340,1575340,1575190,150,0,utRho19
603,gpmM,7570374,7570520,7570374,146,0,utRho19
604,gpsA,7567620,7567620,7567322,298,16634,utRho19
605,gpt,511828,511954,511828,126,178,utRho19
606,grcA,5433046,5433046,5432898,148,20,utRho19
607,greA,6657728,6657728,6657430,298,788,utRho19
608,greB,7073488,7073624,7073488,136,184,utRho19
609,groL,8741566,8742050,8741566,484,34800,utRho19
610,groS,8741232,8741376,8741232,144,18338,utRho19
611,grpE,5501494,5501494,5501416,78,674,utRho19
612,grxA,1781552,1781552,1781506,46,0,utRho19
613,grxB,2248206,2248206,2248108,98,70,utRho19
614,grxC,7569152,7569152,7568884,268,6946,utRho19
615,grxD,3468324,3468324,3468202,122,5192,utRho19
616,gspA,6911268,6911268,6910796,472,94,utRho19
617,gspC,6910964,6911156,6910964,192,90,utRho19
618,gss,6277220,6277220,6277044,176,138,utRho19
619,gstA,3428654,3428754,3428654,100,0,utRho19
620,gstB,1761038,1761038,1760960,78,188,utRho19
621,guaB,5268214,5268214,5268140,74,106,utRho19
622,gudD,5839026,5839026,5838770,256,212,utRho19
623,gyrA,4678914,4678914,4678840,74,6,utRho19
624,gyrB,7760300,7760300,7760238,62,192,utRho19
625,hcaE,5337964,5338064,5337964,100,100,utRho19
626,hcaR,5337928,5337928,5337792,136,68,utRho19
627,hcaT,5336106,5336106,5335692,414,290,utRho19
628,hchA,4071260,4071670,4071260,410,1246,utRho19
629,hcp,1828258,1828258,1827628,630,4,utRho19
630,hcr,1824400,1824400,1824300,100,56,utRho19
631,hdeA,7313582,7313582,7313480,102,0,utRho19
632,hdeD,7313920,7313990,7313920,70,20,utRho19
633,hdfR,7896320,7896320,7895934,386,138,utRho19
634,hdhA,3396244,3396244,3396080,164,70,utRho19
635,helD,2048876,2048942,2048876,66,0,utRho19
636,hemA,2527166,2527428,2527166,262,346,utRho19
637,hemB,779722,779722,779454,268,108,utRho19
638,hemF,5106410,5106450,5106410,40,54,utRho19
639,hemH,996062,996110,996062,48,144,utRho19
640,hemL,349882,349882,349764,118,184,utRho19
641,hemN,8103886,8104090,8103886,204,8,utRho19
642,hepA,127176,127176,126528,648,1312,utRho19
643,hflD,2385372,2385372,2385262,110,494,utRho19
644,hfq,8799602,8800576,8799602,974,7124,utRho19
645,hha,961006,961006,960616,390,14,utRho19
646,hicA,3018442,3018572,3018442,130,0,utRho19
647,higA,6468682,6468682,6468288,394,184,utRho19
648,higB,6468960,6468960,6468910,50,2,utRho19
649,hinT,2323642,2323770,2323642,128,92,utRho19
650,hipB,3184964,3184964,3184884,80,8,utRho19
651,hisB,4186720,4186936,4186720,216,938,utRho19
652,hisJ,4853674,4853674,4853576,98,284,utRho19
653,hisL,8359856,8359984,8359856,128,668,utRho19
654,hisS,5281284,5281284,5281150,134,124,utRho19
655,hlpA,400910,400964,400910,54,80,utRho19
656,hlyE,2460932,2460932,2460788,144,6,utRho19
657,hmp,5371594,5371670,5371594,76,28,utRho19
658,hns,2585916,2585916,2585844,72,764,utRho19
659,hofM,7045856,7045856,7045502,354,2,utRho19
660,hokA,7441620,7441620,7441200,420,8,utRho19
661,hokC,33902,33902,33806,96,116,utRho19
662,hokE,1215462,1215672,1215462,210,2,utRho19
663,holC,8968546,8968546,8968560,14,1922,utRho19
664,holD,9215562,9215606,9215562,44,0,utRho19
665,holE,3850040,3850216,3850040,176,290,utRho19
666,hpt,282720,282862,282720,142,66,utRho19
667,hrpB,324150,324210,324150,60,14,utRho19
668,hscB,5319048,5319048,5318934,114,1110,utRho19
669,hscC,1367188,1367188,1366786,402,1180,utRho19
670,hsdS,9163004,9163004,9162924,80,22,utRho19
671,hslJ,2883560,2883560,2883486,74,186,utRho19
672,hslO,7059344,7059548,7059344,204,11334,utRho19
673,hslR,7058220,7058696,7058220,476,1588,utRho19
674,hslV,8244708,8244708,8244574,134,164,utRho19
675,hsrA,7881412,7881412,7881224,188,0,utRho19
676,htgA,21286,21660,21286,374,316,utRho19
677,htpG,989634,990240,989634,606,2684,utRho19
678,htpX,3825236,3825236,3825152,84,0,utRho19
679,htrE,311036,311036,310852,184,0,utRho19
680,htrL,7587668,7587668,7587366,302,0,utRho19
681,hupA,8400352,8400562,8400352,210,346,utRho19
682,hupB,1845220,1845804,1845220,584,1008,utRho19
683,hyaA,2063968,2064278,2063968,310,2,utRho19
684,hybO,6292726,6292726,6292522,204,2288,utRho19
685,hycA,5700922,5700922,5700870,52,22,utRho19
686,hycI,5686204,5686204,5686086,118,498,utRho19
687,hydN,5676264,5676264,5676210,54,14,utRho19
688,hyfA,5202342,5202402,5202342,60,2,utRho19
689,hypA,11402508,11402588,11402508,80,4,utRho19
690,hypB,11403356,11404004,11403356,648,676,utRho19
691,hypF,5676210,5676210,5674850,1360,512,utRho19
692,hypT,9116634,9116634,9116578,56,0,utRho19
693,hyuA,6019660,6020056,6019660,396,8,utRho19
694,iaaA,1733074,1733136,1733074,62,24,utRho19
695,iadA,9119074,9119074,9119052,22,36,utRho19
696,iap,5753072,5753162,5753072,90,2,utRho19
697,ibaG,6673966,6673966,6673606,360,0,utRho19
698,ibpA,7735036,7735036,7734844,192,414,utRho19
699,ibpB,7733962,7733962,7733794,168,622,utRho19
700,icd,2389922,2390246,2389922,324,738,utRho19
701,iclR,8447304,8447304,8447256,48,132,utRho19
702,idi,6065876,6066130,6065876,254,0,utRho19
703,idnD,8988870,8988870,8988812,58,0,utRho19
704,idnK,8989194,8989246,8989194,52,4,utRho19
705,ihfA,3591442,3591442,3591104,338,1492,utRho19
706,ihfB,1927498,1927656,1927498,158,1870,utRho19
707,ileS,43666,44782,43666,1116,8204,utRho19
708,ileX,6431194,6431196,6431194,2,0,utRho19
709,ilvA,15820940,15821324,15820940,384,92,utRho19
710,ilvC,7915824,7915940,7915824,116,4,utRho19
711,ilvE,15809552,15809936,15809552,384,544,utRho19
712,ilvI,170840,171260,170840,420,4,utRho19
713,ilvL,23701308,23701932,23701308,624,6,utRho19
714,ilvY,7915734,7915734,7915640,94,2,utRho19
715,inaA,4698998,4698998,4698944,54,4,utRho19
716,infA,1853370,1853370,1852886,484,192,utRho19
717,infC,3602692,3602692,3601276,1416,5100,utRho19
718,insA-5,3958452,3958452,3958430,22,36,utRho19
719,insA-7,9036758,9037054,9036758,296,10,utRho19
720,insC-5,6372080,6372284,6372080,204,248,utRho19
721,insEF-2,785238,785238,785820,582,486,utRho19
722,insEF-4,2190310,2190310,2190892,582,418,utRho19
723,insG,9007098,9007098,9006862,236,18,utRho19
724,insH-1,550596,550596,550234,362,660,utRho19
725,insH-11,7306538,7306538,7306396,142,178,utRho19
726,insH-2,1151548,1151548,1151506,42,604,utRho19
727,insH-3,1378444,1378444,1378026,418,256,utRho19
728,insH-4,2791942,2792152,2791942,210,152,utRho19
729,insH-5,2857852,2857852,2857452,400,54,utRho19
730,insH-6,4135022,4135022,4134642,380,410,utRho19
731,insH-7,4206186,4206186,4205822,364,3710,utRho19
732,insH-9,6260050,6260356,6260050,306,288,utRho19
733,insI-3,9017372,9017372,9017234,138,10,utRho19
734,insJ,7441188,7441360,7441188,172,2,utRho19
735,insK,7442130,7442308,7442130,178,0,utRho19
736,insL-1,30760,30890,30760,130,3644,utRho19
737,insL-2,1216112,1216130,1216112,18,70,utRho19
738,insL-3,5028644,5028662,5028644,18,86,utRho19
739,insN-1,540452,540484,540452,32,2,utRho19
740,intD,1132202,1132202,1131956,246,138,utRho19
741,intR,2826520,2826520,2826470,50,2,utRho19
742,intS,4933026,4933090,4933026,64,64,utRho19
743,intZ,5117386,5117542,5117386,156,150,utRho19
744,iraD,9113152,9113986,9113152,834,112,utRho19
745,iraM,2424246,2424246,2424006,240,0,utRho19
746,iraP,802638,802772,802638,134,52,utRho19
747,iscA,5319924,5319924,5319772,152,2190,utRho19
748,iscR,5324398,5324398,5324262,136,10260,utRho19
749,iscX,5313834,5313834,5313472,362,1436,utRho19
750,ispF,5743968,5743968,5743560,408,1532,utRho19
751,ispG,5283908,5283908,5283608,300,648,utRho19
752,ispU,389568,389806,389568,238,184,utRho19
753,isrA,2811502,2811502,2811618,116,0,utRho19
754,istr-1,7706384,7706384,7706384,0,0,utRho19
755,istr-2,7706514,7706514,7706514,0,0,utRho19
756,ivbL,15412092,15412092,15411952,140,1404,utRho19
757,ivy,480638,480686,480638,48,0,utRho19
758,katE,3627628,3627734,3627628,106,308,utRho19
759,katG,8267624,8267670,8267624,46,102,utRho19
760,kbaZ,6557732,6557828,6557732,96,0,utRho19
761,kbl,7585154,7585154,7585102,52,338,utRho19
762,kch,2621046,2621046,2620538,508,80,utRho19
763,kdgR,3820506,3820506,3820198,308,90,utRho19
764,kdpE,1443788,1443788,1443466,322,2,utRho19
765,kdpF,1457698,1457698,1457642,56,0,utRho19
766,kdsA,2535708,2536330,2535708,622,2858,utRho19
767,kdsC,6683438,6684546,6683438,1108,4118,utRho19
768,kduI,5968388,5968388,5968248,140,192,utRho19
769,kefF,94160,94492,94160,332,18,utRho19
770,kgtP,5451624,5451624,5451492,132,72,utRho19
771,kup,7862206,7862632,7862206,426,118,utRho19
772,lacI,735076,735076,735020,56,0,utRho19
773,lacZ,1465508,1465508,1465220,288,556,utRho19
774,ldcA,2486394,2486394,2486160,234,6,utRho19
775,ldhA,2885830,2885830,2885686,144,62,utRho19
776,ldrA,2538954,2538954,2538550,404,236,utRho19
777,ldrB,2540024,2540024,2539620,404,64,utRho19
778,ldrC,2541092,2541092,2540690,402,42,utRho19
779,ldrD,7400544,7400544,7400174,370,8,utRho19
780,lepA,5414392,5414392,5414248,144,280,utRho19
781,lepB,5410928,5410928,5410618,310,1086,utRho19
782,leuD,159188,159188,158906,282,134,utRho19
783,leuE,3761600,3761600,3761518,82,2,utRho19
784,leuL,168048,168048,167416,632,4,utRho19
785,leuO,168308,168736,168308,428,0,utRho19
786,leuQ,9212864,9212864,9212802,62,0,utRho19
787,leuU,6644556,6644556,6644316,240,1584,utRho19
788,leuV,9212546,9212546,9212330,216,420,utRho19
789,leuX,8992772,8992810,8992772,38,44,utRho19
790,lexA,8514174,8514230,8514174,56,178,utRho19
791,lhr,3456706,3458174,3456706,1468,2244,utRho19
792,ligA,5060402,5060402,5060352,50,36,utRho19
793,ligB,7642576,7642576,7642340,236,6,utRho19
794,lipA,1320602,1320602,1320432,170,6,utRho19
795,lipB,1324802,1324802,1324556,246,1984,utRho19
796,lit,2397032,2397390,2397032,358,56,utRho19
797,livJ,7199524,7199524,7199316,208,114,utRho19
798,livK,7195510,7195510,7195120,390,88,utRho19
799,lldP,7554578,7554798,7554578,220,5366,utRho19
800,lnt,1381968,1381968,1381762,206,1538,utRho19
801,loiP,6163784,6163826,6163784,42,0,utRho19
802,lolA,1874656,1874738,1874656,82,282,utRho19
803,lolB,2527112,2527112,2527000,112,314,utRho19
804,lolC,2350748,2350854,2350748,106,0,utRho19
805,lon,917630,917776,917630,146,306,utRho19
806,lpcA,486936,487086,486936,150,26,utRho19
807,lpd,255434,255824,255434,390,2786,utRho19
808,lplA,9248476,9248476,9248234,242,3668,utRho19
809,lplT,5947878,5947878,5947724,154,0,utRho19
810,lpoA,6586422,6586800,6586422,378,636,utRho19
811,lpp,3514592,3514842,3514592,250,130,utRho19
812,lptA,6686598,6686760,6686598,162,1720,utRho19
813,lptB,6686792,6687888,6686792,1096,2308,utRho19
814,lptD,114672,114672,114218,454,2642,utRho19
815,lptF,8972244,8972436,8972244,192,2,utRho19
816,lpxC,213016,213114,213016,98,4558,utRho19
817,lpxD,401920,401942,401920,22,58,utRho19
818,lpxL,2233418,2233418,2233164,254,0,utRho19
819,lpxM,3880456,3880456,3880386,70,24,utRho19
820,lpxP,4991156,4991290,4991156,134,142,utRho19
821,lrhA,4813312,4813312,4813282,30,52,utRho19
822,lrp,1864656,1865190,1864656,534,982,utRho19
823,lspA,50028,50414,50028,386,1998,utRho19
824,lsrA,3202920,3202980,3202920,60,0,utRho19
825,lsrR,3202514,3202514,3202482,32,0,utRho19
826,ltaE,1818640,1818640,1818588,52,88,utRho19
827,luxS,5630130,5630130,5629466,664,1028,utRho19
828,lysA,5957902,5957902,5957798,104,2,utRho19
829,lysC,8467232,8467232,8466466,766,3004,utRho19
830,lysP,4497120,4497120,4497064,56,64,utRho19
831,lysR,5957900,5958042,5957900,142,0,utRho19
832,lysT,1561028,1561108,1561028,80,264,utRho19
833,lysU,8709610,8709610,8709434,176,80,utRho19
834,macB,1840188,1840694,1840188,506,1362,utRho19
835,maeA,3111484,3111484,3111338,146,6496,utRho19
836,mak,820236,820288,820236,52,64,utRho19
837,malE,8492928,8492928,8492838,90,4,utRho19
838,malI,3398456,3398456,3398360,96,124,utRho19
839,malK,8493472,8493568,8493472,96,0,utRho19
840,malP,7105020,7105020,7104946,74,2654,utRho19
841,malQ,7100798,7100798,7100140,658,582,utRho19
842,malS,14949880,14949988,14949880,108,0,utRho19
843,malT,7106048,7106170,7106048,122,148,utRho19
844,malX,3398626,3398710,3398626,84,252,utRho19
845,malZ,1689980,1690072,1689980,92,12,utRho19
846,manA,3377102,3377152,3377102,50,0,utRho19
847,manX,3803866,3804096,3803866,230,14,utRho19
848,marC,3237882,3237882,3237816,66,0,utRho19
849,marR,3238186,3238240,3238186,54,12,utRho19
850,matP,2036918,2036970,2036918,52,110,utRho19
851,mazE,5822736,5822736,5822678,58,90,utRho19
852,mazG,5821720,5821720,5821370,350,4412,utRho19
853,mcbA,1684306,1684306,1684112,194,0,utRho19
854,mcbR,3040192,3040524,3040192,332,0,utRho19
855,mcrA,2420278,2420692,2420278,414,0,utRho19
856,mcrC,9156124,9156124,9155916,208,198,utRho19
857,mdaB,6344814,6345060,6344814,246,2,utRho19
858,mdfA,1767138,1767346,1767138,208,2,utRho19
859,mdh,6768940,6768940,6768536,404,420,utRho19
860,mdoB,9198988,9198988,9198882,106,1918,utRho19
861,mdoD,2993290,2993712,2993290,422,0,utRho19
862,mdoG,2218514,2218670,2218514,156,82,utRho19
863,mdtA,4307958,4308032,4307958,74,0,utRho19
864,mdtE,7318168,7318464,7318168,296,7090,utRho19
865,mdtK,3486538,3486914,3486538,376,46,utRho19
866,mdtP,8602472,8602472,8602060,412,52,utRho19
867,melA,8683774,8683822,8683774,48,104,utRho19
868,melR,8683300,8683300,8683256,44,78,utRho19
869,menA,8240812,8240812,8240698,114,2,utRho19
870,menB,4753774,4753774,4753638,136,1330,utRho19
871,mepH,3468714,3468870,3468714,156,0,utRho19
872,mepM,3883666,3883666,3883270,396,238,utRho19
873,mepS,4539840,4539958,4539840,118,144,utRho19
874,metA,8428318,8428560,8428318,242,0,utRho19
875,metB,8257272,8257344,8257272,72,1758,utRho19
876,metC,6304150,6304472,6304150,322,2,utRho19
877,metE,8025768,8026106,8025768,338,264,utRho19
878,metF,8265092,8265232,8265092,140,122,utRho19
879,metG,4388538,4388600,4388538,62,66,utRho19
880,metH,8447010,8447656,8447010,646,2800,utRho19
881,metJ,8257116,8257116,8256790,326,280,utRho19
882,metK,6173154,6173412,6173154,258,240,utRho19
883,metN,445428,445428,445290,138,0,utRho19
884,metR,8025710,8025710,8025632,78,10,utRho19
885,metT,1394326,1394326,1394266,60,98,utRho19
886,metY,19910250,19910250,19909734,516,102,utRho19
887,metZ,11789528,11789548,11789528,20,48,utRho19
888,mfd,2348056,2348056,2347928,128,132,utRho19
889,mglA,4478782,4478782,4478578,204,710,utRho19
890,mglB,4481132,4481132,4480696,436,28784,utRho19
891,mglC,4475918,4475918,4475506,412,650,utRho19
892,mgrB,3817584,3817584,3817532,52,4,utRho19
893,mgrR,3245828,3245828,3245828,0,0,utRho19
894,mgsA,2054082,2054082,2054030,52,50,utRho19
895,mgtL,8934560,8934862,8934560,302,96,utRho19
896,mhpA,737038,737222,737038,184,90,utRho19
897,mhpR,737072,737072,736840,232,148,utRho19
898,mhpT,750772,750918,750772,146,126,utRho19
899,miaA,8797964,8798504,8797964,540,722,utRho19
900,micA,5629604,5629604,5629604,0,0,utRho19
901,micC,2874242,2874238,2874242,4,0,utRho19
902,micF,4626168,4626168,4626168,0,0,utRho19
903,micM,1014408,1014408,1014408,0,0,utRho19
904,minE,2449422,2449422,2449090,332,5378,utRho19
905,mioC,7852950,7852950,7852910,40,0,utRho19
906,mipA,3733012,3733012,3732944,68,1178,utRho19
907,mlaA,4930270,4930270,4930014,256,20,utRho19
908,mlc,3337206,3337206,3337128,78,0,utRho19
909,mlrA,4429498,4429732,4429498,234,8,utRho19
910,mltA,5894546,5894546,5894356,190,62,utRho19
911,mltD,468050,468050,467910,140,2,utRho19
912,mltF,5391534,5391602,5391534,68,0,utRho19
913,mmuP,550238,550650,550238,412,712,utRho19
914,mngA,1531622,1531968,1531622,346,4,utRho19
915,mngR,1531852,1531852,1531750,102,0,utRho19
916,mnmG,7851348,7851348,7851266,82,366,utRho19
917,mntH,5025470,5025470,5025412,58,0,utRho19
918,mntP,3810918,3811376,3810918,458,18,utRho19
919,mntR,1706160,1706366,1706160,206,0,utRho19
920,mntS,1706128,1706128,1705994,134,0,utRho19
921,moaA,1633654,1634088,1633654,434,968,utRho19
922,moaB,1635954,1636110,1635954,156,4160,utRho19
923,mobA,8084242,8084242,8083998,244,116,utRho19
924,mocA,6030112,6030320,6030112,208,18,utRho19
925,modA,1589990,1590178,1589990,188,0,utRho19
926,moeA,1732788,1732788,1732728,60,134,utRho19
927,mokB,2984610,2984610,2984258,352,688,utRho19
928,molR_1,4392888,4392948,4392888,60,10,utRho19
929,motA,3954604,3954604,3954278,326,0,utRho19
930,mpaA,2781278,2781278,2781196,82,1074,utRho19
931,mpl,8911456,8911570,8911456,114,10,utRho19
932,mppA,2786108,2786454,2786108,346,2,utRho19
933,mprA,5621494,5621540,5621494,46,466,utRho19
934,mqo,4613848,4613848,4613508,340,22,utRho19
935,mqsA,6336742,6336742,6336492,250,1158,utRho19
936,mqsR,6337306,6337306,6337088,218,514,utRho19
937,mraZ,179192,179268,179192,76,0,utRho19
938,mrcA,7045652,7045742,7045652,90,2,utRho19
939,mrcB,329442,329460,329442,18,0,utRho19
940,mreB,13605424,13605424,13604348,1076,1212,utRho19
941,mreD,6798166,6798166,6797750,416,148,utRho19
942,mrp,4388360,4388360,4388336,24,0,utRho19
943,mscK,972984,973072,972984,88,0,utRho19
944,mscL,6876002,6876048,6876002,46,2,utRho19
945,mscS,6139742,6139742,6139614,128,386,utRho19
946,msrA,8884522,8884522,8884352,170,462,utRho19
947,msrB,3725168,3725168,3724858,310,0,utRho19
948,msyB,2228426,2228426,2228362,64,350,utRho19
949,mtfA,4087236,4087302,4087236,66,4972,utRho19
950,mtgA,6699662,6699662,6699618,44,14,utRho19
951,mtlA,30177504,30178248,30177504,744,4432,utRho19
952,mtn,358366,358366,358306,60,10,utRho19
953,mtr,6611864,6611864,6611634,230,0,utRho19
954,mug,6430992,6430992,6430946,46,2,utRho19
955,murQ,5091466,5091546,5091466,80,8,utRho19
956,murR,5091586,5091586,5091218,368,36,utRho19
957,mutH,5939164,5939324,5939164,160,436,utRho19
958,mutL,8794092,8794824,8794092,732,1156,utRho19
959,mutM,7622554,7622554,7622304,250,36,utRho19
960,mutS,5714038,5714186,5714038,148,676,utRho19
961,mutY,18617466,18618078,18617466,612,822,utRho19
962,nac,4123956,4123956,4123866,90,4,utRho19
963,nadA,1564122,1564170,1564122,48,0,utRho19
964,nadB,5420714,5420840,5420714,126,0,utRho19
965,nadC,237326,237326,237290,36,2,utRho19
966,nadE,3644604,3644916,3644604,312,80,utRho19
967,nadK,5501526,5501662,5501526,136,332,utRho19
968,nagA,1406350,1406350,1405502,848,19644,utRho19
969,nagB,1407416,1407416,1407222,194,4,utRho19
970,nagC,1404016,1404016,1403188,828,824,utRho19
971,nagE,1407680,1407888,1407680,208,54,utRho19
972,nagK,2357080,2357186,2357080,106,0,utRho19
973,nanA,6747240,6747240,6747152,88,4,utRho19
974,nanC,9079856,9079856,9079002,854,4,utRho19
975,nanR,6749406,6749406,6748978,428,6,utRho19
976,nanS,9075406,9075406,9075188,218,0,utRho19
977,napF,4607390,4607390,4606994,396,0,utRho19
978,narG,2559614,2559728,2559614,114,104,utRho19
979,narK,2555642,2555914,2555642,272,4,utRho19
980,narP,4580844,4581000,4580844,156,158,utRho19
981,narQ,5171154,5171462,5171154,308,82,utRho19
982,narU,3088326,3088326,3088120,206,2,utRho19
983,narW,3077374,3077374,3074618,2756,372,utRho19
984,narX,2555554,2555554,2555236,318,152,utRho19
985,narZ,3085380,3085380,3085180,200,0,utRho19
986,ndh,2331984,2332170,2331984,186,2,utRho19
987,ndk,5289920,5289920,5289728,192,420,utRho19
988,nemR,6904084,6904092,6904084,8,4,utRho19
989,nepI,7683542,7683542,7683478,64,0,utRho19
990,nfo,4501612,4501680,4501612,68,52,utRho19
991,nfsB,1210906,1210906,1210848,58,2,utRho19
992,nfuA,7090916,7091248,7090916,332,466,utRho19
993,nhaA,34634,34978,34634,344,6,utRho19
994,nhaB,2469534,2469534,2469434,100,80,utRho19
995,nhoA,3067926,3068048,3067926,122,0,utRho19
996,nikA,7226878,7227334,7226878,456,318,utRho19
997,nikR,7237074,7237176,7237074,102,390,utRho19
998,nirB,6987974,6988022,6987974,48,0,utRho19
999,nlpA,7680034,7680034,7679986,48,2,utRho19
1000,nlpC,3585654,3585654,3585462,192,0,utRho19
1001,nlpD,5737658,5737658,5737506,152,0,utRho19
1002,nlpI,6618080,6618080,6617848,232,4,utRho19
1003,nmpC,1153740,1153740,1153650,90,4,utRho19
1004,nohA,3273206,3273206,3272734,472,6,utRho19
1005,norR,5664614,5664614,5664578,36,0,utRho19
1006,norV,5664878,5664952,5664878,74,2,utRho19
1007,nrdA,4689510,4689730,4689510,220,11962,utRho19
1008,nrdD,8925676,8925676,8925320,356,804,utRho19
1009,nrdH,5601312,5601446,5601312,134,1504,utRho19
1010,nrdR,865954,866004,865954,50,114,utRho19
1011,nrfA,8575342,8575528,8575342,186,0,utRho19
1012,nsrR,8812088,8812380,8812088,292,412,utRho19
1013,nudB,3897348,3897348,3897264,84,0,utRho19
1014,nudC,8393428,8393806,8393428,378,196,utRho19
1015,nudE,7052658,7052658,7052298,360,812,utRho19
1016,nudG,3682876,3682980,3682876,104,0,utRho19
1017,nudI,4729050,4729108,4729050,58,0,utRho19
1018,nudJ,2388874,2388874,2388576,298,1292,utRho19
1019,nuoA,4810670,4810670,4810144,526,3780,utRho19
1020,nuoN,4783434,4783434,4783010,424,1630,utRho19
1021,nupC,5026018,5026084,5026018,66,0,utRho19
1022,nupG,6211302,6211428,6211302,126,0,utRho19
1023,ogrK,4335096,4335096,4335040,56,0,utRho19
1024,ogt,2800568,2800568,2800472,96,130,utRho19
1025,ohsC,5401036,5401040,5401036,4,0,utRho19
1026,ompA,2040382,2040382,2040106,276,41086,utRho19
1027,ompC,4625774,4625774,4625498,276,280,utRho19
1028,ompF,1974184,1974184,1973964,220,102,utRho19
1029,ompL,8128958,8128958,8128590,368,6,utRho19
1030,ompN,2874158,2874158,2873786,372,20,utRho19
1031,ompR,7073510,7073510,7073168,342,188,utRho19
1032,ompT,1171330,1171330,1171266,64,264,utRho19
1033,ompW,2627982,2628040,2627982,58,0,utRho19
1034,ompX,1700418,1700900,1700418,482,690,utRho19
1035,omrA,5952378,5952378,5952378,0,0,utRho19
1036,omrB,5952770,5952770,5952770,0,0,utRho19
1037,oppA,2602170,2602364,2602170,194,4806,utRho19
1038,orn,8783168,8783208,8783168,40,64,utRho19
1039,osmB,2686952,2686952,2686656,296,20,utRho19
1040,osmC,3113192,3113250,3113192,58,2490,utRho19
1041,osmE,3644566,3644566,3644512,54,60,utRho19
1042,osmF,4439046,4439046,4438962,84,522,utRho19
1043,osmY,9222306,9222792,9222306,486,2032,utRho19
1044,otsA,3963302,3963302,3963224,78,76,utRho19
1045,otsB,3964930,3964930,3964774,156,296,utRho19
1046,oxc,4984288,4984288,4983900,388,4,utRho19
1047,oxyR,8316914,8316980,8316914,66,14,utRho19
1048,oxyS,8316788,8316788,8316788,0,0,utRho19
1049,paaA,2907730,2907854,2907730,124,0,utRho19
1050,paaX,2927018,2927078,2927018,60,48,utRho19
1051,paaZ,2907340,2907340,2907284,56,0,utRho19
1052,pabA,6981702,6981702,6981658,44,0,utRho19
1053,pabB,3789256,3789610,3789256,354,512,utRho19
1054,pabC,2306186,2306600,2306186,414,202,utRho19
1055,pagP,1313052,1313114,1313052,62,0,utRho19
1056,panB,299260,299260,299202,58,304,utRho19
1057,panC,297840,297840,297590,250,296,utRho19
1058,panD,293490,293490,293388,102,2,utRho19
1059,panZ,7195656,7195968,7195656,312,254,utRho19
1060,parC,6332060,6332060,6331946,114,396,utRho19
1061,patA,6438916,6438988,6438916,72,78,utRho19
1062,patD,3030830,3031156,3030830,326,2,utRho19
1063,pbpC,5294986,5294986,5294650,336,0,utRho19
1064,pbpG,4450132,4450132,4449740,392,32,utRho19
1065,pck,7065358,7065636,7065358,278,1614,utRho19
1066,pcnB,318782,318782,318252,530,338,utRho19
1067,pdhR,244068,244184,244068,116,2,utRho19
1068,pdxB,4875768,4875768,4875702,66,4,utRho19
1069,pdxH,3436068,3436068,3436014,54,518,utRho19
1070,pdxJ,5403626,5403626,5403458,168,0,utRho19
1071,pdxK,5074638,5074638,5074474,164,0,utRho19
1072,pepA,8972278,8972278,8971902,376,472,utRho19
1073,pepD,511618,511618,511432,186,13114,utRho19
1074,pepN,1981182,1981244,1981182,62,94,utRho19
1075,pepQ,8062294,8062322,8062294,28,0,utRho19
1076,pepT,2371646,2371688,2371646,42,56,utRho19
1077,pfkA,8214948,8215104,8214948,156,552,utRho19
1078,pfkB,3612646,3612740,3612646,94,268,utRho19
1079,pflA,1902456,1902456,1902160,296,2,utRho19
1080,pflB,1907850,1907850,1907108,742,856,utRho19
1081,pflD,8287716,8287990,8287716,274,2,utRho19
1082,pgaA,2185046,2185046,2184578,468,6,utRho19
1083,pgi,8467444,8467516,8467444,72,66,utRho19
1084,pgk,12291428,12291428,12290488,940,5444,utRho19
1085,pgl,1597078,1597172,1597078,94,84,utRho19
1086,pgpB,2678324,2678660,2678324,336,14,utRho19
1087,pgpC,5397276,5397276,5397100,176,2,utRho19
1088,pgrR,2783744,2783982,2783744,238,112,utRho19
1089,pheL,5475158,5475198,5475158,40,4,utRho19
1090,pheM,7197204,7197204,7197080,124,188,utRho19
1091,pheP,1203858,1203918,1203858,60,0,utRho19
1092,pheU,8725254,8725254,8725252,2,0,utRho19
1093,pheV,6220730,6220732,6220730,2,32,utRho19
1094,phnC,8650412,8650412,8650330,82,94,utRho19
1095,phoA,803414,803494,803414,80,78,utRho19
1096,phoB,834202,834284,834202,82,0,utRho19
1097,phoE,520316,520316,520200,116,14,utRho19
1098,phoH,2169730,2169984,2169730,254,414,utRho19
1099,phoP,2381016,2381016,2380894,122,3290,utRho19
1100,phoQ,2379880,2379880,2379552,328,966,utRho19
1101,phoU,7815330,7815330,7815156,174,78,utRho19
1102,phr,1478842,1479014,1478842,172,60,utRho19
1103,pinE,2419054,2419370,2419054,316,14,utRho19
1104,pinQ,3267168,3267244,3267168,76,2,utRho19
1105,pinR,2867424,2867424,2867348,76,2,utRho19
1106,pitA,7275224,7275284,7275224,60,78,utRho19
1107,pitB,6272806,6272806,6272742,64,106,utRho19
1108,pka,5439862,5439906,5439862,44,4,utRho19
1109,plaP,4174476,4174476,4174124,352,16,utRho19
1110,pldA,8009628,8009724,8009628,96,24,utRho19
1111,pldB,8018028,8018340,8018028,312,272,utRho19
1112,plsB,8513196,8513196,8512932,264,526,utRho19
1113,pmbA,8915890,8915918,8915890,28,0,utRho19
1114,pmrD,4747148,4747148,4747076,72,0,utRho19
1115,pncB,1980828,1980828,1980712,116,0,utRho19
1116,pncC,5648788,5648788,5648692,96,88,utRho19
1117,pnp,6622652,6622652,6622336,316,12,utRho19
1118,pntA,3355950,3355950,3355806,144,0,utRho19
1119,pntB,3353096,3353096,3352720,376,256,utRho19
1120,polA,8093880,8093932,8093880,52,2,utRho19
1121,polB,131606,131606,131560,46,0,utRho19
1122,potD,2365700,2365700,2365658,42,0,utRho19
1123,potE,1436688,1436688,1436530,158,0,utRho19
1124,potF,1787268,1787568,1787268,300,0,utRho19
1125,poxB,1822152,1822152,1822098,54,26,utRho19
1126,ppa,8899372,8899372,8899304,68,4,utRho19
1127,ppc,8306380,8306380,8306196,184,494,utRho19
1128,ppdA,5928440,5928440,5928354,86,60,utRho19
1129,ppdD,235410,235410,235098,312,2,utRho19
1130,pphA,3846770,3846770,3845938,832,2556,utRho19
1131,pphB,5719474,5719520,5719474,46,0,utRho19
1132,ppiA,6984898,6984898,6984594,304,0,utRho19
1133,ppiC,7919682,7919682,7919626,56,0,utRho19
1134,ppiD,923638,923830,923638,192,150,utRho19
1135,ppk,5245748,5246088,5245748,340,284,utRho19
1136,pppA,6228958,6228958,6228704,254,762,utRho19
1137,ppsA,3574322,3574322,3574224,98,4,utRho19
1138,ppsR,3574678,3574890,3574678,212,0,utRho19
1139,pptA,3065716,3066104,3065716,388,80,utRho19
1140,pqiA,2023318,2024002,2023318,684,60,utRho19
1141,prc,3830054,3830054,3829632,422,17860,utRho19
1142,preT,4467978,4468066,4467978,88,16,utRho19
1143,prfC,9218688,9218828,9218688,140,706,utRho19
1144,prkB,6968622,6968980,6968622,358,1622,utRho19
1145,prlC,7290476,7290476,7290364,112,232,utRho19
1146,prlF,6553944,6554004,6553944,60,324,utRho19
1147,proB,520432,520776,520432,344,10,utRho19
1148,proC,811372,811372,811288,84,0,utRho19
1149,proK,7417388,7417388,7417384,4,2,utRho19
1150,proL,4572414,4572422,4572414,8,60,utRho19
1151,proP,8660640,8661004,8660640,364,1104,utRho19
1152,proS,437674,437674,437550,124,276,utRho19
1153,proV,5609126,5609630,5609126,504,98,utRho19
1154,prpB,697292,697364,697292,72,0,utRho19
1155,prpR,696942,696942,696886,56,0,utRho19
1156,prs,2524354,2524354,2523750,604,57808,utRho19
1157,psd,8781276,8781276,8780720,556,2078,utRho19
1158,psiE,8480600,8480650,8480600,50,2,utRho19
1159,pspA,2736076,2736158,2736076,82,0,utRho19
1160,pspF,2736080,2736080,2735824,256,0,utRho19
1161,pspG,8525632,8525680,8525632,48,2,utRho19
1162,pssA,5445156,5445454,5445156,298,9280,utRho19
1163,pstB,7817112,7817112,7816732,380,8,utRho19
1164,pstC,7821084,7821084,7820796,288,4,utRho19
1165,pstS,23469408,23469408,23469150,258,0,utRho19
1166,psuG,4517114,4517114,4516734,380,2308,utRho19
1167,psuT,4514992,4514992,4514670,322,0,utRho19
1168,pth,2517084,2517084,2517026,58,0,utRho19
1169,ptrA,5918022,5918022,5917768,254,0,utRho19
1170,ptrB,3857730,3857730,3857678,52,282,utRho19
1171,ptsG,2315252,2315738,2315252,486,1526,utRho19
1172,ptsH,5066996,5067528,5066996,532,4494,utRho19
1173,purA,8809328,8809374,8809328,46,0,utRho19
1174,purC,5195562,5195562,5195236,326,332,utRho19
1175,purD,8411972,8411972,8411862,110,60,utRho19
1176,purE,1106284,1106284,1106200,84,160,utRho19
1177,purH,8415254,8415254,8415064,190,0,utRho19
1178,purL,5391178,5391178,5391086,92,428,utRho19
1179,purM,5242306,5242394,5242306,88,0,utRho19
1180,purR,3475378,3475688,3475378,310,472,utRho19
1181,purT,3861438,3861762,3861438,324,0,utRho19
1182,purU,2577512,2577512,2577248,264,1022,utRho19
1183,putA,2157850,2157850,2157764,86,134,utRho19
1184,putP,2158336,2158610,2158336,274,1332,utRho19
1185,puuA,2721936,2721936,2721816,120,0,utRho19
1186,puuC,2725456,2725486,2725456,30,6,utRho19
1187,puuD,2722104,2722240,2722104,136,0,utRho19
1188,puuP,2718746,2718746,2718374,372,552,utRho19
1189,pykA,3874988,3875298,3874988,310,580,utRho19
1190,pykF,3510934,3511396,3510934,462,868,utRho19
1191,pyrC,2245286,2245286,2245214,72,2,utRho19
1192,pyrD,2009464,2009536,2009464,72,54,utRho19
1193,pyrE,7631970,7631970,7631536,434,8,utRho19
1194,pyrF,2683740,2683842,2683740,102,22,utRho19
1195,pyrG,5819594,5819594,5819332,262,630,utRho19
1196,pyrH,383624,383710,383624,86,912,utRho19
1197,pyrL,8945490,8945490,8945066,424,338,utRho19
1198,qmcA,1031646,1031646,1031546,100,26,utRho19
1199,qor,8528608,8528608,8528462,146,348,utRho19
1200,qseB,6339502,6339656,6339502,154,66,utRho19
1201,queA,849970,850022,849970,52,50,utRho19
1202,queE,5811212,5811212,5810836,376,50,utRho19
1203,queF,5850642,5850696,5850642,54,0,utRho19
1204,queG,8788184,8788184,8788134,50,7324,utRho19
1205,racC,2835630,2835630,2835526,104,0,utRho19
1206,racR,2840898,2840898,2840482,416,0,utRho19
1207,raiA,5474208,5474308,5474208,100,386,utRho19
1208,rarD,8008594,8008594,8008356,238,250,utRho19
1209,ravA,7862256,7862256,7862186,70,0,utRho19
1210,rayT,495088,495274,495088,186,168,utRho19
1211,rbn,4763162,4763216,4763162,54,0,utRho19
1212,rbsD,7866644,7866702,7866644,58,192,utRho19
1213,rcnA,4371654,4371834,4371654,180,24,utRho19
1214,rcnB,4373768,4373920,4373768,152,284,utRho19
1215,rcnR,4371806,4371806,4371592,214,92,utRho19
1216,rcsA,4047672,4047936,4047672,264,314,utRho19
1217,rcsB,4631390,4632354,4631390,964,1520,utRho19
1218,rcsC,4640162,4640162,4639656,506,542,utRho19
1219,rcsD,4626904,4626976,4626904,72,54,utRho19
1220,rdgB,6193240,6193362,6193240,122,262,utRho19
1221,rdlA,2538646,2538646,2538646,0,0,utRho19
1222,rdlB,2539712,2539716,2539712,4,0,utRho19
1223,rdlC,2540782,2540786,2540782,4,0,utRho19
1224,rdlD,7400272,7400272,7400272,0,0,utRho19
1225,rdoA,8084782,8084830,8084782,48,56,utRho19
1226,recA,11295276,11295276,11295076,200,1008,utRho19
1227,recC,5925014,5925014,5924856,158,42,utRho19
1228,recF,7763722,7763722,7762442,1280,8298,utRho19
1229,recN,5503518,5503590,5503518,72,0,utRho19
1230,recQ,8011666,8011728,8011666,62,0,utRho19
1231,relA,5828554,5828554,5827302,1252,278,utRho19
1232,relB,3291806,3291806,3291744,62,0,utRho19
1233,rem,3289950,3289950,3289804,146,0,utRho19
1234,rep,7921294,7921354,7921294,60,184,utRho19
1235,rfaD,7587730,7587974,7587730,244,126,utRho19
1236,rfaE,6393852,6393852,6393506,346,720,utRho19
1237,rfaH,8049930,8049930,8049642,288,1254,utRho19
1238,rfbX,4219436,4219436,4219168,268,1082,utRho19
1239,rfe,7935600,7935832,7935600,232,50,utRho19
1240,rhaB,8194944,8194944,8194896,48,0,utRho19
1241,rhaD,8188770,8188770,8188544,226,0,utRho19
1242,rhaS,8195422,8195472,8195422,50,2,utRho19
1243,rhaT,8201132,8201132,8201050,82,60,utRho19
1244,rhlE,1661566,1661744,1661566,178,44,utRho19
1245,rhoL,47593944,47594772,47593944,828,39000,utRho19
1246,rhsB,7238006,7238384,7238006,378,70,utRho19
1247,rhsC,1458758,1459166,1458758,408,0,utRho19
1248,rhsD,1046132,1046522,1046132,390,6,utRho19
1249,rhtA,1700608,1700608,1700194,414,188,utRho19
1250,rhtC,8015478,8015514,8015478,36,442,utRho19
1251,ribA,2678468,2678468,2678320,148,8,utRho19
1252,ribC,3486916,3486916,3486484,432,74,utRho19
1253,ribE,869008,869294,869008,286,6896,utRho19
1254,ribF,42766,42814,42766,48,0,utRho19
1255,ridA,8941892,8941892,8941826,66,68,utRho19
1256,rihA,1369204,1369204,1368824,380,170,utRho19
1257,rihB,4510504,4510504,4510372,132,110,utRho19
1258,rimJ,2251044,2251124,2251044,80,0,utRho19
1259,rimK,1783752,1783934,1783752,182,476,utRho19
1260,rimL,2997486,2997876,2997486,390,548,utRho19
1261,rimO,1756140,1756140,1756070,70,2,utRho19
1262,rimP,6636350,6636350,6636012,338,966,utRho19
1263,rlmA,3814172,3814172,3814120,52,10,utRho19
1264,rlmD,5830086,5830086,5830000,86,0,utRho19
1265,rlmE,6655520,6655520,6655328,192,576,utRho19
1266,rlmF,1684384,1684664,1684384,280,0,utRho19
1267,rlmG,6471784,6471784,6471750,34,4,utRho19
1268,rlmI,2060002,2060002,2059938,64,54,utRho19
1269,rlmJ,7290700,7290770,7290700,70,0,utRho19
1270,rlmL,2015344,2015688,2015344,344,828,utRho19
1271,rlpA,1330444,1330444,1330380,64,248,utRho19
1272,rluA,120900,120900,120692,208,28,utRho19
1273,rluF,8460324,8460708,8460324,384,0,utRho19
1274,rmf,2031006,2031430,2031006,424,438,utRho19
1275,rna,1290068,1290068,1290006,62,10,utRho19
1276,rnb,2698258,2698258,2697824,434,2176,utRho19
1277,rnc,10816892,10816892,10816252,640,6000,utRho19
1278,rnd,3776122,3776122,3775982,140,128,utRho19
1279,rne,2289746,2289746,2288734,1012,11096,utRho19
1280,rnhA,472082,472082,472004,78,912,utRho19
1281,rnk,1288360,1288360,1287934,426,104,utRho19
1282,rnlA,5531788,5531836,5531788,48,146,utRho19
1283,rnlB,5533414,5533968,5533414,554,890,utRho19
1284,rnpB,19623552,19623552,19623552,0,0,utRho19
1285,rob,9270706,9270706,9270620,86,0,utRho19
1286,rodZ,5285868,5285868,5285688,180,0,utRho19
1287,rpe,7030306,7030306,7030118,188,68,utRho19
1288,rph,15266320,15266320,15266196,124,0,utRho19
1289,rpiA,6118706,6118706,6118650,56,10,utRho19
1290,rpiB,8626514,8626700,8626514,186,8,utRho19
1291,rpiR,8626274,8626274,8625982,292,0,utRho19
1292,rplJ,8359246,8359992,8359246,746,4538,utRho19
1293,rplK,8356708,8356894,8356708,186,184,utRho19
1294,rplM,6757344,6757344,6757302,42,2308,utRho19
1295,rplN,6896444,6896444,6896298,146,1090,utRho19
1296,rplS,5489284,5489284,5489060,224,4388,utRho19
1297,rplT,7199052,7199052,7198996,56,168,utRho19
1298,rplU,6667036,6667036,6666902,134,60,utRho19
1299,rplY,4564866,4565034,4564866,168,20,utRho19
1300,rpmA,6666450,6666450,6666238,212,390,utRho19
1301,rpmB,15247980,15247980,15246696,1284,47016,utRho19
1302,rpmE,8253816,8254026,8253816,210,576,utRho19
1303,rpmF,2294676,2294734,2294676,58,17248,utRho19
1304,rpmH,7768130,7768672,7768130,542,2614,utRho19
1305,rpmI,3600854,3600854,3599998,856,8154,utRho19
1306,rpoB,8362126,8362490,8362126,364,266,utRho19
1307,rpoD,6424946,6426094,6424946,1148,33156,utRho19
1308,rpoE,5420372,5420372,5420024,348,0,utRho19
1309,rpoH,7202006,7202006,7201566,440,5218,utRho19
1310,rpoN,6689324,6689434,6689324,110,316,utRho19
1311,rpoS,5736236,5736236,5735102,1134,14280,utRho19
1312,rpoZ,7644154,7644212,7644154,58,654,utRho19
1313,rppH,5937986,5937986,5937954,32,70,utRho19
1314,rprA,3540744,3540744,3540744,0,0,utRho19
1315,rpsA,1923434,1923990,1923434,556,76910,utRho19
1316,rpsF,8850050,8850236,8850050,186,7110,utRho19
1317,rpsI,6756580,6756580,6756414,166,2660,utRho19
1318,rpsJ,6906884,6906884,6906540,344,2408,utRho19
1319,rpsL,6949242,6949242,6949104,138,662,utRho19
1320,rpsM,6885130,6885130,6884942,188,718,utRho19
1321,rpsO,13247144,13247144,13246736,408,200,utRho19
1322,rpsP,5492508,5492508,5492370,138,44,utRho19
1323,rpsT,42420,42420,42156,264,360,utRho19
1324,rpsU,12842584,12843124,12842584,540,304,utRho19
1325,rraA,8238716,8238716,8238660,56,158,utRho19
1326,rraB,8956768,8956946,8956768,178,88,utRho19
1327,rrsA,8070478,8071062,8070478,584,7886,utRho19
1328,rrsB,16665468,16666636,16665468,1168,16800,utRho19
1329,rrsC,7883032,7883616,7883032,584,4168,utRho19
1330,rrsD,6858094,6858094,6857524,570,346,utRho19
1331,rrsE,8415726,8416294,8415726,568,1334,utRho19
1332,rrsG,5462896,5462896,5462314,582,8310,utRho19
1333,rrsH,446970,447542,446970,572,1862,utRho19
1334,rsd,8393908,8393908,8393616,292,176,utRho19
1335,rseA,5419264,5419264,5418808,456,400,utRho19
1336,rseP,392940,393092,392940,152,120,utRho19
1337,rseX,4067298,4067298,4067298,0,0,utRho19
1338,rsfS,1338144,1338144,1338072,72,104,utRho19
1339,rsgA,8783132,8783132,8783018,114,162,utRho19
1340,rsmA,105176,105176,104860,316,3202,utRho19
1341,rsmB,6869982,6870414,6869982,432,166,utRho19
1342,rsmC,9215736,9215736,9215400,336,566,utRho19
1343,rsmD,7208594,7208786,7208594,192,306,utRho19
1344,rsmE,6182036,6182268,6182036,232,200,utRho19
1345,rsmG,7847512,7847512,7847360,152,436,utRho19
1346,rsmH,180020,180188,180020,168,140,utRho19
1347,rsmI,6587106,6587106,6586670,436,1866,utRho19
1348,rssA,2578212,2578412,2578212,200,112,utRho19
1349,rssB,2580440,2580484,2580440,44,334,utRho19
1350,rstA,3364276,3364300,3364276,24,0,utRho19
1351,rsuA,4561096,4561096,4560966,130,38,utRho19
1352,rsxA,3411510,3411534,3411510,24,146,utRho19
1353,rtcA,7114004,7114004,7113698,306,32,utRho19
1354,rtcB,7116214,7116214,7116158,56,2,utRho19
1355,rtn,4541356,4541452,4541356,96,0,utRho19
1356,rutA,2148052,2148052,2148022,30,0,utRho19
1357,rutG,2140090,2140090,2139678,412,200,utRho19
1358,rutR,2148226,2148484,2148226,258,8,utRho19
1359,ruvA,7784096,7784096,7783904,192,256,utRho19
1360,ruvB,7782176,7782176,7781424,752,1172,utRho19
1361,ruvC,3894878,3894878,3894752,126,0,utRho19
1362,rybB,1776114,1776114,1776114,0,0,utRho19
1363,rydB,3529860,3529860,3529322,538,74,utRho19
1364,rydC,2983012,2983012,2983012,0,0,utRho19
1365,ryfA,5307398,5307710,5307398,312,0,utRho19
1366,ryfD,5468590,5468590,5468590,0,0,utRho19
1367,ryhB,7162032,7162032,7162032,0,0,utRho19
1368,ryjA,8556132,8556132,8556132,0,0,utRho19
1369,ryjB,9055954,9055954,9055954,0,0,utRho19
1370,sad,3229598,3229598,3229406,192,172,utRho19
1371,safA,3168056,3168056,3167918,138,0,utRho19
1372,sanA,4465368,4465756,4465368,388,64,utRho19
1373,sapF,2705314,2705314,2705268,46,60,utRho19
1374,sbcB,4165456,4165512,4165456,56,0,utRho19
1375,sbcC,831694,831694,831506,188,34,utRho19
1376,sbcD,833954,833954,833904,50,0,utRho19
1377,sbmA,793106,793278,793106,172,102,utRho19
1378,sbmC,4162650,4162650,4162524,126,0,utRho19
1379,sdaA,3793618,3793864,3793618,246,410,utRho19
1380,sdaC,5856070,5856458,5856070,388,862,utRho19
1381,sdhC,1509916,1510354,1509916,438,41314,utRho19
1382,sdhD,1510808,1511120,1510808,312,12150,utRho19
1383,sdiA,3993834,3993834,3993664,170,60,utRho19
1384,secE,8354354,8354716,8354354,362,2,utRho19
1385,secG,6645180,6645180,6645010,170,422,utRho19
1386,selA,7522594,7522594,7522498,96,168,utRho19
1387,selB,7519850,7519850,7519722,128,482,utRho19
1388,selC,7672396,7672444,7672396,48,2,utRho19
1389,selD,3696058,3696058,3696016,42,6498,utRho19
1390,seqA,1425884,1425974,1425884,90,838,utRho19
1391,serA,6117098,6117098,6116820,278,102,utRho19
1392,serB,9249712,9249790,9249712,78,186,utRho19
1393,serC,3830380,3830612,3830380,232,80,utRho19
1394,serS,1878730,1878856,1878730,126,450,utRho19
1395,serT,2063438,2063438,2063424,14,0,utRho19
1396,serU,4087124,4087124,4087114,10,508,utRho19
1397,serV,5637394,5637394,5637290,104,0,utRho19
1398,serW,1852014,1852014,1851942,72,270,utRho19
1399,serX,2195352,2195352,2195304,48,4,utRho19
1400,setB,4527426,4527726,4527426,300,2,utRho19
1401,setC,7673488,7673906,7673488,418,96,utRho19
1402,sfmA,1116124,1116424,1116124,300,4,utRho19
1403,sfmC,1117606,1117948,1117606,342,2,utRho19
1404,sfsA,323030,323030,322972,58,410,utRho19
1405,sfsB,6669592,6669818,6669592,226,4,utRho19
1406,sgrR,154676,154676,154598,78,44,utRho19
1407,sgrS,154734,154734,154734,0,0,utRho19
1408,shiA,4107068,4107286,4107068,218,2,utRho19
1409,sibA,4306622,4306622,4306622,0,0,utRho19
1410,sibB,4307292,4307292,4307292,0,0,utRho19
1411,sibC,6113702,6113702,6113702,0,0,utRho19
1412,sibD,6389730,6389730,6389730,0,0,utRho19
1413,sibE,6390480,6390480,6390480,0,0,utRho19
1414,sixA,4913998,4913998,4913624,374,36,utRho19
1415,slp,7307872,7307922,7307872,50,48,utRho19
1416,slt,9261400,9261466,9261400,66,94,utRho19
1417,slyA,3442028,3442028,3441648,380,62,utRho19
1418,slyB,3439496,3439752,3439496,256,0,utRho19
1419,slyD,6957398,6957398,6956994,404,1424,utRho19
1420,slyX,6954862,6955280,6954862,418,3602,utRho19
1421,smf,6867372,6867372,6867120,252,86,utRho19
1422,smpB,5509534,5509792,5509534,258,608,utRho19
1423,smrA,2811872,2811958,2811872,86,566,utRho19
1424,smrB,4896872,4897212,4896872,340,130,utRho19
1425,smtA,1946808,1947074,1946808,266,0,utRho19
1426,sodA,8201518,8201620,8201518,102,18710,utRho19
1427,sodB,3470646,3470756,3470646,110,294,utRho19
1428,sodC,3449358,3449358,3449310,48,40,utRho19
1429,sohB,2658568,2658664,2658568,96,82,utRho19
1430,sokB,2984232,2984238,2984232,6,222,utRho19
1431,solA,2241218,2241218,2241172,46,0,utRho19
1432,soxR,8554894,8554938,8554894,44,134,utRho19
1433,soxS,8554846,8554846,8554766,80,0,utRho19
1434,speA,6172096,6172096,6171822,274,2,utRho19
1435,speB,6167892,6167892,6167594,298,146,utRho19
1436,speC,6218350,6218350,6218310,40,0,utRho19
1437,spf,8099798,8099798,8099798,0,0,utRho19
1438,sppA,3697422,3697674,3697422,252,12,utRho19
1439,spy,3651376,3651376,3651250,126,0,utRho19
1440,sra,3112092,3112092,3111926,166,30,utRho19
1441,sraB,2293178,2293178,2293178,0,0,utRho19
1442,sraC,3846132,3846132,3846132,0,0,utRho19
1443,srlA,5651582,5651664,5651582,82,0,utRho19
1444,srlR,5657720,5658094,5657720,374,26232,utRho19
1445,srmB,5425752,5425792,5425752,40,304,utRho19
1446,sroA,151216,151216,151216,0,0,utRho19
1447,sroG,6369436,6369436,6369436,0,0,utRho19
1448,sroH,8380974,8380974,8380974,0,0,utRho19
1449,ssb,8548022,8548250,8548022,228,2,utRho19
1450,sseA,5304782,5304988,5304782,206,13278,utRho19
1451,sspA,6755138,6755138,6754840,298,1058,utRho19
1452,ssrA,5511014,5511186,5511014,172,102,utRho19
1453,ssrS,12223036,12223932,12223036,896,3348,utRho19
1454,sstT,6479726,6479888,6479726,162,0,utRho19
1455,ssuB,1988282,1988282,1988088,194,2,utRho19
1456,ssuE,1995126,1995126,1995024,102,26,utRho19
1457,sthA,8321604,8321604,8321580,24,3072,utRho19
1458,stpA,5597156,5597156,5596990,166,2,utRho19
1459,sucA,3034344,3034824,3034344,480,5092,utRho19
1460,sufA,3528836,3528836,3528772,64,1148,utRho19
1461,sufE,3518962,3518962,3518580,382,2216,utRho19
1462,sugE,8753588,8753750,8753588,162,906,utRho19
1463,sulA,2041894,2041894,2041838,56,82,utRho19
1464,syd,5850738,5850738,5850560,178,240,utRho19
1465,symE,9159834,9159834,9159680,154,14,utRho19
1466,symR,9159670,9159670,9159670,0,0,utRho19
1467,tabA,8949566,8949724,8949566,158,0,utRho19
1468,talA,5157140,5157332,5157140,192,0,utRho19
1469,talB,16382,16476,16382,94,18708,utRho19
1470,tam,3214442,3214692,3214442,250,464,utRho19
1471,tamA,8884540,8884764,8884540,224,74,utRho19
1472,tar,3945432,3945432,3945382,50,0,utRho19
1473,tas,5943138,5943194,5943138,56,244,utRho19
1474,tatA,16087636,16087780,16087636,144,192,utRho19
1475,tatE,1317742,1317894,1317742,152,58,utRho19
1476,tauA,770410,770464,770410,54,0,utRho19
1477,tdcA,6534186,6534186,6534130,56,0,utRho19
1478,tdcG,6519652,6519652,6519298,354,34,utRho19
1479,tdcR,6534380,6534760,6534380,380,2,utRho19
1480,tdk,2586986,2587054,2586986,68,144,utRho19
1481,tehA,3001072,3001146,3001072,74,0,utRho19
1482,tesA,1039898,1039898,1039530,368,96,utRho19
1483,tesB,950402,950402,950322,80,0,utRho19
1484,tfaE,2418532,2418532,2418238,294,10,utRho19
1485,tfaQ,3269912,3269912,3269770,142,60,utRho19
1486,tff,379424,379256,379424,168,240,utRho19
1487,tgt,852110,852274,852110,164,0,utRho19
1488,thiD,4369346,4369346,4369032,314,0,utRho19
1489,thiI,882936,883098,882936,162,168,utRho19
1490,thiM,4370902,4370902,4370602,300,512,utRho19
1491,thiQ,146170,146170,145854,316,50,utRho19
1492,thrL,592,760,592,168,200,utRho19
1493,thrS,7210932,7210932,7210280,652,252,utRho19
1494,thrU,8350762,8350776,8350762,14,0,utRho19
1495,thrV,6847414,6847414,6847310,104,285712,utRho19
1496,thrW,525682,525742,525682,60,296,utRho19
1497,thyA,5930696,5930696,5930310,386,2302,utRho19
1498,tig,909986,910266,909986,280,118,utRho19
1499,tisB,7706674,7707106,7706674,432,870,utRho19
1500,tktA,6163414,6163414,6163270,144,182,utRho19
1501,tktB,5158616,5159272,5158616,656,54804,utRho19
1502,tldD,6784368,6784368,6784056,312,32,utRho19
1503,tmcA,5191876,5191876,5191718,158,40,utRho19
1504,tnaC,15553644,15553740,15553644,96,49924,utRho19
1505,tolB,1555074,1555480,1555074,406,542,utRho19
1506,tolC,6356008,6356230,6356008,222,0,utRho19
1507,tomB,961588,961588,961416,172,630,utRho19
1508,tonB,2622108,2622178,2622108,70,24,utRho19
1509,topA,2661578,2662096,2661578,518,266,utRho19
1510,torC,2116112,2116168,2116112,56,256,utRho19
1511,torR,2115968,2115968,2115908,60,518,utRho19
1512,torS,2112364,2112364,2112356,8,0,utRho19
1513,torT,2112414,2112522,2112414,108,0,utRho19
1514,tpiA,8223138,8223138,8223014,124,550,utRho19
1515,tppB,3425342,3425538,3425342,196,1670,utRho19
1516,tpr,2574376,2574376,2574376,0,0,utRho19
1517,tpx,2777688,2777688,2777622,66,314,utRho19
1518,tqsA,3347780,3347826,3347780,46,0,utRho19
1519,treA,2494850,2494850,2494752,98,34,utRho19
1520,treB,8932420,8932420,8932360,60,122,utRho19
1521,treF,7339102,7339184,7339102,82,16,utRho19
1522,treR,8934694,8934694,8934492,202,96,utRho19
1523,trg,2984878,2984940,2984878,62,0,utRho19
1524,trkG,2847342,2847564,2847342,222,6,utRho19
1525,trmA,8326590,8326590,8326540,50,2,utRho19
1526,trpA,2634678,2634678,2634444,234,604,utRho19
1527,trpC,2639888,2639888,2639570,318,0,utRho19
1528,trpL,5292432,5292432,5292328,104,0,utRho19
1529,trpR,9265408,9265520,9265408,112,302,utRho19
1530,trpS,7027394,7027394,7027276,118,1818,utRho19
1531,trpT,7893560,7893914,7893560,354,120904,utRho19
1532,trxA,7931294,7931522,7931294,228,676,utRho19
1533,trxB,1864156,1864156,1864100,56,106,utRho19
1534,trxC,5437350,5437470,5437350,120,318,utRho19
1535,tsaD,6421256,6421256,6421086,170,2,utRho19
1536,tsgA,6985038,6985136,6985038,98,4,utRho19
1537,tsr,9182824,9183314,9182824,490,84,utRho19
1538,tsx,864490,864490,864026,464,490,utRho19
1539,ttcA,2823970,2823970,2823896,74,1510,utRho19
1540,ttdA,6412848,6412926,6412848,78,0,utRho19
1541,ttdR,6412760,6412760,6412512,248,0,utRho19
1542,tufA,6943448,6943448,6942658,790,96034,utRho19
1543,tus,3368346,3368518,3368346,172,448,utRho19
1544,tusA,7218040,7218040,7217992,48,230,utRho19
1545,tusB,6950218,6950218,6949930,288,2138,utRho19
1546,tynA,2902996,2902996,2902698,298,0,utRho19
1547,typA,8116460,8116814,8116460,354,2788,utRho19
1548,tyrB,8534164,8534228,8534164,64,1872,utRho19
1549,tyrP,3979004,3979362,3979004,358,0,utRho19
1550,tyrR,2773384,2773440,2773384,56,16,utRho19
1551,tyrS,3434566,3434566,3434444,122,0,utRho19
1552,tyrT,2575330,2575330,2575244,86,90,utRho19
1553,uacT,6062378,6062734,6062378,356,18,utRho19
1554,ubiC,8504886,8505012,8504886,126,48,utRho19
1555,ubiD,8049618,8049976,8049618,358,1340,utRho19
1556,ubiE,8037494,8037710,8037494,216,0,utRho19
1557,ubiG,4679078,4679134,4679078,56,2,utRho19
1558,ucpA,5089342,5089342,5089246,96,0,utRho19
1559,udp,8032782,8032862,8032782,80,120,utRho19
1560,ugd,4199470,4199470,4199226,244,0,utRho19
1561,ugpB,7184852,7184852,7184650,202,1010,utRho19
1562,ugpQ,7176600,7176600,7176226,374,494,utRho19
1563,uhpT,7694396,7694396,7694334,62,0,utRho19
1564,uidA,3392304,3392304,3392142,162,60,utRho19
1565,uidC,3386012,3386012,3385702,310,0,utRho19
1566,uidR,3394150,3394150,3394104,46,334,utRho19
1567,ulaA,8839854,8839960,8839854,106,0,utRho19
1568,ulaG,8839350,8839350,8839250,100,2,utRho19
1569,ulaR,8837124,8837124,8836906,218,10,utRho19
1570,umpG,5741372,5741372,5740548,824,336,utRho19
1571,umpH,1400704,1400704,1400652,52,0,utRho19
1572,umuD,2461476,2461534,2461476,58,0,utRho19
1573,ung,5433476,5433508,5433476,32,0,utRho19
1574,uof,2843316,2843316,2842900,416,7096,utRho19
1575,upp,5241818,5241818,5241744,74,116,utRho19
1576,usg,4873780,4873780,4873298,482,418,utRho19
1577,ushA,1009772,1009828,1009772,56,0,utRho19
1578,uspA,7279966,7280222,7279966,256,1064,utRho19
1579,uspB,7279696,7279696,7279440,256,252,utRho19
1580,uspC,3959172,3959506,3959172,334,0,utRho19
1581,uspE,2797318,2797318,2797244,74,114,utRho19
1582,uspF,2871282,2871282,2871238,44,2,utRho19
1583,uspG,1283806,1283806,1283734,72,444,utRho19
1584,uvrA,8547872,8547872,8547742,130,130,utRho19
1585,uvrB,1626304,1627052,1626304,748,2832,utRho19
1586,uvrC,3989758,3989758,3989412,346,436,utRho19
1587,uvrD,7995814,7995966,7995814,152,316,utRho19
1588,uvrY,3990812,3990812,3990718,94,0,utRho19
1589,uxaB,3221474,3221474,3221360,114,0,utRho19
1590,uxaC,6489714,6489714,6489482,232,136,utRho19
1591,uxuA,9103036,9103272,9103036,236,1478,utRho19
1592,uxuR,9108916,9109152,9108916,236,136,utRho19
1593,valS,8967854,8967854,8967674,180,930,utRho19
1594,valU,5041848,5041862,5041848,14,52,utRho19
1595,valV,3492830,3492870,3492830,40,38,utRho19
1596,ves,3649968,3649968,3649874,94,0,utRho19
1597,waaA,7616512,7617080,7616512,568,14,utRho19
1598,waaH,7580298,7580298,7580162,136,0,utRho19
1599,waaQ,7616476,7616476,7616196,280,136,utRho19
1600,waaU,7598996,7598996,7598624,372,2,utRho19
1601,waaY,7602272,7602272,7601930,342,2470,utRho19
1602,wbbH,4214888,4214888,4214452,436,2942,utRho19
1603,wbbK,4209212,4209212,4209018,194,124,utRho19
1604,wcaM,4231868,4231868,4231792,76,0,utRho19
1605,wrbA,2135516,2135516,2135416,100,90,utRho19
1606,wza,4275166,4275166,4274486,680,0,utRho19
1607,wzxC,4240674,4240674,4240316,358,0,utRho19
1608,wzzB,4196950,4196950,4196602,348,0,utRho19
1609,xanP,7657642,7657890,7657642,248,0,utRho19
1610,xanQ,6048520,6048702,6048520,182,2,utRho19
1611,xapA,5049820,5049820,5049756,64,0,utRho19
1612,xapR,10090252,10090252,10089908,344,0,utRho19
1613,xdhA,6000514,6000690,6000514,176,32,utRho19
1614,xerD,6079702,6079702,6079486,216,0,utRho19
1615,xseA,5268394,5268464,5268394,70,2,utRho19
1616,xseB,882746,882746,882686,60,422,utRho19
1617,xthA,3664798,3664856,3664798,58,0,utRho19
1618,xylA,7461614,7461614,7461530,84,1622,utRho19
1619,xylE,8484540,8484540,8484508,32,0,utRho19
1620,xylF,7462138,7462262,7462138,124,128,utRho19
1621,xylR,7469812,7469958,7469812,146,0,utRho19
1622,yaaA,13230,13230,12918,312,154,utRho19
1623,yaaI,23876,23876,23572,304,134,utRho19
1624,yaaJ,16034,16034,15918,116,84,utRho19
1625,yaaU,91184,91614,91184,430,12,utRho19
1626,yaaW,23084,23084,22712,372,2,utRho19
1627,yaaX,10060,10468,10060,408,92,utRho19
1628,yabI,142542,142702,142542,160,174,utRho19
1629,yacC,273880,273880,273834,46,422,utRho19
1630,yacH,262932,262932,262520,412,222,utRho19
1631,yacL,268678,268776,268678,98,34,utRho19
1632,yadD,293796,293936,293796,140,4,utRho19
1633,yadE,289930,290162,289930,232,710,utRho19
1634,yadN,314110,314110,313766,344,0,utRho19
1635,yadS,355572,355572,355248,324,150,utRho19
1636,yadV,312470,312470,312402,68,122,utRho19
1637,yaeF,434270,434270,434006,264,2,utRho19
1638,yaeP,428374,428374,428250,124,74,utRho19
1639,yaeQ,428176,428582,428176,406,78,utRho19
1640,yaeR,423716,423754,423716,38,0,utRho19
1641,yafC,462166,462166,461762,404,272,utRho19
1642,yafD,462128,462244,462128,116,266,utRho19
1643,yafK,491986,491986,491610,376,1240,utRho19
1644,yafL,493282,493424,493282,142,0,utRho19
1645,yafN,503938,504010,503938,72,0,utRho19
1646,yafS,469568,469632,469568,64,1418,utRho19
1647,yafT,474470,474670,474470,200,2,utRho19
1648,yafV,480432,480432,480378,54,2,utRho19
1649,yafZ,536052,536052,536010,42,2,utRho19
1650,yagE,564446,564556,564446,110,6,utRho19
1651,yagG,570414,570790,570414,376,22,utRho19
1652,yagI,578384,578384,578324,60,0,utRho19
1653,yagK,586236,586236,585896,340,270,utRho19
1654,yagL,588062,588062,587836,226,24,utRho19
1655,yagN,591342,591342,591158,184,4148,utRho19
1656,yahA,663746,664742,663746,996,392,utRho19
1657,yahC,670136,670136,670044,92,24,utRho19
1658,yahE,671478,671850,671478,372,2,utRho19
1659,yahM,690504,690808,690504,304,26,utRho19
1660,yahN,692872,692872,692674,198,74,utRho19
1661,yahO,692864,692968,692864,104,146,utRho19
1662,yaiE,816296,816354,816296,58,232,utRho19
1663,yaiI,811396,811528,811396,132,4,utRho19
1664,yaiO,761946,761946,761684,262,8,utRho19
1665,yaiP,767970,767970,767870,100,4,utRho19
1666,yaiS,769660,769660,769232,428,72,utRho19
1667,yaiV,788922,788922,788922,0,0,utRho19
1668,yaiY,799094,799094,798666,428,2,utRho19
1669,yaiZ,798888,799186,798888,298,20,utRho19
1670,yajC,854410,854574,854410,164,96,utRho19
1671,yajD,860938,861210,860938,272,316,utRho19
1672,yajI,866068,866068,865702,366,418,utRho19
1673,yajL,887496,887496,887282,214,398,utRho19
1674,yajQ,889316,889366,889316,50,0,utRho19
1675,yajR,893374,893374,893332,42,24,utRho19
1676,ybaB,987418,988152,987418,734,2614,utRho19
1677,ybaL,1006590,1006590,1006476,114,54,utRho19
1678,ybaM,980648,980648,980542,106,232,utRho19
1679,ybaN,981436,981764,981436,328,1470,utRho19
1680,ybaO,936704,936766,936704,62,0,utRho19
1681,ybaP,1016568,1016568,1016160,408,1492,utRho19
1682,ybaQ,1016348,1016436,1016348,88,4,utRho19
1683,ybaS,1023146,1023282,1023146,136,412,utRho19
1684,ybaV,927504,927874,927504,370,0,utRho19
1685,ybaY,950490,950758,950490,268,2258,utRho19
1686,ybbB,1062724,1062724,1062452,272,196,utRho19
1687,ybbJ,1030154,1030154,1029718,436,298,utRho19
1688,ybbL,1031784,1031838,1031784,54,0,utRho19
1689,ybbN,1037136,1037136,1036558,578,1398,utRho19
1690,ybbO,1038658,1038658,1038298,360,1954,utRho19
1691,ybbY,1080718,1081130,1080718,412,1204,utRho19
1692,ybcH,1176140,1176140,1175962,178,6,utRho19
1693,ybcI,1113264,1113264,1113106,158,152,utRho19
1694,ybcJ,1114050,1114050,1113746,304,492,utRho19
1695,ybcK,1137502,1137804,1137502,302,6,utRho19
1696,ybcL,1141690,1141786,1141690,96,0,utRho19
1697,ybcN,1144628,1144932,1144628,304,6,utRho19
1698,ybcQ,1147548,1147912,1147548,364,22,utRho19
1699,ybcW,1159610,1159760,1159610,150,0,utRho19
1700,ybdD,1263982,1264364,1263982,382,106,utRho19
1701,ybdF,1212106,1212106,1211772,334,200,utRho19
1702,ybdH,1267048,1267048,1266954,94,0,utRho19
1703,ybdJ,1212822,1212822,1212398,424,66,utRho19
1704,ybdK,1215122,1215122,1214766,356,6,utRho19
1705,ybdL,1267114,1267172,1267114,58,40,utRho19
1706,ybdM,1271110,1271110,1270752,358,190,utRho19
1707,ybdN,1273372,1273372,1273138,234,0,utRho19
1708,ybdR,1283844,1284176,1283844,332,770,utRho19
1709,ybeD,1325412,1325412,1325284,128,318,utRho19
1710,ybeF,1323090,1323090,1322756,334,16,utRho19
1711,ybeL,1349986,1350036,1349986,50,976,utRho19
1712,ybeQ,1353412,1353412,1353094,318,2,utRho19
1713,ybeR,1353120,1353422,1353120,302,0,utRho19
1714,ybeT,1358832,1358832,1358812,20,2,utRho19
1715,ybeU,1358924,1359016,1358924,92,0,utRho19
1716,ybeZ,1386938,1386938,1386834,104,1318,utRho19
1717,ybfA,1458074,1458268,1458074,194,0,utRho19
1718,ybfE,1423878,1423878,1423796,82,88,utRho19
1719,ybfF,1425692,1425692,1425604,88,210,utRho19
1720,ybfH,1433282,1433282,1433194,88,0,utRho19
1721,ybgA,1477840,1478002,1477840,162,6,utRho19
1722,ybgC,1549288,1549504,1549288,216,0,utRho19
1723,ybgD,1505916,1505916,1505590,326,222,utRho19
1724,ybgI,1485238,1485654,1485238,416,0,utRho19
1725,ybgO,1498370,1498370,1497964,406,0,utRho19
1726,ybgS,1570992,1570992,1570634,358,1306,utRho19
1727,ybhA,1597184,1597184,1596862,322,94,utRho19
1728,ybhB,1616070,1616070,1615818,252,2,utRho19
1729,ybhC,1614642,1614642,1614562,80,2328,utRho19
1730,ybhD,1601418,1601418,1601276,142,2,utRho19
1731,ybhH,1601104,1601518,1601104,414,2,utRho19
1732,ybhK,1633384,1633384,1633294,90,4,utRho19
1733,ybhM,1641556,1641586,1641556,30,0,utRho19
1734,ybhN,1645296,1645296,1644996,300,612,utRho19
1735,ybhQ,1649202,1649260,1649202,58,10,utRho19
1736,ybiA,1665920,1665920,1665900,20,0,utRho19
1737,ybiI,1676968,1676968,1676912,56,4,utRho19
1738,ybiO,1691328,1691328,1690960,368,406,utRho19
1739,ybiP,1705252,1705252,1705194,58,74,utRho19
1740,ybiS,1711572,1711572,1711488,84,594,utRho19
1741,ybiT,1711894,1711926,1711894,32,0,utRho19
1742,ybiU,1718212,1718212,1718122,90,2,utRho19
1743,ybiV,1720176,1720176,1720056,120,26,utRho19
1744,ybiW,1725566,1725566,1725212,354,1972,utRho19
1745,ybiX,1678548,1678548,1678414,134,208,utRho19
1746,ybjC,1781784,1781826,1781784,42,0,utRho19
1747,ybjE,1830154,1830154,1829714,440,204,utRho19
1748,ybjG,1767016,1767016,1766776,240,1496,utRho19
1749,ybjL,1779882,1779882,1779638,244,268,utRho19
1750,ybjM,1779770,1780178,1779770,408,132,utRho19
1751,ybjO,1795704,1795978,1795704,274,0,utRho19
1752,ybjP,1809046,1809046,1808934,112,38,utRho19
1753,ybjQ,1809034,1809186,1809034,152,174,utRho19
1754,ybjS,1813796,1813796,1813506,290,86,utRho19
1755,ybjX,1838206,1838206,1838168,38,0,utRho19
1756,ycaD,1891438,1891742,1891438,304,0,utRho19
1757,ycaI,1928210,1928640,1928210,430,152,utRho19
1758,ycaK,1899094,1899336,1899094,242,0,utRho19
1759,ycaL,1920264,1920528,1920264,264,0,utRho19
1760,ycaM,1894240,1894458,1894240,218,4,utRho19
1761,ycaR,1941284,1941346,1941284,62,850,utRho19
1762,ycbB,1961862,1962094,1961862,232,2,utRho19
1763,ycbJ,1943344,1943504,1943344,160,0,utRho19
1764,ycbK,1966046,1966150,1966046,104,772,utRho19
1765,ycbZ,2036920,2036920,2036598,322,220,utRho19
1766,yccA,2062886,2062886,2062836,50,0,utRho19
1767,yccF,2048730,2048730,2048696,34,2,utRho19
1768,yccS,2047988,2047988,2047766,222,8,utRho19
1769,yccT,2055674,2055674,2055546,128,28,utRho19
1770,yccX,2059960,2060128,2059960,168,52,utRho19
1771,ycdT,2185682,2185752,2185682,70,0,utRho19
1772,ycdU,2191266,2191686,2191266,420,4,utRho19
1773,ycdZ,2200504,2200592,2200504,88,224,utRho19
1774,yceA,2233544,2233614,2233544,70,42,utRho19
1775,yceD,2293298,2293588,2293298,290,878,utRho19
1776,yceF,2293522,2293522,2293190,332,520,utRho19
1777,yceH,2252154,2252314,2252154,160,5454,utRho19
1778,yceI,2237282,2237282,2236952,330,704,utRho19
1779,yceJ,2238142,2238142,2238092,50,2,utRho19
1780,yceM,2253208,2253612,2253208,404,232,utRho19
1781,yceO,2239264,2239264,2238894,370,456,utRho19
1782,yceQ,2288760,2289004,2288760,244,8612,utRho19
1783,ycfD,2376540,2376540,2376480,60,114,utRho19
1784,ycfJ,2334814,2335198,2334814,384,2,utRho19
1785,ycfS,2340834,2340834,2340748,86,2,utRho19
1786,ycfT,2350658,2350658,2350330,328,2,utRho19
1787,ycfZ,2362760,2362760,2362534,226,76,utRho19
1788,ycgB,2474570,2474570,2474482,88,0,utRho19
1789,ycgG,2434614,2434656,2434614,42,164,utRho19
1790,ycgJ,2452956,2453200,2452956,244,6,utRho19
1791,ycgL,2455218,2455362,2455218,144,0,utRho19
1792,ycgN,2457366,2457660,2457366,294,430,utRho19
1793,ycgR,2489112,2489112,2489054,58,0,utRho19
1794,ycgV,2512222,2512222,2511904,318,4,utRho19
1795,ycgX,2426568,2426568,2426214,354,418,utRho19
1796,ycgY,2490166,2490320,2490166,154,4,utRho19
1797,ycgZ,2431504,2431578,2431504,74,2,utRho19
1798,ychE,2596904,2597196,2596904,292,0,utRho19
1799,ychF,2515764,2515764,2515624,140,104,utRho19
1800,ychH,2517476,2517582,2517476,106,250,utRho19
1801,ychJ,2578354,2578354,2578264,90,34,utRho19
1802,ychN,2547310,2547310,2547198,112,0,utRho19
1803,ychO,2547520,2547850,2547520,330,224,utRho19
1804,ychQ,2533798,2533848,2533798,50,0,utRho19
1805,yciA,2624828,2624828,2624492,336,200,utRho19
1806,yciB,2626110,2626110,2625780,330,3200,utRho19
1807,yciC,2627396,2627396,2627326,70,0,utRho19
1808,yciE,2630794,2630794,2630448,346,564,utRho19
1809,yciG,5264368,5264368,5264140,228,0,utRho19
1810,yciI,2621784,2621784,2621730,54,0,utRho19
1811,yciN,2661606,2661606,2661336,270,124,utRho19
1812,yciS,2680270,2680486,2680270,216,0,utRho19
1813,yciT,2689088,2689088,2688692,396,806,utRho19
1814,yciU,2614718,2614718,2614300,418,1034,utRho19
1815,yciV,2646376,2646440,2646376,64,0,utRho19
1816,yciW,2700472,2700472,2700214,258,76,utRho19
1817,yciZ,2689276,2689276,2689218,58,140,utRho19
1818,ycjD,2703792,2703792,2703520,272,144,utRho19
1819,ycjG,2777748,2777860,2777748,112,238,utRho19
1820,ycjM,2740006,2740432,2740006,426,110,utRho19
1821,ycjW,2767982,2767982,2767922,60,0,utRho19
1822,ycjX,2768138,2768234,2768138,96,0,utRho19
1823,ycjY,5568288,5568288,5567460,828,352,utRho19
1824,ydaE,2836438,2836438,2836016,422,0,utRho19
1825,ydaN,2816048,2816100,2816048,52,0,utRho19
1826,ydaS,2840340,2840730,2840340,390,0,utRho19
1827,ydbC,2948376,2948442,2948376,66,0,utRho19
1828,ydbD,2950132,2950288,2950132,156,0,utRho19
1829,ydbH,2885800,2886102,2885800,302,408,utRho19
1830,ydbJ,2881712,2882116,2881712,404,10,utRho19
1831,ydbK,2881692,2881692,2881568,124,116,utRho19
1832,ydcA,2983294,2983354,2983294,60,60,utRho19
1833,ydcF,2974404,2974470,2974404,66,118,utRho19
1834,ydcI,2990268,2990268,2990142,126,20,utRho19
1835,ydcJ,2990266,2990576,2990266,310,0,utRho19
1836,ydcK,3001280,3001280,3000898,382,0,utRho19
1837,ydcL,3004646,3004914,3004646,268,0,utRho19
1838,ydcN,3012308,3012344,3012308,36,62,utRho19
1839,ydcP,3013508,3013562,3013508,54,138,utRho19
1840,ydcR,3019956,3020006,3019956,50,54,utRho19
1841,ydcS,3022906,3023308,3022906,402,12,utRho19
1842,ydcX,3034442,3034778,3034442,336,98,utRho19
1843,ydcY,3035220,3035296,3035220,76,94,utRho19
1844,ydcZ,3036750,3036750,3036662,88,222,utRho19
1845,yddB,3155332,3155332,3155238,94,50,utRho19
1846,yddE,3071738,3071738,3071716,22,0,utRho19
1847,yddG,3094410,3094410,3094338,72,0,utRho19
1848,yddJ,3089732,3089732,3089438,294,12,utRho19
1849,yddW,3137704,3137704,3137646,58,62,utRho19
1850,ydeA,3233910,3234056,3233910,146,142,utRho19
1851,ydeE,3242528,3242664,3242528,136,2,utRho19
1852,ydeI,3249118,3249118,3248994,124,98,utRho19
1853,ydeJ,3249376,3249546,3249376,170,4,utRho19
1854,ydeN,3165458,3165458,3165048,410,0,utRho19
1855,ydeP,3173328,3173328,3172972,356,0,utRho19
1856,ydeR,3176596,3176596,3176592,4,8,utRho19
1857,ydfA,3296872,3297016,3296872,144,0,utRho19
1858,ydfG,3254982,3255034,3254982,52,4,utRho19
1859,ydfH,3256652,3256704,3256652,52,12,utRho19
1860,ydfK,3265446,3266144,3265446,698,476,utRho19
1861,ydgA,3379588,3379704,3379588,116,56,utRho19
1862,ydgC,3364124,3364124,3364060,64,0,utRho19
1863,ydgD,3343906,3343920,3343906,14,6,utRho19
1864,ydgH,3356754,3356854,3356754,100,62,utRho19
1865,ydgJ,3408798,3408798,3408616,182,4,utRho19
1866,ydgK,3410414,3410500,3410414,86,260,utRho19
1867,ydhB,3479618,3479618,3479596,22,0,utRho19
1868,ydhC,3479698,3479822,3479698,124,0,utRho19
1869,ydhF,3451310,3451310,3451264,46,0,utRho19
1870,ydhI,3441996,3442050,3441996,54,0,utRho19
1871,ydhL,3451864,3451864,3451840,24,8,utRho19
1872,ydhQ,3492404,3492404,3492254,150,72,utRho19
1873,ydhS,3494136,3494262,3494136,126,10,utRho19
1874,ydhT,3499138,3499138,3499118,20,2,utRho19
1875,ydhY,3509284,3509284,3508954,330,12,utRho19
1876,ydhZ,3510418,3510418,3510282,136,6,utRho19
1877,ydiE,3579206,3579226,3579206,20,0,utRho19
1878,ydiH,3530582,3530582,3530406,176,0,utRho19
1879,ydiM,3541852,3542142,3541852,290,186,utRho19
1880,ydiN,3544818,3545024,3544818,206,0,utRho19
1881,ydiP,3558656,3558656,3558602,54,2,utRho19
1882,ydiU,3582508,3582508,3582488,20,6,utRho19
1883,ydiV,3584174,3584174,3584040,134,52,utRho19
1884,ydiY,3612500,3612500,3612166,334,0,utRho19
1885,ydjA,3697400,3697400,3697352,48,50,utRho19
1886,ydjE,3708082,3708082,3707958,124,0,utRho19
1887,ydjF,3709848,3709848,3709708,140,0,utRho19
1888,ydjM,3620340,3620422,3620340,82,0,utRho19
1889,ydjO,3626696,3626696,3626288,408,28,utRho19
1890,ydjX,3666434,3666802,3666434,368,706,utRho19
1891,yeaE,3731448,3731448,3731272,176,40,utRho19
1892,yeaG,3733530,3733816,3733530,286,356,utRho19
1893,yeaI,3740486,3740770,3740486,284,0,utRho19
1894,yeaJ,3743874,3744082,3743874,208,86,utRho19
1895,yeaL,3748646,3748704,3748646,58,192,utRho19
1896,yeaM,3751296,3751296,3751152,144,14,utRho19
1897,yeaN,3750926,3751346,3750926,420,84,utRho19
1898,yeaO,3753554,3753818,3753554,264,8,utRho19
1899,yeaP,3755314,3755430,3755314,116,308,utRho19
1900,yeaQ,3758780,3758780,3758510,270,42,utRho19
1901,yeaR,3759988,3759988,3759896,92,0,utRho19
1902,yeaY,3781122,3781122,3781064,58,8,utRho19
1903,yebB,3892220,3892502,3892220,282,2,utRho19
1904,yebC,3896370,3896370,3896302,68,54,utRho19
1905,yebE,3859464,3859464,3859414,50,8,utRho19
1906,yebG,3861530,3861530,3861494,36,0,utRho19
1907,yebK,3873180,3873304,3873180,124,60,utRho19
1908,yebQ,3820314,3820552,3820314,238,88,utRho19
1909,yebS,3832238,3832516,3832238,278,0,utRho19
1910,yebV,3843430,3843560,3843430,130,60,utRho19
1911,yebW,3843914,3844242,3843914,328,15414,utRho19
1912,yecC,3995646,3995646,3995628,18,0,utRho19
1913,yecD,3901272,3901664,3901272,392,36,utRho19
1914,yecF,3991434,3991636,3991434,202,172,utRho19
1915,yecH,3979304,3979304,3978980,324,4,utRho19
1916,yecJ,3975604,3975604,3975516,88,60,utRho19
1917,yecM,3919968,3919968,3919692,276,114,utRho19
1918,yecR,3976400,3976444,3976400,44,68,utRho19
1919,yecT,3923862,3923944,3923862,82,0,utRho19
1920,yedD,4016522,4016522,4016180,342,6,utRho19
1921,yedE,4016310,4016554,4016310,244,4,utRho19
1922,yedI,4058922,4058922,4058732,190,6,utRho19
1923,yedJ,4066446,4066446,4066158,288,36,utRho19
1924,yedV,4076404,4076404,4076304,100,6,utRho19
1925,yedX,4077680,4077912,4077680,232,4,utRho19
1926,yedY,4078572,4078956,4078572,384,130,utRho19
1927,yeeA,4161322,4161322,4161182,140,0,utRho19
1928,yeeE,4171104,4171104,4171050,54,2,utRho19
1929,yeeJ,4089526,4089822,4089526,296,4,utRho19
1930,yeeN,4113508,4113716,4113508,208,4,utRho19
1931,yeeO,4119444,4119444,4119692,248,0,utRho19
1932,yeeX,4158834,4158834,4158722,112,806,utRho19
1933,yeeZ,4178422,4178422,4178256,166,0,utRho19
1934,yefM,4179466,4179466,4179426,40,70,utRho19
1935,yegD,4295288,4295348,4295288,60,142,utRho19
1936,yegH,4275726,4275804,4275726,78,4,utRho19
1937,yegI,4302154,4302154,4301970,184,0,utRho19
1938,yegJ,4302032,4302370,4302032,338,0,utRho19
1939,yegQ,4331182,4331336,4331182,154,636,utRho19
1940,yegR,4336698,4336698,4336612,86,2,utRho19
1941,yegS,4337086,4337424,4337086,338,0,utRho19
1942,yegT,4357562,4357642,4357562,80,6,utRho19
1943,yegX,4367640,4367640,4367302,338,32,utRho19
1944,yehA,4376944,4376944,4376828,116,8,utRho19
1945,yehE,4385818,4385818,4385592,226,0,utRho19
1946,yehK,4407568,4407944,4407568,376,0,utRho19
1947,yehL,4408804,4409192,4408804,388,2,utRho19
1948,yeiB,4486146,4486146,4485934,212,54,utRho19
1949,yeiE,4499422,4499422,4499236,186,0,utRho19
1950,yeiG,4487776,4487820,4487776,44,318,utRho19
1951,yeiH,4499332,4499434,4499332,102,74,utRho19
1952,yeiI,4503306,4503400,4503306,94,142,utRho19
1953,yeiL,4510580,4510710,4510580,130,0,utRho19
1954,yeiP,4530834,4530900,4530834,66,502,utRho19
1955,yeiQ,4532328,4532490,4532328,162,100,utRho19
1956,yeiR,4535484,4535658,4535484,174,32,utRho19
1957,yeiW,4530840,4530840,4530590,250,792,utRho19
1958,yejA,4544624,4544728,4544624,104,10,utRho19
1959,yejG,4556892,4556892,4556474,418,872,utRho19
1960,yejH,4561244,4561264,4561244,20,0,utRho19
1961,yejK,4568218,4568218,4567894,324,496,utRho19
1962,yejO,4578352,4578352,4577800,552,274,utRho19
1963,yfaD,4713380,4713808,4713380,428,8,utRho19
1964,yfaE,4696676,4697028,4696676,352,1532,utRho19
1965,yfaL,4688568,4688568,4688338,230,0,utRho19
1966,yfaP,4656398,4656398,4656286,112,46,utRho19
1967,yfaU,4717892,4717892,4717690,202,0,utRho19
1968,yfaY,4727310,4727310,4727266,44,8,utRho19
1969,yfaZ,4728744,4728744,4728550,194,8,utRho19
1970,yfbK,4771810,4771810,4771444,366,6,utRho19
1971,yfbL,4771500,4771720,4771500,220,6,utRho19
1972,yfbN,4777174,4777174,4776852,322,66,utRho19
1973,yfbO,4776916,4777162,4776916,246,66,utRho19
1974,yfbP,4777990,4778232,4777990,242,128,utRho19
1975,yfbR,4817662,4817724,4817662,62,0,utRho19
1976,yfcI,4847424,4847424,4847078,346,4,utRho19
1977,yfcJ,4880482,4880482,4880240,242,22,utRho19
1978,yfcL,4888502,4888502,4888338,164,0,utRho19
1979,yfcV,4911642,4911642,4911292,350,50,utRho19
1980,yfcZ,4921958,4921958,4921868,90,86,utRho19
1981,yfdF,4925604,4926024,4925604,420,110,utRho19
1982,yfdG,4935474,4935710,4935474,236,48,utRho19
1983,yfdP,4946844,4947040,4946844,196,4,utRho19
1984,yfdX,4988866,4988866,4988804,62,0,utRho19
1985,yfdY,4990672,4990672,4990584,88,6,utRho19
1986,yfeA,5035784,5035784,5035664,120,12816,utRho19
1987,yfeC,5036668,5036934,5036668,266,98,utRho19
1988,yfeH,5053818,5053892,5053818,74,4,utRho19
1989,yfeK,5074630,5074684,5074630,54,0,utRho19
1990,yfeO,5018906,5019260,5018906,354,378,utRho19
1991,yfeR,5054078,5054078,5053712,366,4,utRho19
1992,yfeX,5101356,5101356,5101090,266,44,utRho19
1993,yfeY,5102486,5102486,5102432,54,0,utRho19
1994,yfeZ,5103842,5103842,5103452,390,436,utRho19
1995,yffO,5123804,5124222,5123804,418,12,utRho19
1996,yffQ,5126778,5127154,5126778,376,80,utRho19
1997,yffS,5128800,5128986,5128800,186,10,utRho19
1998,yfgC,5232052,5232188,5232052,136,4,utRho19
1999,yfgF,5258062,5258062,5257876,186,18,utRho19
2000,yfgG,5258170,5258580,5258170,410,54,utRho19
2001,yfgH,5259344,5259584,5259344,240,0,utRho19
2002,yfgM,5278866,5278866,5278566,300,688,utRho19
2003,yfhH,5397414,5397518,5397414,104,86,utRho19
2004,yfhM,5304648,5304648,5304574,74,0,utRho19
2005,yfhR,5328408,5328726,5328408,318,192,utRho19
2006,yfiC,5425610,5425610,5425528,82,0,utRho19
2007,yfiE,5430688,5430688,5430640,48,18,utRho19
2008,yfiL,5482630,5482720,5482630,90,0,utRho19
2009,yfiM,5448066,5448358,5448066,292,1750,utRho19
2010,yfiR,5483354,5483750,5483354,396,414,utRho19
2011,yfjH,5517326,5517326,5517200,126,0,utRho19
2012,yfjI,5517710,5517970,5517710,260,4,utRho19
2013,yfjJ,5521014,5521094,5521014,80,4,utRho19
2014,yfjM,5531970,5531970,5531552,418,466,utRho19
2015,yfjP,5535080,5535420,5535080,340,16,utRho19
2016,yfjW,5546570,5546636,5546570,66,0,utRho19
2017,yfjX,5551776,5551838,5551776,62,0,utRho19
2018,ygaC,5601180,5601180,5599988,1192,862,utRho19
2019,ygaM,5600242,5600292,5600242,50,26,utRho19
2020,ygaU,5593628,5593628,5593572,56,564,utRho19
2021,ygaZ,5619190,5619234,5619190,44,2,utRho19
2022,ygbA,5713656,5713656,5713612,44,0,utRho19
2023,ygbE,5746784,5746784,5746674,110,260,utRho19
2024,ygbI,5722882,5722882,5722528,354,8,utRho19
2025,ygbK,5724394,5724670,5724394,276,2854,utRho19
2026,ygbL,5727074,5727186,5727074,112,434,utRho19
2027,ygbN,5729814,5730202,5729814,388,1208,utRho19
2028,ygcG,5811210,5811422,5811210,212,0,utRho19
2029,ygcN,5785144,5785314,5785144,170,0,utRho19
2030,ygcU,5799214,5799214,5798836,378,10,utRho19
2031,ygcW,5800942,5800942,5800546,396,0,utRho19
2032,ygdD,5883442,5883442,5883262,180,26,utRho19
2033,ygdG,5861746,5861930,5861746,184,546,utRho19
2034,ygdI,5886526,5886526,5886290,236,82,utRho19
2035,ygdQ,5940784,5940840,5940784,56,0,utRho19
2036,ygdR,5942494,5942542,5942494,48,2,utRho19
2037,ygeA,5961606,5961606,5961270,336,2,utRho19
2038,ygeH,5983758,5984188,5983758,430,8,utRho19
2039,ygeI,5987162,5987276,5987162,114,52,utRho19
2040,ygeR,6000078,6000078,5999782,296,10,utRho19
2041,ygeV,6011694,6011694,6011572,122,0,utRho19
2042,ygeW,6012234,6012524,6012234,290,6,utRho19
2043,ygfB,6110946,6110946,6110888,58,20,utRho19
2044,ygfK,6031984,6032120,6031984,136,4,utRho19
2045,ygfS,6058328,6058328,6058024,304,0,utRho19
2046,ygfZ,6082564,6082626,6082564,62,68,utRho19
2047,yggC,6149512,6149512,6149378,134,302,utRho19
2048,yggE,6136370,6136370,6136160,210,444,utRho19
2049,yggI,6179176,6179510,6179176,334,294,utRho19
2050,yggL,6204508,6204508,6204266,242,194,utRho19
2051,yggM,6199514,6199514,6199130,384,62,utRho19
2052,yggN,6203596,6203596,6203246,350,70,utRho19
2053,yggX,18623958,18624558,18623958,600,504,utRho19
2054,yghA,6298966,6299324,6298966,358,0,utRho19
2055,yghB,6307058,6307126,6307058,68,154,utRho19
2056,yghD,6222614,6222614,6222252,362,160,utRho19
2057,yghF,6225798,6225798,6225840,42,0,utRho19
2058,yghJ,6238640,6238640,6238224,416,246,utRho19
2059,yghQ,6265186,6265186,6264816,370,0,utRho19
2060,yghT,6267830,6268262,6267830,432,8,utRho19
2061,yghU,6277400,6277454,6277400,54,74,utRho19
2062,yghW,6293506,6293506,6293474,32,2,utRho19
2063,yghZ,6295562,6295794,6295562,232,0,utRho19
2064,ygiD,6365122,6365122,6364868,254,556,utRho19
2065,ygiH,6409066,6409388,6409066,322,2,utRho19
2066,ygiL,6370622,6370828,6370622,206,2,utRho19
2067,ygiM,6402084,6402414,6402084,330,450,utRho19
2068,ygiN,6346156,6346284,6346156,128,4600,utRho19
2069,ygiQ,6322620,6322620,6322292,328,8,utRho19
2070,ygiS,6335462,6335462,6335436,26,0,utRho19
2071,ygiV,6338582,6338582,6338462,120,350,utRho19
2072,ygiW,6339774,6339774,6339352,422,126,utRho19
2073,ygiZ,6344506,6344506,6344422,84,0,utRho19
2074,ygjH,6442528,6442528,6442494,34,0,utRho19
2075,ygjI,6452140,6452468,6452140,328,4,utRho19
2076,ygjQ,6472730,6473080,6472730,350,180,utRho19
2077,ygjR,6474564,6474586,6474564,22,50,utRho19
2078,ygjV,6483638,6483638,6483488,150,0,utRho19
2079,yhaB,6535632,6535708,6535632,76,0,utRho19
2080,yhaH,6504498,6504608,6504498,110,4,utRho19
2081,yhaI,6505400,6505822,6505400,422,134,utRho19
2082,yhaJ,6508560,6508560,6508428,132,8,utRho19
2083,yhaK,6508538,6508638,6508538,100,6,utRho19
2084,yhbQ,6599878,6599932,6599878,54,44,utRho19
2085,yhbT,6602736,6602736,6602552,184,12,utRho19
2086,yhbU,6602558,6602970,6602558,412,16,utRho19
2087,yhbX,6643302,6643302,6643226,76,0,utRho19
2088,yhbY,6655518,6655580,6655518,62,202,utRho19
2089,yhcA,6723956,6724224,6723956,268,12,utRho19
2090,yhcB,6760364,6760382,6760364,18,74,utRho19
2091,yhcC,6708470,6708470,6708100,370,94,utRho19
2092,yhcF,6733440,6733852,6733440,412,216,utRho19
2093,yhcH,6739124,6739124,6738956,168,182,utRho19
2094,yhcM,6760312,6760312,6759994,318,24,utRho19
2095,yhcN,6770812,6771076,6770812,264,56,utRho19
2096,yhcO,6772606,6772606,6772258,348,0,utRho19
2097,yhdH,6806560,6806968,6806560,408,800,utRho19
2098,yhdJ,6823234,6823306,6823234,72,0,utRho19
2099,yhdN,6879092,6879092,6879018,74,398,utRho19
2100,yhdT,6814702,6814750,6814702,48,70,utRho19
2101,yhdU,6824994,6825242,6824994,248,212,utRho19
2102,yhdV,6836392,6836780,6836392,388,18,utRho19
2103,yhdW,6837944,6838298,6837944,354,0,utRho19
2104,yheO,6953082,6953082,6952880,202,1034,utRho19
2105,yheV,6957970,6957970,6957584,386,102,utRho19
2106,yhfA,6971902,6971902,6971636,266,114,utRho19
2107,yhfG,6983294,6983294,6983240,54,110,utRho19
2108,yhfL,6998622,6998896,6998622,274,2,utRho19
2109,yhfY,7023244,7023244,7022844,400,0,utRho19
2110,yhgA,7086294,7086334,7086294,40,0,utRho19
2111,yhgE,7065176,7065176,7064878,298,422,utRho19
2112,yhgF,7074352,7074770,7074352,418,3850,utRho19
2113,yhhA,7173458,7173886,7173458,428,12,utRho19
2114,yhhI,7248346,7248756,7248346,410,0,utRho19
2115,yhhJ,7253696,7253696,7253606,90,116,utRho19
2116,yhhM,7211588,7211588,7211220,368,90,utRho19
2117,yhhN,7211150,7211502,7211150,352,84,utRho19
2118,yhhQ,7218238,7218434,7218238,196,334,utRho19
2119,yhhT,7223682,7223730,7223682,48,144,utRho19
2120,yhhX,7162032,7162032,7161610,422,10,utRho19
2121,yhhY,7162222,7162276,7162222,54,4,utRho19
2122,yhhZ,7163516,7163726,7163516,210,78,utRho19
2123,yhiD,7312220,7312220,7311804,416,157574,utRho19
2124,yhiJ,7265190,7265190,7265180,10,0,utRho19
2125,yhiM,7269270,7269682,7269270,412,32,utRho19
2126,yhiN,7275000,7275000,7274820,180,250,utRho19
2127,yhjA,7338522,7338522,7338376,146,2,utRho19
2128,yhjB,7344090,7344090,7343788,302,20,utRho19
2129,yhjC,7344272,7344684,7344272,412,6,utRho19
2130,yhjD,7346660,7346724,7346660,64,104,utRho19
2131,yhjE,7349274,7349572,7349274,298,20,utRho19
2132,yhjG,7356824,7356824,7356730,94,0,utRho19
2133,yhjH,7358458,7358458,7358374,84,44,utRho19
2134,yhjJ,7364032,7364032,7363880,152,4,utRho19
2135,yhjK,7371296,7371296,7371158,138,0,utRho19
2136,yhjR,7392750,7392750,7392370,380,386,utRho19
2137,yhjV,7400796,7401126,7400796,330,26,utRho19
2138,yhjX,7424194,7424194,7424014,180,2,utRho19
2139,yhjY,7425966,7425966,7425868,98,0,utRho19
2140,yiaB,7455654,7455654,7455496,158,0,utRho19
2141,yiaD,7432712,7433094,7432712,382,8,utRho19
2142,yiaF,7438194,7438194,7438088,106,4,utRho19
2143,yiaG,7438862,7438956,7438862,94,1236,utRho19
2144,yiaJ,7485236,7485236,7485064,172,8,utRho19
2145,yiaK,7485348,7485466,7485348,118,0,utRho19
2146,yiaT,7503924,7503924,7503736,188,0,utRho19
2147,yiaU,7503792,7503984,7503792,192,0,utRho19
2148,yiaY,7515856,7515856,7515654,202,114,utRho19
2149,yibF,7523950,7523950,7523910,40,10,utRho19
2150,yibG,7536128,7536354,7536128,226,4,utRho19
2151,yibL,7553194,7553330,7553194,136,390,utRho19
2152,yibN,7570112,7570112,7570030,82,326,utRho19
2153,yibT,7552848,7552848,7552760,88,158,utRho19
2154,yicC,7633290,7633352,7633290,62,64,utRho19
2155,yicH,7660862,7660914,7660862,52,0,utRho19
2156,yicJ,7673328,7673328,7671858,1470,290,utRho19
2157,yicN,7685018,7685018,7684804,214,20,utRho19
2158,yicO,7687914,7687914,7687578,336,0,utRho19
2159,yicR,15250308,15250308,15250236,72,0,utRho19
2160,yidB,7755230,7755230,7754930,300,0,utRho19
2161,yidE,7732780,7732780,7732546,234,0,utRho19
2162,yidF,7711580,7711580,7711222,358,0,utRho19
2163,yidQ,7735088,7735456,7735088,368,2524,utRho19
2164,yidR,7738824,7738824,7738618,206,0,utRho19
2165,yieE,7787658,7787738,7787658,80,18,utRho19
2166,yieH,7793314,7793548,7793314,234,0,utRho19
2167,yieK,7798928,7798928,7798786,142,0,utRho19
2168,yifB,7900350,7900350,7899998,352,68,utRho19
2169,yifL,7988984,7989044,7988984,60,94,utRho19
2170,yigF,8005750,8005750,8005598,152,320,utRho19
2171,yigI,8009448,8009448,8009394,54,6,utRho19
2172,yigM,8022100,8022152,8022100,52,2,utRho19
2173,yihA,8101970,8101970,8101458,512,142,utRho19
2174,yihD,8084098,8084138,8084098,40,2,utRho19
2175,yihF,8088110,8088398,8088110,288,0,utRho19
2176,yihG,8093304,8093304,8093204,100,0,utRho19
2177,yihI,8102616,8102694,8102616,78,56,utRho19
2178,yihL,8120506,8120894,8120506,388,8,utRho19
2179,yihN,8124332,8124494,8124332,162,4,utRho19
2180,yihO,8131942,8131942,8131532,410,0,utRho19
2181,yihQ,8138892,8138892,8138552,340,0,utRho19
2182,yihV,8147064,8147478,8147064,414,8,utRho19
2183,yihX,8151096,8151106,8151096,10,162,utRho19
2184,yiiE,8158192,8158582,8158192,390,26,utRho19
2185,yiiF,8159124,8159502,8159124,378,4,utRho19
2186,yiiG,8173762,8174004,8173762,242,2,utRho19
2187,yiiM,8205506,8205644,8205506,138,22,utRho19
2188,yiiQ,8224624,8224624,8224428,196,116,utRho19
2189,yiiS,8225738,8225934,8225738,196,2,utRho19
2190,yijE,8272178,8272216,8272178,38,48,utRho19
2191,yijF,8275728,8275728,8275314,414,52,utRho19
2192,yijO,8296858,8296858,8296634,224,68,utRho19
2193,yjaA,8426240,8426468,8426240,228,116320,utRho19
2194,yjaB,8428312,8428312,8428246,66,6,utRho19
2195,yjaG,8398746,8399008,8398746,262,1962,utRho19
2196,yjaH,8401022,8401132,8401022,110,500,utRho19
2197,yjaZ,8379506,8379572,8379506,66,2,utRho19
2198,yjbB,8455204,8455462,8455204,258,0,utRho19
2199,yjbE,16943432,16943624,16943432,192,12,utRho19
2200,yjbL,8520318,8520642,8520318,324,0,utRho19
2201,yjbQ,8540428,8540476,8540428,48,0,utRho19
2202,yjcB,8550328,8550328,8550082,246,148,utRho19
2203,yjcC,8550836,8550942,8550836,106,166,utRho19
2204,yjcD,8556628,8556958,8556628,330,36,utRho19
2205,yjcE,8559658,8559960,8559658,302,2,utRho19
2206,yjcF,8566212,8566212,8566150,62,0,utRho19
2207,yjcO,8594660,8594660,8594250,410,112,utRho19
2208,yjdA,8654128,8654270,8654128,142,0,utRho19
2209,yjdC,8726660,8726660,8726616,44,0,utRho19
2210,yjdK,8704780,8705168,8704780,388,404,utRho19
2211,yjdL,8713034,8713034,8712822,212,26,utRho19
2212,yjdM,8653672,8653672,8653468,204,2402,utRho19
2213,yjeF,8787354,8788132,8787354,778,14832,utRho19
2214,yjeI,8745522,8745618,8745522,96,8,utRho19
2215,yjeJ,8748806,8748806,8748468,338,40,utRho19
2216,yjeV,8785472,8785784,8785472,312,12,utRho19
2217,yjfP,8833512,8833904,8833512,392,0,utRho19
2218,yjfY,8849656,8849656,8849582,74,2,utRho19
2219,yjfZ,8855052,8855052,8854844,208,12,utRho19
2220,yjgA,8916162,8916162,8915730,432,116,utRho19
2221,yjgL,8950802,8950874,8950802,72,0,utRho19
2222,yjgM,8959342,8959342,8959074,268,0,utRho19
2223,yjgN,8959132,8959460,8959132,328,0,utRho19
2224,yjgR,8980170,8980170,8980126,44,422,utRho19
2225,yjgZ,9002116,9002520,9002116,404,238,utRho19
2226,yjhB,9007764,9008116,9007764,352,258,utRho19
2227,yjhG,9048452,9048452,9048188,264,2370,utRho19
2228,yjhU,9041080,9041080,9040648,432,1590,utRho19
2229,yjiA,9178096,9178096,9177730,366,1226,utRho19
2230,yjiJ,9125364,9125364,9125350,14,0,utRho19
2231,yjiK,9127270,9127270,9127422,152,220,utRho19
2232,yjiL,9129604,9129604,9129378,226,0,utRho19
2233,yjiS,9143410,9143502,9143410,92,2,utRho19
2234,yjiY,9182734,9182734,9182558,176,18,utRho19
2235,yjjA,9200674,9200674,9200378,296,156,utRho19
2236,yjjB,18408708,18408708,18407800,908,8,utRho19
2237,yjjJ,9243314,9243538,9243314,224,0,utRho19
2238,yjjK,9261132,9261132,9261044,88,4,utRho19
2239,yjjL,9189764,9189764,9189444,320,298,utRho19
2240,yjjM,9191894,9191894,9191702,192,112,utRho19
2241,yjjP,9206068,9206068,9205716,352,80,utRho19
2242,yjjQ,9206638,9206954,9206638,316,60,utRho19
2243,yjjX,9267798,9267798,9267490,308,1160,utRho19
2244,yjjY,9280716,9280804,9280716,88,1038,utRho19
2245,yjjZ,9211554,9211608,9211554,54,220,utRho19
2246,yjtD,9281676,9281884,9281676,208,50,utRho19
2247,ykfB,532454,532454,532174,280,352,utRho19
2248,ykfI,527636,527636,527338,298,22,utRho19
2249,ykgB,637050,637050,636638,412,0,utRho19
2250,ykgC,640430,640430,640002,428,8,utRho19
2251,ykgD,640232,640454,640232,222,6,utRho19
2252,ykgE,642962,643216,642962,254,154,utRho19
2253,ykgJ,608524,608524,608364,160,1690,utRho19
2254,ykgL,623878,624224,623878,346,10,utRho19
2255,ykgM,625610,625610,625554,56,2,utRho19
2256,ykgR,626570,626570,626484,86,0,utRho19
2257,ylaC,958576,958576,958502,74,774,utRho19
2258,yliE,1745938,1745958,1745938,20,0,utRho19
2259,ymcE,2103660,2103694,2103660,34,4,utRho19
2260,ymdA,2210450,2210828,2210450,378,6,utRho19
2261,ymdB,2211428,2211640,2211428,212,0,utRho19
2262,ymfD,2395322,2395322,2395064,258,404,utRho19
2263,ymfI,2402880,2402994,2402880,114,0,utRho19
2264,ymfJ,2404518,2404518,2404168,350,608,utRho19
2265,ymfK,2406176,2406176,2405866,310,0,utRho19
2266,ymfT,2405766,2406048,2405766,282,118,utRho19
2267,ymgE,2489110,2489456,2489110,346,8,utRho19
2268,ymgF,2437628,2437966,2437628,338,2,utRho19
2269,ymiA,2670112,2670320,2670112,208,72,utRho19
2270,ymjA,2715620,2715620,2715336,284,120,utRho19
2271,ynaI,2791946,2791946,2791844,102,0,utRho19
2272,ynaK,2850438,2850754,2850438,316,2,utRho19
2273,ynbA,2954924,2955242,2954924,318,0,utRho19
2274,yncD,3046552,3046552,3046130,422,54,utRho19
2275,yncE,3046454,3046614,3046454,160,96,utRho19
2276,yncG,3052456,3052494,3052456,38,142,utRho19
2277,yncL,3034492,3034492,3034388,104,60,utRho19
2278,yneE,3218364,3218364,3218044,320,0,utRho19
2279,yneF,3223748,3223748,3223708,40,0,utRho19
2280,yneJ,3229560,3229608,3229560,48,46,utRho19
2281,yneK,3231100,3231526,3231100,426,4,utRho19
2282,yneM,3245176,3245292,3245176,116,44,utRho19
2283,ynfA,3311398,3311398,3311346,52,0,utRho19
2284,ynfB,3311418,3311616,3311418,198,318,utRho19
2285,ynfC,3315094,3315094,3314914,180,156,utRho19
2286,ynfD,3314828,3315130,3314828,302,156,utRho19
2287,ynfE,3316006,3316138,3316006,132,6,utRho19
2288,ynfK,3334670,3334670,3334438,232,162,utRho19
2289,ynfL,3339304,3339304,3339184,120,0,utRho19
2290,ynfM,3339260,3339398,3339260,138,56,utRho19
2291,ynfN,3276598,3276598,3276218,380,0,utRho19
2292,ynfO,3273454,3273512,3273454,58,4,utRho19
2293,ynhG,3517890,3517890,3517450,440,1272,utRho19
2294,yniA,3615158,3615592,3615158,434,204,utRho19
2295,yniB,3618526,3618526,3618466,60,0,utRho19
2296,yniC,3618652,3618760,3618652,108,0,utRho19
2297,yniD,3610202,3610330,3610202,128,2,utRho19
2298,ynjE,3678880,3678934,3678880,54,0,utRho19
2299,ynjF,3683222,3683222,3682806,416,4,utRho19
2300,ynjH,3684376,3684376,3684270,106,160,utRho19
2301,ynjI,3690022,3690022,3689742,280,2,utRho19
2302,yoaB,3786642,3786734,3786642,92,246,utRho19
2303,yoaC,3787932,3788146,3787932,214,20,utRho19
2304,yoaE,3803544,3803544,3803170,374,680,utRho19
2305,yoaF,3755444,3755444,3755064,380,526,utRho19
2306,yoaH,3789866,3789866,3789462,404,1662,utRho19
2307,yobB,3850418,3850880,3850418,462,1542,utRho19
2308,yobF,3815586,3815586,3815182,404,2,utRho19
2309,yobH,3817800,3817850,3817800,50,0,utRho19
2310,yodB,4084352,4084736,4084352,384,4,utRho19
2311,yodC,4057008,4057008,4056740,268,0,utRho19
2312,yohC,4451358,4451358,4451262,96,2,utRho19
2313,yohD,4451526,4451602,4451526,76,4,utRho19
2314,yohJ,4460986,4461248,4460986,262,0,utRho19
2315,yohO,4431172,4431314,4431172,142,416,utRho19
2316,yojI,4617282,4617282,4617230,52,0,utRho19
2317,ypdI,4988988,4989396,4988988,408,4,utRho19
2318,ypfG,5165786,5165786,5165554,232,48,utRho19
2319,ypfM,5182140,5182140,5181732,408,986,utRho19
2320,yphB,5349590,5349590,5349376,214,94,utRho19
2321,ypjA,5565644,5565644,5565452,192,16,utRho19
2322,ypjB,5569636,5569636,5568858,778,8,utRho19
2323,ypjD,5495860,5495774,5495860,86,0,utRho19
2324,yqaE,5594170,5594170,5594056,114,44,utRho19
2325,yqcA,5846100,5846100,5845968,132,40,utRho19
2326,yqcE,5800944,5801184,5800944,240,0,utRho19
2327,yqeC,6030468,6030468,6030114,354,20,utRho19
2328,yqeF,5971618,5971618,5971184,434,80,utRho19
2329,yqeG,5971438,5971694,5971438,256,114,utRho19
2330,yqeH,5975016,5975072,5975016,56,94,utRho19
2331,yqeI,5976688,5977004,5976688,316,0,utRho19
2332,yqeK,5981140,5981140,5980720,420,42,utRho19
2333,yqfA,6086728,6086728,6086296,432,334,utRho19
2334,yqgA,6219042,6219106,6219042,64,0,utRho19
2335,yqgB,6172500,6172500,6172102,398,248,utRho19
2336,yqgE,6185768,6185874,6185768,106,320,utRho19
2337,yqhA,6299150,6299150,6298942,208,0,utRho19
2338,yqhC,6310768,6310768,6310436,332,576,utRho19
2339,yqhD,6310604,6310710,6310604,106,354,utRho19
2340,yqhH,6316842,6317254,6316842,412,4,utRho19
2341,yqiC,6369662,6369680,6369662,18,68,utRho19
2342,yqiJ,6384108,6384416,6384108,308,4,utRho19
2343,yqjA,6495096,6495546,6495096,450,1216,utRho19
2344,yqjF,6500932,6501124,6500932,192,2366,utRho19
2345,yqjG,6501948,6502048,6501948,100,0,utRho19
2346,yqjH,6433078,6433078,6432982,96,0,utRho19
2347,yqjI,6433506,6433558,6433506,52,2,utRho19
2348,yraH,6574552,6574852,6574552,300,2,utRho19
2349,yraP,6592144,6592818,6592144,674,300,utRho19
2350,yraQ,6596414,6596414,6596276,138,0,utRho19
2351,yraR,6598024,6598024,6597692,332,636,utRho19
2352,yrbG,13360844,13361100,13360844,256,0,utRho19
2353,yrbL,6696842,6696904,6696842,62,46,utRho19
2354,yrbN,6616172,6616172,6615866,306,142,utRho19
2355,yrdB,6860176,6860176,6860046,130,0,utRho19
2356,yrfF,7052548,7052938,7052548,390,1032,utRho19
2357,yrhB,7169440,7169518,7169440,78,2,utRho19
2358,ysaB,7451804,7451804,7451424,380,4,utRho19
2359,ysgA,8032686,8032686,8032338,348,362,utRho19
2360,ytfB,8857638,8857638,8857434,204,310,utRho19
2361,ytfE,8864018,8864018,8863966,52,0,utRho19
2362,ytfF,8866296,8866296,8866130,166,2,utRho19
2363,ytfH,8868164,8868226,8868164,62,8,utRho19
2364,ytfI,8875234,8875414,8875234,180,12,utRho19
2365,ytfJ,8878572,8878572,8878524,48,284,utRho19
2366,ytfK,8879022,8879174,8879022,152,514,utRho19
2367,ytfL,8882642,8882642,8882430,212,66,utRho19
2368,ytfQ,8899634,8899924,8899634,290,1118,utRho19
2369,ytjB,9249598,9249598,9249578,20,84,utRho19
2370,yzfA,8896588,8896588,8896490,98,0,utRho19
2371,zapA,6111102,6111224,6111102,122,1912,utRho19
2372,zapB,8236772,8237030,8236772,258,448,utRho19
2373,zapC,2011700,2011904,2011700,204,0,utRho19
2374,zinT,4082692,4082750,4082692,58,2,utRho19
2375,zipA,5062814,5062814,5062466,348,12,utRho19
2376,zitB,1569716,1569716,1569646,70,2,utRho19
2377,zntA,7212844,7212902,7212844,58,8,utRho19
2378,zntR,6878336,6878336,6878260,76,0,utRho19
2379,znuA,3885322,3885322,3885166,156,0,utRho19
2380,znuC,3885268,3885324,3885268,56,0,utRho19
2381,zraP,8403424,8403424,8403376,48,0,utRho19
2382,zraS,8403810,8403852,8403810,42,0,utRho19
2383,zupT,6364866,6365100,6364866,234,556,utRho19
2384,zur,8520282,8520282,8520006,276,394,utRho19
2385,zwf,3872752,3872752,3872628,124,170,utRho19
0,C0343,2818676,2818728,2818676,52,284,utRho20
1,aaeB,6776526,6776526,6776376,150,0,utRho20
2,aaeR,6778762,6779040,6778762,278,14,utRho20
3,aaeX,6778860,6778860,6778674,186,84,utRho20
4,aat,1854920,1854920,1854864,56,0,utRho20
5,accA,416822,417242,416822,420,1970,utRho20
6,accB,6810280,6810872,6810280,592,4734,utRho20
7,accD,4868030,4868030,4867852,178,28,utRho20
8,aceB,8430804,8430956,8430804,152,236,utRho20
9,aceE,245938,246034,245938,96,68,utRho20
10,ackA,4826918,4826940,4826918,22,210,utRho20
11,acnA,2670848,2671662,2670848,814,5118,utRho20
12,acnB,263038,263230,263038,192,1936,utRho20
13,acpP,2303148,2303230,2303148,82,548,utRho20
14,acpS,5402324,5402324,5401996,328,352,utRho20
15,acrA,971396,971396,971238,158,340,utRho20
16,acrB,969370,969370,968806,564,5266,utRho20
17,acrD,5174950,5175190,5174950,240,0,utRho20
18,acrE,6827404,6827728,6827404,324,0,utRho20
19,acrR,971398,971522,971398,124,82,utRho20
20,acrZ,1589502,1589546,1589502,44,168,utRho20
21,acs,8575190,8575190,8574742,448,138,utRho20
22,actP,8569870,8569870,8569804,66,90,utRho20
23,ada,4620854,4620854,4620810,44,0,utRho20
24,add,3404404,3404466,3404404,62,70,utRho20
25,ade,7687802,7687928,7687802,126,0,utRho20
26,adhE,2596826,2596826,2596242,584,140,utRho20
27,adhP,3107988,3107988,3107676,312,2364,utRho20
28,adiA,8681112,8681112,8681042,70,100,utRho20
29,adiC,8674404,8674404,8674062,342,4,utRho20
30,adiY,8676084,8676084,8675858,226,0,utRho20
31,adk,994278,994350,994278,72,24,utRho20
32,adrA,807374,807406,807374,32,62,utRho20
33,aer,6438240,6438240,6438152,88,80,utRho20
34,aes,1000102,1000102,999946,156,0,utRho20
35,agaR,6557406,6557406,6557330,76,0,utRho20
36,agaS,6563778,6563952,6563778,174,0,utRho20
37,agp,2131118,2131170,2131118,52,50,utRho20
38,agrA,7296126,7296126,7296126,0,0,utRho20
39,agrB,7296588,7296588,7296588,0,0,utRho20
40,ahpC,1277386,1277890,1277386,504,5526,utRho20
41,ahpF,1278004,1279506,1278004,1502,485932,utRho20
42,ahr,8992698,8992698,8992418,280,0,utRho20
43,aidB,8828494,8828550,8828494,56,0,utRho20
44,ais,4731512,4731512,4731240,272,0,utRho20
45,alaA,4814816,4815122,4814816,306,0,utRho20
46,alaC,4996798,4996798,4996590,208,182,utRho20
47,alaE,5598140,5598328,5598140,188,1166,utRho20
48,alaS,5644180,5644180,5644022,158,7036,utRho20
49,alaW,5036612,5036612,5036462,150,0,utRho20
50,aldA,2976380,2976464,2976380,84,1198,utRho20
51,aldB,7513070,7513070,7513022,48,52,utRho20
52,alkA,4295118,4295118,4295080,38,0,utRho20
53,alkB,4618890,4618890,4618682,208,140,utRho20
54,allA,1064780,1064902,1064780,122,0,utRho20
55,allD,1092822,1092822,1092726,96,0,utRho20
56,allE,1088112,1088112,1088092,20,82,utRho20
57,allS,1064600,1064600,1064442,158,2,utRho20
58,alr,8531178,8531564,8531178,386,2684,utRho20
59,alsE,8617334,8617334,8616956,378,154,utRho20
60,alsK,8615990,8615990,8615598,392,0,utRho20
61,alx,6476740,6477160,6476740,420,70,utRho20
62,amiA,5104482,5104704,5104482,222,0,utRho20
63,amiC,5898378,5898378,5898020,358,0,utRho20
64,amn,4110062,4110122,4110062,60,0,utRho20
65,ampC,8758006,8758006,8757888,118,0,utRho20
66,ampD,237362,237466,237362,104,114,utRho20
67,ampG,907372,907372,907090,282,236,utRho20
68,ampH,792726,792726,792574,152,34,utRho20
69,amyA,4012230,4012312,4012230,82,188,utRho20
70,anmK,3439346,3439346,3439204,142,0,utRho20
71,ansB,6201580,6201580,6201456,124,0,utRho20
72,ansP,3052040,3052040,3051960,80,0,utRho20
73,apaG,104068,104068,103212,856,6978,utRho20
74,apaH,102586,102586,102444,142,5840,utRho20
75,apbE,4623188,4623188,4623068,120,0,utRho20
76,appA,2081198,2081234,2081198,36,392,utRho20
77,appC,2075420,2075480,2075420,60,0,utRho20
78,appY,1167134,1167362,1167134,228,0,utRho20
79,apt,982620,982824,982620,204,18,utRho20
80,aqpZ,1832424,1832424,1832094,330,34,utRho20
81,araB,140150,140150,140096,54,0,utRho20
82,araC,140482,140774,140482,292,1438,utRho20
83,araE,5964416,5964416,5964364,52,54,utRho20
84,araF,3972476,3972476,3972256,220,150,utRho20
85,araH,3967120,3967120,3967086,34,0,utRho20
86,araJ,825058,825058,824962,96,2,utRho20
87,arcA,9281602,9281602,9280612,990,19900,utRho20
88,arcB,6706098,6706098,6706050,48,0,utRho20
89,arcZ,6701154,6701154,6701154,0,0,utRho20
90,arfA,6877346,6877346,6877298,48,94,utRho20
91,argA,5898312,5898484,5898312,172,40,utRho20
92,argC,8309770,8310002,8309770,232,52,utRho20
93,argD,6980442,6980442,6980360,82,0,utRho20
94,argE,8310156,8310156,8309694,462,266,utRho20
95,argF,580680,580680,580610,70,0,utRho20
96,argG,6637124,6637274,6637124,150,26,utRho20
97,argI,8956688,8956688,8956622,66,0,utRho20
98,argO,6137672,6137672,6137616,56,64,utRho20
99,argP,6119460,6119506,6119460,46,2,utRho20
100,argR,6769204,6769406,6769204,202,0,utRho20
101,argS,3920002,3920124,3920002,122,0,utRho20
102,argT,4855698,4855698,4855582,116,200,utRho20
103,argU,1129406,1129446,1129406,40,4,utRho20
104,argW,4932616,4932618,4932616,2,32,utRho20
105,argX,7964728,7964750,7964728,22,14,utRho20
106,aroF,5482402,5482402,5482300,102,0,utRho20
107,aroG,1571182,1571266,1571182,84,152,utRho20
108,aroH,3576636,3576870,3576636,234,894,utRho20
109,aroK,7038760,7038760,7038128,632,1432,utRho20
110,aroL,812560,812810,812560,250,0,utRho20
111,aroP,243342,243342,243102,240,0,utRho20
112,arpA,8445382,8445382,8444974,408,2,utRho20
113,arrS,7316108,7316108,7316108,0,0,utRho20
114,arsR,7297024,7297056,7297024,32,0,utRho20
115,artJ,1801252,1801252,1801150,102,0,utRho20
116,artP,1807686,1807686,1807468,218,2244,utRho20
117,ascF,5678858,5679048,5678858,190,0,utRho20
118,ascG,5678574,5678574,5678528,46,20,utRho20
119,aslB,7965562,7965916,7965562,354,104,utRho20
120,asnA,7854258,7854310,7854258,52,4,utRho20
121,asnB,1398444,1398444,1398354,90,4,utRho20
122,asnC,23562186,23562186,23562018,168,0,utRho20
123,asnS,1978088,1978088,1977970,118,13598,utRho20
124,asnT,4089082,4089098,4089082,16,474,utRho20
125,asnU,4119690,4119702,4119690,12,0,utRho20
126,asnV,4124504,4124520,4124504,16,58,utRho20
127,aspA,17473728,17473728,17473308,420,132,utRho20
128,aspC,1971486,1971486,1971418,68,52,utRho20
129,aspS,3901402,3901402,3901044,358,224,utRho20
130,aspT,7893560,7893744,7893560,184,186610,utRho20
131,aspV,473826,473862,473826,36,8,utRho20
132,asr,3342654,3342752,3342654,98,78,utRho20
133,astC,3664088,3664088,3663964,124,0,utRho20
134,astE,3654138,3654138,3653846,292,74,utRho20
135,atoD,4646824,4646894,4646824,70,2,utRho20
136,atpB,7844540,7844540,7844102,438,354,utRho20
137,atpC,7832118,7832118,7831944,174,1328,utRho20
138,atpI,7845050,7845050,7844880,170,2,utRho20
139,avtA,7479348,7479410,7479348,62,10,utRho20
140,azoR,2965982,2965982,2965720,262,384,utRho20
141,azuC,3976002,3976002,3975918,84,0,utRho20
142,bacA,6408350,6408350,6408262,88,0,utRho20
143,bamA,394052,395856,394052,1804,1762,utRho20
144,bamB,5277950,5277950,5277304,646,1444,utRho20
145,bamC,5198028,5198028,5197730,298,2152,utRho20
146,bamD,5471922,5472292,5471922,370,1164,utRho20
147,bamE,5506972,5507210,5506972,238,1052,utRho20
148,basS,8666954,8666954,8666544,410,444,utRho20
149,bax,7474468,7474468,7474354,114,626,utRho20
150,bcp,5200874,5200956,5200874,82,3574,utRho20
151,bcsB,7385346,7385346,7385214,132,0,utRho20
152,bcsE,7392644,7392916,7392644,272,36,utRho20
153,bdcA,8948128,8948128,8948106,22,0,utRho20
154,bdcR,8948192,8948248,8948192,56,0,utRho20
155,bdm,3112680,3112680,3112560,120,0,utRho20
156,betA,654522,654522,654494,28,780,utRho20
157,betI,658722,658722,658668,54,34,utRho20
158,betT,658842,658926,658842,84,0,utRho20
159,bfr,6933498,6933498,6933450,48,0,utRho20
160,bglG,23440182,23440182,23439402,780,0,utRho20
161,bglX,4444240,4444240,4443978,262,0,utRho20
162,bhsA,2337962,2338146,2337962,184,0,utRho20
163,bioA,1618584,1618584,1618514,70,0,utRho20
164,bioB,1618604,1618688,1618604,84,8,utRho20
165,bioH,7089716,7089716,7089688,28,0,utRho20
166,bisC,7433026,7433026,7432788,238,0,utRho20
167,blc,8755490,8755490,8755444,46,0,utRho20
168,blr,3409024,3409102,3409024,78,94,utRho20
169,bluF,2431226,2431226,2430950,276,176,utRho20
170,bluR,2428226,2428226,2428118,108,0,utRho20
171,bolA,908698,908944,908698,246,178,utRho20
172,borD,1157842,1157842,1157786,56,58,utRho20
173,brnQ,838976,839182,838976,206,418,utRho20
174,bssR,1756492,1756496,1756492,4,0,utRho20
175,bssS,2242116,2242116,2241910,206,594,utRho20
176,btuB,8326798,8327278,8326798,480,1644,utRho20
177,cadB,8720212,8720212,8720062,150,4,utRho20
178,cadC,8723926,8723926,8723868,58,0,utRho20
179,caiE,70998,70998,70742,256,38,utRho20
180,caiF,68436,68600,68436,164,34,utRho20
181,caiT,84074,84074,83862,212,0,utRho20
182,can,285406,285406,285340,66,124,utRho20
183,carA,59102,59302,59102,200,0,utRho20
184,carB,61550,61634,61550,84,680,utRho20
185,cas2,5757830,5757830,5757706,124,224,utRho20
186,casA,5768638,5768638,5768276,362,0,utRho20
187,cbl,4121882,4121882,4121828,54,0,utRho20
188,cbpA,2128074,2128074,2127550,524,476,utRho20
189,cbrA,7738628,7738754,7738628,126,0,utRho20
190,cbrB,7794958,7795012,7794958,54,88,utRho20
191,ccmH,4585242,4585242,4584820,422,4,utRho20
192,cdaR,364894,364926,364894,32,0,utRho20
193,cdd,4463638,4463688,4463638,50,112,utRho20
194,cdh,8219814,8219860,8219814,46,0,utRho20
195,cdsA,391110,391354,391110,244,564,utRho20
196,cedA,3627484,3627484,3627326,158,100,utRho20
197,cfa,3482402,3482826,3482402,424,632,utRho20
198,chaC,2544844,2544972,2544844,128,78,utRho20
199,chbB,3643452,3643452,3643238,214,0,utRho20
200,chbG,3634624,3634624,3634270,354,0,utRho20
201,cheW,3946924,3946924,3946678,246,12,utRho20
202,chiA,6939792,6939792,6939706,86,0,utRho20
203,chiP,1416472,1416668,1416472,196,2,utRho20
204,cho,3646984,3647030,3646984,46,170,utRho20
205,chpS,8896804,8896894,8896804,90,0,utRho20
206,cirA,4493884,4493884,4493538,346,48,utRho20
207,citC,1304078,1304078,1303712,366,0,utRho20
208,citT,1293264,1293264,1293160,104,0,utRho20
209,clcA,350104,350214,350104,110,2,utRho20
210,clpA,1846160,1846528,1846160,368,474,utRho20
211,clpB,5468410,5468410,5468346,64,996,utRho20
212,clpP,913154,913354,913154,200,580,utRho20
213,clpS,1845500,1845826,1845500,326,28,utRho20
214,clpX,914404,914852,914404,448,4672,utRho20
215,clsA,2617346,2617346,2617290,56,2,utRho20
216,clsC,2212584,2212710,2212584,126,482,utRho20
217,cmk,1922330,1922402,1922330,72,92,utRho20
218,cnu,3409522,3409898,3409522,376,874,utRho20
219,coaA,8350214,8350214,8350052,162,374,utRho20
220,cobC,1340092,1340092,1339814,278,344,utRho20
221,cobT,4129202,4129202,4128934,268,28,utRho20
222,cobU,4131944,4131944,4131528,416,16,utRho20
223,codB,709768,709844,709768,76,0,utRho20
224,comR,2337726,2337726,2337664,62,0,utRho20
225,copA,1022822,1022822,1022758,64,0,utRho20
226,corA,8002388,8002852,8002388,464,6830,utRho20
227,cpdB,8873258,8873258,8873130,128,588,utRho20
228,cptB,6082198,6082198,6082140,58,30,utRho20
229,cpxA,8210202,8210202,8209950,252,2090,utRho20
230,cpxP,8211570,8211640,8211570,70,392,utRho20
231,cpxR,8211372,8211372,8211340,32,306,utRho20
232,cra,175894,176056,175894,162,0,utRho20
233,crcB,1316016,1316016,1315876,140,76,utRho20
234,creA,9270486,9271042,9270486,556,1262,utRho20
235,creD,9276320,9276356,9276320,36,0,utRho20
236,crl,515620,515658,515620,38,3338,utRho20
237,crp,6971906,6972240,6971906,334,5184,utRho20
238,crr,5070960,5071668,5070960,708,19500,utRho20
239,csdA,5886414,5886674,5886414,260,20,utRho20
240,csgB,2207718,2207902,2207718,184,0,utRho20
241,csgD,2206688,2206688,2206392,296,0,utRho20
242,csgG,2203510,2203510,2203368,142,74,utRho20
243,csiD,5577854,5577970,5577854,116,2004,utRho20
244,csiE,5330802,5330870,5330802,68,88,utRho20
245,csiR,5590942,5591348,5590942,406,796,utRho20
246,cspA,7439778,7440098,7439778,320,746,utRho20
247,cspB,3283430,3283430,3283108,322,0,utRho20
248,cspC,3815018,3815018,3814870,148,752,utRho20
249,cspD,1845352,1845352,1845180,172,36914,utRho20
250,cspE,1314294,1314584,1314294,290,0,utRho20
251,cspF,3283380,3283710,3283380,330,0,utRho20
252,cspG,2102610,2102922,2102610,312,506,utRho20
253,cspH,2102746,2102746,2102350,396,2,utRho20
254,cspI,3277624,3277624,3277334,290,0,utRho20
255,csrA,5638746,5638746,5638292,454,3216,utRho20
256,csrB,5849048,5849048,5849048,0,0,utRho20
257,csrC,8102072,8102072,8102072,0,0,utRho20
258,csrD,6806850,6806850,6806664,186,84,utRho20
259,cstA,1259710,1259788,1259710,78,0,utRho20
260,cueO,274090,274166,274090,76,0,utRho20
261,cueR,1027948,1027986,1027948,38,62,utRho20
262,curA,3037784,3038054,3037784,270,28,utRho20
263,cusC,1191146,1191200,1191146,54,0,utRho20
264,cusR,1190924,1190924,1190886,38,0,utRho20
265,cutA,8730784,8730784,8730712,72,0,utRho20
266,cutC,3918534,3918534,3917920,614,194,utRho20
267,cvpA,4861600,4861600,4861526,74,0,utRho20
268,cvrA,2484328,2484328,2484142,186,176,utRho20
269,cyaA,7981548,7982306,7981548,758,850,utRho20
270,cyaR,4334228,4334224,4334228,4,0,utRho20
271,cyaY,7988166,7988166,7988118,48,168,utRho20
272,cybB,2981522,2981804,2981522,282,102,utRho20
273,cycA,8859560,8859728,8859560,168,310,utRho20
274,cydA,1542340,1542916,1542340,576,6,utRho20
275,cydC,1858800,1858800,1858390,410,280,utRho20
276,cydD,1862062,1862062,1861924,138,0,utRho20
277,cydX,1548300,1548392,1548300,92,682,utRho20
278,cynR,717418,717418,717380,38,0,utRho20
279,cynT,1435092,1435196,1435092,104,0,utRho20
280,cyoA,903306,903306,903220,86,1180,utRho20
281,cyoE,895540,895540,895410,130,930,utRho20
282,cysB,2667576,2667710,2667576,134,988,utRho20
283,cysC,5748056,5748056,5747984,72,62,utRho20
284,cysD,5752736,5752736,5752658,78,0,utRho20
285,cysE,7565362,7565362,7565124,238,1708,utRho20
286,cysG,6995508,6995656,6995508,148,38,utRho20
287,cysJ,5783928,5783928,5783796,132,216,utRho20
288,cysK,5064688,5064818,5064688,130,200,utRho20
289,cysP,5087114,5087114,5087056,58,0,utRho20
290,cysS,1109154,1109222,1109154,68,358,utRho20
291,cysT,3984100,3984100,3983974,126,396,utRho20
292,cysZ,5062766,5062926,5062766,160,282,utRho20
293,cytR,8249018,8249018,8248912,106,2,utRho20
294,dacA,1328002,1328002,1327926,76,104,utRho20
295,dacB,6657714,6657926,6657714,212,104,utRho20
296,dacC,1761306,1761454,1761306,148,88,utRho20
297,dadA,2475018,2475142,2475018,124,114,utRho20
298,dam,7032504,7032504,7031826,678,1552,utRho20
299,damX,7035200,7035200,7034612,588,660,utRho20
300,dapA,5199568,5199568,5199520,48,0,utRho20
301,dapB,56576,56748,56576,172,4,utRho20
302,dapD,371954,371954,371894,60,514,utRho20
303,dapE,5183120,5183214,5183120,94,1788,utRho20
304,dcp,3254844,3254844,3254760,84,320,utRho20
305,dcrB,7219534,7219910,7219534,376,88,utRho20
306,dctA,7366996,7366996,7366894,102,394,utRho20
307,dcuA,8733686,8733686,8733546,140,2,utRho20
308,dcuB,8698182,8698182,8697488,694,74,utRho20
309,dcuC,1312166,1312166,1311936,230,0,utRho20
310,dcuD,6749166,6749738,6749166,572,0,utRho20
311,dcuR,8701130,8701130,8700068,1062,250,utRho20
312,dcuS,8703370,8703370,8703324,46,0,utRho20
313,dcyD,3999016,3999016,3998960,56,42,utRho20
314,ddpX,3126498,3126498,3126152,346,0,utRho20
315,deaD,6615818,6615818,6615720,98,210,utRho20
316,dedA,4869880,4869880,4869482,398,8036,utRho20
317,dedD,4863750,4863750,4863368,382,2,utRho20
318,def,6867300,6867380,6867300,80,0,utRho20
319,degP,361690,361768,361690,78,0,utRho20
320,degQ,6761308,6761486,6761308,178,678,utRho20
321,deoB,9239134,9239206,9239134,72,68,utRho20
322,deoC,9233358,9234646,9233358,1288,1652,utRho20
323,dfp,7625406,7625462,7625406,56,2,utRho20
324,dgcZ,3247758,3247758,3247700,58,0,utRho20
325,dgkA,8512914,8513274,8512914,360,930,utRho20
326,dgt,358392,358474,358392,82,74,utRho20
327,dhaK,2501888,2501888,2501676,212,138,utRho20
328,dhaR,2502006,2502132,2502006,126,0,utRho20
329,dicB,3299194,3299218,3299194,24,0,utRho20
330,dicC,3295752,3295752,3295700,52,0,utRho20
331,dinB,501760,501796,501760,36,0,utRho20
332,dinD,7635398,7635520,7635398,122,0,utRho20
333,dinG,1666146,1666140,1666146,6,0,utRho20
334,dinI,2243018,2243018,2242974,44,52,utRho20
335,dinJ,493230,493230,493004,226,102,utRho20
336,dinQ,7295964,7295964,7295576,388,1092,utRho20
337,djlA,114536,114728,114536,192,0,utRho20
338,dkgA,6313142,6313246,6313142,104,1214,utRho20
339,dkgB,458196,458334,458196,138,102,utRho20
340,dksA,321502,321502,321208,294,996,utRho20
341,dld,4444164,4444370,4444164,206,64,utRho20
342,dmlA,3763424,3763824,3763424,400,18,utRho20
343,dmlR,3763710,3763710,3763618,92,0,utRho20
344,dmsA,1881646,1881918,1881646,272,0,utRho20
345,dnaA,7767922,7767922,7767458,464,1756,utRho20
346,dnaB,8528566,8528628,8528566,62,446,utRho20
347,dnaK,24096,24326,24096,230,4750,utRho20
348,dnaN,7765466,7765466,7764642,824,606,utRho20
349,dnaQ,471868,472134,471868,266,3142,utRho20
350,dnaT,18406460,18406460,18406068,392,76,utRho20
351,dnaX,984112,984184,984112,72,182,utRho20
352,dosP,3131486,3131486,3131466,20,134,utRho20
353,dpiB,1303968,1304470,1303968,502,0,utRho20
354,dppA,7415740,7415740,7415410,330,6250,utRho20
355,dps,1697900,1697900,1697822,78,440,utRho20
356,dsbA,8086754,8086836,8086754,82,3342,utRho20
357,dsbB,2466294,2466294,2466060,234,0,utRho20
358,dsbC,6079266,6079266,6077644,1622,1490,utRho20
359,dsbG,1277600,1277600,1277146,454,780,utRho20
360,dsdA,4958242,4958404,4958242,162,10,utRho20
361,dsdC,4955492,4955492,4955258,234,0,utRho20
362,dsdX,4955642,4955694,4955642,52,0,utRho20
363,dsrA,4050626,4050626,4050626,0,0,utRho20
364,dsrB,4049686,4049686,4049646,40,0,utRho20
365,dtpD,1485340,1485340,1485112,228,28,utRho20
366,dusA,8523200,8523338,8523200,138,1690,utRho20
367,dusB,6820492,6820560,6820492,68,0,utRho20
368,dusC,4460790,4460790,4460770,20,0,utRho20
369,dut,7627704,7627864,7627704,160,1442,utRho20
370,dxr,386670,387042,386670,372,1630,utRho20
371,ebgA,6445102,6445266,6445102,164,0,utRho20
372,ebgR,6442874,6442932,6442874,58,40,utRho20
373,ecnB,8753018,8753106,8753018,88,66,utRho20
374,eco,4607594,4607810,4607594,216,0,utRho20
375,ecpA,621594,621594,621342,252,0,utRho20
376,ecpB,620238,620238,620052,186,0,utRho20
377,ecpR,622964,622964,622672,292,0,utRho20
378,eda,3866218,3866218,3865512,706,100,utRho20
379,edd,3869426,3869426,3869208,218,0,utRho20
380,efeO,2164308,2164486,2164308,178,112,utRho20
381,efeU_1,2162614,2162712,2162614,98,76,utRho20
382,efp,8751134,8751398,8751134,264,3228,utRho20
383,elaA,4763372,4763372,4763086,286,158,utRho20
384,elaD,4765308,4765426,4765308,118,62,utRho20
385,elfA,1995530,1995736,1995530,206,0,utRho20
386,elfD,1996642,1996980,1996642,338,0,utRho20
387,emrD,7707690,7707844,7707690,154,0,utRho20
388,emrK,4966896,4966896,4966678,218,0,utRho20
389,emrY,4964668,4964668,4964352,316,184,utRho20
390,emtA,2486250,2486360,2486250,110,32,utRho20
391,endA,12361100,12361388,12361100,288,0,utRho20
392,eno,5817692,5817692,5815882,1810,6634,utRho20
393,entC,1249662,1249770,1249662,108,42,utRho20
394,entD,1220508,1220508,1220158,350,0,utRho20
395,entH,1258584,1258600,1258584,16,100,utRho20
396,entS,1244506,1244600,1244506,94,0,utRho20
397,envR,6827266,6827266,6826930,336,0,utRho20
398,epd,12295292,12295292,12294764,528,0,utRho20
399,epmA,8765236,8765286,8765236,50,0,utRho20
400,epmB,8751406,8751406,8751314,92,1400,utRho20
401,eptB,7421162,7421162,7420950,212,56,utRho20
402,eptC,8300622,8300622,8300530,92,28,utRho20
403,erfK,4126708,4126708,4126646,62,298,utRho20
404,erpA,353122,353220,353122,98,212,utRho20
405,esrE,8039956,8039956,8039956,0,0,utRho20
406,essD,1153746,1154796,1153746,1050,124,utRho20
407,etk,2088606,2088606,2088420,186,0,utRho20
408,evgA,4967262,4967510,4967262,248,0,utRho20
409,exbB,6304028,6304028,6303968,60,120,utRho20
410,exbD,6302780,6302780,6302486,294,210,utRho20
411,exuR,6493016,6493304,6493016,288,108,utRho20
412,exuT,6490004,6490208,6490004,204,0,utRho20
413,fabA,2032996,2032996,2032940,56,116,utRho20
414,fabB,4883282,4883282,4883210,72,0,utRho20
415,fabH,2297032,2297518,2297032,486,1962,utRho20
416,fabI,2702236,2702236,2702078,158,0,utRho20
417,fadB,8062026,8062026,8061942,84,0,utRho20
418,fadD,3779614,3779614,3779492,122,12,utRho20
419,fadE,486812,486812,486606,206,0,utRho20
420,fadH,6463248,6463330,6463248,82,4,utRho20
421,fadI,4921022,4921022,4920938,84,0,utRho20
422,fadL,4922410,4922600,4922410,190,812,utRho20
423,fadM,928720,928804,928720,84,72,utRho20
424,fadR,2469810,2469876,2469810,66,0,utRho20
425,fbaB,4357334,4357334,4357128,206,1182,utRho20
426,fdhE,8162722,8162722,8162456,266,2524,utRho20
427,fdhF,8598814,8598814,8598732,82,0,utRho20
428,fdnG,3094744,3094802,3094744,58,0,utRho20
429,fdrA,1093012,1093360,1093012,348,0,utRho20
430,feaB,2894994,2895038,2894994,44,0,utRho20
431,feaR,2894734,2894734,2894566,168,254,utRho20
432,fecA,9033454,9033454,9033354,100,80,utRho20
433,fecE,9023288,9023288,9022914,374,1846,utRho20
434,fecI,9036564,9036564,9036470,94,0,utRho20
435,feoA,7080114,7080326,7080114,212,488,utRho20
436,fepA,1225334,1225334,1224988,346,0,utRho20
437,fepB,1249454,1249454,1249020,434,604,utRho20
438,fepD,1244468,1244468,1244378,90,0,utRho20
439,fes,1225374,1225630,1225374,256,146,utRho20
440,ffh,5495706,5495706,5495590,116,998,utRho20
441,ffs,952576,952848,952576,272,186,utRho20
442,fhuA,334884,334968,334884,84,34,utRho20
443,fhuE,2323294,2323294,2323102,192,292,utRho20
444,fhuF,9211504,9211504,9211326,178,290,utRho20
445,fic,6983296,6983296,6982926,370,88,utRho20
446,fieF,8212864,8212938,8212864,74,0,utRho20
447,fimA,9085388,9086230,9085388,842,998,utRho20
448,fimB,9081334,9081914,9081334,580,1716,utRho20
449,fimE,9083742,9084074,9083742,332,0,utRho20
450,fimZ,1129214,1129214,1128960,254,150,utRho20
451,fiu,1683296,1683296,1683062,234,0,utRho20
452,fixA,84650,84806,84650,156,0,utRho20
453,fkpA,6955050,6955050,6954838,212,5632,utRho20
454,fldA,2846084,2846084,2845860,224,5356,utRho20
455,fldB,6079644,6079710,6079644,66,30,utRho20
456,flgA,2261770,2261770,2261726,44,0,utRho20
457,flgB,2261986,2262036,2261986,50,0,utRho20
458,flgK,2276702,2276756,2276702,54,6,utRho20
459,flgM,2260330,2260330,2260256,74,174,utRho20
460,flgN,2259828,2259828,2259660,168,0,utRho20
461,flhB,3932432,3932432,3932382,50,62,utRho20
462,flhC,3955864,3955864,3955688,176,96,utRho20
463,flhD,3957154,3957154,3956394,760,418,utRho20
464,fliA,4003638,4003638,4003578,60,0,utRho20
465,fliC,4007352,4007352,4007212,140,0,utRho20
466,fliD,4007634,4007744,4007634,110,0,utRho20
467,fliE,4026186,4026186,4026028,158,0,utRho20
468,fliF,4026292,4026458,4026292,166,2,utRho20
469,fliL,4039168,4039236,4039168,68,0,utRho20
470,flk,4875824,4875900,4875824,76,8,utRho20
471,flu,4142634,4143078,4142634,444,0,utRho20
472,flxA,3292776,3292810,3292776,34,386,utRho20
473,fnr,2799104,2799104,2799052,52,0,utRho20
474,fnrS,2818258,2818258,2818258,0,0,utRho20
475,focA,1909628,1909628,1908932,696,52,utRho20
476,folA,99598,99646,99598,48,0,utRho20
477,folB,6409296,6409296,6409178,118,0,utRho20
478,folD,1115562,1115562,1115482,80,58,utRho20
479,folE,4487696,4487696,4487304,392,2612,utRho20
480,fpr,8228998,8228998,8228944,54,0,utRho20
481,frc,4986878,4986878,4986508,370,0,utRho20
482,frdA,8764824,8764824,8764636,188,0,utRho20
483,frdD,8758948,8758948,8758732,216,1422,utRho20
484,fre,8052886,8053054,8052886,168,2352,utRho20
485,frlA,6999518,6999820,6999518,302,0,utRho20
486,frr,385624,385744,385624,120,3584,utRho20
487,frsA,513004,513054,513004,50,82,utRho20
488,fruB,4527194,4527194,4526990,204,116,utRho20
489,frvR,8179804,8179804,8179710,94,0,utRho20
490,fryA,5008986,5008986,5008970,16,0,utRho20
491,fsaA,1727060,1727284,1727060,224,0,utRho20
492,fsr,1009710,1009710,1009392,318,238,utRho20
493,ftnA,3977364,3977432,3977364,68,0,utRho20
494,ftnB,3973550,3973850,3973550,300,76,utRho20
495,ftsA,207122,207964,207122,842,920,utRho20
496,ftsB,5745802,5745802,5745640,162,88,utRho20
497,ftsH,6654204,6654204,6653870,334,450,utRho20
498,ftsK,1865858,1866448,1865858,590,3470,utRho20
499,ftsL,181376,182064,181376,688,4360,utRho20
500,ftsP,6325732,6325732,6325338,394,150,utRho20
501,ftsQ,205484,206310,205484,826,1436,utRho20
502,ftsX,7204512,7204512,7204172,340,1460,utRho20
503,ftsZ,209272,210610,209272,1338,300,utRho20
504,fucA,5867708,5867708,5867376,332,48,utRho20
505,fucP,5868238,5868470,5868238,232,0,utRho20
506,fumA,6753760,6753760,6753508,252,11280,utRho20
507,fumB,8694696,8694696,8694652,44,0,utRho20
508,fumC,3373418,3373418,3373176,242,64,utRho20
509,fur,2842892,2842892,2842584,308,6484,utRho20
510,fusA,6947370,6947370,6947028,342,17678,utRho20
511,fxsA,8737206,8737328,8737206,122,592,utRho20
512,gabD,5581824,5582546,5581824,722,50258,utRho20
513,gadA,7335214,7335214,7335160,54,16,utRho20
514,gadB,3144144,3144144,3144090,54,0,utRho20
515,gadC,3141168,3141168,3140978,190,112,utRho20
516,gadE,7315600,7316732,7315600,1132,96,utRho20
517,gadW,7329562,7329562,7329236,326,2,utRho20
518,gadX,14663356,14663356,14663240,116,320,utRho20
519,gadY,7329728,7329728,7329728,0,0,utRho20
520,galE,1584354,1584354,1584110,244,32,utRho20
521,galF,4228702,4228702,4228654,48,0,utRho20
522,galM,1577796,1577796,1577674,122,4786,utRho20
523,galP,6176510,6176568,6176510,58,0,utRho20
524,galR,5953138,5953198,5953138,60,2,utRho20
525,galS,4483420,4483420,4483336,84,0,utRho20
526,galU,2582810,2582914,2582810,104,1708,utRho20
527,gapA,3724480,3725542,3724480,1062,20980,utRho20
528,garP,6549868,6549868,6549814,54,0,utRho20
529,gatY,4354468,4354468,4354408,60,50,utRho20
530,gatZ,4352864,4352864,4352642,222,51132,utRho20
531,gcd,282558,282558,282450,108,0,utRho20
532,gcl,1067814,1067832,1067814,18,0,utRho20
533,gcvA,5885278,5885278,5885134,144,0,utRho20
534,gcvB,5885392,5885392,5885392,0,0,utRho20
535,gcvR,5199758,5199812,5199758,54,74,utRho20
536,gcvT,6101544,6101544,6101334,210,3484,utRho20
537,gdhA,3684616,3684742,3684616,126,0,utRho20
538,gfcA,2099668,2099668,2099488,180,62,utRho20
539,gfcD,2096236,2096236,2095890,346,4,utRho20
540,ghrA,2195648,2195772,2195648,124,80,utRho20
541,ghrB,7434378,7434620,7434378,242,852,utRho20
542,glcA,6242728,6242728,6242558,170,438,utRho20
543,glcC,6256412,6256544,6256412,132,0,utRho20
544,glcD,6256152,6256152,6256042,110,0,utRho20
545,gldA,8278092,8278092,8278070,22,588,utRho20
546,glgA,7136784,7136784,7136066,718,3398,utRho20
547,glgB,7147314,7147314,7147004,310,556,utRho20
548,glgC,7139142,7139142,7138656,486,2058,utRho20
549,glgP,7133546,7133546,7133162,384,1668,utRho20
550,glgS,6384024,6384024,6383878,146,108,utRho20
551,glgX,7142838,7142838,7142638,200,264,utRho20
552,glk,5018922,5018922,5018852,70,104,utRho20
553,glmS,7827622,7827622,7827336,286,9066,utRho20
554,glmU,7830652,7830652,7830400,252,0,utRho20
555,glmY,10765360,10765360,10765360,0,0,utRho20
556,glmZ,7972864,7972864,7972864,0,0,utRho20
557,glnA,16232888,16232888,16232136,752,1392,utRho20
558,glnB,5375052,5375052,5374816,236,196,utRho20
559,glnD,377310,377310,377300,10,0,utRho20
560,glnE,6399602,6399602,6399282,320,984,utRho20
561,glnH,1696396,1696396,1696008,388,640,utRho20
562,glnK,945112,945196,945112,84,0,utRho20
563,glnL,8112742,8112742,8112678,64,0,utRho20
564,glnQ,1693262,1693262,1692926,336,2138,utRho20
565,glnS,1411998,1412186,1411998,188,432,utRho20
566,gloA,3455602,3455674,3455602,72,72,utRho20
567,gloB,469852,469852,469564,288,3752,utRho20
568,glpA,4705166,4705294,4705166,128,0,utRho20
569,glpD,7123942,7124026,7123942,84,0,utRho20
570,glpE,7123698,7123698,7123646,52,0,utRho20
571,glpF,8236322,8236322,8236180,142,0,utRho20
572,glpG,7122960,7122960,7122904,56,26,utRho20
573,glpR,7121782,7121782,7121210,572,346,utRho20
574,glpT,4704902,4704902,4704748,154,0,utRho20
575,glpX,8231212,8231212,8231158,54,154,utRho20
576,glrK,5382246,5382246,5382196,50,0,utRho20
577,gltA,1509534,1509534,1508936,598,61032,utRho20
578,gltB,6709018,6709264,6709018,246,92,utRho20
579,gltI,1375792,1375792,1375494,298,2686,utRho20
580,gltP,8588536,8588962,8588536,426,766,utRho20
581,gltS,7657382,7657382,7657330,52,246,utRho20
582,gltX,5041568,5041568,5041344,224,634,utRho20
583,gluQ,320286,320286,320224,62,314,utRho20
584,glyA,5371148,5371148,5371014,134,236,utRho20
585,glyQ,7450708,7450708,7450636,72,124,utRho20
586,glyS,7448990,7448990,7448794,196,3072,utRho20
587,glyU,5998128,5998128,5998114,14,88,utRho20
588,glyV,8784626,8784720,8784626,94,396,utRho20
589,glyW,3984360,3984360,3984234,126,0,utRho20
590,gmhB,445612,445666,445612,54,0,utRho20
591,gmk,7642776,7642856,7642776,80,8,utRho20
592,gmr,2693686,2693686,2693484,202,278,utRho20
593,gnd,4202648,4202648,4202536,112,852,utRho20
594,gnsB,3275692,3275692,3275564,128,20,utRho20
595,gntK,14310580,14310580,14310368,212,0,utRho20
596,gntP,9102668,9102668,9102592,76,0,utRho20
597,gntR,7157760,7157760,7157452,308,1392,utRho20
598,gntT,7092810,7093118,7092810,308,4,utRho20
599,gntU,7154170,7154170,7154122,48,0,utRho20
600,gntX,7089334,7089764,7089334,430,0,utRho20
601,gor,7292224,7292598,7292224,374,120,utRho20
602,gpmA,1575340,1575340,1575190,150,16,utRho20
603,gpmM,7570374,7570520,7570374,146,80,utRho20
604,gpsA,7567620,7567620,7567322,298,25556,utRho20
605,gpt,511828,511954,511828,126,276,utRho20
606,grcA,5433046,5433046,5432898,148,0,utRho20
607,greA,6657728,6657728,6657430,298,586,utRho20
608,greB,7073488,7073624,7073488,136,122,utRho20
609,groL,8741566,8742050,8741566,484,36778,utRho20
610,groS,8741232,8741376,8741232,144,24128,utRho20
611,grpE,5501494,5501494,5501416,78,468,utRho20
612,grxA,1781552,1781552,1781506,46,0,utRho20
613,grxB,2248206,2248206,2248108,98,68,utRho20
614,grxC,7569152,7569152,7568884,268,9164,utRho20
615,grxD,3468324,3468324,3468202,122,7960,utRho20
616,gspA,6911268,6911268,6910796,472,34,utRho20
617,gspC,6910964,6911156,6910964,192,0,utRho20
618,gss,6277220,6277220,6277044,176,168,utRho20
619,gstA,3428654,3428754,3428654,100,0,utRho20
620,gstB,1761038,1761038,1760960,78,42,utRho20
621,guaB,5268214,5268214,5268140,74,90,utRho20
622,gudD,5839026,5839026,5838770,256,146,utRho20
623,gyrA,4678914,4678914,4678840,74,4,utRho20
624,gyrB,7760300,7760300,7760238,62,134,utRho20
625,hcaE,5337964,5338064,5337964,100,48,utRho20
626,hcaR,5337928,5337928,5337792,136,0,utRho20
627,hcaT,5336106,5336106,5335692,414,486,utRho20
628,hchA,4071260,4071670,4071260,410,1292,utRho20
629,hcp,1828258,1828258,1827628,630,0,utRho20
630,hcr,1824400,1824400,1824300,100,44,utRho20
631,hdeA,7313582,7313582,7313480,102,52,utRho20
632,hdeD,7313920,7313990,7313920,70,0,utRho20
633,hdfR,7896320,7896320,7895934,386,570,utRho20
634,hdhA,3396244,3396244,3396080,164,26,utRho20
635,helD,2048876,2048942,2048876,66,0,utRho20
636,hemA,2527166,2527428,2527166,262,200,utRho20
637,hemB,779722,779722,779454,268,40,utRho20
638,hemF,5106410,5106450,5106410,40,140,utRho20
639,hemH,996062,996110,996062,48,56,utRho20
640,hemL,349882,349882,349764,118,190,utRho20
641,hemN,8103886,8104090,8103886,204,282,utRho20
642,hepA,127176,127176,126528,648,1662,utRho20
643,hflD,2385372,2385372,2385262,110,796,utRho20
644,hfq,8799602,8800576,8799602,974,11900,utRho20
645,hha,961006,961006,960616,390,0,utRho20
646,hicA,3018442,3018572,3018442,130,0,utRho20
647,higA,6468682,6468682,6468288,394,354,utRho20
648,higB,6468960,6468960,6468910,50,2,utRho20
649,hinT,2323642,2323770,2323642,128,88,utRho20
650,hipB,3184964,3184964,3184884,80,274,utRho20
651,hisB,4186720,4186936,4186720,216,1590,utRho20
652,hisJ,4853674,4853674,4853576,98,696,utRho20
653,hisL,8359856,8359984,8359856,128,60,utRho20
654,hisS,5281284,5281284,5281150,134,284,utRho20
655,hlpA,400910,400964,400910,54,392,utRho20
656,hlyE,2460932,2460932,2460788,144,0,utRho20
657,hmp,5371594,5371670,5371594,76,174,utRho20
658,hns,2585916,2585916,2585844,72,1076,utRho20
659,hofM,7045856,7045856,7045502,354,0,utRho20
660,hokA,7441620,7441620,7441200,420,76,utRho20
661,hokC,33902,33902,33806,96,0,utRho20
662,hokE,1215462,1215672,1215462,210,0,utRho20
663,holC,8968546,8968546,8968560,14,2596,utRho20
664,holD,9215562,9215606,9215562,44,50,utRho20
665,holE,3850040,3850216,3850040,176,72,utRho20
666,hpt,282720,282862,282720,142,160,utRho20
667,hrpB,324150,324210,324150,60,22,utRho20
668,hscB,5319048,5319048,5318934,114,1972,utRho20
669,hscC,1367188,1367188,1366786,402,1086,utRho20
670,hsdS,9163004,9163004,9162924,80,0,utRho20
671,hslJ,2883560,2883560,2883486,74,264,utRho20
672,hslO,7059344,7059548,7059344,204,12634,utRho20
673,hslR,7058220,7058696,7058220,476,2076,utRho20
674,hslV,8244708,8244708,8244574,134,0,utRho20
675,hsrA,7881412,7881412,7881224,188,64,utRho20
676,htgA,21286,21660,21286,374,10,utRho20
677,htpG,989634,990240,989634,606,2126,utRho20
678,htpX,3825236,3825236,3825152,84,0,utRho20
679,htrE,311036,311036,310852,184,0,utRho20
680,htrL,7587668,7587668,7587366,302,0,utRho20
681,hupA,8400352,8400562,8400352,210,288,utRho20
682,hupB,1845220,1845804,1845220,584,632,utRho20
683,hyaA,2063968,2064278,2063968,310,0,utRho20
684,hybO,6292726,6292726,6292522,204,1062,utRho20
685,hycA,5700922,5700922,5700870,52,0,utRho20
686,hycI,5686204,5686204,5686086,118,460,utRho20
687,hydN,5676264,5676264,5676210,54,0,utRho20
688,hyfA,5202342,5202402,5202342,60,0,utRho20
689,hypA,11402508,11402588,11402508,80,0,utRho20
690,hypB,11403356,11404004,11403356,648,104,utRho20
691,hypF,5676210,5676210,5674850,1360,380,utRho20
692,hypT,9116634,9116634,9116578,56,0,utRho20
693,hyuA,6019660,6020056,6019660,396,0,utRho20
694,iaaA,1733074,1733136,1733074,62,0,utRho20
695,iadA,9119074,9119074,9119052,22,164,utRho20
696,iap,5753072,5753162,5753072,90,104,utRho20
697,ibaG,6673966,6673966,6673606,360,188,utRho20
698,ibpA,7735036,7735036,7734844,192,318,utRho20
699,ibpB,7733962,7733962,7733794,168,860,utRho20
700,icd,2389922,2390246,2389922,324,886,utRho20
701,iclR,8447304,8447304,8447256,48,40,utRho20
702,idi,6065876,6066130,6065876,254,0,utRho20
703,idnD,8988870,8988870,8988812,58,0,utRho20
704,idnK,8989194,8989246,8989194,52,0,utRho20
705,ihfA,3591442,3591442,3591104,338,1342,utRho20
706,ihfB,1927498,1927656,1927498,158,2666,utRho20
707,ileS,43666,44782,43666,1116,10006,utRho20
708,ileX,6431194,6431196,6431194,2,62,utRho20
709,ilvA,15820940,15821324,15820940,384,0,utRho20
710,ilvC,7915824,7915940,7915824,116,0,utRho20
711,ilvE,15809552,15809936,15809552,384,156,utRho20
712,ilvI,170840,171260,170840,420,0,utRho20
713,ilvL,23701308,23701932,23701308,624,168,utRho20
714,ilvY,7915734,7915734,7915640,94,0,utRho20
715,inaA,4698998,4698998,4698944,54,66,utRho20
716,infA,1853370,1853370,1852886,484,1214,utRho20
717,infC,3602692,3602692,3601276,1416,8608,utRho20
718,insA-5,3958452,3958452,3958430,22,0,utRho20
719,insA-7,9036758,9037054,9036758,296,400,utRho20
720,insC-5,6372080,6372284,6372080,204,236,utRho20
721,insEF-2,785238,785238,785820,582,728,utRho20
722,insEF-4,2190310,2190310,2190892,582,520,utRho20
723,insG,9007098,9007098,9006862,236,0,utRho20
724,insH-1,550596,550596,550234,362,192,utRho20
725,insH-11,7306538,7306538,7306396,142,244,utRho20
726,insH-2,1151548,1151548,1151506,42,1092,utRho20
727,insH-3,1378444,1378444,1378026,418,306,utRho20
728,insH-4,2791942,2792152,2791942,210,244,utRho20
729,insH-5,2857852,2857852,2857452,400,0,utRho20
730,insH-6,4135022,4135022,4134642,380,204,utRho20
731,insH-7,4206186,4206186,4205822,364,2704,utRho20
732,insH-9,6260050,6260356,6260050,306,320,utRho20
733,insI-3,9017372,9017372,9017234,138,0,utRho20
734,insJ,7441188,7441360,7441188,172,0,utRho20
735,insK,7442130,7442308,7442130,178,0,utRho20
736,insL-1,30760,30890,30760,130,4596,utRho20
737,insL-2,1216112,1216130,1216112,18,72,utRho20
738,insL-3,5028644,5028662,5028644,18,158,utRho20
739,insN-1,540452,540484,540452,32,0,utRho20
740,intD,1132202,1132202,1131956,246,160,utRho20
741,intR,2826520,2826520,2826470,50,0,utRho20
742,intS,4933026,4933090,4933026,64,44,utRho20
743,intZ,5117386,5117542,5117386,156,382,utRho20
744,iraD,9113152,9113986,9113152,834,122,utRho20
745,iraM,2424246,2424246,2424006,240,0,utRho20
746,iraP,802638,802772,802638,134,0,utRho20
747,iscA,5319924,5319924,5319772,152,2602,utRho20
748,iscR,5324398,5324398,5324262,136,11952,utRho20
749,iscX,5313834,5313834,5313472,362,1924,utRho20
750,ispF,5743968,5743968,5743560,408,2384,utRho20
751,ispG,5283908,5283908,5283608,300,1228,utRho20
752,ispU,389568,389806,389568,238,154,utRho20
753,isrA,2811502,2811502,2811618,116,140,utRho20
754,istr-1,7706384,7706384,7706384,0,0,utRho20
755,istr-2,7706514,7706514,7706514,0,0,utRho20
756,ivbL,15412092,15412092,15411952,140,744,utRho20
757,ivy,480638,480686,480638,48,0,utRho20
758,katE,3627628,3627734,3627628,106,610,utRho20
759,katG,8267624,8267670,8267624,46,208,utRho20
760,kbaZ,6557732,6557828,6557732,96,0,utRho20
761,kbl,7585154,7585154,7585102,52,376,utRho20
762,kch,2621046,2621046,2620538,508,0,utRho20
763,kdgR,3820506,3820506,3820198,308,16,utRho20
764,kdpE,1443788,1443788,1443466,322,382,utRho20
765,kdpF,1457698,1457698,1457642,56,0,utRho20
766,kdsA,2535708,2536330,2535708,622,2874,utRho20
767,kdsC,6683438,6684546,6683438,1108,8372,utRho20
768,kduI,5968388,5968388,5968248,140,68,utRho20
769,kefF,94160,94492,94160,332,0,utRho20
770,kgtP,5451624,5451624,5451492,132,2,utRho20
771,kup,7862206,7862632,7862206,426,74,utRho20
772,lacI,735076,735076,735020,56,378,utRho20
773,lacZ,1465508,1465508,1465220,288,588,utRho20
774,ldcA,2486394,2486394,2486160,234,32,utRho20
775,ldhA,2885830,2885830,2885686,144,34,utRho20
776,ldrA,2538954,2538954,2538550,404,12,utRho20
777,ldrB,2540024,2540024,2539620,404,8,utRho20
778,ldrC,2541092,2541092,2540690,402,2,utRho20
779,ldrD,7400544,7400544,7400174,370,60,utRho20
780,lepA,5414392,5414392,5414248,144,198,utRho20
781,lepB,5410928,5410928,5410618,310,704,utRho20
782,leuD,159188,159188,158906,282,316,utRho20
783,leuE,3761600,3761600,3761518,82,0,utRho20
784,leuL,168048,168048,167416,632,0,utRho20
785,leuO,168308,168736,168308,428,0,utRho20
786,leuQ,9212864,9212864,9212802,62,0,utRho20
787,leuU,6644556,6644556,6644316,240,2466,utRho20
788,leuV,9212546,9212546,9212330,216,556,utRho20
789,leuX,8992772,8992810,8992772,38,0,utRho20
790,lexA,8514174,8514230,8514174,56,36,utRho20
791,lhr,3456706,3458174,3456706,1468,1260,utRho20
792,ligA,5060402,5060402,5060352,50,0,utRho20
793,ligB,7642576,7642576,7642340,236,8,utRho20
794,lipA,1320602,1320602,1320432,170,78,utRho20
795,lipB,1324802,1324802,1324556,246,2470,utRho20
796,lit,2397032,2397390,2397032,358,204,utRho20
797,livJ,7199524,7199524,7199316,208,80,utRho20
798,livK,7195510,7195510,7195120,390,120,utRho20
799,lldP,7554578,7554798,7554578,220,5762,utRho20
800,lnt,1381968,1381968,1381762,206,1210,utRho20
801,loiP,6163784,6163826,6163784,42,38,utRho20
802,lolA,1874656,1874738,1874656,82,340,utRho20
803,lolB,2527112,2527112,2527000,112,0,utRho20
804,lolC,2350748,2350854,2350748,106,0,utRho20
805,lon,917630,917776,917630,146,584,utRho20
806,lpcA,486936,487086,486936,150,0,utRho20
807,lpd,255434,255824,255434,390,3002,utRho20
808,lplA,9248476,9248476,9248234,242,3292,utRho20
809,lplT,5947878,5947878,5947724,154,0,utRho20
810,lpoA,6586422,6586800,6586422,378,824,utRho20
811,lpp,3514592,3514842,3514592,250,514,utRho20
812,lptA,6686598,6686760,6686598,162,870,utRho20
813,lptB,6686792,6687888,6686792,1096,3216,utRho20
814,lptD,114672,114672,114218,454,1970,utRho20
815,lptF,8972244,8972436,8972244,192,0,utRho20
816,lpxC,213016,213114,213016,98,8270,utRho20
817,lpxD,401920,401942,401920,22,48,utRho20
818,lpxL,2233418,2233418,2233164,254,14,utRho20
819,lpxM,3880456,3880456,3880386,70,2,utRho20
820,lpxP,4991156,4991290,4991156,134,80,utRho20
821,lrhA,4813312,4813312,4813282,30,98,utRho20
822,lrp,1864656,1865190,1864656,534,1810,utRho20
823,lspA,50028,50414,50028,386,2624,utRho20
824,lsrA,3202920,3202980,3202920,60,0,utRho20
825,lsrR,3202514,3202514,3202482,32,0,utRho20
826,ltaE,1818640,1818640,1818588,52,170,utRho20
827,luxS,5630130,5630130,5629466,664,1518,utRho20
828,lysA,5957902,5957902,5957798,104,0,utRho20
829,lysC,8467232,8467232,8466466,766,5226,utRho20
830,lysP,4497120,4497120,4497064,56,98,utRho20
831,lysR,5957900,5958042,5957900,142,0,utRho20
832,lysT,1561028,1561108,1561028,80,44,utRho20
833,lysU,8709610,8709610,8709434,176,18,utRho20
834,macB,1840188,1840694,1840188,506,1768,utRho20
835,maeA,3111484,3111484,3111338,146,7150,utRho20
836,mak,820236,820288,820236,52,240,utRho20
837,malE,8492928,8492928,8492838,90,0,utRho20
838,malI,3398456,3398456,3398360,96,0,utRho20
839,malK,8493472,8493568,8493472,96,0,utRho20
840,malP,7105020,7105020,7104946,74,3368,utRho20
841,malQ,7100798,7100798,7100140,658,346,utRho20
842,malS,14949880,14949988,14949880,108,0,utRho20
843,malT,7106048,7106170,7106048,122,218,utRho20
844,malX,3398626,3398710,3398626,84,0,utRho20
845,malZ,1689980,1690072,1689980,92,132,utRho20
846,manA,3377102,3377152,3377102,50,0,utRho20
847,manX,3803866,3804096,3803866,230,0,utRho20
848,marC,3237882,3237882,3237816,66,62,utRho20
849,marR,3238186,3238240,3238186,54,0,utRho20
850,matP,2036918,2036970,2036918,52,0,utRho20
851,mazE,5822736,5822736,5822678,58,86,utRho20
852,mazG,5821720,5821720,5821370,350,7092,utRho20
853,mcbA,1684306,1684306,1684112,194,18,utRho20
854,mcbR,3040192,3040524,3040192,332,16,utRho20
855,mcrA,2420278,2420692,2420278,414,32,utRho20
856,mcrC,9156124,9156124,9155916,208,456,utRho20
857,mdaB,6344814,6345060,6344814,246,0,utRho20
858,mdfA,1767138,1767346,1767138,208,0,utRho20
859,mdh,6768940,6768940,6768536,404,526,utRho20
860,mdoB,9198988,9198988,9198882,106,1406,utRho20
861,mdoD,2993290,2993712,2993290,422,0,utRho20
862,mdoG,2218514,2218670,2218514,156,218,utRho20
863,mdtA,4307958,4308032,4307958,74,0,utRho20
864,mdtE,7318168,7318464,7318168,296,5070,utRho20
865,mdtK,3486538,3486914,3486538,376,62,utRho20
866,mdtP,8602472,8602472,8602060,412,56,utRho20
867,melA,8683774,8683822,8683774,48,0,utRho20
868,melR,8683300,8683300,8683256,44,114,utRho20
869,menA,8240812,8240812,8240698,114,24,utRho20
870,menB,4753774,4753774,4753638,136,798,utRho20
871,mepH,3468714,3468870,3468714,156,0,utRho20
872,mepM,3883666,3883666,3883270,396,304,utRho20
873,mepS,4539840,4539958,4539840,118,36,utRho20
874,metA,8428318,8428560,8428318,242,0,utRho20
875,metB,8257272,8257344,8257272,72,1576,utRho20
876,metC,6304150,6304472,6304150,322,250,utRho20
877,metE,8025768,8026106,8025768,338,204,utRho20
878,metF,8265092,8265232,8265092,140,0,utRho20
879,metG,4388538,4388600,4388538,62,150,utRho20
880,metH,8447010,8447656,8447010,646,2028,utRho20
881,metJ,8257116,8257116,8256790,326,242,utRho20
882,metK,6173154,6173412,6173154,258,0,utRho20
883,metN,445428,445428,445290,138,60,utRho20
884,metR,8025710,8025710,8025632,78,104,utRho20
885,metT,1394326,1394326,1394266,60,202,utRho20
886,metY,19910250,19910250,19909734,516,366,utRho20
887,metZ,11789528,11789548,11789528,20,172,utRho20
888,mfd,2348056,2348056,2347928,128,132,utRho20
889,mglA,4478782,4478782,4478578,204,682,utRho20
890,mglB,4481132,4481132,4480696,436,41936,utRho20
891,mglC,4475918,4475918,4475506,412,1902,utRho20
892,mgrB,3817584,3817584,3817532,52,0,utRho20
893,mgrR,3245828,3245828,3245828,0,0,utRho20
894,mgsA,2054082,2054082,2054030,52,10,utRho20
895,mgtL,8934560,8934862,8934560,302,80,utRho20
896,mhpA,737038,737222,737038,184,0,utRho20
897,mhpR,737072,737072,736840,232,356,utRho20
898,mhpT,750772,750918,750772,146,0,utRho20
899,miaA,8797964,8798504,8797964,540,620,utRho20
900,micA,5629604,5629604,5629604,0,0,utRho20
901,micC,2874242,2874238,2874242,4,0,utRho20
902,micF,4626168,4626168,4626168,0,0,utRho20
903,micM,1014408,1014408,1014408,0,0,utRho20
904,minE,2449422,2449422,2449090,332,3556,utRho20
905,mioC,7852950,7852950,7852910,40,0,utRho20
906,mipA,3733012,3733012,3732944,68,1868,utRho20
907,mlaA,4930270,4930270,4930014,256,196,utRho20
908,mlc,3337206,3337206,3337128,78,38,utRho20
909,mlrA,4429498,4429732,4429498,234,108,utRho20
910,mltA,5894546,5894546,5894356,190,40,utRho20
911,mltD,468050,468050,467910,140,40,utRho20
912,mltF,5391534,5391602,5391534,68,0,utRho20
913,mmuP,550238,550650,550238,412,192,utRho20
914,mngA,1531622,1531968,1531622,346,70,utRho20
915,mngR,1531852,1531852,1531750,102,0,utRho20
916,mnmG,7851348,7851348,7851266,82,346,utRho20
917,mntH,5025470,5025470,5025412,58,202,utRho20
918,mntP,3810918,3811376,3810918,458,406,utRho20
919,mntR,1706160,1706366,1706160,206,0,utRho20
920,mntS,1706128,1706128,1705994,134,0,utRho20
921,moaA,1633654,1634088,1633654,434,1050,utRho20
922,moaB,1635954,1636110,1635954,156,4594,utRho20
923,mobA,8084242,8084242,8083998,244,16,utRho20
924,mocA,6030112,6030320,6030112,208,0,utRho20
925,modA,1589990,1590178,1589990,188,20,utRho20
926,moeA,1732788,1732788,1732728,60,368,utRho20
927,mokB,2984610,2984610,2984258,352,830,utRho20
928,molR_1,4392888,4392948,4392888,60,0,utRho20
929,motA,3954604,3954604,3954278,326,100,utRho20
930,mpaA,2781278,2781278,2781196,82,498,utRho20
931,mpl,8911456,8911570,8911456,114,0,utRho20
932,mppA,2786108,2786454,2786108,346,38,utRho20
933,mprA,5621494,5621540,5621494,46,544,utRho20
934,mqo,4613848,4613848,4613508,340,122,utRho20
935,mqsA,6336742,6336742,6336492,250,1584,utRho20
936,mqsR,6337306,6337306,6337088,218,1332,utRho20
937,mraZ,179192,179268,179192,76,44,utRho20
938,mrcA,7045652,7045742,7045652,90,0,utRho20
939,mrcB,329442,329460,329442,18,0,utRho20
940,mreB,13605424,13605424,13604348,1076,1100,utRho20
941,mreD,6798166,6798166,6797750,416,32,utRho20
942,mrp,4388360,4388360,4388336,24,30,utRho20
943,mscK,972984,973072,972984,88,20,utRho20
944,mscL,6876002,6876048,6876002,46,126,utRho20
945,mscS,6139742,6139742,6139614,128,668,utRho20
946,msrA,8884522,8884522,8884352,170,816,utRho20
947,msrB,3725168,3725168,3724858,310,0,utRho20
948,msyB,2228426,2228426,2228362,64,410,utRho20
949,mtfA,4087236,4087302,4087236,66,4768,utRho20
950,mtgA,6699662,6699662,6699618,44,228,utRho20
951,mtlA,30177504,30178248,30177504,744,4040,utRho20
952,mtn,358366,358366,358306,60,74,utRho20
953,mtr,6611864,6611864,6611634,230,0,utRho20
954,mug,6430992,6430992,6430946,46,4,utRho20
955,murQ,5091466,5091546,5091466,80,0,utRho20
956,murR,5091586,5091586,5091218,368,0,utRho20
957,mutH,5939164,5939324,5939164,160,408,utRho20
958,mutL,8794092,8794824,8794092,732,736,utRho20
959,mutM,7622554,7622554,7622304,250,352,utRho20
960,mutS,5714038,5714186,5714038,148,710,utRho20
961,mutY,18617466,18618078,18617466,612,546,utRho20
962,nac,4123956,4123956,4123866,90,0,utRho20
963,nadA,1564122,1564170,1564122,48,88,utRho20
964,nadB,5420714,5420840,5420714,126,0,utRho20
965,nadC,237326,237326,237290,36,102,utRho20
966,nadE,3644604,3644916,3644604,312,158,utRho20
967,nadK,5501526,5501662,5501526,136,314,utRho20
968,nagA,1406350,1406350,1405502,848,18710,utRho20
969,nagB,1407416,1407416,1407222,194,400,utRho20
970,nagC,1404016,1404016,1403188,828,458,utRho20
971,nagE,1407680,1407888,1407680,208,0,utRho20
972,nagK,2357080,2357186,2357080,106,48,utRho20
973,nanA,6747240,6747240,6747152,88,0,utRho20
974,nanC,9079856,9079856,9079002,854,68,utRho20
975,nanR,6749406,6749406,6748978,428,14,utRho20
976,nanS,9075406,9075406,9075188,218,0,utRho20
977,napF,4607390,4607390,4606994,396,0,utRho20
978,narG,2559614,2559728,2559614,114,224,utRho20
979,narK,2555642,2555914,2555642,272,22,utRho20
980,narP,4580844,4581000,4580844,156,256,utRho20
981,narQ,5171154,5171462,5171154,308,76,utRho20
982,narU,3088326,3088326,3088120,206,132,utRho20
983,narW,3077374,3077374,3074618,2756,1608,utRho20
984,narX,2555554,2555554,2555236,318,22,utRho20
985,narZ,3085380,3085380,3085180,200,78,utRho20
986,ndh,2331984,2332170,2331984,186,0,utRho20
987,ndk,5289920,5289920,5289728,192,600,utRho20
988,nemR,6904084,6904092,6904084,8,0,utRho20
989,nepI,7683542,7683542,7683478,64,0,utRho20
990,nfo,4501612,4501680,4501612,68,0,utRho20
991,nfsB,1210906,1210906,1210848,58,0,utRho20
992,nfuA,7090916,7091248,7090916,332,570,utRho20
993,nhaA,34634,34978,34634,344,108,utRho20
994,nhaB,2469534,2469534,2469434,100,46,utRho20
995,nhoA,3067926,3068048,3067926,122,0,utRho20
996,nikA,7226878,7227334,7226878,456,296,utRho20
997,nikR,7237074,7237176,7237074,102,234,utRho20
998,nirB,6987974,6988022,6987974,48,0,utRho20
999,nlpA,7680034,7680034,7679986,48,0,utRho20
1000,nlpC,3585654,3585654,3585462,192,144,utRho20
1001,nlpD,5737658,5737658,5737506,152,8,utRho20
1002,nlpI,6618080,6618080,6617848,232,0,utRho20
1003,nmpC,1153740,1153740,1153650,90,4,utRho20
1004,nohA,3273206,3273206,3272734,472,0,utRho20
1005,norR,5664614,5664614,5664578,36,0,utRho20
1006,norV,5664878,5664952,5664878,74,0,utRho20
1007,nrdA,4689510,4689730,4689510,220,11288,utRho20
1008,nrdD,8925676,8925676,8925320,356,738,utRho20
1009,nrdH,5601312,5601446,5601312,134,1872,utRho20
1010,nrdR,865954,866004,865954,50,130,utRho20
1011,nrfA,8575342,8575528,8575342,186,0,utRho20
1012,nsrR,8812088,8812380,8812088,292,510,utRho20
1013,nudB,3897348,3897348,3897264,84,10,utRho20
1014,nudC,8393428,8393806,8393428,378,306,utRho20
1015,nudE,7052658,7052658,7052298,360,1156,utRho20
1016,nudG,3682876,3682980,3682876,104,56,utRho20
1017,nudI,4729050,4729108,4729050,58,0,utRho20
1018,nudJ,2388874,2388874,2388576,298,1660,utRho20
1019,nuoA,4810670,4810670,4810144,526,5604,utRho20
1020,nuoN,4783434,4783434,4783010,424,2506,utRho20
1021,nupC,5026018,5026084,5026018,66,0,utRho20
1022,nupG,6211302,6211428,6211302,126,96,utRho20
1023,ogrK,4335096,4335096,4335040,56,0,utRho20
1024,ogt,2800568,2800568,2800472,96,140,utRho20
1025,ohsC,5401036,5401040,5401036,4,0,utRho20
1026,ompA,2040382,2040382,2040106,276,60398,utRho20
1027,ompC,4625774,4625774,4625498,276,334,utRho20
1028,ompF,1974184,1974184,1973964,220,212,utRho20
1029,ompL,8128958,8128958,8128590,368,0,utRho20
1030,ompN,2874158,2874158,2873786,372,0,utRho20
1031,ompR,7073510,7073510,7073168,342,16,utRho20
1032,ompT,1171330,1171330,1171266,64,2,utRho20
1033,ompW,2627982,2628040,2627982,58,0,utRho20
1034,ompX,1700418,1700900,1700418,482,482,utRho20
1035,omrA,5952378,5952378,5952378,0,0,utRho20
1036,omrB,5952770,5952770,5952770,0,0,utRho20
1037,oppA,2602170,2602364,2602170,194,5768,utRho20
1038,orn,8783168,8783208,8783168,40,166,utRho20
1039,osmB,2686952,2686952,2686656,296,24,utRho20
1040,osmC,3113192,3113250,3113192,58,3810,utRho20
1041,osmE,3644566,3644566,3644512,54,0,utRho20
1042,osmF,4439046,4439046,4438962,84,230,utRho20
1043,osmY,9222306,9222792,9222306,486,3450,utRho20
1044,otsA,3963302,3963302,3963224,78,140,utRho20
1045,otsB,3964930,3964930,3964774,156,314,utRho20
1046,oxc,4984288,4984288,4983900,388,0,utRho20
1047,oxyR,8316914,8316980,8316914,66,136,utRho20
1048,oxyS,8316788,8316788,8316788,0,0,utRho20
1049,paaA,2907730,2907854,2907730,124,0,utRho20
1050,paaX,2927018,2927078,2927018,60,0,utRho20
1051,paaZ,2907340,2907340,2907284,56,0,utRho20
1052,pabA,6981702,6981702,6981658,44,0,utRho20
1053,pabB,3789256,3789610,3789256,354,598,utRho20
1054,pabC,2306186,2306600,2306186,414,524,utRho20
1055,pagP,1313052,1313114,1313052,62,0,utRho20
1056,panB,299260,299260,299202,58,344,utRho20
1057,panC,297840,297840,297590,250,676,utRho20
1058,panD,293490,293490,293388,102,38,utRho20
1059,panZ,7195656,7195968,7195656,312,0,utRho20
1060,parC,6332060,6332060,6331946,114,306,utRho20
1061,patA,6438916,6438988,6438916,72,116,utRho20
1062,patD,3030830,3031156,3030830,326,46,utRho20
1063,pbpC,5294986,5294986,5294650,336,152,utRho20
1064,pbpG,4450132,4450132,4449740,392,206,utRho20
1065,pck,7065358,7065636,7065358,278,2364,utRho20
1066,pcnB,318782,318782,318252,530,886,utRho20
1067,pdhR,244068,244184,244068,116,154,utRho20
1068,pdxB,4875768,4875768,4875702,66,0,utRho20
1069,pdxH,3436068,3436068,3436014,54,642,utRho20
1070,pdxJ,5403626,5403626,5403458,168,102,utRho20
1071,pdxK,5074638,5074638,5074474,164,0,utRho20
1072,pepA,8972278,8972278,8971902,376,464,utRho20
1073,pepD,511618,511618,511432,186,16158,utRho20
1074,pepN,1981182,1981244,1981182,62,0,utRho20
1075,pepQ,8062294,8062322,8062294,28,0,utRho20
1076,pepT,2371646,2371688,2371646,42,24,utRho20
1077,pfkA,8214948,8215104,8214948,156,118,utRho20
1078,pfkB,3612646,3612740,3612646,94,34,utRho20
1079,pflA,1902456,1902456,1902160,296,0,utRho20
1080,pflB,1907850,1907850,1907108,742,2256,utRho20
1081,pflD,8287716,8287990,8287716,274,0,utRho20
1082,pgaA,2185046,2185046,2184578,468,0,utRho20
1083,pgi,8467444,8467516,8467444,72,146,utRho20
1084,pgk,12291428,12291428,12290488,940,6844,utRho20
1085,pgl,1597078,1597172,1597078,94,0,utRho20
1086,pgpB,2678324,2678660,2678324,336,2,utRho20
1087,pgpC,5397276,5397276,5397100,176,0,utRho20
1088,pgrR,2783744,2783982,2783744,238,96,utRho20
1089,pheL,5475158,5475198,5475158,40,20,utRho20
1090,pheM,7197204,7197204,7197080,124,0,utRho20
1091,pheP,1203858,1203918,1203858,60,0,utRho20
1092,pheU,8725254,8725254,8725252,2,102,utRho20
1093,pheV,6220730,6220732,6220730,2,50,utRho20
1094,phnC,8650412,8650412,8650330,82,0,utRho20
1095,phoA,803414,803494,803414,80,136,utRho20
1096,phoB,834202,834284,834202,82,24,utRho20
1097,phoE,520316,520316,520200,116,60,utRho20
1098,phoH,2169730,2169984,2169730,254,526,utRho20
1099,phoP,2381016,2381016,2380894,122,4240,utRho20
1100,phoQ,2379880,2379880,2379552,328,2202,utRho20
1101,phoU,7815330,7815330,7815156,174,92,utRho20
1102,phr,1478842,1479014,1478842,172,198,utRho20
1103,pinE,2419054,2419370,2419054,316,0,utRho20
1104,pinQ,3267168,3267244,3267168,76,6,utRho20
1105,pinR,2867424,2867424,2867348,76,2,utRho20
1106,pitA,7275224,7275284,7275224,60,26,utRho20
1107,pitB,6272806,6272806,6272742,64,76,utRho20
1108,pka,5439862,5439906,5439862,44,2,utRho20
1109,plaP,4174476,4174476,4174124,352,116,utRho20
1110,pldA,8009628,8009724,8009628,96,162,utRho20
1111,pldB,8018028,8018340,8018028,312,160,utRho20
1112,plsB,8513196,8513196,8512932,264,700,utRho20
1113,pmbA,8915890,8915918,8915890,28,0,utRho20
1114,pmrD,4747148,4747148,4747076,72,0,utRho20
1115,pncB,1980828,1980828,1980712,116,36,utRho20
1116,pncC,5648788,5648788,5648692,96,144,utRho20
1117,pnp,6622652,6622652,6622336,316,16,utRho20
1118,pntA,3355950,3355950,3355806,144,42,utRho20
1119,pntB,3353096,3353096,3352720,376,32,utRho20
1120,polA,8093880,8093932,8093880,52,0,utRho20
1121,polB,131606,131606,131560,46,0,utRho20
1122,potD,2365700,2365700,2365658,42,0,utRho20
1123,potE,1436688,1436688,1436530,158,0,utRho20
1124,potF,1787268,1787568,1787268,300,0,utRho20
1125,poxB,1822152,1822152,1822098,54,0,utRho20
1126,ppa,8899372,8899372,8899304,68,150,utRho20
1127,ppc,8306380,8306380,8306196,184,920,utRho20
1128,ppdA,5928440,5928440,5928354,86,4,utRho20
1129,ppdD,235410,235410,235098,312,0,utRho20
1130,pphA,3846770,3846770,3845938,832,3978,utRho20
1131,pphB,5719474,5719520,5719474,46,0,utRho20
1132,ppiA,6984898,6984898,6984594,304,0,utRho20
1133,ppiC,7919682,7919682,7919626,56,48,utRho20
1134,ppiD,923638,923830,923638,192,224,utRho20
1135,ppk,5245748,5246088,5245748,340,136,utRho20
1136,pppA,6228958,6228958,6228704,254,572,utRho20
1137,ppsA,3574322,3574322,3574224,98,56,utRho20
1138,ppsR,3574678,3574890,3574678,212,0,utRho20
1139,pptA,3065716,3066104,3065716,388,204,utRho20
1140,pqiA,2023318,2024002,2023318,684,210,utRho20
1141,prc,3830054,3830054,3829632,422,20406,utRho20
1142,preT,4467978,4468066,4467978,88,34,utRho20
1143,prfC,9218688,9218828,9218688,140,682,utRho20
1144,prkB,6968622,6968980,6968622,358,1960,utRho20
1145,prlC,7290476,7290476,7290364,112,168,utRho20
1146,prlF,6553944,6554004,6553944,60,138,utRho20
1147,proB,520432,520776,520432,344,260,utRho20
1148,proC,811372,811372,811288,84,0,utRho20
1149,proK,7417388,7417388,7417384,4,0,utRho20
1150,proL,4572414,4572422,4572414,8,0,utRho20
1151,proP,8660640,8661004,8660640,364,1588,utRho20
1152,proS,437674,437674,437550,124,1060,utRho20
1153,proV,5609126,5609630,5609126,504,86,utRho20
1154,prpB,697292,697364,697292,72,0,utRho20
1155,prpR,696942,696942,696886,56,0,utRho20
1156,prs,2524354,2524354,2523750,604,69878,utRho20
1157,psd,8781276,8781276,8780720,556,3096,utRho20
1158,psiE,8480600,8480650,8480600,50,0,utRho20
1159,pspA,2736076,2736158,2736076,82,2,utRho20
1160,pspF,2736080,2736080,2735824,256,2,utRho20
1161,pspG,8525632,8525680,8525632,48,0,utRho20
1162,pssA,5445156,5445454,5445156,298,14274,utRho20
1163,pstB,7817112,7817112,7816732,380,12,utRho20
1164,pstC,7821084,7821084,7820796,288,114,utRho20
1165,pstS,23469408,23469408,23469150,258,90,utRho20
1166,psuG,4517114,4517114,4516734,380,2664,utRho20
1167,psuT,4514992,4514992,4514670,322,0,utRho20
1168,pth,2517084,2517084,2517026,58,0,utRho20
1169,ptrA,5918022,5918022,5917768,254,0,utRho20
1170,ptrB,3857730,3857730,3857678,52,216,utRho20
1171,ptsG,2315252,2315738,2315252,486,1514,utRho20
1172,ptsH,5066996,5067528,5066996,532,10438,utRho20
1173,purA,8809328,8809374,8809328,46,2,utRho20
1174,purC,5195562,5195562,5195236,326,302,utRho20
1175,purD,8411972,8411972,8411862,110,146,utRho20
1176,purE,1106284,1106284,1106200,84,42,utRho20
1177,purH,8415254,8415254,8415064,190,2,utRho20
1178,purL,5391178,5391178,5391086,92,442,utRho20
1179,purM,5242306,5242394,5242306,88,30,utRho20
1180,purR,3475378,3475688,3475378,310,960,utRho20
1181,purT,3861438,3861762,3861438,324,0,utRho20
1182,purU,2577512,2577512,2577248,264,1128,utRho20
1183,putA,2157850,2157850,2157764,86,116,utRho20
1184,putP,2158336,2158610,2158336,274,1348,utRho20
1185,puuA,2721936,2721936,2721816,120,0,utRho20
1186,puuC,2725456,2725486,2725456,30,0,utRho20
1187,puuD,2722104,2722240,2722104,136,0,utRho20
1188,puuP,2718746,2718746,2718374,372,604,utRho20
1189,pykA,3874988,3875298,3874988,310,732,utRho20
1190,pykF,3510934,3511396,3510934,462,1762,utRho20
1191,pyrC,2245286,2245286,2245214,72,148,utRho20
1192,pyrD,2009464,2009536,2009464,72,0,utRho20
1193,pyrE,7631970,7631970,7631536,434,4,utRho20
1194,pyrF,2683740,2683842,2683740,102,166,utRho20
1195,pyrG,5819594,5819594,5819332,262,1250,utRho20
1196,pyrH,383624,383710,383624,86,1362,utRho20
1197,pyrL,8945490,8945490,8945066,424,244,utRho20
1198,qmcA,1031646,1031646,1031546,100,0,utRho20
1199,qor,8528608,8528608,8528462,146,258,utRho20
1200,qseB,6339502,6339656,6339502,154,0,utRho20
1201,queA,849970,850022,849970,52,88,utRho20
1202,queE,5811212,5811212,5810836,376,0,utRho20
1203,queF,5850642,5850696,5850642,54,0,utRho20
1204,queG,8788184,8788184,8788134,50,7346,utRho20
1205,racC,2835630,2835630,2835526,104,0,utRho20
1206,racR,2840898,2840898,2840482,416,0,utRho20
1207,raiA,5474208,5474308,5474208,100,752,utRho20
1208,rarD,8008594,8008594,8008356,238,224,utRho20
1209,ravA,7862256,7862256,7862186,70,12,utRho20
1210,rayT,495088,495274,495088,186,0,utRho20
1211,rbn,4763162,4763216,4763162,54,0,utRho20
1212,rbsD,7866644,7866702,7866644,58,138,utRho20
1213,rcnA,4371654,4371834,4371654,180,0,utRho20
1214,rcnB,4373768,4373920,4373768,152,410,utRho20
1215,rcnR,4371806,4371806,4371592,214,0,utRho20
1216,rcsA,4047672,4047936,4047672,264,6,utRho20
1217,rcsB,4631390,4632354,4631390,964,932,utRho20
1218,rcsC,4640162,4640162,4639656,506,126,utRho20
1219,rcsD,4626904,4626976,4626904,72,108,utRho20
1220,rdgB,6193240,6193362,6193240,122,1216,utRho20
1221,rdlA,2538646,2538646,2538646,0,0,utRho20
1222,rdlB,2539712,2539716,2539712,4,0,utRho20
1223,rdlC,2540782,2540786,2540782,4,0,utRho20
1224,rdlD,7400272,7400272,7400272,0,0,utRho20
1225,rdoA,8084782,8084830,8084782,48,226,utRho20
1226,recA,11295276,11295276,11295076,200,1232,utRho20
1227,recC,5925014,5925014,5924856,158,94,utRho20
1228,recF,7763722,7763722,7762442,1280,8258,utRho20
1229,recN,5503518,5503590,5503518,72,0,utRho20
1230,recQ,8011666,8011728,8011666,62,0,utRho20
1231,relA,5828554,5828554,5827302,1252,660,utRho20
1232,relB,3291806,3291806,3291744,62,0,utRho20
1233,rem,3289950,3289950,3289804,146,0,utRho20
1234,rep,7921294,7921354,7921294,60,84,utRho20
1235,rfaD,7587730,7587974,7587730,244,210,utRho20
1236,rfaE,6393852,6393852,6393506,346,116,utRho20
1237,rfaH,8049930,8049930,8049642,288,1470,utRho20
1238,rfbX,4219436,4219436,4219168,268,1558,utRho20
1239,rfe,7935600,7935832,7935600,232,0,utRho20
1240,rhaB,8194944,8194944,8194896,48,0,utRho20
1241,rhaD,8188770,8188770,8188544,226,0,utRho20
1242,rhaS,8195422,8195472,8195422,50,0,utRho20
1243,rhaT,8201132,8201132,8201050,82,2,utRho20
1244,rhlE,1661566,1661744,1661566,178,0,utRho20
1245,rhoL,47593944,47594772,47593944,828,38892,utRho20
1246,rhsB,7238006,7238384,7238006,378,0,utRho20
1247,rhsC,1458758,1459166,1458758,408,0,utRho20
1248,rhsD,1046132,1046522,1046132,390,0,utRho20
1249,rhtA,1700608,1700608,1700194,414,0,utRho20
1250,rhtC,8015478,8015514,8015478,36,374,utRho20
1251,ribA,2678468,2678468,2678320,148,2,utRho20
1252,ribC,3486916,3486916,3486484,432,62,utRho20
1253,ribE,869008,869294,869008,286,7410,utRho20
1254,ribF,42766,42814,42766,48,10,utRho20
1255,ridA,8941892,8941892,8941826,66,150,utRho20
1256,rihA,1369204,1369204,1368824,380,482,utRho20
1257,rihB,4510504,4510504,4510372,132,0,utRho20
1258,rimJ,2251044,2251124,2251044,80,152,utRho20
1259,rimK,1783752,1783934,1783752,182,512,utRho20
1260,rimL,2997486,2997876,2997486,390,302,utRho20
1261,rimO,1756140,1756140,1756070,70,4,utRho20
1262,rimP,6636350,6636350,6636012,338,926,utRho20
1263,rlmA,3814172,3814172,3814120,52,130,utRho20
1264,rlmD,5830086,5830086,5830000,86,132,utRho20
1265,rlmE,6655520,6655520,6655328,192,1092,utRho20
1266,rlmF,1684384,1684664,1684384,280,0,utRho20
1267,rlmG,6471784,6471784,6471750,34,16,utRho20
1268,rlmI,2060002,2060002,2059938,64,88,utRho20
1269,rlmJ,7290700,7290770,7290700,70,12,utRho20
1270,rlmL,2015344,2015688,2015344,344,1482,utRho20
1271,rlpA,1330444,1330444,1330380,64,332,utRho20
1272,rluA,120900,120900,120692,208,76,utRho20
1273,rluF,8460324,8460708,8460324,384,2,utRho20
1274,rmf,2031006,2031430,2031006,424,454,utRho20
1275,rna,1290068,1290068,1290006,62,0,utRho20
1276,rnb,2698258,2698258,2697824,434,2172,utRho20
1277,rnc,10816892,10816892,10816252,640,6076,utRho20
1278,rnd,3776122,3776122,3775982,140,2,utRho20
1279,rne,2289746,2289746,2288734,1012,12108,utRho20
1280,rnhA,472082,472082,472004,78,1228,utRho20
1281,rnk,1288360,1288360,1287934,426,204,utRho20
1282,rnlA,5531788,5531836,5531788,48,86,utRho20
1283,rnlB,5533414,5533968,5533414,554,1438,utRho20
1284,rnpB,19623552,19623552,19623552,0,0,utRho20
1285,rob,9270706,9270706,9270620,86,32,utRho20
1286,rodZ,5285868,5285868,5285688,180,130,utRho20
1287,rpe,7030306,7030306,7030118,188,414,utRho20
1288,rph,15266320,15266320,15266196,124,0,utRho20
1289,rpiA,6118706,6118706,6118650,56,0,utRho20
1290,rpiB,8626514,8626700,8626514,186,0,utRho20
1291,rpiR,8626274,8626274,8625982,292,0,utRho20
1292,rplJ,8359246,8359992,8359246,746,5758,utRho20
1293,rplK,8356708,8356894,8356708,186,208,utRho20
1294,rplM,6757344,6757344,6757302,42,2344,utRho20
1295,rplN,6896444,6896444,6896298,146,2526,utRho20
1296,rplS,5489284,5489284,5489060,224,6646,utRho20
1297,rplT,7199052,7199052,7198996,56,904,utRho20
1298,rplU,6667036,6667036,6666902,134,48,utRho20
1299,rplY,4564866,4565034,4564866,168,0,utRho20
1300,rpmA,6666450,6666450,6666238,212,636,utRho20
1301,rpmB,15247980,15247980,15246696,1284,58212,utRho20
1302,rpmE,8253816,8254026,8253816,210,150,utRho20
1303,rpmF,2294676,2294734,2294676,58,25088,utRho20
1304,rpmH,7768130,7768672,7768130,542,2666,utRho20
1305,rpmI,3600854,3600854,3599998,856,11474,utRho20
1306,rpoB,8362126,8362490,8362126,364,560,utRho20
1307,rpoD,6424946,6426094,6424946,1148,48324,utRho20
1308,rpoE,5420372,5420372,5420024,348,0,utRho20
1309,rpoH,7202006,7202006,7201566,440,6168,utRho20
1310,rpoN,6689324,6689434,6689324,110,136,utRho20
1311,rpoS,5736236,5736236,5735102,1134,21888,utRho20
1312,rpoZ,7644154,7644212,7644154,58,600,utRho20
1313,rppH,5937986,5937986,5937954,32,44,utRho20
1314,rprA,3540744,3540744,3540744,0,0,utRho20
1315,rpsA,1923434,1923990,1923434,556,105854,utRho20
1316,rpsF,8850050,8850236,8850050,186,10002,utRho20
1317,rpsI,6756580,6756580,6756414,166,3750,utRho20
1318,rpsJ,6906884,6906884,6906540,344,4966,utRho20
1319,rpsL,6949242,6949242,6949104,138,238,utRho20
1320,rpsM,6885130,6885130,6884942,188,918,utRho20
1321,rpsO,13247144,13247144,13246736,408,448,utRho20
1322,rpsP,5492508,5492508,5492370,138,0,utRho20
1323,rpsT,42420,42420,42156,264,200,utRho20
1324,rpsU,12842584,12843124,12842584,540,736,utRho20
1325,rraA,8238716,8238716,8238660,56,72,utRho20
1326,rraB,8956768,8956946,8956768,178,0,utRho20
1327,rrsA,8070478,8071062,8070478,584,9830,utRho20
1328,rrsB,16665468,16666636,16665468,1168,19508,utRho20
1329,rrsC,7883032,7883616,7883032,584,4884,utRho20
1330,rrsD,6858094,6858094,6857524,570,762,utRho20
1331,rrsE,8415726,8416294,8415726,568,1008,utRho20
1332,rrsG,5462896,5462896,5462314,582,9296,utRho20
1333,rrsH,446970,447542,446970,572,2016,utRho20
1334,rsd,8393908,8393908,8393616,292,340,utRho20
1335,rseA,5419264,5419264,5418808,456,1266,utRho20
1336,rseP,392940,393092,392940,152,92,utRho20
1337,rseX,4067298,4067298,4067298,0,0,utRho20
1338,rsfS,1338144,1338144,1338072,72,262,utRho20
1339,rsgA,8783132,8783132,8783018,114,60,utRho20
1340,rsmA,105176,105176,104860,316,4054,utRho20
1341,rsmB,6869982,6870414,6869982,432,396,utRho20
1342,rsmC,9215736,9215736,9215400,336,472,utRho20
1343,rsmD,7208594,7208786,7208594,192,0,utRho20
1344,rsmE,6182036,6182268,6182036,232,268,utRho20
1345,rsmG,7847512,7847512,7847360,152,10,utRho20
1346,rsmH,180020,180188,180020,168,402,utRho20
1347,rsmI,6587106,6587106,6586670,436,2514,utRho20
1348,rssA,2578212,2578412,2578212,200,164,utRho20
1349,rssB,2580440,2580484,2580440,44,328,utRho20
1350,rstA,3364276,3364300,3364276,24,0,utRho20
1351,rsuA,4561096,4561096,4560966,130,284,utRho20
1352,rsxA,3411510,3411534,3411510,24,70,utRho20
1353,rtcA,7114004,7114004,7113698,306,92,utRho20
1354,rtcB,7116214,7116214,7116158,56,0,utRho20
1355,rtn,4541356,4541452,4541356,96,236,utRho20
1356,rutA,2148052,2148052,2148022,30,0,utRho20
1357,rutG,2140090,2140090,2139678,412,0,utRho20
1358,rutR,2148226,2148484,2148226,258,2,utRho20
1359,ruvA,7784096,7784096,7783904,192,0,utRho20
1360,ruvB,7782176,7782176,7781424,752,1508,utRho20
1361,ruvC,3894878,3894878,3894752,126,20,utRho20
1362,rybB,1776114,1776114,1776114,0,0,utRho20
1363,rydB,3529860,3529860,3529322,538,268,utRho20
1364,rydC,2983012,2983012,2983012,0,0,utRho20
1365,ryfA,5307398,5307710,5307398,312,2,utRho20
1366,ryfD,5468590,5468590,5468590,0,0,utRho20
1367,ryhB,7162032,7162032,7162032,0,0,utRho20
1368,ryjA,8556132,8556132,8556132,0,0,utRho20
1369,ryjB,9055954,9055954,9055954,0,0,utRho20
1370,sad,3229598,3229598,3229406,192,0,utRho20
1371,safA,3168056,3168056,3167918,138,0,utRho20
1372,sanA,4465368,4465756,4465368,388,184,utRho20
1373,sapF,2705314,2705314,2705268,46,0,utRho20
1374,sbcB,4165456,4165512,4165456,56,0,utRho20
1375,sbcC,831694,831694,831506,188,148,utRho20
1376,sbcD,833954,833954,833904,50,0,utRho20
1377,sbmA,793106,793278,793106,172,0,utRho20
1378,sbmC,4162650,4162650,4162524,126,0,utRho20
1379,sdaA,3793618,3793864,3793618,246,936,utRho20
1380,sdaC,5856070,5856458,5856070,388,1110,utRho20
1381,sdhC,1509916,1510354,1509916,438,38316,utRho20
1382,sdhD,1510808,1511120,1510808,312,7994,utRho20
1383,sdiA,3993834,3993834,3993664,170,58,utRho20
1384,secE,8354354,8354716,8354354,362,22,utRho20
1385,secG,6645180,6645180,6645010,170,1604,utRho20
1386,selA,7522594,7522594,7522498,96,282,utRho20
1387,selB,7519850,7519850,7519722,128,214,utRho20
1388,selC,7672396,7672444,7672396,48,0,utRho20
1389,selD,3696058,3696058,3696016,42,7076,utRho20
1390,seqA,1425884,1425974,1425884,90,868,utRho20
1391,serA,6117098,6117098,6116820,278,0,utRho20
1392,serB,9249712,9249790,9249712,78,0,utRho20
1393,serC,3830380,3830612,3830380,232,0,utRho20
1394,serS,1878730,1878856,1878730,126,520,utRho20
1395,serT,2063438,2063438,2063424,14,0,utRho20
1396,serU,4087124,4087124,4087114,10,214,utRho20
1397,serV,5637394,5637394,5637290,104,90,utRho20
1398,serW,1852014,1852014,1851942,72,656,utRho20
1399,serX,2195352,2195352,2195304,48,32,utRho20
1400,setB,4527426,4527726,4527426,300,0,utRho20
1401,setC,7673488,7673906,7673488,418,0,utRho20
1402,sfmA,1116124,1116424,1116124,300,0,utRho20
1403,sfmC,1117606,1117948,1117606,342,0,utRho20
1404,sfsA,323030,323030,322972,58,394,utRho20
1405,sfsB,6669592,6669818,6669592,226,2,utRho20
1406,sgrR,154676,154676,154598,78,40,utRho20
1407,sgrS,154734,154734,154734,0,0,utRho20
1408,shiA,4107068,4107286,4107068,218,0,utRho20
1409,sibA,4306622,4306622,4306622,0,0,utRho20
1410,sibB,4307292,4307292,4307292,0,0,utRho20
1411,sibC,6113702,6113702,6113702,0,0,utRho20
1412,sibD,6389730,6389730,6389730,0,0,utRho20
1413,sibE,6390480,6390480,6390480,0,0,utRho20
1414,sixA,4913998,4913998,4913624,374,70,utRho20
1415,slp,7307872,7307922,7307872,50,0,utRho20
1416,slt,9261400,9261466,9261400,66,0,utRho20
1417,slyA,3442028,3442028,3441648,380,6,utRho20
1418,slyB,3439496,3439752,3439496,256,114,utRho20
1419,slyD,6957398,6957398,6956994,404,1550,utRho20
1420,slyX,6954862,6955280,6954862,418,5528,utRho20
1421,smf,6867372,6867372,6867120,252,0,utRho20
1422,smpB,5509534,5509792,5509534,258,462,utRho20
1423,smrA,2811872,2811958,2811872,86,412,utRho20
1424,smrB,4896872,4897212,4896872,340,148,utRho20
1425,smtA,1946808,1947074,1946808,266,0,utRho20
1426,sodA,8201518,8201620,8201518,102,17096,utRho20
1427,sodB,3470646,3470756,3470646,110,0,utRho20
1428,sodC,3449358,3449358,3449310,48,116,utRho20
1429,sohB,2658568,2658664,2658568,96,2,utRho20
1430,sokB,2984232,2984238,2984232,6,132,utRho20
1431,solA,2241218,2241218,2241172,46,0,utRho20
1432,soxR,8554894,8554938,8554894,44,0,utRho20
1433,soxS,8554846,8554846,8554766,80,0,utRho20
1434,speA,6172096,6172096,6171822,274,74,utRho20
1435,speB,6167892,6167892,6167594,298,0,utRho20
1436,speC,6218350,6218350,6218310,40,68,utRho20
1437,spf,8099798,8099798,8099798,0,0,utRho20
1438,sppA,3697422,3697674,3697422,252,64,utRho20
1439,spy,3651376,3651376,3651250,126,6,utRho20
1440,sra,3112092,3112092,3111926,166,260,utRho20
1441,sraB,2293178,2293178,2293178,0,0,utRho20
1442,sraC,3846132,3846132,3846132,0,0,utRho20
1443,srlA,5651582,5651664,5651582,82,36,utRho20
1444,srlR,5657720,5658094,5657720,374,24582,utRho20
1445,srmB,5425752,5425792,5425752,40,350,utRho20
1446,sroA,151216,151216,151216,0,0,utRho20
1447,sroG,6369436,6369436,6369436,0,0,utRho20
1448,sroH,8380974,8380974,8380974,0,0,utRho20
1449,ssb,8548022,8548250,8548022,228,120,utRho20
1450,sseA,5304782,5304988,5304782,206,15500,utRho20
1451,sspA,6755138,6755138,6754840,298,1866,utRho20
1452,ssrA,5511014,5511186,5511014,172,2,utRho20
1453,ssrS,12223036,12223932,12223036,896,2764,utRho20
1454,sstT,6479726,6479888,6479726,162,0,utRho20
1455,ssuB,1988282,1988282,1988088,194,0,utRho20
1456,ssuE,1995126,1995126,1995024,102,0,utRho20
1457,sthA,8321604,8321604,8321580,24,2594,utRho20
1458,stpA,5597156,5597156,5596990,166,0,utRho20
1459,sucA,3034344,3034824,3034344,480,6212,utRho20
1460,sufA,3528836,3528836,3528772,64,1018,utRho20
1461,sufE,3518962,3518962,3518580,382,2456,utRho20
1462,sugE,8753588,8753750,8753588,162,718,utRho20
1463,sulA,2041894,2041894,2041838,56,228,utRho20
1464,syd,5850738,5850738,5850560,178,36,utRho20
1465,symE,9159834,9159834,9159680,154,26,utRho20
1466,symR,9159670,9159670,9159670,0,0,utRho20
1467,tabA,8949566,8949724,8949566,158,0,utRho20
1468,talA,5157140,5157332,5157140,192,190,utRho20
1469,talB,16382,16476,16382,94,20434,utRho20
1470,tam,3214442,3214692,3214442,250,318,utRho20
1471,tamA,8884540,8884764,8884540,224,118,utRho20
1472,tar,3945432,3945432,3945382,50,0,utRho20
1473,tas,5943138,5943194,5943138,56,198,utRho20
1474,tatA,16087636,16087780,16087636,144,0,utRho20
1475,tatE,1317742,1317894,1317742,152,76,utRho20
1476,tauA,770410,770464,770410,54,0,utRho20
1477,tdcA,6534186,6534186,6534130,56,0,utRho20
1478,tdcG,6519652,6519652,6519298,354,64,utRho20
1479,tdcR,6534380,6534760,6534380,380,20,utRho20
1480,tdk,2586986,2587054,2586986,68,48,utRho20
1481,tehA,3001072,3001146,3001072,74,0,utRho20
1482,tesA,1039898,1039898,1039530,368,162,utRho20
1483,tesB,950402,950402,950322,80,0,utRho20
1484,tfaE,2418532,2418532,2418238,294,28,utRho20
1485,tfaQ,3269912,3269912,3269770,142,64,utRho20
1486,tff,379424,379256,379424,168,72,utRho20
1487,tgt,852110,852274,852110,164,0,utRho20
1488,thiD,4369346,4369346,4369032,314,0,utRho20
1489,thiI,882936,883098,882936,162,68,utRho20
1490,thiM,4370902,4370902,4370602,300,196,utRho20
1491,thiQ,146170,146170,145854,316,274,utRho20
1492,thrL,592,760,592,168,568,utRho20
1493,thrS,7210932,7210932,7210280,652,1508,utRho20
1494,thrU,8350762,8350776,8350762,14,64,utRho20
1495,thrV,6847414,6847414,6847310,104,338674,utRho20
1496,thrW,525682,525742,525682,60,348,utRho20
1497,thyA,5930696,5930696,5930310,386,1080,utRho20
1498,tig,909986,910266,909986,280,820,utRho20
1499,tisB,7706674,7707106,7706674,432,800,utRho20
1500,tktA,6163414,6163414,6163270,144,132,utRho20
1501,tktB,5158616,5159272,5158616,656,43572,utRho20
1502,tldD,6784368,6784368,6784056,312,22,utRho20
1503,tmcA,5191876,5191876,5191718,158,0,utRho20
1504,tnaC,15553644,15553740,15553644,96,47084,utRho20
1505,tolB,1555074,1555480,1555074,406,488,utRho20
1506,tolC,6356008,6356230,6356008,222,882,utRho20
1507,tomB,961588,961588,961416,172,814,utRho20
1508,tonB,2622108,2622178,2622108,70,2,utRho20
1509,topA,2661578,2662096,2661578,518,776,utRho20
1510,torC,2116112,2116168,2116112,56,190,utRho20
1511,torR,2115968,2115968,2115908,60,132,utRho20
1512,torS,2112364,2112364,2112356,8,0,utRho20
1513,torT,2112414,2112522,2112414,108,0,utRho20
1514,tpiA,8223138,8223138,8223014,124,894,utRho20
1515,tppB,3425342,3425538,3425342,196,1368,utRho20
1516,tpr,2574376,2574376,2574376,0,0,utRho20
1517,tpx,2777688,2777688,2777622,66,394,utRho20
1518,tqsA,3347780,3347826,3347780,46,66,utRho20
1519,treA,2494850,2494850,2494752,98,166,utRho20
1520,treB,8932420,8932420,8932360,60,10,utRho20
1521,treF,7339102,7339184,7339102,82,106,utRho20
1522,treR,8934694,8934694,8934492,202,2,utRho20
1523,trg,2984878,2984940,2984878,62,0,utRho20
1524,trkG,2847342,2847564,2847342,222,6,utRho20
1525,trmA,8326590,8326590,8326540,50,0,utRho20
1526,trpA,2634678,2634678,2634444,234,876,utRho20
1527,trpC,2639888,2639888,2639570,318,190,utRho20
1528,trpL,5292432,5292432,5292328,104,0,utRho20
1529,trpR,9265408,9265520,9265408,112,446,utRho20
1530,trpS,7027394,7027394,7027276,118,3536,utRho20
1531,trpT,7893560,7893914,7893560,354,187018,utRho20
1532,trxA,7931294,7931522,7931294,228,890,utRho20
1533,trxB,1864156,1864156,1864100,56,108,utRho20
1534,trxC,5437350,5437470,5437350,120,382,utRho20
1535,tsaD,6421256,6421256,6421086,170,8,utRho20
1536,tsgA,6985038,6985136,6985038,98,50,utRho20
1537,tsr,9182824,9183314,9182824,490,0,utRho20
1538,tsx,864490,864490,864026,464,490,utRho20
1539,ttcA,2823970,2823970,2823896,74,1960,utRho20
1540,ttdA,6412848,6412926,6412848,78,0,utRho20
1541,ttdR,6412760,6412760,6412512,248,0,utRho20
1542,tufA,6943448,6943448,6942658,790,137256,utRho20
1543,tus,3368346,3368518,3368346,172,268,utRho20
1544,tusA,7218040,7218040,7217992,48,514,utRho20
1545,tusB,6950218,6950218,6949930,288,1312,utRho20
1546,tynA,2902996,2902996,2902698,298,0,utRho20
1547,typA,8116460,8116814,8116460,354,3180,utRho20
1548,tyrB,8534164,8534228,8534164,64,2566,utRho20
1549,tyrP,3979004,3979362,3979004,358,4,utRho20
1550,tyrR,2773384,2773440,2773384,56,132,utRho20
1551,tyrS,3434566,3434566,3434444,122,0,utRho20
1552,tyrT,2575330,2575330,2575244,86,30,utRho20
1553,uacT,6062378,6062734,6062378,356,8,utRho20
1554,ubiC,8504886,8505012,8504886,126,88,utRho20
1555,ubiD,8049618,8049976,8049618,358,1690,utRho20
1556,ubiE,8037494,8037710,8037494,216,0,utRho20
1557,ubiG,4679078,4679134,4679078,56,0,utRho20
1558,ucpA,5089342,5089342,5089246,96,0,utRho20
1559,udp,8032782,8032862,8032782,80,458,utRho20
1560,ugd,4199470,4199470,4199226,244,0,utRho20
1561,ugpB,7184852,7184852,7184650,202,1574,utRho20
1562,ugpQ,7176600,7176600,7176226,374,152,utRho20
1563,uhpT,7694396,7694396,7694334,62,0,utRho20
1564,uidA,3392304,3392304,3392142,162,0,utRho20
1565,uidC,3386012,3386012,3385702,310,0,utRho20
1566,uidR,3394150,3394150,3394104,46,178,utRho20
1567,ulaA,8839854,8839960,8839854,106,0,utRho20
1568,ulaG,8839350,8839350,8839250,100,0,utRho20
1569,ulaR,8837124,8837124,8836906,218,0,utRho20
1570,umpG,5741372,5741372,5740548,824,234,utRho20
1571,umpH,1400704,1400704,1400652,52,34,utRho20
1572,umuD,2461476,2461534,2461476,58,0,utRho20
1573,ung,5433476,5433508,5433476,32,0,utRho20
1574,uof,2843316,2843316,2842900,416,6984,utRho20
1575,upp,5241818,5241818,5241744,74,158,utRho20
1576,usg,4873780,4873780,4873298,482,362,utRho20
1577,ushA,1009772,1009828,1009772,56,0,utRho20
1578,uspA,7279966,7280222,7279966,256,1544,utRho20
1579,uspB,7279696,7279696,7279440,256,526,utRho20
1580,uspC,3959172,3959506,3959172,334,122,utRho20
1581,uspE,2797318,2797318,2797244,74,138,utRho20
1582,uspF,2871282,2871282,2871238,44,86,utRho20
1583,uspG,1283806,1283806,1283734,72,772,utRho20
1584,uvrA,8547872,8547872,8547742,130,272,utRho20
1585,uvrB,1626304,1627052,1626304,748,3510,utRho20
1586,uvrC,3989758,3989758,3989412,346,158,utRho20
1587,uvrD,7995814,7995966,7995814,152,368,utRho20
1588,uvrY,3990812,3990812,3990718,94,24,utRho20
1589,uxaB,3221474,3221474,3221360,114,0,utRho20
1590,uxaC,6489714,6489714,6489482,232,292,utRho20
1591,uxuA,9103036,9103272,9103036,236,1432,utRho20
1592,uxuR,9108916,9109152,9108916,236,24,utRho20
1593,valS,8967854,8967854,8967674,180,2114,utRho20
1594,valU,5041848,5041862,5041848,14,56,utRho20
1595,valV,3492830,3492870,3492830,40,0,utRho20
1596,ves,3649968,3649968,3649874,94,0,utRho20
1597,waaA,7616512,7617080,7616512,568,88,utRho20
1598,waaH,7580298,7580298,7580162,136,20,utRho20
1599,waaQ,7616476,7616476,7616196,280,72,utRho20
1600,waaU,7598996,7598996,7598624,372,0,utRho20
1601,waaY,7602272,7602272,7601930,342,3726,utRho20
1602,wbbH,4214888,4214888,4214452,436,3306,utRho20
1603,wbbK,4209212,4209212,4209018,194,176,utRho20
1604,wcaM,4231868,4231868,4231792,76,0,utRho20
1605,wrbA,2135516,2135516,2135416,100,0,utRho20
1606,wza,4275166,4275166,4274486,680,0,utRho20
1607,wzxC,4240674,4240674,4240316,358,0,utRho20
1608,wzzB,4196950,4196950,4196602,348,0,utRho20
1609,xanP,7657642,7657890,7657642,248,30,utRho20
1610,xanQ,6048520,6048702,6048520,182,0,utRho20
1611,xapA,5049820,5049820,5049756,64,0,utRho20
1612,xapR,10090252,10090252,10089908,344,0,utRho20
1613,xdhA,6000514,6000690,6000514,176,0,utRho20
1614,xerD,6079702,6079702,6079486,216,188,utRho20
1615,xseA,5268394,5268464,5268394,70,4,utRho20
1616,xseB,882746,882746,882686,60,184,utRho20
1617,xthA,3664798,3664856,3664798,58,0,utRho20
1618,xylA,7461614,7461614,7461530,84,1410,utRho20
1619,xylE,8484540,8484540,8484508,32,0,utRho20
1620,xylF,7462138,7462262,7462138,124,224,utRho20
1621,xylR,7469812,7469958,7469812,146,0,utRho20
1622,yaaA,13230,13230,12918,312,150,utRho20
1623,yaaI,23876,23876,23572,304,126,utRho20
1624,yaaJ,16034,16034,15918,116,46,utRho20
1625,yaaU,91184,91614,91184,430,88,utRho20
1626,yaaW,23084,23084,22712,372,20,utRho20
1627,yaaX,10060,10468,10060,408,398,utRho20
1628,yabI,142542,142702,142542,160,398,utRho20
1629,yacC,273880,273880,273834,46,494,utRho20
1630,yacH,262932,262932,262520,412,96,utRho20
1631,yacL,268678,268776,268678,98,48,utRho20
1632,yadD,293796,293936,293796,140,0,utRho20
1633,yadE,289930,290162,289930,232,346,utRho20
1634,yadN,314110,314110,313766,344,0,utRho20
1635,yadS,355572,355572,355248,324,60,utRho20
1636,yadV,312470,312470,312402,68,306,utRho20
1637,yaeF,434270,434270,434006,264,168,utRho20
1638,yaeP,428374,428374,428250,124,0,utRho20
1639,yaeQ,428176,428582,428176,406,144,utRho20
1640,yaeR,423716,423754,423716,38,0,utRho20
1641,yafC,462166,462166,461762,404,254,utRho20
1642,yafD,462128,462244,462128,116,386,utRho20
1643,yafK,491986,491986,491610,376,276,utRho20
1644,yafL,493282,493424,493282,142,36,utRho20
1645,yafN,503938,504010,503938,72,0,utRho20
1646,yafS,469568,469632,469568,64,1662,utRho20
1647,yafT,474470,474670,474470,200,0,utRho20
1648,yafV,480432,480432,480378,54,0,utRho20
1649,yafZ,536052,536052,536010,42,0,utRho20
1650,yagE,564446,564556,564446,110,54,utRho20
1651,yagG,570414,570790,570414,376,0,utRho20
1652,yagI,578384,578384,578324,60,74,utRho20
1653,yagK,586236,586236,585896,340,172,utRho20
1654,yagL,588062,588062,587836,226,74,utRho20
1655,yagN,591342,591342,591158,184,2904,utRho20
1656,yahA,663746,664742,663746,996,60,utRho20
1657,yahC,670136,670136,670044,92,0,utRho20
1658,yahE,671478,671850,671478,372,0,utRho20
1659,yahM,690504,690808,690504,304,54,utRho20
1660,yahN,692872,692872,692674,198,0,utRho20
1661,yahO,692864,692968,692864,104,178,utRho20
1662,yaiE,816296,816354,816296,58,94,utRho20
1663,yaiI,811396,811528,811396,132,0,utRho20
1664,yaiO,761946,761946,761684,262,0,utRho20
1665,yaiP,767970,767970,767870,100,0,utRho20
1666,yaiS,769660,769660,769232,428,0,utRho20
1667,yaiV,788922,788922,788922,0,0,utRho20
1668,yaiY,799094,799094,798666,428,0,utRho20
1669,yaiZ,798888,799186,798888,298,24,utRho20
1670,yajC,854410,854574,854410,164,668,utRho20
1671,yajD,860938,861210,860938,272,384,utRho20
1672,yajI,866068,866068,865702,366,708,utRho20
1673,yajL,887496,887496,887282,214,716,utRho20
1674,yajQ,889316,889366,889316,50,0,utRho20
1675,yajR,893374,893374,893332,42,0,utRho20
1676,ybaB,987418,988152,987418,734,4228,utRho20
1677,ybaL,1006590,1006590,1006476,114,58,utRho20
1678,ybaM,980648,980648,980542,106,374,utRho20
1679,ybaN,981436,981764,981436,328,808,utRho20
1680,ybaO,936704,936766,936704,62,0,utRho20
1681,ybaP,1016568,1016568,1016160,408,1146,utRho20
1682,ybaQ,1016348,1016436,1016348,88,0,utRho20
1683,ybaS,1023146,1023282,1023146,136,728,utRho20
1684,ybaV,927504,927874,927504,370,18,utRho20
1685,ybaY,950490,950758,950490,268,1826,utRho20
1686,ybbB,1062724,1062724,1062452,272,314,utRho20
1687,ybbJ,1030154,1030154,1029718,436,688,utRho20
1688,ybbL,1031784,1031838,1031784,54,0,utRho20
1689,ybbN,1037136,1037136,1036558,578,2014,utRho20
1690,ybbO,1038658,1038658,1038298,360,1958,utRho20
1691,ybbY,1080718,1081130,1080718,412,902,utRho20
1692,ybcH,1176140,1176140,1175962,178,26,utRho20
1693,ybcI,1113264,1113264,1113106,158,230,utRho20
1694,ybcJ,1114050,1114050,1113746,304,770,utRho20
1695,ybcK,1137502,1137804,1137502,302,44,utRho20
1696,ybcL,1141690,1141786,1141690,96,30,utRho20
1697,ybcN,1144628,1144932,1144628,304,0,utRho20
1698,ybcQ,1147548,1147912,1147548,364,0,utRho20
1699,ybcW,1159610,1159760,1159610,150,0,utRho20
1700,ybdD,1263982,1264364,1263982,382,476,utRho20
1701,ybdF,1212106,1212106,1211772,334,108,utRho20
1702,ybdH,1267048,1267048,1266954,94,0,utRho20
1703,ybdJ,1212822,1212822,1212398,424,24,utRho20
1704,ybdK,1215122,1215122,1214766,356,4,utRho20
1705,ybdL,1267114,1267172,1267114,58,0,utRho20
1706,ybdM,1271110,1271110,1270752,358,4,utRho20
1707,ybdN,1273372,1273372,1273138,234,0,utRho20
1708,ybdR,1283844,1284176,1283844,332,1030,utRho20
1709,ybeD,1325412,1325412,1325284,128,258,utRho20
1710,ybeF,1323090,1323090,1322756,334,0,utRho20
1711,ybeL,1349986,1350036,1349986,50,922,utRho20
1712,ybeQ,1353412,1353412,1353094,318,40,utRho20
1713,ybeR,1353120,1353422,1353120,302,40,utRho20
1714,ybeT,1358832,1358832,1358812,20,0,utRho20
1715,ybeU,1358924,1359016,1358924,92,0,utRho20
1716,ybeZ,1386938,1386938,1386834,104,1782,utRho20
1717,ybfA,1458074,1458268,1458074,194,8,utRho20
1718,ybfE,1423878,1423878,1423796,82,50,utRho20
1719,ybfF,1425692,1425692,1425604,88,252,utRho20
1720,ybfH,1433282,1433282,1433194,88,0,utRho20
1721,ybgA,1477840,1478002,1477840,162,0,utRho20
1722,ybgC,1549288,1549504,1549288,216,0,utRho20
1723,ybgD,1505916,1505916,1505590,326,4,utRho20
1724,ybgI,1485238,1485654,1485238,416,64,utRho20
1725,ybgO,1498370,1498370,1497964,406,0,utRho20
1726,ybgS,1570992,1570992,1570634,358,2202,utRho20
1727,ybhA,1597184,1597184,1596862,322,0,utRho20
1728,ybhB,1616070,1616070,1615818,252,0,utRho20
1729,ybhC,1614642,1614642,1614562,80,4086,utRho20
1730,ybhD,1601418,1601418,1601276,142,0,utRho20
1731,ybhH,1601104,1601518,1601104,414,0,utRho20
1732,ybhK,1633384,1633384,1633294,90,0,utRho20
1733,ybhM,1641556,1641586,1641556,30,4,utRho20
1734,ybhN,1645296,1645296,1644996,300,578,utRho20
1735,ybhQ,1649202,1649260,1649202,58,0,utRho20
1736,ybiA,1665920,1665920,1665900,20,60,utRho20
1737,ybiI,1676968,1676968,1676912,56,66,utRho20
1738,ybiO,1691328,1691328,1690960,368,84,utRho20
1739,ybiP,1705252,1705252,1705194,58,66,utRho20
1740,ybiS,1711572,1711572,1711488,84,598,utRho20
1741,ybiT,1711894,1711926,1711894,32,0,utRho20
1742,ybiU,1718212,1718212,1718122,90,0,utRho20
1743,ybiV,1720176,1720176,1720056,120,0,utRho20
1744,ybiW,1725566,1725566,1725212,354,1228,utRho20
1745,ybiX,1678548,1678548,1678414,134,294,utRho20
1746,ybjC,1781784,1781826,1781784,42,0,utRho20
1747,ybjE,1830154,1830154,1829714,440,464,utRho20
1748,ybjG,1767016,1767016,1766776,240,2598,utRho20
1749,ybjL,1779882,1779882,1779638,244,116,utRho20
1750,ybjM,1779770,1780178,1779770,408,60,utRho20
1751,ybjO,1795704,1795978,1795704,274,0,utRho20
1752,ybjP,1809046,1809046,1808934,112,12,utRho20
1753,ybjQ,1809034,1809186,1809034,152,398,utRho20
1754,ybjS,1813796,1813796,1813506,290,328,utRho20
1755,ybjX,1838206,1838206,1838168,38,122,utRho20
1756,ycaD,1891438,1891742,1891438,304,118,utRho20
1757,ycaI,1928210,1928640,1928210,430,112,utRho20
1758,ycaK,1899094,1899336,1899094,242,0,utRho20
1759,ycaL,1920264,1920528,1920264,264,48,utRho20
1760,ycaM,1894240,1894458,1894240,218,0,utRho20
1761,ycaR,1941284,1941346,1941284,62,822,utRho20
1762,ycbB,1961862,1962094,1961862,232,216,utRho20
1763,ycbJ,1943344,1943504,1943344,160,0,utRho20
1764,ycbK,1966046,1966150,1966046,104,932,utRho20
1765,ycbZ,2036920,2036920,2036598,322,48,utRho20
1766,yccA,2062886,2062886,2062836,50,42,utRho20
1767,yccF,2048730,2048730,2048696,34,0,utRho20
1768,yccS,2047988,2047988,2047766,222,0,utRho20
1769,yccT,2055674,2055674,2055546,128,162,utRho20
1770,yccX,2059960,2060128,2059960,168,126,utRho20
1771,ycdT,2185682,2185752,2185682,70,0,utRho20
1772,ycdU,2191266,2191686,2191266,420,94,utRho20
1773,ycdZ,2200504,2200592,2200504,88,302,utRho20
1774,yceA,2233544,2233614,2233544,70,178,utRho20
1775,yceD,2293298,2293588,2293298,290,4308,utRho20
1776,yceF,2293522,2293522,2293190,332,2486,utRho20
1777,yceH,2252154,2252314,2252154,160,6480,utRho20
1778,yceI,2237282,2237282,2236952,330,1250,utRho20
1779,yceJ,2238142,2238142,2238092,50,0,utRho20
1780,yceM,2253208,2253612,2253208,404,642,utRho20
1781,yceO,2239264,2239264,2238894,370,576,utRho20
1782,yceQ,2288760,2289004,2288760,244,7928,utRho20
1783,ycfD,2376540,2376540,2376480,60,384,utRho20
1784,ycfJ,2334814,2335198,2334814,384,80,utRho20
1785,ycfS,2340834,2340834,2340748,86,0,utRho20
1786,ycfT,2350658,2350658,2350330,328,16,utRho20
1787,ycfZ,2362760,2362760,2362534,226,0,utRho20
1788,ycgB,2474570,2474570,2474482,88,0,utRho20
1789,ycgG,2434614,2434656,2434614,42,456,utRho20
1790,ycgJ,2452956,2453200,2452956,244,0,utRho20
1791,ycgL,2455218,2455362,2455218,144,54,utRho20
1792,ycgN,2457366,2457660,2457366,294,230,utRho20
1793,ycgR,2489112,2489112,2489054,58,0,utRho20
1794,ycgV,2512222,2512222,2511904,318,0,utRho20
1795,ycgX,2426568,2426568,2426214,354,782,utRho20
1796,ycgY,2490166,2490320,2490166,154,0,utRho20
1797,ycgZ,2431504,2431578,2431504,74,0,utRho20
1798,ychE,2596904,2597196,2596904,292,0,utRho20
1799,ychF,2515764,2515764,2515624,140,0,utRho20
1800,ychH,2517476,2517582,2517476,106,62,utRho20
1801,ychJ,2578354,2578354,2578264,90,0,utRho20
1802,ychN,2547310,2547310,2547198,112,0,utRho20
1803,ychO,2547520,2547850,2547520,330,428,utRho20
1804,ychQ,2533798,2533848,2533798,50,0,utRho20
1805,yciA,2624828,2624828,2624492,336,106,utRho20
1806,yciB,2626110,2626110,2625780,330,3274,utRho20
1807,yciC,2627396,2627396,2627326,70,0,utRho20
1808,yciE,2630794,2630794,2630448,346,1254,utRho20
1809,yciG,5264368,5264368,5264140,228,0,utRho20
1810,yciI,2621784,2621784,2621730,54,32,utRho20
1811,yciN,2661606,2661606,2661336,270,262,utRho20
1812,yciS,2680270,2680486,2680270,216,24,utRho20
1813,yciT,2689088,2689088,2688692,396,192,utRho20
1814,yciU,2614718,2614718,2614300,418,922,utRho20
1815,yciV,2646376,2646440,2646376,64,0,utRho20
1816,yciW,2700472,2700472,2700214,258,98,utRho20
1817,yciZ,2689276,2689276,2689218,58,4,utRho20
1818,ycjD,2703792,2703792,2703520,272,0,utRho20
1819,ycjG,2777748,2777860,2777748,112,0,utRho20
1820,ycjM,2740006,2740432,2740006,426,132,utRho20
1821,ycjW,2767982,2767982,2767922,60,52,utRho20
1822,ycjX,2768138,2768234,2768138,96,190,utRho20
1823,ycjY,5568288,5568288,5567460,828,628,utRho20
1824,ydaE,2836438,2836438,2836016,422,0,utRho20
1825,ydaN,2816048,2816100,2816048,52,0,utRho20
1826,ydaS,2840340,2840730,2840340,390,74,utRho20
1827,ydbC,2948376,2948442,2948376,66,70,utRho20
1828,ydbD,2950132,2950288,2950132,156,0,utRho20
1829,ydbH,2885800,2886102,2885800,302,350,utRho20
1830,ydbJ,2881712,2882116,2881712,404,4,utRho20
1831,ydbK,2881692,2881692,2881568,124,14,utRho20
1832,ydcA,2983294,2983354,2983294,60,0,utRho20
1833,ydcF,2974404,2974470,2974404,66,68,utRho20
1834,ydcI,2990268,2990268,2990142,126,0,utRho20
1835,ydcJ,2990266,2990576,2990266,310,0,utRho20
1836,ydcK,3001280,3001280,3000898,382,0,utRho20
1837,ydcL,3004646,3004914,3004646,268,20,utRho20
1838,ydcN,3012308,3012344,3012308,36,0,utRho20
1839,ydcP,3013508,3013562,3013508,54,58,utRho20
1840,ydcR,3019956,3020006,3019956,50,52,utRho20
1841,ydcS,3022906,3023308,3022906,402,50,utRho20
1842,ydcX,3034442,3034778,3034442,336,480,utRho20
1843,ydcY,3035220,3035296,3035220,76,82,utRho20
1844,ydcZ,3036750,3036750,3036662,88,38,utRho20
1845,yddB,3155332,3155332,3155238,94,206,utRho20
1846,yddE,3071738,3071738,3071716,22,6,utRho20
1847,yddG,3094410,3094410,3094338,72,0,utRho20
1848,yddJ,3089732,3089732,3089438,294,0,utRho20
1849,yddW,3137704,3137704,3137646,58,50,utRho20
1850,ydeA,3233910,3234056,3233910,146,74,utRho20
1851,ydeE,3242528,3242664,3242528,136,0,utRho20
1852,ydeI,3249118,3249118,3248994,124,100,utRho20
1853,ydeJ,3249376,3249546,3249376,170,0,utRho20
1854,ydeN,3165458,3165458,3165048,410,0,utRho20
1855,ydeP,3173328,3173328,3172972,356,0,utRho20
1856,ydeR,3176596,3176596,3176592,4,0,utRho20
1857,ydfA,3296872,3297016,3296872,144,46,utRho20
1858,ydfG,3254982,3255034,3254982,52,120,utRho20
1859,ydfH,3256652,3256704,3256652,52,296,utRho20
1860,ydfK,3265446,3266144,3265446,698,142,utRho20
1861,ydgA,3379588,3379704,3379588,116,180,utRho20
1862,ydgC,3364124,3364124,3364060,64,0,utRho20
1863,ydgD,3343906,3343920,3343906,14,2,utRho20
1864,ydgH,3356754,3356854,3356754,100,28,utRho20
1865,ydgJ,3408798,3408798,3408616,182,0,utRho20
1866,ydgK,3410414,3410500,3410414,86,88,utRho20
1867,ydhB,3479618,3479618,3479596,22,0,utRho20
1868,ydhC,3479698,3479822,3479698,124,0,utRho20
1869,ydhF,3451310,3451310,3451264,46,120,utRho20
1870,ydhI,3441996,3442050,3441996,54,0,utRho20
1871,ydhL,3451864,3451864,3451840,24,0,utRho20
1872,ydhQ,3492404,3492404,3492254,150,104,utRho20
1873,ydhS,3494136,3494262,3494136,126,8,utRho20
1874,ydhT,3499138,3499138,3499118,20,0,utRho20
1875,ydhY,3509284,3509284,3508954,330,0,utRho20
1876,ydhZ,3510418,3510418,3510282,136,0,utRho20
1877,ydiE,3579206,3579226,3579206,20,0,utRho20
1878,ydiH,3530582,3530582,3530406,176,0,utRho20
1879,ydiM,3541852,3542142,3541852,290,0,utRho20
1880,ydiN,3544818,3545024,3544818,206,0,utRho20
1881,ydiP,3558656,3558656,3558602,54,0,utRho20
1882,ydiU,3582508,3582508,3582488,20,0,utRho20
1883,ydiV,3584174,3584174,3584040,134,266,utRho20
1884,ydiY,3612500,3612500,3612166,334,0,utRho20
1885,ydjA,3697400,3697400,3697352,48,66,utRho20
1886,ydjE,3708082,3708082,3707958,124,0,utRho20
1887,ydjF,3709848,3709848,3709708,140,0,utRho20
1888,ydjM,3620340,3620422,3620340,82,0,utRho20
1889,ydjO,3626696,3626696,3626288,408,0,utRho20
1890,ydjX,3666434,3666802,3666434,368,816,utRho20
1891,yeaE,3731448,3731448,3731272,176,0,utRho20
1892,yeaG,3733530,3733816,3733530,286,216,utRho20
1893,yeaI,3740486,3740770,3740486,284,0,utRho20
1894,yeaJ,3743874,3744082,3743874,208,8,utRho20
1895,yeaL,3748646,3748704,3748646,58,158,utRho20
1896,yeaM,3751296,3751296,3751152,144,0,utRho20
1897,yeaN,3750926,3751346,3750926,420,224,utRho20
1898,yeaO,3753554,3753818,3753554,264,58,utRho20
1899,yeaP,3755314,3755430,3755314,116,882,utRho20
1900,yeaQ,3758780,3758780,3758510,270,88,utRho20
1901,yeaR,3759988,3759988,3759896,92,4,utRho20
1902,yeaY,3781122,3781122,3781064,58,48,utRho20
1903,yebB,3892220,3892502,3892220,282,0,utRho20
1904,yebC,3896370,3896370,3896302,68,74,utRho20
1905,yebE,3859464,3859464,3859414,50,4,utRho20
1906,yebG,3861530,3861530,3861494,36,0,utRho20
1907,yebK,3873180,3873304,3873180,124,70,utRho20
1908,yebQ,3820314,3820552,3820314,238,32,utRho20
1909,yebS,3832238,3832516,3832238,278,12,utRho20
1910,yebV,3843430,3843560,3843430,130,36,utRho20
1911,yebW,3843914,3844242,3843914,328,18126,utRho20
1912,yecC,3995646,3995646,3995628,18,0,utRho20
1913,yecD,3901272,3901664,3901272,392,138,utRho20
1914,yecF,3991434,3991636,3991434,202,2,utRho20
1915,yecH,3979304,3979304,3978980,324,4,utRho20
1916,yecJ,3975604,3975604,3975516,88,0,utRho20
1917,yecM,3919968,3919968,3919692,276,0,utRho20
1918,yecR,3976400,3976444,3976400,44,0,utRho20
1919,yecT,3923862,3923944,3923862,82,0,utRho20
1920,yedD,4016522,4016522,4016180,342,0,utRho20
1921,yedE,4016310,4016554,4016310,244,0,utRho20
1922,yedI,4058922,4058922,4058732,190,0,utRho20
1923,yedJ,4066446,4066446,4066158,288,150,utRho20
1924,yedV,4076404,4076404,4076304,100,8,utRho20
1925,yedX,4077680,4077912,4077680,232,0,utRho20
1926,yedY,4078572,4078956,4078572,384,552,utRho20
1927,yeeA,4161322,4161322,4161182,140,2,utRho20
1928,yeeE,4171104,4171104,4171050,54,0,utRho20
1929,yeeJ,4089526,4089822,4089526,296,0,utRho20
1930,yeeN,4113508,4113716,4113508,208,114,utRho20
1931,yeeO,4119444,4119444,4119692,248,0,utRho20
1932,yeeX,4158834,4158834,4158722,112,774,utRho20
1933,yeeZ,4178422,4178422,4178256,166,234,utRho20
1934,yefM,4179466,4179466,4179426,40,64,utRho20
1935,yegD,4295288,4295348,4295288,60,46,utRho20
1936,yegH,4275726,4275804,4275726,78,0,utRho20
1937,yegI,4302154,4302154,4301970,184,0,utRho20
1938,yegJ,4302032,4302370,4302032,338,0,utRho20
1939,yegQ,4331182,4331336,4331182,154,578,utRho20
1940,yegR,4336698,4336698,4336612,86,2,utRho20
1941,yegS,4337086,4337424,4337086,338,0,utRho20
1942,yegT,4357562,4357642,4357562,80,0,utRho20
1943,yegX,4367640,4367640,4367302,338,146,utRho20
1944,yehA,4376944,4376944,4376828,116,18,utRho20
1945,yehE,4385818,4385818,4385592,226,52,utRho20
1946,yehK,4407568,4407944,4407568,376,0,utRho20
1947,yehL,4408804,4409192,4408804,388,0,utRho20
1948,yeiB,4486146,4486146,4485934,212,8,utRho20
1949,yeiE,4499422,4499422,4499236,186,0,utRho20
1950,yeiG,4487776,4487820,4487776,44,732,utRho20
1951,yeiH,4499332,4499434,4499332,102,164,utRho20
1952,yeiI,4503306,4503400,4503306,94,604,utRho20
1953,yeiL,4510580,4510710,4510580,130,34,utRho20
1954,yeiP,4530834,4530900,4530834,66,220,utRho20
1955,yeiQ,4532328,4532490,4532328,162,8,utRho20
1956,yeiR,4535484,4535658,4535484,174,76,utRho20
1957,yeiW,4530840,4530840,4530590,250,512,utRho20
1958,yejA,4544624,4544728,4544624,104,0,utRho20
1959,yejG,4556892,4556892,4556474,418,1828,utRho20
1960,yejH,4561244,4561264,4561244,20,14,utRho20
1961,yejK,4568218,4568218,4567894,324,112,utRho20
1962,yejO,4578352,4578352,4577800,552,308,utRho20
1963,yfaD,4713380,4713808,4713380,428,0,utRho20
1964,yfaE,4696676,4697028,4696676,352,1368,utRho20
1965,yfaL,4688568,4688568,4688338,230,0,utRho20
1966,yfaP,4656398,4656398,4656286,112,0,utRho20
1967,yfaU,4717892,4717892,4717690,202,0,utRho20
1968,yfaY,4727310,4727310,4727266,44,0,utRho20
1969,yfaZ,4728744,4728744,4728550,194,0,utRho20
1970,yfbK,4771810,4771810,4771444,366,4,utRho20
1971,yfbL,4771500,4771720,4771500,220,4,utRho20
1972,yfbN,4777174,4777174,4776852,322,0,utRho20
1973,yfbO,4776916,4777162,4776916,246,0,utRho20
1974,yfbP,4777990,4778232,4777990,242,264,utRho20
1975,yfbR,4817662,4817724,4817662,62,26,utRho20
1976,yfcI,4847424,4847424,4847078,346,14,utRho20
1977,yfcJ,4880482,4880482,4880240,242,106,utRho20
1978,yfcL,4888502,4888502,4888338,164,28,utRho20
1979,yfcV,4911642,4911642,4911292,350,68,utRho20
1980,yfcZ,4921958,4921958,4921868,90,28,utRho20
1981,yfdF,4925604,4926024,4925604,420,14,utRho20
1982,yfdG,4935474,4935710,4935474,236,0,utRho20
1983,yfdP,4946844,4947040,4946844,196,0,utRho20
1984,yfdX,4988866,4988866,4988804,62,0,utRho20
1985,yfdY,4990672,4990672,4990584,88,0,utRho20
1986,yfeA,5035784,5035784,5035664,120,13036,utRho20
1987,yfeC,5036668,5036934,5036668,266,44,utRho20
1988,yfeH,5053818,5053892,5053818,74,64,utRho20
1989,yfeK,5074630,5074684,5074630,54,0,utRho20
1990,yfeO,5018906,5019260,5018906,354,614,utRho20
1991,yfeR,5054078,5054078,5053712,366,184,utRho20
1992,yfeX,5101356,5101356,5101090,266,260,utRho20
1993,yfeY,5102486,5102486,5102432,54,2,utRho20
1994,yfeZ,5103842,5103842,5103452,390,440,utRho20
1995,yffO,5123804,5124222,5123804,418,0,utRho20
1996,yffQ,5126778,5127154,5126778,376,68,utRho20
1997,yffS,5128800,5128986,5128800,186,22,utRho20
1998,yfgC,5232052,5232188,5232052,136,0,utRho20
1999,yfgF,5258062,5258062,5257876,186,0,utRho20
2000,yfgG,5258170,5258580,5258170,410,44,utRho20
2001,yfgH,5259344,5259584,5259344,240,2,utRho20
2002,yfgM,5278866,5278866,5278566,300,416,utRho20
2003,yfhH,5397414,5397518,5397414,104,0,utRho20
2004,yfhM,5304648,5304648,5304574,74,0,utRho20
2005,yfhR,5328408,5328726,5328408,318,6,utRho20
2006,yfiC,5425610,5425610,5425528,82,2,utRho20
2007,yfiE,5430688,5430688,5430640,48,0,utRho20
2008,yfiL,5482630,5482720,5482630,90,0,utRho20
2009,yfiM,5448066,5448358,5448066,292,1088,utRho20
2010,yfiR,5483354,5483750,5483354,396,520,utRho20
2011,yfjH,5517326,5517326,5517200,126,0,utRho20
2012,yfjI,5517710,5517970,5517710,260,66,utRho20
2013,yfjJ,5521014,5521094,5521014,80,20,utRho20
2014,yfjM,5531970,5531970,5531552,418,736,utRho20
2015,yfjP,5535080,5535420,5535080,340,4,utRho20
2016,yfjW,5546570,5546636,5546570,66,0,utRho20
2017,yfjX,5551776,5551838,5551776,62,0,utRho20
2018,ygaC,5601180,5601180,5599988,1192,1400,utRho20
2019,ygaM,5600242,5600292,5600242,50,4,utRho20
2020,ygaU,5593628,5593628,5593572,56,228,utRho20
2021,ygaZ,5619190,5619234,5619190,44,2,utRho20
2022,ygbA,5713656,5713656,5713612,44,0,utRho20
2023,ygbE,5746784,5746784,5746674,110,166,utRho20
2024,ygbI,5722882,5722882,5722528,354,0,utRho20
2025,ygbK,5724394,5724670,5724394,276,3530,utRho20
2026,ygbL,5727074,5727186,5727074,112,402,utRho20
2027,ygbN,5729814,5730202,5729814,388,2192,utRho20
2028,ygcG,5811210,5811422,5811210,212,0,utRho20
2029,ygcN,5785144,5785314,5785144,170,0,utRho20
2030,ygcU,5799214,5799214,5798836,378,0,utRho20
2031,ygcW,5800942,5800942,5800546,396,0,utRho20
2032,ygdD,5883442,5883442,5883262,180,334,utRho20
2033,ygdG,5861746,5861930,5861746,184,218,utRho20
2034,ygdI,5886526,5886526,5886290,236,144,utRho20
2035,ygdQ,5940784,5940840,5940784,56,8,utRho20
2036,ygdR,5942494,5942542,5942494,48,92,utRho20
2037,ygeA,5961606,5961606,5961270,336,0,utRho20
2038,ygeH,5983758,5984188,5983758,430,0,utRho20
2039,ygeI,5987162,5987276,5987162,114,4,utRho20
2040,ygeR,6000078,6000078,5999782,296,0,utRho20
2041,ygeV,6011694,6011694,6011572,122,4,utRho20
2042,ygeW,6012234,6012524,6012234,290,0,utRho20
2043,ygfB,6110946,6110946,6110888,58,34,utRho20
2044,ygfK,6031984,6032120,6031984,136,0,utRho20
2045,ygfS,6058328,6058328,6058024,304,166,utRho20
2046,ygfZ,6082564,6082626,6082564,62,30,utRho20
2047,yggC,6149512,6149512,6149378,134,228,utRho20
2048,yggE,6136370,6136370,6136160,210,380,utRho20
2049,yggI,6179176,6179510,6179176,334,136,utRho20
2050,yggL,6204508,6204508,6204266,242,222,utRho20
2051,yggM,6199514,6199514,6199130,384,80,utRho20
2052,yggN,6203596,6203596,6203246,350,4,utRho20
2053,yggX,18623958,18624558,18623958,600,2592,utRho20
2054,yghA,6298966,6299324,6298966,358,138,utRho20
2055,yghB,6307058,6307126,6307058,68,0,utRho20
2056,yghD,6222614,6222614,6222252,362,202,utRho20
2057,yghF,6225798,6225798,6225840,42,0,utRho20
2058,yghJ,6238640,6238640,6238224,416,204,utRho20
2059,yghQ,6265186,6265186,6264816,370,0,utRho20
2060,yghT,6267830,6268262,6267830,432,0,utRho20
2061,yghU,6277400,6277454,6277400,54,58,utRho20
2062,yghW,6293506,6293506,6293474,32,114,utRho20
2063,yghZ,6295562,6295794,6295562,232,8,utRho20
2064,ygiD,6365122,6365122,6364868,254,1480,utRho20
2065,ygiH,6409066,6409388,6409066,322,2,utRho20
2066,ygiL,6370622,6370828,6370622,206,0,utRho20
2067,ygiM,6402084,6402414,6402084,330,552,utRho20
2068,ygiN,6346156,6346284,6346156,128,6860,utRho20
2069,ygiQ,6322620,6322620,6322292,328,76,utRho20
2070,ygiS,6335462,6335462,6335436,26,44,utRho20
2071,ygiV,6338582,6338582,6338462,120,1030,utRho20
2072,ygiW,6339774,6339774,6339352,422,0,utRho20
2073,ygiZ,6344506,6344506,6344422,84,0,utRho20
2074,ygjH,6442528,6442528,6442494,34,0,utRho20
2075,ygjI,6452140,6452468,6452140,328,0,utRho20
2076,ygjQ,6472730,6473080,6472730,350,52,utRho20
2077,ygjR,6474564,6474586,6474564,22,2,utRho20
2078,ygjV,6483638,6483638,6483488,150,0,utRho20
2079,yhaB,6535632,6535708,6535632,76,0,utRho20
2080,yhaH,6504498,6504608,6504498,110,0,utRho20
2081,yhaI,6505400,6505822,6505400,422,28,utRho20
2082,yhaJ,6508560,6508560,6508428,132,60,utRho20
2083,yhaK,6508538,6508638,6508538,100,0,utRho20
2084,yhbQ,6599878,6599932,6599878,54,2,utRho20
2085,yhbT,6602736,6602736,6602552,184,120,utRho20
2086,yhbU,6602558,6602970,6602558,412,120,utRho20
2087,yhbX,6643302,6643302,6643226,76,48,utRho20
2088,yhbY,6655518,6655580,6655518,62,452,utRho20
2089,yhcA,6723956,6724224,6723956,268,0,utRho20
2090,yhcB,6760364,6760382,6760364,18,340,utRho20
2091,yhcC,6708470,6708470,6708100,370,6,utRho20
2092,yhcF,6733440,6733852,6733440,412,224,utRho20
2093,yhcH,6739124,6739124,6738956,168,32,utRho20
2094,yhcM,6760312,6760312,6759994,318,334,utRho20
2095,yhcN,6770812,6771076,6770812,264,0,utRho20
2096,yhcO,6772606,6772606,6772258,348,2,utRho20
2097,yhdH,6806560,6806968,6806560,408,328,utRho20
2098,yhdJ,6823234,6823306,6823234,72,0,utRho20
2099,yhdN,6879092,6879092,6879018,74,88,utRho20
2100,yhdT,6814702,6814750,6814702,48,82,utRho20
2101,yhdU,6824994,6825242,6824994,248,260,utRho20
2102,yhdV,6836392,6836780,6836392,388,0,utRho20
2103,yhdW,6837944,6838298,6837944,354,0,utRho20
2104,yheO,6953082,6953082,6952880,202,1392,utRho20
2105,yheV,6957970,6957970,6957584,386,360,utRho20
2106,yhfA,6971902,6971902,6971636,266,0,utRho20
2107,yhfG,6983294,6983294,6983240,54,76,utRho20
2108,yhfL,6998622,6998896,6998622,274,0,utRho20
2109,yhfY,7023244,7023244,7022844,400,84,utRho20
2110,yhgA,7086294,7086334,7086294,40,0,utRho20
2111,yhgE,7065176,7065176,7064878,298,58,utRho20
2112,yhgF,7074352,7074770,7074352,418,4276,utRho20
2113,yhhA,7173458,7173886,7173458,428,0,utRho20
2114,yhhI,7248346,7248756,7248346,410,0,utRho20
2115,yhhJ,7253696,7253696,7253606,90,246,utRho20
2116,yhhM,7211588,7211588,7211220,368,4,utRho20
2117,yhhN,7211150,7211502,7211150,352,2,utRho20
2118,yhhQ,7218238,7218434,7218238,196,284,utRho20
2119,yhhT,7223682,7223730,7223682,48,0,utRho20
2120,yhhX,7162032,7162032,7161610,422,0,utRho20
2121,yhhY,7162222,7162276,7162222,54,0,utRho20
2122,yhhZ,7163516,7163726,7163516,210,4,utRho20
2123,yhiD,7312220,7312220,7311804,416,179118,utRho20
2124,yhiJ,7265190,7265190,7265180,10,0,utRho20
2125,yhiM,7269270,7269682,7269270,412,8,utRho20
2126,yhiN,7275000,7275000,7274820,180,466,utRho20
2127,yhjA,7338522,7338522,7338376,146,4,utRho20
2128,yhjB,7344090,7344090,7343788,302,0,utRho20
2129,yhjC,7344272,7344684,7344272,412,0,utRho20
2130,yhjD,7346660,7346724,7346660,64,74,utRho20
2131,yhjE,7349274,7349572,7349274,298,54,utRho20
2132,yhjG,7356824,7356824,7356730,94,0,utRho20
2133,yhjH,7358458,7358458,7358374,84,0,utRho20
2134,yhjJ,7364032,7364032,7363880,152,36,utRho20
2135,yhjK,7371296,7371296,7371158,138,0,utRho20
2136,yhjR,7392750,7392750,7392370,380,72,utRho20
2137,yhjV,7400796,7401126,7400796,330,0,utRho20
2138,yhjX,7424194,7424194,7424014,180,0,utRho20
2139,yhjY,7425966,7425966,7425868,98,234,utRho20
2140,yiaB,7455654,7455654,7455496,158,0,utRho20
2141,yiaD,7432712,7433094,7432712,382,0,utRho20
2142,yiaF,7438194,7438194,7438088,106,0,utRho20
2143,yiaG,7438862,7438956,7438862,94,1806,utRho20
2144,yiaJ,7485236,7485236,7485064,172,0,utRho20
2145,yiaK,7485348,7485466,7485348,118,0,utRho20
2146,yiaT,7503924,7503924,7503736,188,0,utRho20
2147,yiaU,7503792,7503984,7503792,192,0,utRho20
2148,yiaY,7515856,7515856,7515654,202,0,utRho20
2149,yibF,7523950,7523950,7523910,40,0,utRho20
2150,yibG,7536128,7536354,7536128,226,0,utRho20
2151,yibL,7553194,7553330,7553194,136,544,utRho20
2152,yibN,7570112,7570112,7570030,82,204,utRho20
2153,yibT,7552848,7552848,7552760,88,594,utRho20
2154,yicC,7633290,7633352,7633290,62,0,utRho20
2155,yicH,7660862,7660914,7660862,52,120,utRho20
2156,yicJ,7673328,7673328,7671858,1470,404,utRho20
2157,yicN,7685018,7685018,7684804,214,0,utRho20
2158,yicO,7687914,7687914,7687578,336,0,utRho20
2159,yicR,15250308,15250308,15250236,72,0,utRho20
2160,yidB,7755230,7755230,7754930,300,2,utRho20
2161,yidE,7732780,7732780,7732546,234,2,utRho20
2162,yidF,7711580,7711580,7711222,358,30,utRho20
2163,yidQ,7735088,7735456,7735088,368,2628,utRho20
2164,yidR,7738824,7738824,7738618,206,0,utRho20
2165,yieE,7787658,7787738,7787658,80,4,utRho20
2166,yieH,7793314,7793548,7793314,234,0,utRho20
2167,yieK,7798928,7798928,7798786,142,0,utRho20
2168,yifB,7900350,7900350,7899998,352,32,utRho20
2169,yifL,7988984,7989044,7988984,60,40,utRho20
2170,yigF,8005750,8005750,8005598,152,120,utRho20
2171,yigI,8009448,8009448,8009394,54,0,utRho20
2172,yigM,8022100,8022152,8022100,52,0,utRho20
2173,yihA,8101970,8101970,8101458,512,0,utRho20
2174,yihD,8084098,8084138,8084098,40,0,utRho20
2175,yihF,8088110,8088398,8088110,288,2,utRho20
2176,yihG,8093304,8093304,8093204,100,0,utRho20
2177,yihI,8102616,8102694,8102616,78,0,utRho20
2178,yihL,8120506,8120894,8120506,388,0,utRho20
2179,yihN,8124332,8124494,8124332,162,4,utRho20
2180,yihO,8131942,8131942,8131532,410,0,utRho20
2181,yihQ,8138892,8138892,8138552,340,0,utRho20
2182,yihV,8147064,8147478,8147064,414,40,utRho20
2183,yihX,8151096,8151106,8151096,10,140,utRho20
2184,yiiE,8158192,8158582,8158192,390,0,utRho20
2185,yiiF,8159124,8159502,8159124,378,0,utRho20
2186,yiiG,8173762,8174004,8173762,242,0,utRho20
2187,yiiM,8205506,8205644,8205506,138,0,utRho20
2188,yiiQ,8224624,8224624,8224428,196,0,utRho20
2189,yiiS,8225738,8225934,8225738,196,28,utRho20
2190,yijE,8272178,8272216,8272178,38,164,utRho20
2191,yijF,8275728,8275728,8275314,414,94,utRho20
2192,yijO,8296858,8296858,8296634,224,0,utRho20
2193,yjaA,8426240,8426468,8426240,228,181160,utRho20
2194,yjaB,8428312,8428312,8428246,66,2,utRho20
2195,yjaG,8398746,8399008,8398746,262,2714,utRho20
2196,yjaH,8401022,8401132,8401022,110,844,utRho20
2197,yjaZ,8379506,8379572,8379506,66,0,utRho20
2198,yjbB,8455204,8455462,8455204,258,0,utRho20
2199,yjbE,16943432,16943624,16943432,192,0,utRho20
2200,yjbL,8520318,8520642,8520318,324,0,utRho20
2201,yjbQ,8540428,8540476,8540428,48,208,utRho20
2202,yjcB,8550328,8550328,8550082,246,356,utRho20
2203,yjcC,8550836,8550942,8550836,106,172,utRho20
2204,yjcD,8556628,8556958,8556628,330,6,utRho20
2205,yjcE,8559658,8559960,8559658,302,0,utRho20
2206,yjcF,8566212,8566212,8566150,62,0,utRho20
2207,yjcO,8594660,8594660,8594250,410,406,utRho20
2208,yjdA,8654128,8654270,8654128,142,0,utRho20
2209,yjdC,8726660,8726660,8726616,44,104,utRho20
2210,yjdK,8704780,8705168,8704780,388,464,utRho20
2211,yjdL,8713034,8713034,8712822,212,0,utRho20
2212,yjdM,8653672,8653672,8653468,204,1928,utRho20
2213,yjeF,8787354,8788132,8787354,778,14268,utRho20
2214,yjeI,8745522,8745618,8745522,96,130,utRho20
2215,yjeJ,8748806,8748806,8748468,338,52,utRho20
2216,yjeV,8785472,8785784,8785472,312,0,utRho20
2217,yjfP,8833512,8833904,8833512,392,0,utRho20
2218,yjfY,8849656,8849656,8849582,74,0,utRho20
2219,yjfZ,8855052,8855052,8854844,208,0,utRho20
2220,yjgA,8916162,8916162,8915730,432,176,utRho20
2221,yjgL,8950802,8950874,8950802,72,2,utRho20
2222,yjgM,8959342,8959342,8959074,268,0,utRho20
2223,yjgN,8959132,8959460,8959132,328,0,utRho20
2224,yjgR,8980170,8980170,8980126,44,324,utRho20
2225,yjgZ,9002116,9002520,9002116,404,142,utRho20
2226,yjhB,9007764,9008116,9007764,352,154,utRho20
2227,yjhG,9048452,9048452,9048188,264,2498,utRho20
2228,yjhU,9041080,9041080,9040648,432,542,utRho20
2229,yjiA,9178096,9178096,9177730,366,2266,utRho20
2230,yjiJ,9125364,9125364,9125350,14,0,utRho20
2231,yjiK,9127270,9127270,9127422,152,256,utRho20
2232,yjiL,9129604,9129604,9129378,226,70,utRho20
2233,yjiS,9143410,9143502,9143410,92,0,utRho20
2234,yjiY,9182734,9182734,9182558,176,0,utRho20
2235,yjjA,9200674,9200674,9200378,296,404,utRho20
2236,yjjB,18408708,18408708,18407800,908,0,utRho20
2237,yjjJ,9243314,9243538,9243314,224,166,utRho20
2238,yjjK,9261132,9261132,9261044,88,0,utRho20
2239,yjjL,9189764,9189764,9189444,320,62,utRho20
2240,yjjM,9191894,9191894,9191702,192,0,utRho20
2241,yjjP,9206068,9206068,9205716,352,4,utRho20
2242,yjjQ,9206638,9206954,9206638,316,4,utRho20
2243,yjjX,9267798,9267798,9267490,308,910,utRho20
2244,yjjY,9280716,9280804,9280716,88,1624,utRho20
2245,yjjZ,9211554,9211608,9211554,54,92,utRho20
2246,yjtD,9281676,9281884,9281676,208,56,utRho20
2247,ykfB,532454,532454,532174,280,144,utRho20
2248,ykfI,527636,527636,527338,298,192,utRho20
2249,ykgB,637050,637050,636638,412,0,utRho20
2250,ykgC,640430,640430,640002,428,4,utRho20
2251,ykgD,640232,640454,640232,222,4,utRho20
2252,ykgE,642962,643216,642962,254,264,utRho20
2253,ykgJ,608524,608524,608364,160,940,utRho20
2254,ykgL,623878,624224,623878,346,68,utRho20
2255,ykgM,625610,625610,625554,56,0,utRho20
2256,ykgR,626570,626570,626484,86,0,utRho20
2257,ylaC,958576,958576,958502,74,946,utRho20
2258,yliE,1745938,1745958,1745938,20,18,utRho20
2259,ymcE,2103660,2103694,2103660,34,0,utRho20
2260,ymdA,2210450,2210828,2210450,378,0,utRho20
2261,ymdB,2211428,2211640,2211428,212,0,utRho20
2262,ymfD,2395322,2395322,2395064,258,586,utRho20
2263,ymfI,2402880,2402994,2402880,114,0,utRho20
2264,ymfJ,2404518,2404518,2404168,350,222,utRho20
2265,ymfK,2406176,2406176,2405866,310,0,utRho20
2266,ymfT,2405766,2406048,2405766,282,68,utRho20
2267,ymgE,2489110,2489456,2489110,346,146,utRho20
2268,ymgF,2437628,2437966,2437628,338,0,utRho20
2269,ymiA,2670112,2670320,2670112,208,0,utRho20
2270,ymjA,2715620,2715620,2715336,284,434,utRho20
2271,ynaI,2791946,2791946,2791844,102,26,utRho20
2272,ynaK,2850438,2850754,2850438,316,260,utRho20
2273,ynbA,2954924,2955242,2954924,318,0,utRho20
2274,yncD,3046552,3046552,3046130,422,142,utRho20
2275,yncE,3046454,3046614,3046454,160,0,utRho20
2276,yncG,3052456,3052494,3052456,38,66,utRho20
2277,yncL,3034492,3034492,3034388,104,360,utRho20
2278,yneE,3218364,3218364,3218044,320,0,utRho20
2279,yneF,3223748,3223748,3223708,40,0,utRho20
2280,yneJ,3229560,3229608,3229560,48,0,utRho20
2281,yneK,3231100,3231526,3231100,426,0,utRho20
2282,yneM,3245176,3245292,3245176,116,0,utRho20
2283,ynfA,3311398,3311398,3311346,52,0,utRho20
2284,ynfB,3311418,3311616,3311418,198,194,utRho20
2285,ynfC,3315094,3315094,3314914,180,124,utRho20
2286,ynfD,3314828,3315130,3314828,302,154,utRho20
2287,ynfE,3316006,3316138,3316006,132,0,utRho20
2288,ynfK,3334670,3334670,3334438,232,64,utRho20
2289,ynfL,3339304,3339304,3339184,120,0,utRho20
2290,ynfM,3339260,3339398,3339260,138,0,utRho20
2291,ynfN,3276598,3276598,3276218,380,6,utRho20
2292,ynfO,3273454,3273512,3273454,58,0,utRho20
2293,ynhG,3517890,3517890,3517450,440,1742,utRho20
2294,yniA,3615158,3615592,3615158,434,318,utRho20
2295,yniB,3618526,3618526,3618466,60,0,utRho20
2296,yniC,3618652,3618760,3618652,108,0,utRho20
2297,yniD,3610202,3610330,3610202,128,0,utRho20
2298,ynjE,3678880,3678934,3678880,54,0,utRho20
2299,ynjF,3683222,3683222,3682806,416,88,utRho20
2300,ynjH,3684376,3684376,3684270,106,224,utRho20
2301,ynjI,3690022,3690022,3689742,280,20,utRho20
2302,yoaB,3786642,3786734,3786642,92,146,utRho20
2303,yoaC,3787932,3788146,3787932,214,136,utRho20
2304,yoaE,3803544,3803544,3803170,374,242,utRho20
2305,yoaF,3755444,3755444,3755064,380,882,utRho20
2306,yoaH,3789866,3789866,3789462,404,1046,utRho20
2307,yobB,3850418,3850880,3850418,462,2190,utRho20
2308,yobF,3815586,3815586,3815182,404,0,utRho20
2309,yobH,3817800,3817850,3817800,50,0,utRho20
2310,yodB,4084352,4084736,4084352,384,0,utRho20
2311,yodC,4057008,4057008,4056740,268,0,utRho20
2312,yohC,4451358,4451358,4451262,96,0,utRho20
2313,yohD,4451526,4451602,4451526,76,0,utRho20
2314,yohJ,4460986,4461248,4460986,262,4,utRho20
2315,yohO,4431172,4431314,4431172,142,268,utRho20
2316,yojI,4617282,4617282,4617230,52,0,utRho20
2317,ypdI,4988988,4989396,4988988,408,4,utRho20
2318,ypfG,5165786,5165786,5165554,232,52,utRho20
2319,ypfM,5182140,5182140,5181732,408,2412,utRho20
2320,yphB,5349590,5349590,5349376,214,192,utRho20
2321,ypjA,5565644,5565644,5565452,192,0,utRho20
2322,ypjB,5569636,5569636,5568858,778,0,utRho20
2323,ypjD,5495860,5495774,5495860,86,0,utRho20
2324,yqaE,5594170,5594170,5594056,114,250,utRho20
2325,yqcA,5846100,5846100,5845968,132,0,utRho20
2326,yqcE,5800944,5801184,5800944,240,0,utRho20
2327,yqeC,6030468,6030468,6030114,354,0,utRho20
2328,yqeF,5971618,5971618,5971184,434,68,utRho20
2329,yqeG,5971438,5971694,5971438,256,154,utRho20
2330,yqeH,5975016,5975072,5975016,56,0,utRho20
2331,yqeI,5976688,5977004,5976688,316,6,utRho20
2332,yqeK,5981140,5981140,5980720,420,0,utRho20
2333,yqfA,6086728,6086728,6086296,432,542,utRho20
2334,yqgA,6219042,6219106,6219042,64,0,utRho20
2335,yqgB,6172500,6172500,6172102,398,226,utRho20
2336,yqgE,6185768,6185874,6185768,106,218,utRho20
2337,yqhA,6299150,6299150,6298942,208,138,utRho20
2338,yqhC,6310768,6310768,6310436,332,744,utRho20
2339,yqhD,6310604,6310710,6310604,106,500,utRho20
2340,yqhH,6316842,6317254,6316842,412,208,utRho20
2341,yqiC,6369662,6369680,6369662,18,10,utRho20
2342,yqiJ,6384108,6384416,6384108,308,40,utRho20
2343,yqjA,6495096,6495546,6495096,450,1382,utRho20
2344,yqjF,6500932,6501124,6500932,192,840,utRho20
2345,yqjG,6501948,6502048,6501948,100,0,utRho20
2346,yqjH,6433078,6433078,6432982,96,0,utRho20
2347,yqjI,6433506,6433558,6433506,52,0,utRho20
2348,yraH,6574552,6574852,6574552,300,0,utRho20
2349,yraP,6592144,6592818,6592144,674,248,utRho20
2350,yraQ,6596414,6596414,6596276,138,0,utRho20
2351,yraR,6598024,6598024,6597692,332,390,utRho20
2352,yrbG,13360844,13361100,13360844,256,0,utRho20
2353,yrbL,6696842,6696904,6696842,62,32,utRho20
2354,yrbN,6616172,6616172,6615866,306,580,utRho20
2355,yrdB,6860176,6860176,6860046,130,0,utRho20
2356,yrfF,7052548,7052938,7052548,390,860,utRho20
2357,yrhB,7169440,7169518,7169440,78,4,utRho20
2358,ysaB,7451804,7451804,7451424,380,0,utRho20
2359,ysgA,8032686,8032686,8032338,348,286,utRho20
2360,ytfB,8857638,8857638,8857434,204,174,utRho20
2361,ytfE,8864018,8864018,8863966,52,0,utRho20
2362,ytfF,8866296,8866296,8866130,166,2,utRho20
2363,ytfH,8868164,8868226,8868164,62,0,utRho20
2364,ytfI,8875234,8875414,8875234,180,34,utRho20
2365,ytfJ,8878572,8878572,8878524,48,0,utRho20
2366,ytfK,8879022,8879174,8879022,152,744,utRho20
2367,ytfL,8882642,8882642,8882430,212,0,utRho20
2368,ytfQ,8899634,8899924,8899634,290,2342,utRho20
2369,ytjB,9249598,9249598,9249578,20,0,utRho20
2370,yzfA,8896588,8896588,8896490,98,58,utRho20
2371,zapA,6111102,6111224,6111102,122,3666,utRho20
2372,zapB,8236772,8237030,8236772,258,1028,utRho20
2373,zapC,2011700,2011904,2011700,204,4,utRho20
2374,zinT,4082692,4082750,4082692,58,76,utRho20
2375,zipA,5062814,5062814,5062466,348,0,utRho20
2376,zitB,1569716,1569716,1569646,70,8,utRho20
2377,zntA,7212844,7212902,7212844,58,186,utRho20
2378,zntR,6878336,6878336,6878260,76,0,utRho20
2379,znuA,3885322,3885322,3885166,156,0,utRho20
2380,znuC,3885268,3885324,3885268,56,0,utRho20
2381,zraP,8403424,8403424,8403376,48,0,utRho20
2382,zraS,8403810,8403852,8403810,42,0,utRho20
2383,zupT,6364866,6365100,6364866,234,1382,utRho20
2384,zur,8520282,8520282,8520006,276,404,utRho20
2385,zwf,3872752,3872752,3872628,124,318,utRho20
0,C0343,2818676,2818728,2818676,52,120,utRho21
1,aaeB,6776526,6776526,6776376,150,0,utRho21
2,aaeR,6778762,6779040,6778762,278,120,utRho21
3,aaeX,6778860,6778860,6778674,186,144,utRho21
4,aat,1854920,1854920,1854864,56,0,utRho21
5,accA,416822,417242,416822,420,1520,utRho21
6,accB,6810280,6810872,6810280,592,5168,utRho21
7,accD,4868030,4868030,4867852,178,606,utRho21
8,aceB,8430804,8430956,8430804,152,2,utRho21
9,aceE,245938,246034,245938,96,0,utRho21
10,ackA,4826918,4826940,4826918,22,340,utRho21
11,acnA,2670848,2671662,2670848,814,4990,utRho21
12,acnB,263038,263230,263038,192,1758,utRho21
13,acpP,2303148,2303230,2303148,82,344,utRho21
14,acpS,5402324,5402324,5401996,328,864,utRho21
15,acrA,971396,971396,971238,158,326,utRho21
16,acrB,969370,969370,968806,564,4284,utRho21
17,acrD,5174950,5175190,5174950,240,30,utRho21
18,acrE,6827404,6827728,6827404,324,0,utRho21
19,acrR,971398,971522,971398,124,202,utRho21
20,acrZ,1589502,1589546,1589502,44,20,utRho21
21,acs,8575190,8575190,8574742,448,224,utRho21
22,actP,8569870,8569870,8569804,66,146,utRho21
23,ada,4620854,4620854,4620810,44,0,utRho21
24,add,3404404,3404466,3404404,62,46,utRho21
25,ade,7687802,7687928,7687802,126,0,utRho21
26,adhE,2596826,2596826,2596242,584,244,utRho21
27,adhP,3107988,3107988,3107676,312,2810,utRho21
28,adiA,8681112,8681112,8681042,70,148,utRho21
29,adiC,8674404,8674404,8674062,342,0,utRho21
30,adiY,8676084,8676084,8675858,226,0,utRho21
31,adk,994278,994350,994278,72,24,utRho21
32,adrA,807374,807406,807374,32,0,utRho21
33,aer,6438240,6438240,6438152,88,134,utRho21
34,aes,1000102,1000102,999946,156,18,utRho21
35,agaR,6557406,6557406,6557330,76,0,utRho21
36,agaS,6563778,6563952,6563778,174,0,utRho21
37,agp,2131118,2131170,2131118,52,0,utRho21
38,agrA,7296126,7296126,7296126,0,0,utRho21
39,agrB,7296588,7296588,7296588,0,0,utRho21
40,ahpC,1277386,1277890,1277386,504,5004,utRho21
41,ahpF,1278004,1279506,1278004,1502,406848,utRho21
42,ahr,8992698,8992698,8992418,280,0,utRho21
43,aidB,8828494,8828550,8828494,56,0,utRho21
44,ais,4731512,4731512,4731240,272,0,utRho21
45,alaA,4814816,4815122,4814816,306,0,utRho21
46,alaC,4996798,4996798,4996590,208,0,utRho21
47,alaE,5598140,5598328,5598140,188,842,utRho21
48,alaS,5644180,5644180,5644022,158,2402,utRho21
49,alaW,5036612,5036612,5036462,150,142,utRho21
50,aldA,2976380,2976464,2976380,84,1046,utRho21
51,aldB,7513070,7513070,7513022,48,110,utRho21
52,alkA,4295118,4295118,4295080,38,154,utRho21
53,alkB,4618890,4618890,4618682,208,84,utRho21
54,allA,1064780,1064902,1064780,122,34,utRho21
55,allD,1092822,1092822,1092726,96,0,utRho21
56,allE,1088112,1088112,1088092,20,206,utRho21
57,allS,1064600,1064600,1064442,158,0,utRho21
58,alr,8531178,8531564,8531178,386,1234,utRho21
59,alsE,8617334,8617334,8616956,378,212,utRho21
60,alsK,8615990,8615990,8615598,392,6,utRho21
61,alx,6476740,6477160,6476740,420,24,utRho21
62,amiA,5104482,5104704,5104482,222,0,utRho21
63,amiC,5898378,5898378,5898020,358,0,utRho21
64,amn,4110062,4110122,4110062,60,48,utRho21
65,ampC,8758006,8758006,8757888,118,0,utRho21
66,ampD,237362,237466,237362,104,138,utRho21
67,ampG,907372,907372,907090,282,368,utRho21
68,ampH,792726,792726,792574,152,154,utRho21
69,amyA,4012230,4012312,4012230,82,24,utRho21
70,anmK,3439346,3439346,3439204,142,0,utRho21
71,ansB,6201580,6201580,6201456,124,2,utRho21
72,ansP,3052040,3052040,3051960,80,6,utRho21
73,apaG,104068,104068,103212,856,4802,utRho21
74,apaH,102586,102586,102444,142,3494,utRho21
75,apbE,4623188,4623188,4623068,120,142,utRho21
76,appA,2081198,2081234,2081198,36,20,utRho21
77,appC,2075420,2075480,2075420,60,0,utRho21
78,appY,1167134,1167362,1167134,228,0,utRho21
79,apt,982620,982824,982620,204,254,utRho21
80,aqpZ,1832424,1832424,1832094,330,2,utRho21
81,araB,140150,140150,140096,54,30,utRho21
82,araC,140482,140774,140482,292,2018,utRho21
83,araE,5964416,5964416,5964364,52,0,utRho21
84,araF,3972476,3972476,3972256,220,234,utRho21
85,araH,3967120,3967120,3967086,34,0,utRho21
86,araJ,825058,825058,824962,96,0,utRho21
87,arcA,9281602,9281602,9280612,990,19266,utRho21
88,arcB,6706098,6706098,6706050,48,4,utRho21
89,arcZ,6701154,6701154,6701154,0,0,utRho21
90,arfA,6877346,6877346,6877298,48,180,utRho21
91,argA,5898312,5898484,5898312,172,0,utRho21
92,argC,8309770,8310002,8309770,232,254,utRho21
93,argD,6980442,6980442,6980360,82,0,utRho21
94,argE,8310156,8310156,8309694,462,522,utRho21
95,argF,580680,580680,580610,70,0,utRho21
96,argG,6637124,6637274,6637124,150,324,utRho21
97,argI,8956688,8956688,8956622,66,0,utRho21
98,argO,6137672,6137672,6137616,56,90,utRho21
99,argP,6119460,6119506,6119460,46,0,utRho21
100,argR,6769204,6769406,6769204,202,0,utRho21
101,argS,3920002,3920124,3920002,122,0,utRho21
102,argT,4855698,4855698,4855582,116,44,utRho21
103,argU,1129406,1129446,1129406,40,0,utRho21
104,argW,4932616,4932618,4932616,2,12,utRho21
105,argX,7964728,7964750,7964728,22,134,utRho21
106,aroF,5482402,5482402,5482300,102,18,utRho21
107,aroG,1571182,1571266,1571182,84,62,utRho21
108,aroH,3576636,3576870,3576636,234,1156,utRho21
109,aroK,7038760,7038760,7038128,632,1098,utRho21
110,aroL,812560,812810,812560,250,12,utRho21
111,aroP,243342,243342,243102,240,0,utRho21
112,arpA,8445382,8445382,8444974,408,0,utRho21
113,arrS,7316108,7316108,7316108,0,0,utRho21
114,arsR,7297024,7297056,7297024,32,0,utRho21
115,artJ,1801252,1801252,1801150,102,0,utRho21
116,artP,1807686,1807686,1807468,218,1684,utRho21
117,ascF,5678858,5679048,5678858,190,0,utRho21
118,ascG,5678574,5678574,5678528,46,0,utRho21
119,aslB,7965562,7965916,7965562,354,204,utRho21
120,asnA,7854258,7854310,7854258,52,0,utRho21
121,asnB,1398444,1398444,1398354,90,0,utRho21
122,asnC,23562186,23562186,23562018,168,0,utRho21
123,asnS,1978088,1978088,1977970,118,10128,utRho21
124,asnT,4089082,4089098,4089082,16,926,utRho21
125,asnU,4119690,4119702,4119690,12,0,utRho21
126,asnV,4124504,4124520,4124504,16,22,utRho21
127,aspA,17473728,17473728,17473308,420,0,utRho21
128,aspC,1971486,1971486,1971418,68,116,utRho21
129,aspS,3901402,3901402,3901044,358,440,utRho21
130,aspT,7893560,7893744,7893560,184,124652,utRho21
131,aspV,473826,473862,473826,36,86,utRho21
132,asr,3342654,3342752,3342654,98,176,utRho21
133,astC,3664088,3664088,3663964,124,0,utRho21
134,astE,3654138,3654138,3653846,292,0,utRho21
135,atoD,4646824,4646894,4646824,70,36,utRho21
136,atpB,7844540,7844540,7844102,438,70,utRho21
137,atpC,7832118,7832118,7831944,174,852,utRho21
138,atpI,7845050,7845050,7844880,170,108,utRho21
139,avtA,7479348,7479410,7479348,62,440,utRho21
140,azoR,2965982,2965982,2965720,262,210,utRho21
141,azuC,3976002,3976002,3975918,84,0,utRho21
142,bacA,6408350,6408350,6408262,88,0,utRho21
143,bamA,394052,395856,394052,1804,1190,utRho21
144,bamB,5277950,5277950,5277304,646,1250,utRho21
145,bamC,5198028,5198028,5197730,298,2836,utRho21
146,bamD,5471922,5472292,5471922,370,1640,utRho21
147,bamE,5506972,5507210,5506972,238,466,utRho21
148,basS,8666954,8666954,8666544,410,898,utRho21
149,bax,7474468,7474468,7474354,114,224,utRho21
150,bcp,5200874,5200956,5200874,82,4866,utRho21
151,bcsB,7385346,7385346,7385214,132,0,utRho21
152,bcsE,7392644,7392916,7392644,272,0,utRho21
153,bdcA,8948128,8948128,8948106,22,0,utRho21
154,bdcR,8948192,8948248,8948192,56,0,utRho21
155,bdm,3112680,3112680,3112560,120,0,utRho21
156,betA,654522,654522,654494,28,696,utRho21
157,betI,658722,658722,658668,54,0,utRho21
158,betT,658842,658926,658842,84,0,utRho21
159,bfr,6933498,6933498,6933450,48,122,utRho21
160,bglG,23440182,23440182,23439402,780,0,utRho21
161,bglX,4444240,4444240,4443978,262,0,utRho21
162,bhsA,2337962,2338146,2337962,184,0,utRho21
163,bioA,1618584,1618584,1618514,70,0,utRho21
164,bioB,1618604,1618688,1618604,84,0,utRho21
165,bioH,7089716,7089716,7089688,28,0,utRho21
166,bisC,7433026,7433026,7432788,238,96,utRho21
167,blc,8755490,8755490,8755444,46,0,utRho21
168,blr,3409024,3409102,3409024,78,82,utRho21
169,bluF,2431226,2431226,2430950,276,0,utRho21
170,bluR,2428226,2428226,2428118,108,0,utRho21
171,bolA,908698,908944,908698,246,80,utRho21
172,borD,1157842,1157842,1157786,56,22,utRho21
173,brnQ,838976,839182,838976,206,652,utRho21
174,bssR,1756492,1756496,1756492,4,0,utRho21
175,bssS,2242116,2242116,2241910,206,0,utRho21
176,btuB,8326798,8327278,8326798,480,1502,utRho21
177,cadB,8720212,8720212,8720062,150,4,utRho21
178,cadC,8723926,8723926,8723868,58,0,utRho21
179,caiE,70998,70998,70742,256,2,utRho21
180,caiF,68436,68600,68436,164,4,utRho21
181,caiT,84074,84074,83862,212,0,utRho21
182,can,285406,285406,285340,66,56,utRho21
183,carA,59102,59302,59102,200,2,utRho21
184,carB,61550,61634,61550,84,600,utRho21
185,cas2,5757830,5757830,5757706,124,30,utRho21
186,casA,5768638,5768638,5768276,362,0,utRho21
187,cbl,4121882,4121882,4121828,54,0,utRho21
188,cbpA,2128074,2128074,2127550,524,104,utRho21
189,cbrA,7738628,7738754,7738628,126,0,utRho21
190,cbrB,7794958,7795012,7794958,54,212,utRho21
191,ccmH,4585242,4585242,4584820,422,0,utRho21
192,cdaR,364894,364926,364894,32,0,utRho21
193,cdd,4463638,4463688,4463638,50,148,utRho21
194,cdh,8219814,8219860,8219814,46,0,utRho21
195,cdsA,391110,391354,391110,244,230,utRho21
196,cedA,3627484,3627484,3627326,158,290,utRho21
197,cfa,3482402,3482826,3482402,424,496,utRho21
198,chaC,2544844,2544972,2544844,128,120,utRho21
199,chbB,3643452,3643452,3643238,214,0,utRho21
200,chbG,3634624,3634624,3634270,354,0,utRho21
201,cheW,3946924,3946924,3946678,246,64,utRho21
202,chiA,6939792,6939792,6939706,86,2,utRho21
203,chiP,1416472,1416668,1416472,196,12,utRho21
204,cho,3646984,3647030,3646984,46,20,utRho21
205,chpS,8896804,8896894,8896804,90,0,utRho21
206,cirA,4493884,4493884,4493538,346,0,utRho21
207,citC,1304078,1304078,1303712,366,2,utRho21
208,citT,1293264,1293264,1293160,104,0,utRho21
209,clcA,350104,350214,350104,110,490,utRho21
210,clpA,1846160,1846528,1846160,368,62,utRho21
211,clpB,5468410,5468410,5468346,64,672,utRho21
212,clpP,913154,913354,913154,200,386,utRho21
213,clpS,1845500,1845826,1845500,326,0,utRho21
214,clpX,914404,914852,914404,448,3442,utRho21
215,clsA,2617346,2617346,2617290,56,2,utRho21
216,clsC,2212584,2212710,2212584,126,672,utRho21
217,cmk,1922330,1922402,1922330,72,162,utRho21
218,cnu,3409522,3409898,3409522,376,546,utRho21
219,coaA,8350214,8350214,8350052,162,4,utRho21
220,cobC,1340092,1340092,1339814,278,558,utRho21
221,cobT,4129202,4129202,4128934,268,0,utRho21
222,cobU,4131944,4131944,4131528,416,4,utRho21
223,codB,709768,709844,709768,76,0,utRho21
224,comR,2337726,2337726,2337664,62,0,utRho21
225,copA,1022822,1022822,1022758,64,0,utRho21
226,corA,8002388,8002852,8002388,464,5626,utRho21
227,cpdB,8873258,8873258,8873130,128,872,utRho21
228,cptB,6082198,6082198,6082140,58,0,utRho21
229,cpxA,8210202,8210202,8209950,252,1504,utRho21
230,cpxP,8211570,8211640,8211570,70,252,utRho21
231,cpxR,8211372,8211372,8211340,32,174,utRho21
232,cra,175894,176056,175894,162,2,utRho21
233,crcB,1316016,1316016,1315876,140,0,utRho21
234,creA,9270486,9271042,9270486,556,834,utRho21
235,creD,9276320,9276356,9276320,36,0,utRho21
236,crl,515620,515658,515620,38,3698,utRho21
237,crp,6971906,6972240,6971906,334,3100,utRho21
238,crr,5070960,5071668,5070960,708,16382,utRho21
239,csdA,5886414,5886674,5886414,260,0,utRho21
240,csgB,2207718,2207902,2207718,184,0,utRho21
241,csgD,2206688,2206688,2206392,296,0,utRho21
242,csgG,2203510,2203510,2203368,142,116,utRho21
243,csiD,5577854,5577970,5577854,116,1730,utRho21
244,csiE,5330802,5330870,5330802,68,148,utRho21
245,csiR,5590942,5591348,5590942,406,192,utRho21
246,cspA,7439778,7440098,7439778,320,604,utRho21
247,cspB,3283430,3283430,3283108,322,0,utRho21
248,cspC,3815018,3815018,3814870,148,332,utRho21
249,cspD,1845352,1845352,1845180,172,25044,utRho21
250,cspE,1314294,1314584,1314294,290,12,utRho21
251,cspF,3283380,3283710,3283380,330,28,utRho21
252,cspG,2102610,2102922,2102610,312,202,utRho21
253,cspH,2102746,2102746,2102350,396,0,utRho21
254,cspI,3277624,3277624,3277334,290,0,utRho21
255,csrA,5638746,5638746,5638292,454,3324,utRho21
256,csrB,5849048,5849048,5849048,0,0,utRho21
257,csrC,8102072,8102072,8102072,0,0,utRho21
258,csrD,6806850,6806850,6806664,186,362,utRho21
259,cstA,1259710,1259788,1259710,78,0,utRho21
260,cueO,274090,274166,274090,76,0,utRho21
261,cueR,1027948,1027986,1027948,38,76,utRho21
262,curA,3037784,3038054,3037784,270,0,utRho21
263,cusC,1191146,1191200,1191146,54,0,utRho21
264,cusR,1190924,1190924,1190886,38,252,utRho21
265,cutA,8730784,8730784,8730712,72,74,utRho21
266,cutC,3918534,3918534,3917920,614,40,utRho21
267,cvpA,4861600,4861600,4861526,74,0,utRho21
268,cvrA,2484328,2484328,2484142,186,2,utRho21
269,cyaA,7981548,7982306,7981548,758,982,utRho21
270,cyaR,4334228,4334224,4334228,4,0,utRho21
271,cyaY,7988166,7988166,7988118,48,452,utRho21
272,cybB,2981522,2981804,2981522,282,58,utRho21
273,cycA,8859560,8859728,8859560,168,268,utRho21
274,cydA,1542340,1542916,1542340,576,40,utRho21
275,cydC,1858800,1858800,1858390,410,140,utRho21
276,cydD,1862062,1862062,1861924,138,92,utRho21
277,cydX,1548300,1548392,1548300,92,396,utRho21
278,cynR,717418,717418,717380,38,32,utRho21
279,cynT,1435092,1435196,1435092,104,0,utRho21
280,cyoA,903306,903306,903220,86,1708,utRho21
281,cyoE,895540,895540,895410,130,330,utRho21
282,cysB,2667576,2667710,2667576,134,284,utRho21
283,cysC,5748056,5748056,5747984,72,0,utRho21
284,cysD,5752736,5752736,5752658,78,54,utRho21
285,cysE,7565362,7565362,7565124,238,1448,utRho21
286,cysG,6995508,6995656,6995508,148,0,utRho21
287,cysJ,5783928,5783928,5783796,132,60,utRho21
288,cysK,5064688,5064818,5064688,130,312,utRho21
289,cysP,5087114,5087114,5087056,58,2,utRho21
290,cysS,1109154,1109222,1109154,68,0,utRho21
291,cysT,3984100,3984100,3983974,126,66,utRho21
292,cysZ,5062766,5062926,5062766,160,268,utRho21
293,cytR,8249018,8249018,8248912,106,108,utRho21
294,dacA,1328002,1328002,1327926,76,314,utRho21
295,dacB,6657714,6657926,6657714,212,0,utRho21
296,dacC,1761306,1761454,1761306,148,0,utRho21
297,dadA,2475018,2475142,2475018,124,40,utRho21
298,dam,7032504,7032504,7031826,678,1568,utRho21
299,damX,7035200,7035200,7034612,588,908,utRho21
300,dapA,5199568,5199568,5199520,48,0,utRho21
301,dapB,56576,56748,56576,172,4,utRho21
302,dapD,371954,371954,371894,60,138,utRho21
303,dapE,5183120,5183214,5183120,94,1094,utRho21
304,dcp,3254844,3254844,3254760,84,108,utRho21
305,dcrB,7219534,7219910,7219534,376,30,utRho21
306,dctA,7366996,7366996,7366894,102,376,utRho21
307,dcuA,8733686,8733686,8733546,140,0,utRho21
308,dcuB,8698182,8698182,8697488,694,14,utRho21
309,dcuC,1312166,1312166,1311936,230,0,utRho21
310,dcuD,6749166,6749738,6749166,572,2,utRho21
311,dcuR,8701130,8701130,8700068,1062,262,utRho21
312,dcuS,8703370,8703370,8703324,46,28,utRho21
313,dcyD,3999016,3999016,3998960,56,0,utRho21
314,ddpX,3126498,3126498,3126152,346,0,utRho21
315,deaD,6615818,6615818,6615720,98,4,utRho21
316,dedA,4869880,4869880,4869482,398,7938,utRho21
317,dedD,4863750,4863750,4863368,382,34,utRho21
318,def,6867300,6867380,6867300,80,24,utRho21
319,degP,361690,361768,361690,78,56,utRho21
320,degQ,6761308,6761486,6761308,178,1096,utRho21
321,deoB,9239134,9239206,9239134,72,80,utRho21
322,deoC,9233358,9234646,9233358,1288,332,utRho21
323,dfp,7625406,7625462,7625406,56,0,utRho21
324,dgcZ,3247758,3247758,3247700,58,0,utRho21
325,dgkA,8512914,8513274,8512914,360,292,utRho21
326,dgt,358392,358474,358392,82,0,utRho21
327,dhaK,2501888,2501888,2501676,212,128,utRho21
328,dhaR,2502006,2502132,2502006,126,2,utRho21
329,dicB,3299194,3299218,3299194,24,0,utRho21
330,dicC,3295752,3295752,3295700,52,0,utRho21
331,dinB,501760,501796,501760,36,0,utRho21
332,dinD,7635398,7635520,7635398,122,0,utRho21
333,dinG,1666146,1666140,1666146,6,0,utRho21
334,dinI,2243018,2243018,2242974,44,0,utRho21
335,dinJ,493230,493230,493004,226,44,utRho21
336,dinQ,7295964,7295964,7295576,388,900,utRho21
337,djlA,114536,114728,114536,192,0,utRho21
338,dkgA,6313142,6313246,6313142,104,1208,utRho21
339,dkgB,458196,458334,458196,138,4,utRho21
340,dksA,321502,321502,321208,294,734,utRho21
341,dld,4444164,4444370,4444164,206,0,utRho21
342,dmlA,3763424,3763824,3763424,400,152,utRho21
343,dmlR,3763710,3763710,3763618,92,0,utRho21
344,dmsA,1881646,1881918,1881646,272,0,utRho21
345,dnaA,7767922,7767922,7767458,464,642,utRho21
346,dnaB,8528566,8528628,8528566,62,44,utRho21
347,dnaK,24096,24326,24096,230,3076,utRho21
348,dnaN,7765466,7765466,7764642,824,624,utRho21
349,dnaQ,471868,472134,471868,266,2554,utRho21
350,dnaT,18406460,18406460,18406068,392,136,utRho21
351,dnaX,984112,984184,984112,72,60,utRho21
352,dosP,3131486,3131486,3131466,20,76,utRho21
353,dpiB,1303968,1304470,1303968,502,0,utRho21
354,dppA,7415740,7415740,7415410,330,4806,utRho21
355,dps,1697900,1697900,1697822,78,588,utRho21
356,dsbA,8086754,8086836,8086754,82,2018,utRho21
357,dsbB,2466294,2466294,2466060,234,108,utRho21
358,dsbC,6079266,6079266,6077644,1622,1600,utRho21
359,dsbG,1277600,1277600,1277146,454,996,utRho21
360,dsdA,4958242,4958404,4958242,162,126,utRho21
361,dsdC,4955492,4955492,4955258,234,30,utRho21
362,dsdX,4955642,4955694,4955642,52,2,utRho21
363,dsrA,4050626,4050626,4050626,0,0,utRho21
364,dsrB,4049686,4049686,4049646,40,2,utRho21
365,dtpD,1485340,1485340,1485112,228,0,utRho21
366,dusA,8523200,8523338,8523200,138,624,utRho21
367,dusB,6820492,6820560,6820492,68,0,utRho21
368,dusC,4460790,4460790,4460770,20,0,utRho21
369,dut,7627704,7627864,7627704,160,1442,utRho21
370,dxr,386670,387042,386670,372,1606,utRho21
371,ebgA,6445102,6445266,6445102,164,0,utRho21
372,ebgR,6442874,6442932,6442874,58,0,utRho21
373,ecnB,8753018,8753106,8753018,88,0,utRho21
374,eco,4607594,4607810,4607594,216,72,utRho21
375,ecpA,621594,621594,621342,252,112,utRho21
376,ecpB,620238,620238,620052,186,0,utRho21
377,ecpR,622964,622964,622672,292,2,utRho21
378,eda,3866218,3866218,3865512,706,258,utRho21
379,edd,3869426,3869426,3869208,218,20,utRho21
380,efeO,2164308,2164486,2164308,178,614,utRho21
381,efeU_1,2162614,2162712,2162614,98,0,utRho21
382,efp,8751134,8751398,8751134,264,2808,utRho21
383,elaA,4763372,4763372,4763086,286,154,utRho21
384,elaD,4765308,4765426,4765308,118,0,utRho21
385,elfA,1995530,1995736,1995530,206,0,utRho21
386,elfD,1996642,1996980,1996642,338,0,utRho21
387,emrD,7707690,7707844,7707690,154,0,utRho21
388,emrK,4966896,4966896,4966678,218,0,utRho21
389,emrY,4964668,4964668,4964352,316,0,utRho21
390,emtA,2486250,2486360,2486250,110,0,utRho21
391,endA,12361100,12361388,12361100,288,256,utRho21
392,eno,5817692,5817692,5815882,1810,3866,utRho21
393,entC,1249662,1249770,1249662,108,0,utRho21
394,entD,1220508,1220508,1220158,350,320,utRho21
395,entH,1258584,1258600,1258584,16,48,utRho21
396,entS,1244506,1244600,1244506,94,0,utRho21
397,envR,6827266,6827266,6826930,336,0,utRho21
398,epd,12295292,12295292,12294764,528,92,utRho21
399,epmA,8765236,8765286,8765236,50,70,utRho21
400,epmB,8751406,8751406,8751314,92,1030,utRho21
401,eptB,7421162,7421162,7420950,212,0,utRho21
402,eptC,8300622,8300622,8300530,92,48,utRho21
403,erfK,4126708,4126708,4126646,62,0,utRho21
404,erpA,353122,353220,353122,98,406,utRho21
405,esrE,8039956,8039956,8039956,0,0,utRho21
406,essD,1153746,1154796,1153746,1050,66,utRho21
407,etk,2088606,2088606,2088420,186,128,utRho21
408,evgA,4967262,4967510,4967262,248,26,utRho21
409,exbB,6304028,6304028,6303968,60,0,utRho21
410,exbD,6302780,6302780,6302486,294,0,utRho21
411,exuR,6493016,6493304,6493016,288,6,utRho21
412,exuT,6490004,6490208,6490004,204,0,utRho21
413,fabA,2032996,2032996,2032940,56,30,utRho21
414,fabB,4883282,4883282,4883210,72,98,utRho21
415,fabH,2297032,2297518,2297032,486,1434,utRho21
416,fabI,2702236,2702236,2702078,158,108,utRho21
417,fadB,8062026,8062026,8061942,84,0,utRho21
418,fadD,3779614,3779614,3779492,122,0,utRho21
419,fadE,486812,486812,486606,206,0,utRho21
420,fadH,6463248,6463330,6463248,82,4,utRho21
421,fadI,4921022,4921022,4920938,84,90,utRho21
422,fadL,4922410,4922600,4922410,190,184,utRho21
423,fadM,928720,928804,928720,84,0,utRho21
424,fadR,2469810,2469876,2469810,66,0,utRho21
425,fbaB,4357334,4357334,4357128,206,866,utRho21
426,fdhE,8162722,8162722,8162456,266,2200,utRho21
427,fdhF,8598814,8598814,8598732,82,2,utRho21
428,fdnG,3094744,3094802,3094744,58,30,utRho21
429,fdrA,1093012,1093360,1093012,348,0,utRho21
430,feaB,2894994,2895038,2894994,44,0,utRho21
431,feaR,2894734,2894734,2894566,168,24,utRho21
432,fecA,9033454,9033454,9033354,100,66,utRho21
433,fecE,9023288,9023288,9022914,374,2358,utRho21
434,fecI,9036564,9036564,9036470,94,0,utRho21
435,feoA,7080114,7080326,7080114,212,810,utRho21
436,fepA,1225334,1225334,1224988,346,4,utRho21
437,fepB,1249454,1249454,1249020,434,388,utRho21
438,fepD,1244468,1244468,1244378,90,0,utRho21
439,fes,1225374,1225630,1225374,256,218,utRho21
440,ffh,5495706,5495706,5495590,116,1640,utRho21
441,ffs,952576,952848,952576,272,110,utRho21
442,fhuA,334884,334968,334884,84,0,utRho21
443,fhuE,2323294,2323294,2323102,192,206,utRho21
444,fhuF,9211504,9211504,9211326,178,434,utRho21
445,fic,6983296,6983296,6982926,370,126,utRho21
446,fieF,8212864,8212938,8212864,74,0,utRho21
447,fimA,9085388,9086230,9085388,842,242,utRho21
448,fimB,9081334,9081914,9081334,580,1232,utRho21
449,fimE,9083742,9084074,9083742,332,44,utRho21
450,fimZ,1129214,1129214,1128960,254,0,utRho21
451,fiu,1683296,1683296,1683062,234,128,utRho21
452,fixA,84650,84806,84650,156,0,utRho21
453,fkpA,6955050,6955050,6954838,212,3544,utRho21
454,fldA,2846084,2846084,2845860,224,5008,utRho21
455,fldB,6079644,6079710,6079644,66,0,utRho21
456,flgA,2261770,2261770,2261726,44,2,utRho21
457,flgB,2261986,2262036,2261986,50,0,utRho21
458,flgK,2276702,2276756,2276702,54,132,utRho21
459,flgM,2260330,2260330,2260256,74,0,utRho21
460,flgN,2259828,2259828,2259660,168,4,utRho21
461,flhB,3932432,3932432,3932382,50,84,utRho21
462,flhC,3955864,3955864,3955688,176,340,utRho21
463,flhD,3957154,3957154,3956394,760,588,utRho21
464,fliA,4003638,4003638,4003578,60,0,utRho21
465,fliC,4007352,4007352,4007212,140,4,utRho21
466,fliD,4007634,4007744,4007634,110,0,utRho21
467,fliE,4026186,4026186,4026028,158,0,utRho21
468,fliF,4026292,4026458,4026292,166,12,utRho21
469,fliL,4039168,4039236,4039168,68,0,utRho21
470,flk,4875824,4875900,4875824,76,0,utRho21
471,flu,4142634,4143078,4142634,444,50,utRho21
472,flxA,3292776,3292810,3292776,34,276,utRho21
473,fnr,2799104,2799104,2799052,52,30,utRho21
474,fnrS,2818258,2818258,2818258,0,0,utRho21
475,focA,1909628,1909628,1908932,696,86,utRho21
476,folA,99598,99646,99598,48,2,utRho21
477,folB,6409296,6409296,6409178,118,0,utRho21
478,folD,1115562,1115562,1115482,80,2,utRho21
479,folE,4487696,4487696,4487304,392,3092,utRho21
480,fpr,8228998,8228998,8228944,54,0,utRho21
481,frc,4986878,4986878,4986508,370,0,utRho21
482,frdA,8764824,8764824,8764636,188,0,utRho21
483,frdD,8758948,8758948,8758732,216,1844,utRho21
484,fre,8052886,8053054,8052886,168,1242,utRho21
485,frlA,6999518,6999820,6999518,302,0,utRho21
486,frr,385624,385744,385624,120,1192,utRho21
487,frsA,513004,513054,513004,50,212,utRho21
488,fruB,4527194,4527194,4526990,204,0,utRho21
489,frvR,8179804,8179804,8179710,94,86,utRho21
490,fryA,5008986,5008986,5008970,16,0,utRho21
491,fsaA,1727060,1727284,1727060,224,2,utRho21
492,fsr,1009710,1009710,1009392,318,116,utRho21
493,ftnA,3977364,3977432,3977364,68,0,utRho21
494,ftnB,3973550,3973850,3973550,300,0,utRho21
495,ftsA,207122,207964,207122,842,2600,utRho21
496,ftsB,5745802,5745802,5745640,162,360,utRho21
497,ftsH,6654204,6654204,6653870,334,438,utRho21
498,ftsK,1865858,1866448,1865858,590,3492,utRho21
499,ftsL,181376,182064,181376,688,4152,utRho21
500,ftsP,6325732,6325732,6325338,394,546,utRho21
501,ftsQ,205484,206310,205484,826,602,utRho21
502,ftsX,7204512,7204512,7204172,340,1270,utRho21
503,ftsZ,209272,210610,209272,1338,82,utRho21
504,fucA,5867708,5867708,5867376,332,6,utRho21
505,fucP,5868238,5868470,5868238,232,0,utRho21
506,fumA,6753760,6753760,6753508,252,11068,utRho21
507,fumB,8694696,8694696,8694652,44,0,utRho21
508,fumC,3373418,3373418,3373176,242,42,utRho21
509,fur,2842892,2842892,2842584,308,8864,utRho21
510,fusA,6947370,6947370,6947028,342,12512,utRho21
511,fxsA,8737206,8737328,8737206,122,312,utRho21
512,gabD,5581824,5582546,5581824,722,50584,utRho21
513,gadA,7335214,7335214,7335160,54,0,utRho21
514,gadB,3144144,3144144,3144090,54,4,utRho21
515,gadC,3141168,3141168,3140978,190,10,utRho21
516,gadE,7315600,7316732,7315600,1132,10,utRho21
517,gadW,7329562,7329562,7329236,326,74,utRho21
518,gadX,14663356,14663356,14663240,116,188,utRho21
519,gadY,7329728,7329728,7329728,0,0,utRho21
520,galE,1584354,1584354,1584110,244,0,utRho21
521,galF,4228702,4228702,4228654,48,60,utRho21
522,galM,1577796,1577796,1577674,122,3344,utRho21
523,galP,6176510,6176568,6176510,58,0,utRho21
524,galR,5953138,5953198,5953138,60,18,utRho21
525,galS,4483420,4483420,4483336,84,0,utRho21
526,galU,2582810,2582914,2582810,104,906,utRho21
527,gapA,3724480,3725542,3724480,1062,11880,utRho21
528,garP,6549868,6549868,6549814,54,102,utRho21
529,gatY,4354468,4354468,4354408,60,82,utRho21
530,gatZ,4352864,4352864,4352642,222,56862,utRho21
531,gcd,282558,282558,282450,108,0,utRho21
532,gcl,1067814,1067832,1067814,18,0,utRho21
533,gcvA,5885278,5885278,5885134,144,0,utRho21
534,gcvB,5885392,5885392,5885392,0,0,utRho21
535,gcvR,5199758,5199812,5199758,54,44,utRho21
536,gcvT,6101544,6101544,6101334,210,3924,utRho21
537,gdhA,3684616,3684742,3684616,126,0,utRho21
538,gfcA,2099668,2099668,2099488,180,6,utRho21
539,gfcD,2096236,2096236,2095890,346,302,utRho21
540,ghrA,2195648,2195772,2195648,124,0,utRho21
541,ghrB,7434378,7434620,7434378,242,1600,utRho21
542,glcA,6242728,6242728,6242558,170,892,utRho21
543,glcC,6256412,6256544,6256412,132,0,utRho21
544,glcD,6256152,6256152,6256042,110,26,utRho21
545,gldA,8278092,8278092,8278070,22,216,utRho21
546,glgA,7136784,7136784,7136066,718,4944,utRho21
547,glgB,7147314,7147314,7147004,310,1036,utRho21
548,glgC,7139142,7139142,7138656,486,1616,utRho21
549,glgP,7133546,7133546,7133162,384,1754,utRho21
550,glgS,6384024,6384024,6383878,146,88,utRho21
551,glgX,7142838,7142838,7142638,200,122,utRho21
552,glk,5018922,5018922,5018852,70,52,utRho21
553,glmS,7827622,7827622,7827336,286,6240,utRho21
554,glmU,7830652,7830652,7830400,252,0,utRho21
555,glmY,10765360,10765360,10765360,0,0,utRho21
556,glmZ,7972864,7972864,7972864,0,0,utRho21
557,glnA,16232888,16232888,16232136,752,516,utRho21
558,glnB,5375052,5375052,5374816,236,112,utRho21
559,glnD,377310,377310,377300,10,0,utRho21
560,glnE,6399602,6399602,6399282,320,690,utRho21
561,glnH,1696396,1696396,1696008,388,502,utRho21
562,glnK,945112,945196,945112,84,0,utRho21
563,glnL,8112742,8112742,8112678,64,0,utRho21
564,glnQ,1693262,1693262,1692926,336,1288,utRho21
565,glnS,1411998,1412186,1411998,188,1314,utRho21
566,gloA,3455602,3455674,3455602,72,0,utRho21
567,gloB,469852,469852,469564,288,3670,utRho21
568,glpA,4705166,4705294,4705166,128,0,utRho21
569,glpD,7123942,7124026,7123942,84,0,utRho21
570,glpE,7123698,7123698,7123646,52,4,utRho21
571,glpF,8236322,8236322,8236180,142,28,utRho21
572,glpG,7122960,7122960,7122904,56,74,utRho21
573,glpR,7121782,7121782,7121210,572,470,utRho21
574,glpT,4704902,4704902,4704748,154,0,utRho21
575,glpX,8231212,8231212,8231158,54,210,utRho21
576,glrK,5382246,5382246,5382196,50,0,utRho21
577,gltA,1509534,1509534,1508936,598,64306,utRho21
578,gltB,6709018,6709264,6709018,246,0,utRho21
579,gltI,1375792,1375792,1375494,298,4108,utRho21
580,gltP,8588536,8588962,8588536,426,1572,utRho21
581,gltS,7657382,7657382,7657330,52,168,utRho21
582,gltX,5041568,5041568,5041344,224,296,utRho21
583,gluQ,320286,320286,320224,62,28,utRho21
584,glyA,5371148,5371148,5371014,134,2,utRho21
585,glyQ,7450708,7450708,7450636,72,222,utRho21
586,glyS,7448990,7448990,7448794,196,2678,utRho21
587,glyU,5998128,5998128,5998114,14,0,utRho21
588,glyV,8784626,8784720,8784626,94,86,utRho21
589,glyW,3984360,3984360,3984234,126,0,utRho21
590,gmhB,445612,445666,445612,54,0,utRho21
591,gmk,7642776,7642856,7642776,80,12,utRho21
592,gmr,2693686,2693686,2693484,202,46,utRho21
593,gnd,4202648,4202648,4202536,112,788,utRho21
594,gnsB,3275692,3275692,3275564,128,92,utRho21
595,gntK,14310580,14310580,14310368,212,92,utRho21
596,gntP,9102668,9102668,9102592,76,36,utRho21
597,gntR,7157760,7157760,7157452,308,1086,utRho21
598,gntT,7092810,7093118,7092810,308,0,utRho21
599,gntU,7154170,7154170,7154122,48,0,utRho21
600,gntX,7089334,7089764,7089334,430,10,utRho21
601,gor,7292224,7292598,7292224,374,734,utRho21
602,gpmA,1575340,1575340,1575190,150,8,utRho21
603,gpmM,7570374,7570520,7570374,146,0,utRho21
604,gpsA,7567620,7567620,7567322,298,17540,utRho21
605,gpt,511828,511954,511828,126,260,utRho21
606,grcA,5433046,5433046,5432898,148,112,utRho21
607,greA,6657728,6657728,6657430,298,462,utRho21
608,greB,7073488,7073624,7073488,136,226,utRho21
609,groL,8741566,8742050,8741566,484,29992,utRho21
610,groS,8741232,8741376,8741232,144,17288,utRho21
611,grpE,5501494,5501494,5501416,78,798,utRho21
612,grxA,1781552,1781552,1781506,46,0,utRho21
613,grxB,2248206,2248206,2248108,98,80,utRho21
614,grxC,7569152,7569152,7568884,268,6724,utRho21
615,grxD,3468324,3468324,3468202,122,7020,utRho21
616,gspA,6911268,6911268,6910796,472,0,utRho21
617,gspC,6910964,6911156,6910964,192,0,utRho21
618,gss,6277220,6277220,6277044,176,144,utRho21
619,gstA,3428654,3428754,3428654,100,0,utRho21
620,gstB,1761038,1761038,1760960,78,28,utRho21
621,guaB,5268214,5268214,5268140,74,110,utRho21
622,gudD,5839026,5839026,5838770,256,152,utRho21
623,gyrA,4678914,4678914,4678840,74,2,utRho21
624,gyrB,7760300,7760300,7760238,62,226,utRho21
625,hcaE,5337964,5338064,5337964,100,194,utRho21
626,hcaR,5337928,5337928,5337792,136,114,utRho21
627,hcaT,5336106,5336106,5335692,414,1008,utRho21
628,hchA,4071260,4071670,4071260,410,1060,utRho21
629,hcp,1828258,1828258,1827628,630,28,utRho21
630,hcr,1824400,1824400,1824300,100,116,utRho21
631,hdeA,7313582,7313582,7313480,102,0,utRho21
632,hdeD,7313920,7313990,7313920,70,2,utRho21
633,hdfR,7896320,7896320,7895934,386,120,utRho21
634,hdhA,3396244,3396244,3396080,164,0,utRho21
635,helD,2048876,2048942,2048876,66,0,utRho21
636,hemA,2527166,2527428,2527166,262,320,utRho21
637,hemB,779722,779722,779454,268,120,utRho21
638,hemF,5106410,5106450,5106410,40,146,utRho21
639,hemH,996062,996110,996062,48,0,utRho21
640,hemL,349882,349882,349764,118,186,utRho21
641,hemN,8103886,8104090,8103886,204,134,utRho21
642,hepA,127176,127176,126528,648,1524,utRho21
643,hflD,2385372,2385372,2385262,110,510,utRho21
644,hfq,8799602,8800576,8799602,974,6262,utRho21
645,hha,961006,961006,960616,390,240,utRho21
646,hicA,3018442,3018572,3018442,130,150,utRho21
647,higA,6468682,6468682,6468288,394,96,utRho21
648,higB,6468960,6468960,6468910,50,0,utRho21
649,hinT,2323642,2323770,2323642,128,28,utRho21
650,hipB,3184964,3184964,3184884,80,18,utRho21
651,hisB,4186720,4186936,4186720,216,986,utRho21
652,hisJ,4853674,4853674,4853576,98,110,utRho21
653,hisL,8359856,8359984,8359856,128,84,utRho21
654,hisS,5281284,5281284,5281150,134,148,utRho21
655,hlpA,400910,400964,400910,54,172,utRho21
656,hlyE,2460932,2460932,2460788,144,68,utRho21
657,hmp,5371594,5371670,5371594,76,2,utRho21
658,hns,2585916,2585916,2585844,72,1580,utRho21
659,hofM,7045856,7045856,7045502,354,0,utRho21
660,hokA,7441620,7441620,7441200,420,2,utRho21
661,hokC,33902,33902,33806,96,96,utRho21
662,hokE,1215462,1215672,1215462,210,2,utRho21
663,holC,8968546,8968546,8968560,14,1852,utRho21
664,holD,9215562,9215606,9215562,44,0,utRho21
665,holE,3850040,3850216,3850040,176,190,utRho21
666,hpt,282720,282862,282720,142,4,utRho21
667,hrpB,324150,324210,324150,60,98,utRho21
668,hscB,5319048,5319048,5318934,114,1492,utRho21
669,hscC,1367188,1367188,1366786,402,814,utRho21
670,hsdS,9163004,9163004,9162924,80,0,utRho21
671,hslJ,2883560,2883560,2883486,74,142,utRho21
672,hslO,7059344,7059548,7059344,204,12076,utRho21
673,hslR,7058220,7058696,7058220,476,1524,utRho21
674,hslV,8244708,8244708,8244574,134,14,utRho21
675,hsrA,7881412,7881412,7881224,188,162,utRho21
676,htgA,21286,21660,21286,374,44,utRho21
677,htpG,989634,990240,989634,606,2406,utRho21
678,htpX,3825236,3825236,3825152,84,0,utRho21
679,htrE,311036,311036,310852,184,0,utRho21
680,htrL,7587668,7587668,7587366,302,4,utRho21
681,hupA,8400352,8400562,8400352,210,520,utRho21
682,hupB,1845220,1845804,1845220,584,108,utRho21
683,hyaA,2063968,2064278,2063968,310,0,utRho21
684,hybO,6292726,6292726,6292522,204,2230,utRho21
685,hycA,5700922,5700922,5700870,52,112,utRho21
686,hycI,5686204,5686204,5686086,118,368,utRho21
687,hydN,5676264,5676264,5676210,54,0,utRho21
688,hyfA,5202342,5202402,5202342,60,0,utRho21
689,hypA,11402508,11402588,11402508,80,8,utRho21
690,hypB,11403356,11404004,11403356,648,504,utRho21
691,hypF,5676210,5676210,5674850,1360,328,utRho21
692,hypT,9116634,9116634,9116578,56,0,utRho21
693,hyuA,6019660,6020056,6019660,396,86,utRho21
694,iaaA,1733074,1733136,1733074,62,0,utRho21
695,iadA,9119074,9119074,9119052,22,36,utRho21
696,iap,5753072,5753162,5753072,90,0,utRho21
697,ibaG,6673966,6673966,6673606,360,96,utRho21
698,ibpA,7735036,7735036,7734844,192,144,utRho21
699,ibpB,7733962,7733962,7733794,168,1092,utRho21
700,icd,2389922,2390246,2389922,324,622,utRho21
701,iclR,8447304,8447304,8447256,48,0,utRho21
702,idi,6065876,6066130,6065876,254,0,utRho21
703,idnD,8988870,8988870,8988812,58,0,utRho21
704,idnK,8989194,8989246,8989194,52,0,utRho21
705,ihfA,3591442,3591442,3591104,338,908,utRho21
706,ihfB,1927498,1927656,1927498,158,1948,utRho21
707,ileS,43666,44782,43666,1116,5592,utRho21
708,ileX,6431194,6431196,6431194,2,0,utRho21
709,ilvA,15820940,15821324,15820940,384,404,utRho21
710,ilvC,7915824,7915940,7915824,116,192,utRho21
711,ilvE,15809552,15809936,15809552,384,0,utRho21
712,ilvI,170840,171260,170840,420,0,utRho21
713,ilvL,23701308,23701932,23701308,624,114,utRho21
714,ilvY,7915734,7915734,7915640,94,4,utRho21
715,inaA,4698998,4698998,4698944,54,0,utRho21
716,infA,1853370,1853370,1852886,484,598,utRho21
717,infC,3602692,3602692,3601276,1416,6300,utRho21
718,insA-5,3958452,3958452,3958430,22,4,utRho21
719,insA-7,9036758,9037054,9036758,296,346,utRho21
720,insC-5,6372080,6372284,6372080,204,208,utRho21
721,insEF-2,785238,785238,785820,582,768,utRho21
722,insEF-4,2190310,2190310,2190892,582,638,utRho21
723,insG,9007098,9007098,9006862,236,16,utRho21
724,insH-1,550596,550596,550234,362,250,utRho21
725,insH-11,7306538,7306538,7306396,142,214,utRho21
726,insH-2,1151548,1151548,1151506,42,984,utRho21
727,insH-3,1378444,1378444,1378026,418,246,utRho21
728,insH-4,2791942,2792152,2791942,210,358,utRho21
729,insH-5,2857852,2857852,2857452,400,104,utRho21
730,insH-6,4135022,4135022,4134642,380,38,utRho21
731,insH-7,4206186,4206186,4205822,364,2456,utRho21
732,insH-9,6260050,6260356,6260050,306,428,utRho21
733,insI-3,9017372,9017372,9017234,138,2,utRho21
734,insJ,7441188,7441360,7441188,172,0,utRho21
735,insK,7442130,7442308,7442130,178,0,utRho21
736,insL-1,30760,30890,30760,130,3384,utRho21
737,insL-2,1216112,1216130,1216112,18,74,utRho21
738,insL-3,5028644,5028662,5028644,18,156,utRho21
739,insN-1,540452,540484,540452,32,0,utRho21
740,intD,1132202,1132202,1131956,246,22,utRho21
741,intR,2826520,2826520,2826470,50,0,utRho21
742,intS,4933026,4933090,4933026,64,74,utRho21
743,intZ,5117386,5117542,5117386,156,348,utRho21
744,iraD,9113152,9113986,9113152,834,4,utRho21
745,iraM,2424246,2424246,2424006,240,0,utRho21
746,iraP,802638,802772,802638,134,0,utRho21
747,iscA,5319924,5319924,5319772,152,2904,utRho21
748,iscR,5324398,5324398,5324262,136,11916,utRho21
749,iscX,5313834,5313834,5313472,362,2238,utRho21
750,ispF,5743968,5743968,5743560,408,2444,utRho21
751,ispG,5283908,5283908,5283608,300,784,utRho21
752,ispU,389568,389806,389568,238,8,utRho21
753,isrA,2811502,2811502,2811618,116,0,utRho21
754,istr-1,7706384,7706384,7706384,0,0,utRho21
755,istr-2,7706514,7706514,7706514,0,0,utRho21
756,ivbL,15412092,15412092,15411952,140,1492,utRho21
757,ivy,480638,480686,480638,48,80,utRho21
758,katE,3627628,3627734,3627628,106,300,utRho21
759,katG,8267624,8267670,8267624,46,398,utRho21
760,kbaZ,6557732,6557828,6557732,96,0,utRho21
761,kbl,7585154,7585154,7585102,52,578,utRho21
762,kch,2621046,2621046,2620538,508,0,utRho21
763,kdgR,3820506,3820506,3820198,308,42,utRho21
764,kdpE,1443788,1443788,1443466,322,292,utRho21
765,kdpF,1457698,1457698,1457642,56,0,utRho21
766,kdsA,2535708,2536330,2535708,622,3630,utRho21
767,kdsC,6683438,6684546,6683438,1108,4506,utRho21
768,kduI,5968388,5968388,5968248,140,166,utRho21
769,kefF,94160,94492,94160,332,6,utRho21
770,kgtP,5451624,5451624,5451492,132,2,utRho21
771,kup,7862206,7862632,7862206,426,52,utRho21
772,lacI,735076,735076,735020,56,80,utRho21
773,lacZ,1465508,1465508,1465220,288,24,utRho21
774,ldcA,2486394,2486394,2486160,234,0,utRho21
775,ldhA,2885830,2885830,2885686,144,0,utRho21
776,ldrA,2538954,2538954,2538550,404,538,utRho21
777,ldrB,2540024,2540024,2539620,404,8,utRho21
778,ldrC,2541092,2541092,2540690,402,26,utRho21
779,ldrD,7400544,7400544,7400174,370,44,utRho21
780,lepA,5414392,5414392,5414248,144,102,utRho21
781,lepB,5410928,5410928,5410618,310,744,utRho21
782,leuD,159188,159188,158906,282,266,utRho21
783,leuE,3761600,3761600,3761518,82,0,utRho21
784,leuL,168048,168048,167416,632,0,utRho21
785,leuO,168308,168736,168308,428,0,utRho21
786,leuQ,9212864,9212864,9212802,62,0,utRho21
787,leuU,6644556,6644556,6644316,240,2022,utRho21
788,leuV,9212546,9212546,9212330,216,754,utRho21
789,leuX,8992772,8992810,8992772,38,112,utRho21
790,lexA,8514174,8514230,8514174,56,2,utRho21
791,lhr,3456706,3458174,3456706,1468,3160,utRho21
792,ligA,5060402,5060402,5060352,50,0,utRho21
793,ligB,7642576,7642576,7642340,236,0,utRho21
794,lipA,1320602,1320602,1320432,170,42,utRho21
795,lipB,1324802,1324802,1324556,246,1980,utRho21
796,lit,2397032,2397390,2397032,358,242,utRho21
797,livJ,7199524,7199524,7199316,208,6,utRho21
798,livK,7195510,7195510,7195120,390,84,utRho21
799,lldP,7554578,7554798,7554578,220,5292,utRho21
800,lnt,1381968,1381968,1381762,206,956,utRho21
801,loiP,6163784,6163826,6163784,42,0,utRho21
802,lolA,1874656,1874738,1874656,82,328,utRho21
803,lolB,2527112,2527112,2527000,112,248,utRho21
804,lolC,2350748,2350854,2350748,106,0,utRho21
805,lon,917630,917776,917630,146,156,utRho21
806,lpcA,486936,487086,486936,150,20,utRho21
807,lpd,255434,255824,255434,390,3722,utRho21
808,lplA,9248476,9248476,9248234,242,3238,utRho21
809,lplT,5947878,5947878,5947724,154,92,utRho21
810,lpoA,6586422,6586800,6586422,378,88,utRho21
811,lpp,3514592,3514842,3514592,250,182,utRho21
812,lptA,6686598,6686760,6686598,162,1396,utRho21
813,lptB,6686792,6687888,6686792,1096,3168,utRho21
814,lptD,114672,114672,114218,454,2752,utRho21
815,lptF,8972244,8972436,8972244,192,0,utRho21
816,lpxC,213016,213114,213016,98,4360,utRho21
817,lpxD,401920,401942,401920,22,36,utRho21
818,lpxL,2233418,2233418,2233164,254,194,utRho21
819,lpxM,3880456,3880456,3880386,70,0,utRho21
820,lpxP,4991156,4991290,4991156,134,272,utRho21
821,lrhA,4813312,4813312,4813282,30,94,utRho21
822,lrp,1864656,1865190,1864656,534,1588,utRho21
823,lspA,50028,50414,50028,386,1792,utRho21
824,lsrA,3202920,3202980,3202920,60,0,utRho21
825,lsrR,3202514,3202514,3202482,32,0,utRho21
826,ltaE,1818640,1818640,1818588,52,22,utRho21
827,luxS,5630130,5630130,5629466,664,1642,utRho21
828,lysA,5957902,5957902,5957798,104,0,utRho21
829,lysC,8467232,8467232,8466466,766,4106,utRho21
830,lysP,4497120,4497120,4497064,56,230,utRho21
831,lysR,5957900,5958042,5957900,142,0,utRho21
832,lysT,1561028,1561108,1561028,80,62,utRho21
833,lysU,8709610,8709610,8709434,176,6,utRho21
834,macB,1840188,1840694,1840188,506,774,utRho21
835,maeA,3111484,3111484,3111338,146,6198,utRho21
836,mak,820236,820288,820236,52,0,utRho21
837,malE,8492928,8492928,8492838,90,8,utRho21
838,malI,3398456,3398456,3398360,96,0,utRho21
839,malK,8493472,8493568,8493472,96,0,utRho21
840,malP,7105020,7105020,7104946,74,2400,utRho21
841,malQ,7100798,7100798,7100140,658,1348,utRho21
842,malS,14949880,14949988,14949880,108,0,utRho21
843,malT,7106048,7106170,7106048,122,32,utRho21
844,malX,3398626,3398710,3398626,84,0,utRho21
845,malZ,1689980,1690072,1689980,92,124,utRho21
846,manA,3377102,3377152,3377102,50,70,utRho21
847,manX,3803866,3804096,3803866,230,0,utRho21
848,marC,3237882,3237882,3237816,66,194,utRho21
849,marR,3238186,3238240,3238186,54,0,utRho21
850,matP,2036918,2036970,2036918,52,18,utRho21
851,mazE,5822736,5822736,5822678,58,56,utRho21
852,mazG,5821720,5821720,5821370,350,7468,utRho21
853,mcbA,1684306,1684306,1684112,194,0,utRho21
854,mcbR,3040192,3040524,3040192,332,0,utRho21
855,mcrA,2420278,2420692,2420278,414,0,utRho21
856,mcrC,9156124,9156124,9155916,208,148,utRho21
857,mdaB,6344814,6345060,6344814,246,40,utRho21
858,mdfA,1767138,1767346,1767138,208,0,utRho21
859,mdh,6768940,6768940,6768536,404,848,utRho21
860,mdoB,9198988,9198988,9198882,106,1512,utRho21
861,mdoD,2993290,2993712,2993290,422,0,utRho21
862,mdoG,2218514,2218670,2218514,156,0,utRho21
863,mdtA,4307958,4308032,4307958,74,0,utRho21
864,mdtE,7318168,7318464,7318168,296,11286,utRho21
865,mdtK,3486538,3486914,3486538,376,248,utRho21
866,mdtP,8602472,8602472,8602060,412,70,utRho21
867,melA,8683774,8683822,8683774,48,0,utRho21
868,melR,8683300,8683300,8683256,44,72,utRho21
869,menA,8240812,8240812,8240698,114,0,utRho21
870,menB,4753774,4753774,4753638,136,562,utRho21
871,mepH,3468714,3468870,3468714,156,0,utRho21
872,mepM,3883666,3883666,3883270,396,450,utRho21
873,mepS,4539840,4539958,4539840,118,104,utRho21
874,metA,8428318,8428560,8428318,242,0,utRho21
875,metB,8257272,8257344,8257272,72,1666,utRho21
876,metC,6304150,6304472,6304150,322,24,utRho21
877,metE,8025768,8026106,8025768,338,88,utRho21
878,metF,8265092,8265232,8265092,140,0,utRho21
879,metG,4388538,4388600,4388538,62,58,utRho21
880,metH,8447010,8447656,8447010,646,2650,utRho21
881,metJ,8257116,8257116,8256790,326,12,utRho21
882,metK,6173154,6173412,6173154,258,96,utRho21
883,metN,445428,445428,445290,138,82,utRho21
884,metR,8025710,8025710,8025632,78,0,utRho21
885,metT,1394326,1394326,1394266,60,150,utRho21
886,metY,19910250,19910250,19909734,516,0,utRho21
887,metZ,11789528,11789548,11789528,20,4,utRho21
888,mfd,2348056,2348056,2347928,128,112,utRho21
889,mglA,4478782,4478782,4478578,204,684,utRho21
890,mglB,4481132,4481132,4480696,436,40170,utRho21
891,mglC,4475918,4475918,4475506,412,164,utRho21
892,mgrB,3817584,3817584,3817532,52,0,utRho21
893,mgrR,3245828,3245828,3245828,0,0,utRho21
894,mgsA,2054082,2054082,2054030,52,144,utRho21
895,mgtL,8934560,8934862,8934560,302,252,utRho21
896,mhpA,737038,737222,737038,184,158,utRho21
897,mhpR,737072,737072,736840,232,352,utRho21
898,mhpT,750772,750918,750772,146,112,utRho21
899,miaA,8797964,8798504,8797964,540,320,utRho21
900,micA,5629604,5629604,5629604,0,0,utRho21
901,micC,2874242,2874238,2874242,4,0,utRho21
902,micF,4626168,4626168,4626168,0,0,utRho21
903,micM,1014408,1014408,1014408,0,0,utRho21
904,minE,2449422,2449422,2449090,332,3922,utRho21
905,mioC,7852950,7852950,7852910,40,0,utRho21
906,mipA,3733012,3733012,3732944,68,1640,utRho21
907,mlaA,4930270,4930270,4930014,256,0,utRho21
908,mlc,3337206,3337206,3337128,78,0,utRho21
909,mlrA,4429498,4429732,4429498,234,0,utRho21
910,mltA,5894546,5894546,5894356,190,94,utRho21
911,mltD,468050,468050,467910,140,0,utRho21
912,mltF,5391534,5391602,5391534,68,0,utRho21
913,mmuP,550238,550650,550238,412,262,utRho21
914,mngA,1531622,1531968,1531622,346,2,utRho21
915,mngR,1531852,1531852,1531750,102,0,utRho21
916,mnmG,7851348,7851348,7851266,82,398,utRho21
917,mntH,5025470,5025470,5025412,58,0,utRho21
918,mntP,3810918,3811376,3810918,458,34,utRho21
919,mntR,1706160,1706366,1706160,206,36,utRho21
920,mntS,1706128,1706128,1705994,134,0,utRho21
921,moaA,1633654,1634088,1633654,434,1578,utRho21
922,moaB,1635954,1636110,1635954,156,3300,utRho21
923,mobA,8084242,8084242,8083998,244,4,utRho21
924,mocA,6030112,6030320,6030112,208,0,utRho21
925,modA,1589990,1590178,1589990,188,4,utRho21
926,moeA,1732788,1732788,1732728,60,134,utRho21
927,mokB,2984610,2984610,2984258,352,568,utRho21
928,molR_1,4392888,4392948,4392888,60,2,utRho21
929,motA,3954604,3954604,3954278,326,128,utRho21
930,mpaA,2781278,2781278,2781196,82,694,utRho21
931,mpl,8911456,8911570,8911456,114,0,utRho21
932,mppA,2786108,2786454,2786108,346,76,utRho21
933,mprA,5621494,5621540,5621494,46,254,utRho21
934,mqo,4613848,4613848,4613508,340,72,utRho21
935,mqsA,6336742,6336742,6336492,250,532,utRho21
936,mqsR,6337306,6337306,6337088,218,602,utRho21
937,mraZ,179192,179268,179192,76,0,utRho21
938,mrcA,7045652,7045742,7045652,90,0,utRho21
939,mrcB,329442,329460,329442,18,0,utRho21
940,mreB,13605424,13605424,13604348,1076,1040,utRho21
941,mreD,6798166,6798166,6797750,416,166,utRho21
942,mrp,4388360,4388360,4388336,24,10,utRho21
943,mscK,972984,973072,972984,88,0,utRho21
944,mscL,6876002,6876048,6876002,46,128,utRho21
945,mscS,6139742,6139742,6139614,128,236,utRho21
946,msrA,8884522,8884522,8884352,170,838,utRho21
947,msrB,3725168,3725168,3724858,310,8,utRho21
948,msyB,2228426,2228426,2228362,64,340,utRho21
949,mtfA,4087236,4087302,4087236,66,4394,utRho21
950,mtgA,6699662,6699662,6699618,44,22,utRho21
951,mtlA,30177504,30178248,30177504,744,1448,utRho21
952,mtn,358366,358366,358306,60,14,utRho21
953,mtr,6611864,6611864,6611634,230,0,utRho21
954,mug,6430992,6430992,6430946,46,0,utRho21
955,murQ,5091466,5091546,5091466,80,0,utRho21
956,murR,5091586,5091586,5091218,368,0,utRho21
957,mutH,5939164,5939324,5939164,160,392,utRho21
958,mutL,8794092,8794824,8794092,732,902,utRho21
959,mutM,7622554,7622554,7622304,250,276,utRho21
960,mutS,5714038,5714186,5714038,148,984,utRho21
961,mutY,18617466,18618078,18617466,612,192,utRho21
962,nac,4123956,4123956,4123866,90,2,utRho21
963,nadA,1564122,1564170,1564122,48,0,utRho21
964,nadB,5420714,5420840,5420714,126,0,utRho21
965,nadC,237326,237326,237290,36,0,utRho21
966,nadE,3644604,3644916,3644604,312,2,utRho21
967,nadK,5501526,5501662,5501526,136,226,utRho21
968,nagA,1406350,1406350,1405502,848,23598,utRho21
969,nagB,1407416,1407416,1407222,194,312,utRho21
970,nagC,1404016,1404016,1403188,828,456,utRho21
971,nagE,1407680,1407888,1407680,208,2,utRho21
972,nagK,2357080,2357186,2357080,106,188,utRho21
973,nanA,6747240,6747240,6747152,88,90,utRho21
974,nanC,9079856,9079856,9079002,854,98,utRho21
975,nanR,6749406,6749406,6748978,428,2,utRho21
976,nanS,9075406,9075406,9075188,218,0,utRho21
977,napF,4607390,4607390,4606994,396,0,utRho21
978,narG,2559614,2559728,2559614,114,74,utRho21
979,narK,2555642,2555914,2555642,272,0,utRho21
980,narP,4580844,4581000,4580844,156,220,utRho21
981,narQ,5171154,5171462,5171154,308,0,utRho21
982,narU,3088326,3088326,3088120,206,24,utRho21
983,narW,3077374,3077374,3074618,2756,732,utRho21
984,narX,2555554,2555554,2555236,318,336,utRho21
985,narZ,3085380,3085380,3085180,200,0,utRho21
986,ndh,2331984,2332170,2331984,186,158,utRho21
987,ndk,5289920,5289920,5289728,192,282,utRho21
988,nemR,6904084,6904092,6904084,8,4,utRho21
989,nepI,7683542,7683542,7683478,64,2,utRho21
990,nfo,4501612,4501680,4501612,68,2,utRho21
991,nfsB,1210906,1210906,1210848,58,76,utRho21
992,nfuA,7090916,7091248,7090916,332,992,utRho21
993,nhaA,34634,34978,34634,344,0,utRho21
994,nhaB,2469534,2469534,2469434,100,0,utRho21
995,nhoA,3067926,3068048,3067926,122,0,utRho21
996,nikA,7226878,7227334,7226878,456,238,utRho21
997,nikR,7237074,7237176,7237074,102,134,utRho21
998,nirB,6987974,6988022,6987974,48,0,utRho21
999,nlpA,7680034,7680034,7679986,48,0,utRho21
1000,nlpC,3585654,3585654,3585462,192,242,utRho21
1001,nlpD,5737658,5737658,5737506,152,172,utRho21
1002,nlpI,6618080,6618080,6617848,232,58,utRho21
1003,nmpC,1153740,1153740,1153650,90,244,utRho21
1004,nohA,3273206,3273206,3272734,472,0,utRho21
1005,norR,5664614,5664614,5664578,36,0,utRho21
1006,norV,5664878,5664952,5664878,74,0,utRho21
1007,nrdA,4689510,4689730,4689510,220,15026,utRho21
1008,nrdD,8925676,8925676,8925320,356,98,utRho21
1009,nrdH,5601312,5601446,5601312,134,1368,utRho21
1010,nrdR,865954,866004,865954,50,0,utRho21
1011,nrfA,8575342,8575528,8575342,186,0,utRho21
1012,nsrR,8812088,8812380,8812088,292,286,utRho21
1013,nudB,3897348,3897348,3897264,84,0,utRho21
1014,nudC,8393428,8393806,8393428,378,322,utRho21
1015,nudE,7052658,7052658,7052298,360,200,utRho21
1016,nudG,3682876,3682980,3682876,104,0,utRho21
1017,nudI,4729050,4729108,4729050,58,0,utRho21
1018,nudJ,2388874,2388874,2388576,298,1920,utRho21
1019,nuoA,4810670,4810670,4810144,526,3818,utRho21
1020,nuoN,4783434,4783434,4783010,424,1782,utRho21
1021,nupC,5026018,5026084,5026018,66,0,utRho21
1022,nupG,6211302,6211428,6211302,126,110,utRho21
1023,ogrK,4335096,4335096,4335040,56,152,utRho21
1024,ogt,2800568,2800568,2800472,96,208,utRho21
1025,ohsC,5401036,5401040,5401036,4,0,utRho21
1026,ompA,2040382,2040382,2040106,276,50854,utRho21
1027,ompC,4625774,4625774,4625498,276,268,utRho21
1028,ompF,1974184,1974184,1973964,220,0,utRho21
1029,ompL,8128958,8128958,8128590,368,2,utRho21
1030,ompN,2874158,2874158,2873786,372,0,utRho21
1031,ompR,7073510,7073510,7073168,342,0,utRho21
1032,ompT,1171330,1171330,1171266,64,118,utRho21
1033,ompW,2627982,2628040,2627982,58,0,utRho21
1034,ompX,1700418,1700900,1700418,482,632,utRho21
1035,omrA,5952378,5952378,5952378,0,0,utRho21
1036,omrB,5952770,5952770,5952770,0,0,utRho21
1037,oppA,2602170,2602364,2602170,194,4380,utRho21
1038,orn,8783168,8783208,8783168,40,68,utRho21
1039,osmB,2686952,2686952,2686656,296,198,utRho21
1040,osmC,3113192,3113250,3113192,58,1650,utRho21
1041,osmE,3644566,3644566,3644512,54,2,utRho21
1042,osmF,4439046,4439046,4438962,84,582,utRho21
1043,osmY,9222306,9222792,9222306,486,2056,utRho21
1044,otsA,3963302,3963302,3963224,78,304,utRho21
1045,otsB,3964930,3964930,3964774,156,926,utRho21
1046,oxc,4984288,4984288,4983900,388,0,utRho21
1047,oxyR,8316914,8316980,8316914,66,0,utRho21
1048,oxyS,8316788,8316788,8316788,0,0,utRho21
1049,paaA,2907730,2907854,2907730,124,0,utRho21
1050,paaX,2927018,2927078,2927018,60,114,utRho21
1051,paaZ,2907340,2907340,2907284,56,0,utRho21
1052,pabA,6981702,6981702,6981658,44,0,utRho21
1053,pabB,3789256,3789610,3789256,354,434,utRho21
1054,pabC,2306186,2306600,2306186,414,258,utRho21
1055,pagP,1313052,1313114,1313052,62,0,utRho21
1056,panB,299260,299260,299202,58,106,utRho21
1057,panC,297840,297840,297590,250,718,utRho21
1058,panD,293490,293490,293388,102,0,utRho21
1059,panZ,7195656,7195968,7195656,312,66,utRho21
1060,parC,6332060,6332060,6331946,114,168,utRho21
1061,patA,6438916,6438988,6438916,72,0,utRho21
1062,patD,3030830,3031156,3030830,326,260,utRho21
1063,pbpC,5294986,5294986,5294650,336,28,utRho21
1064,pbpG,4450132,4450132,4449740,392,0,utRho21
1065,pck,7065358,7065636,7065358,278,2214,utRho21
1066,pcnB,318782,318782,318252,530,906,utRho21
1067,pdhR,244068,244184,244068,116,0,utRho21
1068,pdxB,4875768,4875768,4875702,66,0,utRho21
1069,pdxH,3436068,3436068,3436014,54,478,utRho21
1070,pdxJ,5403626,5403626,5403458,168,108,utRho21
1071,pdxK,5074638,5074638,5074474,164,0,utRho21
1072,pepA,8972278,8972278,8971902,376,746,utRho21
1073,pepD,511618,511618,511432,186,14214,utRho21
1074,pepN,1981182,1981244,1981182,62,284,utRho21
1075,pepQ,8062294,8062322,8062294,28,0,utRho21
1076,pepT,2371646,2371688,2371646,42,60,utRho21
1077,pfkA,8214948,8215104,8214948,156,436,utRho21
1078,pfkB,3612646,3612740,3612646,94,46,utRho21
1079,pflA,1902456,1902456,1902160,296,120,utRho21
1080,pflB,1907850,1907850,1907108,742,1912,utRho21
1081,pflD,8287716,8287990,8287716,274,6,utRho21
1082,pgaA,2185046,2185046,2184578,468,4,utRho21
1083,pgi,8467444,8467516,8467444,72,0,utRho21
1084,pgk,12291428,12291428,12290488,940,5312,utRho21
1085,pgl,1597078,1597172,1597078,94,208,utRho21
1086,pgpB,2678324,2678660,2678324,336,0,utRho21
1087,pgpC,5397276,5397276,5397100,176,0,utRho21
1088,pgrR,2783744,2783982,2783744,238,48,utRho21
1089,pheL,5475158,5475198,5475158,40,0,utRho21
1090,pheM,7197204,7197204,7197080,124,116,utRho21
1091,pheP,1203858,1203918,1203858,60,0,utRho21
1092,pheU,8725254,8725254,8725252,2,14,utRho21
1093,pheV,6220730,6220732,6220730,2,12,utRho21
1094,phnC,8650412,8650412,8650330,82,0,utRho21
1095,phoA,803414,803494,803414,80,110,utRho21
1096,phoB,834202,834284,834202,82,30,utRho21
1097,phoE,520316,520316,520200,116,10,utRho21
1098,phoH,2169730,2169984,2169730,254,552,utRho21
1099,phoP,2381016,2381016,2380894,122,4742,utRho21
1100,phoQ,2379880,2379880,2379552,328,1162,utRho21
1101,phoU,7815330,7815330,7815156,174,404,utRho21
1102,phr,1478842,1479014,1478842,172,134,utRho21
1103,pinE,2419054,2419370,2419054,316,0,utRho21
1104,pinQ,3267168,3267244,3267168,76,2,utRho21
1105,pinR,2867424,2867424,2867348,76,0,utRho21
1106,pitA,7275224,7275284,7275224,60,16,utRho21
1107,pitB,6272806,6272806,6272742,64,48,utRho21
1108,pka,5439862,5439906,5439862,44,0,utRho21
1109,plaP,4174476,4174476,4174124,352,2,utRho21
1110,pldA,8009628,8009724,8009628,96,10,utRho21
1111,pldB,8018028,8018340,8018028,312,336,utRho21
1112,plsB,8513196,8513196,8512932,264,122,utRho21
1113,pmbA,8915890,8915918,8915890,28,60,utRho21
1114,pmrD,4747148,4747148,4747076,72,2,utRho21
1115,pncB,1980828,1980828,1980712,116,0,utRho21
1116,pncC,5648788,5648788,5648692,96,0,utRho21
1117,pnp,6622652,6622652,6622336,316,10,utRho21
1118,pntA,3355950,3355950,3355806,144,0,utRho21
1119,pntB,3353096,3353096,3352720,376,158,utRho21
1120,polA,8093880,8093932,8093880,52,56,utRho21
1121,polB,131606,131606,131560,46,0,utRho21
1122,potD,2365700,2365700,2365658,42,0,utRho21
1123,potE,1436688,1436688,1436530,158,0,utRho21
1124,potF,1787268,1787568,1787268,300,0,utRho21
1125,poxB,1822152,1822152,1822098,54,0,utRho21
1126,ppa,8899372,8899372,8899304,68,152,utRho21
1127,ppc,8306380,8306380,8306196,184,440,utRho21
1128,ppdA,5928440,5928440,5928354,86,6,utRho21
1129,ppdD,235410,235410,235098,312,32,utRho21
1130,pphA,3846770,3846770,3845938,832,2362,utRho21
1131,pphB,5719474,5719520,5719474,46,0,utRho21
1132,ppiA,6984898,6984898,6984594,304,0,utRho21
1133,ppiC,7919682,7919682,7919626,56,0,utRho21
1134,ppiD,923638,923830,923638,192,340,utRho21
1135,ppk,5245748,5246088,5245748,340,48,utRho21
1136,pppA,6228958,6228958,6228704,254,344,utRho21
1137,ppsA,3574322,3574322,3574224,98,16,utRho21
1138,ppsR,3574678,3574890,3574678,212,68,utRho21
1139,pptA,3065716,3066104,3065716,388,170,utRho21
1140,pqiA,2023318,2024002,2023318,684,224,utRho21
1141,prc,3830054,3830054,3829632,422,16954,utRho21
1142,preT,4467978,4468066,4467978,88,32,utRho21
1143,prfC,9218688,9218828,9218688,140,1112,utRho21
1144,prkB,6968622,6968980,6968622,358,2650,utRho21
1145,prlC,7290476,7290476,7290364,112,446,utRho21
1146,prlF,6553944,6554004,6553944,60,252,utRho21
1147,proB,520432,520776,520432,344,164,utRho21
1148,proC,811372,811372,811288,84,0,utRho21
1149,proK,7417388,7417388,7417384,4,0,utRho21
1150,proL,4572414,4572422,4572414,8,2,utRho21
1151,proP,8660640,8661004,8660640,364,1268,utRho21
1152,proS,437674,437674,437550,124,178,utRho21
1153,proV,5609126,5609630,5609126,504,40,utRho21
1154,prpB,697292,697364,697292,72,0,utRho21
1155,prpR,696942,696942,696886,56,2,utRho21
1156,prs,2524354,2524354,2523750,604,58694,utRho21
1157,psd,8781276,8781276,8780720,556,1368,utRho21
1158,psiE,8480600,8480650,8480600,50,0,utRho21
1159,pspA,2736076,2736158,2736076,82,0,utRho21
1160,pspF,2736080,2736080,2735824,256,0,utRho21
1161,pspG,8525632,8525680,8525632,48,0,utRho21
1162,pssA,5445156,5445454,5445156,298,7880,utRho21
1163,pstB,7817112,7817112,7816732,380,0,utRho21
1164,pstC,7821084,7821084,7820796,288,108,utRho21
1165,pstS,23469408,23469408,23469150,258,0,utRho21
1166,psuG,4517114,4517114,4516734,380,2174,utRho21
1167,psuT,4514992,4514992,4514670,322,0,utRho21
1168,pth,2517084,2517084,2517026,58,0,utRho21
1169,ptrA,5918022,5918022,5917768,254,32,utRho21
1170,ptrB,3857730,3857730,3857678,52,146,utRho21
1171,ptsG,2315252,2315738,2315252,486,1268,utRho21
1172,ptsH,5066996,5067528,5066996,532,6626,utRho21
1173,purA,8809328,8809374,8809328,46,0,utRho21
1174,purC,5195562,5195562,5195236,326,4,utRho21
1175,purD,8411972,8411972,8411862,110,0,utRho21
1176,purE,1106284,1106284,1106200,84,154,utRho21
1177,purH,8415254,8415254,8415064,190,196,utRho21
1178,purL,5391178,5391178,5391086,92,546,utRho21
1179,purM,5242306,5242394,5242306,88,0,utRho21
1180,purR,3475378,3475688,3475378,310,446,utRho21
1181,purT,3861438,3861762,3861438,324,0,utRho21
1182,purU,2577512,2577512,2577248,264,596,utRho21
1183,putA,2157850,2157850,2157764,86,78,utRho21
1184,putP,2158336,2158610,2158336,274,1246,utRho21
1185,puuA,2721936,2721936,2721816,120,0,utRho21
1186,puuC,2725456,2725486,2725456,30,0,utRho21
1187,puuD,2722104,2722240,2722104,136,0,utRho21
1188,puuP,2718746,2718746,2718374,372,584,utRho21
1189,pykA,3874988,3875298,3874988,310,214,utRho21
1190,pykF,3510934,3511396,3510934,462,1904,utRho21
1191,pyrC,2245286,2245286,2245214,72,196,utRho21
1192,pyrD,2009464,2009536,2009464,72,16,utRho21
1193,pyrE,7631970,7631970,7631536,434,90,utRho21
1194,pyrF,2683740,2683842,2683740,102,18,utRho21
1195,pyrG,5819594,5819594,5819332,262,946,utRho21
1196,pyrH,383624,383710,383624,86,1112,utRho21
1197,pyrL,8945490,8945490,8945066,424,446,utRho21
1198,qmcA,1031646,1031646,1031546,100,0,utRho21
1199,qor,8528608,8528608,8528462,146,104,utRho21
1200,qseB,6339502,6339656,6339502,154,164,utRho21
1201,queA,849970,850022,849970,52,100,utRho21
1202,queE,5811212,5811212,5810836,376,0,utRho21
1203,queF,5850642,5850696,5850642,54,0,utRho21
1204,queG,8788184,8788184,8788134,50,6034,utRho21
1205,racC,2835630,2835630,2835526,104,0,utRho21
1206,racR,2840898,2840898,2840482,416,90,utRho21
1207,raiA,5474208,5474308,5474208,100,438,utRho21
1208,rarD,8008594,8008594,8008356,238,890,utRho21
1209,ravA,7862256,7862256,7862186,70,0,utRho21
1210,rayT,495088,495274,495088,186,0,utRho21
1211,rbn,4763162,4763216,4763162,54,0,utRho21
1212,rbsD,7866644,7866702,7866644,58,46,utRho21
1213,rcnA,4371654,4371834,4371654,180,10,utRho21
1214,rcnB,4373768,4373920,4373768,152,290,utRho21
1215,rcnR,4371806,4371806,4371592,214,20,utRho21
1216,rcsA,4047672,4047936,4047672,264,146,utRho21
1217,rcsB,4631390,4632354,4631390,964,2624,utRho21
1218,rcsC,4640162,4640162,4639656,506,580,utRho21
1219,rcsD,4626904,4626976,4626904,72,198,utRho21
1220,rdgB,6193240,6193362,6193240,122,990,utRho21
1221,rdlA,2538646,2538646,2538646,0,0,utRho21
1222,rdlB,2539712,2539716,2539712,4,0,utRho21
1223,rdlC,2540782,2540786,2540782,4,0,utRho21
1224,rdlD,7400272,7400272,7400272,0,0,utRho21
1225,rdoA,8084782,8084830,8084782,48,148,utRho21
1226,recA,11295276,11295276,11295076,200,552,utRho21
1227,recC,5925014,5925014,5924856,158,16,utRho21
1228,recF,7763722,7763722,7762442,1280,11010,utRho21
1229,recN,5503518,5503590,5503518,72,94,utRho21
1230,recQ,8011666,8011728,8011666,62,0,utRho21
1231,relA,5828554,5828554,5827302,1252,216,utRho21
1232,relB,3291806,3291806,3291744,62,0,utRho21
1233,rem,3289950,3289950,3289804,146,0,utRho21
1234,rep,7921294,7921354,7921294,60,64,utRho21
1235,rfaD,7587730,7587974,7587730,244,146,utRho21
1236,rfaE,6393852,6393852,6393506,346,636,utRho21
1237,rfaH,8049930,8049930,8049642,288,1112,utRho21
1238,rfbX,4219436,4219436,4219168,268,1262,utRho21
1239,rfe,7935600,7935832,7935600,232,24,utRho21
1240,rhaB,8194944,8194944,8194896,48,0,utRho21
1241,rhaD,8188770,8188770,8188544,226,0,utRho21
1242,rhaS,8195422,8195472,8195422,50,0,utRho21
1243,rhaT,8201132,8201132,8201050,82,8,utRho21
1244,rhlE,1661566,1661744,1661566,178,0,utRho21
1245,rhoL,47593944,47594772,47593944,828,44280,utRho21
1246,rhsB,7238006,7238384,7238006,378,28,utRho21
1247,rhsC,1458758,1459166,1458758,408,0,utRho21
1248,rhsD,1046132,1046522,1046132,390,0,utRho21
1249,rhtA,1700608,1700608,1700194,414,76,utRho21
1250,rhtC,8015478,8015514,8015478,36,620,utRho21
1251,ribA,2678468,2678468,2678320,148,0,utRho21
1252,ribC,3486916,3486916,3486484,432,248,utRho21
1253,ribE,869008,869294,869008,286,7750,utRho21
1254,ribF,42766,42814,42766,48,36,utRho21
1255,ridA,8941892,8941892,8941826,66,0,utRho21
1256,rihA,1369204,1369204,1368824,380,40,utRho21
1257,rihB,4510504,4510504,4510372,132,0,utRho21
1258,rimJ,2251044,2251124,2251044,80,0,utRho21
1259,rimK,1783752,1783934,1783752,182,490,utRho21
1260,rimL,2997486,2997876,2997486,390,598,utRho21
1261,rimO,1756140,1756140,1756070,70,0,utRho21
1262,rimP,6636350,6636350,6636012,338,1622,utRho21
1263,rlmA,3814172,3814172,3814120,52,72,utRho21
1264,rlmD,5830086,5830086,5830000,86,120,utRho21
1265,rlmE,6655520,6655520,6655328,192,286,utRho21
1266,rlmF,1684384,1684664,1684384,280,0,utRho21
1267,rlmG,6471784,6471784,6471750,34,18,utRho21
1268,rlmI,2060002,2060002,2059938,64,30,utRho21
1269,rlmJ,7290700,7290770,7290700,70,0,utRho21
1270,rlmL,2015344,2015688,2015344,344,716,utRho21
1271,rlpA,1330444,1330444,1330380,64,146,utRho21
1272,rluA,120900,120900,120692,208,154,utRho21
1273,rluF,8460324,8460708,8460324,384,2,utRho21
1274,rmf,2031006,2031430,2031006,424,274,utRho21
1275,rna,1290068,1290068,1290006,62,0,utRho21
1276,rnb,2698258,2698258,2697824,434,2440,utRho21
1277,rnc,10816892,10816892,10816252,640,4808,utRho21
1278,rnd,3776122,3776122,3775982,140,84,utRho21
1279,rne,2289746,2289746,2288734,1012,13490,utRho21
1280,rnhA,472082,472082,472004,78,1096,utRho21
1281,rnk,1288360,1288360,1287934,426,0,utRho21
1282,rnlA,5531788,5531836,5531788,48,0,utRho21
1283,rnlB,5533414,5533968,5533414,554,718,utRho21
1284,rnpB,19623552,19623552,19623552,0,0,utRho21
1285,rob,9270706,9270706,9270620,86,54,utRho21
1286,rodZ,5285868,5285868,5285688,180,38,utRho21
1287,rpe,7030306,7030306,7030118,188,360,utRho21
1288,rph,15266320,15266320,15266196,124,0,utRho21
1289,rpiA,6118706,6118706,6118650,56,92,utRho21
1290,rpiB,8626514,8626700,8626514,186,2,utRho21
1291,rpiR,8626274,8626274,8625982,292,0,utRho21
1292,rplJ,8359246,8359992,8359246,746,5274,utRho21
1293,rplK,8356708,8356894,8356708,186,436,utRho21
1294,rplM,6757344,6757344,6757302,42,1684,utRho21
1295,rplN,6896444,6896444,6896298,146,1470,utRho21
1296,rplS,5489284,5489284,5489060,224,6620,utRho21
1297,rplT,7199052,7199052,7198996,56,336,utRho21
1298,rplU,6667036,6667036,6666902,134,0,utRho21
1299,rplY,4564866,4565034,4564866,168,0,utRho21
1300,rpmA,6666450,6666450,6666238,212,468,utRho21
1301,rpmB,15247980,15247980,15246696,1284,56048,utRho21
1302,rpmE,8253816,8254026,8253816,210,146,utRho21
1303,rpmF,2294676,2294734,2294676,58,17034,utRho21
1304,rpmH,7768130,7768672,7768130,542,2584,utRho21
1305,rpmI,3600854,3600854,3599998,856,8726,utRho21
1306,rpoB,8362126,8362490,8362126,364,364,utRho21
1307,rpoD,6424946,6426094,6424946,1148,32706,utRho21
1308,rpoE,5420372,5420372,5420024,348,114,utRho21
1309,rpoH,7202006,7202006,7201566,440,5524,utRho21
1310,rpoN,6689324,6689434,6689324,110,158,utRho21
1311,rpoS,5736236,5736236,5735102,1134,16920,utRho21
1312,rpoZ,7644154,7644212,7644154,58,908,utRho21
1313,rppH,5937986,5937986,5937954,32,0,utRho21
1314,rprA,3540744,3540744,3540744,0,0,utRho21
1315,rpsA,1923434,1923990,1923434,556,64858,utRho21
1316,rpsF,8850050,8850236,8850050,186,7078,utRho21
1317,rpsI,6756580,6756580,6756414,166,3482,utRho21
1318,rpsJ,6906884,6906884,6906540,344,2012,utRho21
1319,rpsL,6949242,6949242,6949104,138,126,utRho21
1320,rpsM,6885130,6885130,6884942,188,588,utRho21
1321,rpsO,13247144,13247144,13246736,408,16,utRho21
1322,rpsP,5492508,5492508,5492370,138,18,utRho21
1323,rpsT,42420,42420,42156,264,178,utRho21
1324,rpsU,12842584,12843124,12842584,540,184,utRho21
1325,rraA,8238716,8238716,8238660,56,8,utRho21
1326,rraB,8956768,8956946,8956768,178,0,utRho21
1327,rrsA,8070478,8071062,8070478,584,7902,utRho21
1328,rrsB,16665468,16666636,16665468,1168,15492,utRho21
1329,rrsC,7883032,7883616,7883032,584,6782,utRho21
1330,rrsD,6858094,6858094,6857524,570,584,utRho21
1331,rrsE,8415726,8416294,8415726,568,1274,utRho21
1332,rrsG,5462896,5462896,5462314,582,7570,utRho21
1333,rrsH,446970,447542,446970,572,1308,utRho21
1334,rsd,8393908,8393908,8393616,292,168,utRho21
1335,rseA,5419264,5419264,5418808,456,1380,utRho21
1336,rseP,392940,393092,392940,152,0,utRho21
1337,rseX,4067298,4067298,4067298,0,0,utRho21
1338,rsfS,1338144,1338144,1338072,72,64,utRho21
1339,rsgA,8783132,8783132,8783018,114,132,utRho21
1340,rsmA,105176,105176,104860,316,3332,utRho21
1341,rsmB,6869982,6870414,6869982,432,314,utRho21
1342,rsmC,9215736,9215736,9215400,336,480,utRho21
1343,rsmD,7208594,7208786,7208594,192,138,utRho21
1344,rsmE,6182036,6182268,6182036,232,170,utRho21
1345,rsmG,7847512,7847512,7847360,152,126,utRho21
1346,rsmH,180020,180188,180020,168,482,utRho21
1347,rsmI,6587106,6587106,6586670,436,1566,utRho21
1348,rssA,2578212,2578412,2578212,200,198,utRho21
1349,rssB,2580440,2580484,2580440,44,274,utRho21
1350,rstA,3364276,3364300,3364276,24,0,utRho21
1351,rsuA,4561096,4561096,4560966,130,208,utRho21
1352,rsxA,3411510,3411534,3411510,24,18,utRho21
1353,rtcA,7114004,7114004,7113698,306,4,utRho21
1354,rtcB,7116214,7116214,7116158,56,20,utRho21
1355,rtn,4541356,4541452,4541356,96,0,utRho21
1356,rutA,2148052,2148052,2148022,30,0,utRho21
1357,rutG,2140090,2140090,2139678,412,46,utRho21
1358,rutR,2148226,2148484,2148226,258,2,utRho21
1359,ruvA,7784096,7784096,7783904,192,40,utRho21
1360,ruvB,7782176,7782176,7781424,752,812,utRho21
1361,ruvC,3894878,3894878,3894752,126,0,utRho21
1362,rybB,1776114,1776114,1776114,0,0,utRho21
1363,rydB,3529860,3529860,3529322,538,210,utRho21
1364,rydC,2983012,2983012,2983012,0,0,utRho21
1365,ryfA,5307398,5307710,5307398,312,0,utRho21
1366,ryfD,5468590,5468590,5468590,0,0,utRho21
1367,ryhB,7162032,7162032,7162032,0,0,utRho21
1368,ryjA,8556132,8556132,8556132,0,0,utRho21
1369,ryjB,9055954,9055954,9055954,0,0,utRho21
1370,sad,3229598,3229598,3229406,192,268,utRho21
1371,safA,3168056,3168056,3167918,138,2,utRho21
1372,sanA,4465368,4465756,4465368,388,0,utRho21
1373,sapF,2705314,2705314,2705268,46,0,utRho21
1374,sbcB,4165456,4165512,4165456,56,18,utRho21
1375,sbcC,831694,831694,831506,188,138,utRho21
1376,sbcD,833954,833954,833904,50,0,utRho21
1377,sbmA,793106,793278,793106,172,2,utRho21
1378,sbmC,4162650,4162650,4162524,126,0,utRho21
1379,sdaA,3793618,3793864,3793618,246,1614,utRho21
1380,sdaC,5856070,5856458,5856070,388,1312,utRho21
1381,sdhC,1509916,1510354,1509916,438,39990,utRho21
1382,sdhD,1510808,1511120,1510808,312,15444,utRho21
1383,sdiA,3993834,3993834,3993664,170,16,utRho21
1384,secE,8354354,8354716,8354354,362,80,utRho21
1385,secG,6645180,6645180,6645010,170,578,utRho21
1386,selA,7522594,7522594,7522498,96,286,utRho21
1387,selB,7519850,7519850,7519722,128,776,utRho21
1388,selC,7672396,7672444,7672396,48,0,utRho21
1389,selD,3696058,3696058,3696016,42,6416,utRho21
1390,seqA,1425884,1425974,1425884,90,374,utRho21
1391,serA,6117098,6117098,6116820,278,2,utRho21
1392,serB,9249712,9249790,9249712,78,212,utRho21
1393,serC,3830380,3830612,3830380,232,0,utRho21
1394,serS,1878730,1878856,1878730,126,1062,utRho21
1395,serT,2063438,2063438,2063424,14,0,utRho21
1396,serU,4087124,4087124,4087114,10,106,utRho21
1397,serV,5637394,5637394,5637290,104,2,utRho21
1398,serW,1852014,1852014,1851942,72,346,utRho21
1399,serX,2195352,2195352,2195304,48,60,utRho21
1400,setB,4527426,4527726,4527426,300,0,utRho21
1401,setC,7673488,7673906,7673488,418,14,utRho21
1402,sfmA,1116124,1116424,1116124,300,0,utRho21
1403,sfmC,1117606,1117948,1117606,342,34,utRho21
1404,sfsA,323030,323030,322972,58,546,utRho21
1405,sfsB,6669592,6669818,6669592,226,158,utRho21
1406,sgrR,154676,154676,154598,78,0,utRho21
1407,sgrS,154734,154734,154734,0,0,utRho21
1408,shiA,4107068,4107286,4107068,218,0,utRho21
1409,sibA,4306622,4306622,4306622,0,0,utRho21
1410,sibB,4307292,4307292,4307292,0,0,utRho21
1411,sibC,6113702,6113702,6113702,0,0,utRho21
1412,sibD,6389730,6389730,6389730,0,0,utRho21
1413,sibE,6390480,6390480,6390480,0,0,utRho21
1414,sixA,4913998,4913998,4913624,374,54,utRho21
1415,slp,7307872,7307922,7307872,50,0,utRho21
1416,slt,9261400,9261466,9261400,66,0,utRho21
1417,slyA,3442028,3442028,3441648,380,60,utRho21
1418,slyB,3439496,3439752,3439496,256,44,utRho21
1419,slyD,6957398,6957398,6956994,404,1470,utRho21
1420,slyX,6954862,6955280,6954862,418,3524,utRho21
1421,smf,6867372,6867372,6867120,252,26,utRho21
1422,smpB,5509534,5509792,5509534,258,982,utRho21
1423,smrA,2811872,2811958,2811872,86,418,utRho21
1424,smrB,4896872,4897212,4896872,340,268,utRho21
1425,smtA,1946808,1947074,1946808,266,0,utRho21
1426,sodA,8201518,8201620,8201518,102,18494,utRho21
1427,sodB,3470646,3470756,3470646,110,98,utRho21
1428,sodC,3449358,3449358,3449310,48,176,utRho21
1429,sohB,2658568,2658664,2658568,96,0,utRho21
1430,sokB,2984232,2984238,2984232,6,244,utRho21
1431,solA,2241218,2241218,2241172,46,0,utRho21
1432,soxR,8554894,8554938,8554894,44,102,utRho21
1433,soxS,8554846,8554846,8554766,80,0,utRho21
1434,speA,6172096,6172096,6171822,274,4,utRho21
1435,speB,6167892,6167892,6167594,298,26,utRho21
1436,speC,6218350,6218350,6218310,40,0,utRho21
1437,spf,8099798,8099798,8099798,0,0,utRho21
1438,sppA,3697422,3697674,3697422,252,4,utRho21
1439,spy,3651376,3651376,3651250,126,0,utRho21
1440,sra,3112092,3112092,3111926,166,176,utRho21
1441,sraB,2293178,2293178,2293178,0,0,utRho21
1442,sraC,3846132,3846132,3846132,0,0,utRho21
1443,srlA,5651582,5651664,5651582,82,52,utRho21
1444,srlR,5657720,5658094,5657720,374,23568,utRho21
1445,srmB,5425752,5425792,5425752,40,544,utRho21
1446,sroA,151216,151216,151216,0,0,utRho21
1447,sroG,6369436,6369436,6369436,0,0,utRho21
1448,sroH,8380974,8380974,8380974,0,0,utRho21
1449,ssb,8548022,8548250,8548022,228,0,utRho21
1450,sseA,5304782,5304988,5304782,206,14502,utRho21
1451,sspA,6755138,6755138,6754840,298,1056,utRho21
1452,ssrA,5511014,5511186,5511014,172,350,utRho21
1453,ssrS,12223036,12223932,12223036,896,2768,utRho21
1454,sstT,6479726,6479888,6479726,162,0,utRho21
1455,ssuB,1988282,1988282,1988088,194,66,utRho21
1456,ssuE,1995126,1995126,1995024,102,0,utRho21
1457,sthA,8321604,8321604,8321580,24,5390,utRho21
1458,stpA,5597156,5597156,5596990,166,0,utRho21
1459,sucA,3034344,3034824,3034344,480,5960,utRho21
1460,sufA,3528836,3528836,3528772,64,728,utRho21
1461,sufE,3518962,3518962,3518580,382,2634,utRho21
1462,sugE,8753588,8753750,8753588,162,908,utRho21
1463,sulA,2041894,2041894,2041838,56,38,utRho21
1464,syd,5850738,5850738,5850560,178,116,utRho21
1465,symE,9159834,9159834,9159680,154,2,utRho21
1466,symR,9159670,9159670,9159670,0,0,utRho21
1467,tabA,8949566,8949724,8949566,158,0,utRho21
1468,talA,5157140,5157332,5157140,192,0,utRho21
1469,talB,16382,16476,16382,94,28372,utRho21
1470,tam,3214442,3214692,3214442,250,696,utRho21
1471,tamA,8884540,8884764,8884540,224,52,utRho21
1472,tar,3945432,3945432,3945382,50,0,utRho21
1473,tas,5943138,5943194,5943138,56,346,utRho21
1474,tatA,16087636,16087780,16087636,144,0,utRho21
1475,tatE,1317742,1317894,1317742,152,2,utRho21
1476,tauA,770410,770464,770410,54,0,utRho21
1477,tdcA,6534186,6534186,6534130,56,0,utRho21
1478,tdcG,6519652,6519652,6519298,354,166,utRho21
1479,tdcR,6534380,6534760,6534380,380,0,utRho21
1480,tdk,2586986,2587054,2586986,68,48,utRho21
1481,tehA,3001072,3001146,3001072,74,0,utRho21
1482,tesA,1039898,1039898,1039530,368,146,utRho21
1483,tesB,950402,950402,950322,80,0,utRho21
1484,tfaE,2418532,2418532,2418238,294,4,utRho21
1485,tfaQ,3269912,3269912,3269770,142,0,utRho21
1486,tff,379424,379256,379424,168,228,utRho21
1487,tgt,852110,852274,852110,164,174,utRho21
1488,thiD,4369346,4369346,4369032,314,0,utRho21
1489,thiI,882936,883098,882936,162,124,utRho21
1490,thiM,4370902,4370902,4370602,300,374,utRho21
1491,thiQ,146170,146170,145854,316,196,utRho21
1492,thrL,592,760,592,168,544,utRho21
1493,thrS,7210932,7210932,7210280,652,424,utRho21
1494,thrU,8350762,8350776,8350762,14,0,utRho21
1495,thrV,6847414,6847414,6847310,104,332690,utRho21
1496,thrW,525682,525742,525682,60,294,utRho21
1497,thyA,5930696,5930696,5930310,386,2174,utRho21
1498,tig,909986,910266,909986,280,604,utRho21
1499,tisB,7706674,7707106,7706674,432,930,utRho21
1500,tktA,6163414,6163414,6163270,144,176,utRho21
1501,tktB,5158616,5159272,5158616,656,62634,utRho21
1502,tldD,6784368,6784368,6784056,312,60,utRho21
1503,tmcA,5191876,5191876,5191718,158,6,utRho21
1504,tnaC,15553644,15553740,15553644,96,63912,utRho21
1505,tolB,1555074,1555480,1555074,406,270,utRho21
1506,tolC,6356008,6356230,6356008,222,146,utRho21
1507,tomB,961588,961588,961416,172,698,utRho21
1508,tonB,2622108,2622178,2622108,70,0,utRho21
1509,topA,2661578,2662096,2661578,518,230,utRho21
1510,torC,2116112,2116168,2116112,56,256,utRho21
1511,torR,2115968,2115968,2115908,60,740,utRho21
1512,torS,2112364,2112364,2112356,8,0,utRho21
1513,torT,2112414,2112522,2112414,108,0,utRho21
1514,tpiA,8223138,8223138,8223014,124,270,utRho21
1515,tppB,3425342,3425538,3425342,196,1346,utRho21
1516,tpr,2574376,2574376,2574376,0,0,utRho21
1517,tpx,2777688,2777688,2777622,66,1112,utRho21
1518,tqsA,3347780,3347826,3347780,46,0,utRho21
1519,treA,2494850,2494850,2494752,98,6,utRho21
1520,treB,8932420,8932420,8932360,60,0,utRho21
1521,treF,7339102,7339184,7339102,82,0,utRho21
1522,treR,8934694,8934694,8934492,202,0,utRho21
1523,trg,2984878,2984940,2984878,62,0,utRho21
1524,trkG,2847342,2847564,2847342,222,0,utRho21
1525,trmA,8326590,8326590,8326540,50,128,utRho21
1526,trpA,2634678,2634678,2634444,234,786,utRho21
1527,trpC,2639888,2639888,2639570,318,72,utRho21
1528,trpL,5292432,5292432,5292328,104,0,utRho21
1529,trpR,9265408,9265520,9265408,112,524,utRho21
1530,trpS,7027394,7027394,7027276,118,3128,utRho21
1531,trpT,7893560,7893914,7893560,354,124984,utRho21
1532,trxA,7931294,7931522,7931294,228,724,utRho21
1533,trxB,1864156,1864156,1864100,56,0,utRho21
1534,trxC,5437350,5437470,5437350,120,592,utRho21
1535,tsaD,6421256,6421256,6421086,170,156,utRho21
1536,tsgA,6985038,6985136,6985038,98,2,utRho21
1537,tsr,9182824,9183314,9182824,490,6,utRho21
1538,tsx,864490,864490,864026,464,518,utRho21
1539,ttcA,2823970,2823970,2823896,74,1128,utRho21
1540,ttdA,6412848,6412926,6412848,78,0,utRho21
1541,ttdR,6412760,6412760,6412512,248,0,utRho21
1542,tufA,6943448,6943448,6942658,790,102730,utRho21
1543,tus,3368346,3368518,3368346,172,20,utRho21
1544,tusA,7218040,7218040,7217992,48,208,utRho21
1545,tusB,6950218,6950218,6949930,288,630,utRho21
1546,tynA,2902996,2902996,2902698,298,0,utRho21
1547,typA,8116460,8116814,8116460,354,2234,utRho21
1548,tyrB,8534164,8534228,8534164,64,2068,utRho21
1549,tyrP,3979004,3979362,3979004,358,0,utRho21
1550,tyrR,2773384,2773440,2773384,56,66,utRho21
1551,tyrS,3434566,3434566,3434444,122,52,utRho21
1552,tyrT,2575330,2575330,2575244,86,170,utRho21
1553,uacT,6062378,6062734,6062378,356,104,utRho21
1554,ubiC,8504886,8505012,8504886,126,0,utRho21
1555,ubiD,8049618,8049976,8049618,358,1212,utRho21
1556,ubiE,8037494,8037710,8037494,216,2,utRho21
1557,ubiG,4679078,4679134,4679078,56,0,utRho21
1558,ucpA,5089342,5089342,5089246,96,0,utRho21
1559,udp,8032782,8032862,8032782,80,180,utRho21
1560,ugd,4199470,4199470,4199226,244,0,utRho21
1561,ugpB,7184852,7184852,7184650,202,958,utRho21
1562,ugpQ,7176600,7176600,7176226,374,366,utRho21
1563,uhpT,7694396,7694396,7694334,62,0,utRho21
1564,uidA,3392304,3392304,3392142,162,0,utRho21
1565,uidC,3386012,3386012,3385702,310,60,utRho21
1566,uidR,3394150,3394150,3394104,46,332,utRho21
1567,ulaA,8839854,8839960,8839854,106,0,utRho21
1568,ulaG,8839350,8839350,8839250,100,0,utRho21
1569,ulaR,8837124,8837124,8836906,218,122,utRho21
1570,umpG,5741372,5741372,5740548,824,794,utRho21
1571,umpH,1400704,1400704,1400652,52,14,utRho21
1572,umuD,2461476,2461534,2461476,58,0,utRho21
1573,ung,5433476,5433508,5433476,32,0,utRho21
1574,uof,2843316,2843316,2842900,416,7752,utRho21
1575,upp,5241818,5241818,5241744,74,152,utRho21
1576,usg,4873780,4873780,4873298,482,384,utRho21
1577,ushA,1009772,1009828,1009772,56,0,utRho21
1578,uspA,7279966,7280222,7279966,256,1958,utRho21
1579,uspB,7279696,7279696,7279440,256,818,utRho21
1580,uspC,3959172,3959506,3959172,334,0,utRho21
1581,uspE,2797318,2797318,2797244,74,52,utRho21
1582,uspF,2871282,2871282,2871238,44,0,utRho21
1583,uspG,1283806,1283806,1283734,72,1058,utRho21
1584,uvrA,8547872,8547872,8547742,130,352,utRho21
1585,uvrB,1626304,1627052,1626304,748,3030,utRho21
1586,uvrC,3989758,3989758,3989412,346,396,utRho21
1587,uvrD,7995814,7995966,7995814,152,86,utRho21
1588,uvrY,3990812,3990812,3990718,94,76,utRho21
1589,uxaB,3221474,3221474,3221360,114,42,utRho21
1590,uxaC,6489714,6489714,6489482,232,90,utRho21
1591,uxuA,9103036,9103272,9103036,236,1130,utRho21
1592,uxuR,9108916,9109152,9108916,236,12,utRho21
1593,valS,8967854,8967854,8967674,180,768,utRho21
1594,valU,5041848,5041862,5041848,14,0,utRho21
1595,valV,3492830,3492870,3492830,40,0,utRho21
1596,ves,3649968,3649968,3649874,94,0,utRho21
1597,waaA,7616512,7617080,7616512,568,148,utRho21
1598,waaH,7580298,7580298,7580162,136,0,utRho21
1599,waaQ,7616476,7616476,7616196,280,132,utRho21
1600,waaU,7598996,7598996,7598624,372,96,utRho21
1601,waaY,7602272,7602272,7601930,342,2896,utRho21
1602,wbbH,4214888,4214888,4214452,436,3878,utRho21
1603,wbbK,4209212,4209212,4209018,194,298,utRho21
1604,wcaM,4231868,4231868,4231792,76,0,utRho21
1605,wrbA,2135516,2135516,2135416,100,0,utRho21
1606,wza,4275166,4275166,4274486,680,0,utRho21
1607,wzxC,4240674,4240674,4240316,358,0,utRho21
1608,wzzB,4196950,4196950,4196602,348,0,utRho21
1609,xanP,7657642,7657890,7657642,248,0,utRho21
1610,xanQ,6048520,6048702,6048520,182,0,utRho21
1611,xapA,5049820,5049820,5049756,64,0,utRho21
1612,xapR,10090252,10090252,10089908,344,168,utRho21
1613,xdhA,6000514,6000690,6000514,176,128,utRho21
1614,xerD,6079702,6079702,6079486,216,0,utRho21
1615,xseA,5268394,5268464,5268394,70,0,utRho21
1616,xseB,882746,882746,882686,60,512,utRho21
1617,xthA,3664798,3664856,3664798,58,0,utRho21
1618,xylA,7461614,7461614,7461530,84,1532,utRho21
1619,xylE,8484540,8484540,8484508,32,0,utRho21
1620,xylF,7462138,7462262,7462138,124,0,utRho21
1621,xylR,7469812,7469958,7469812,146,0,utRho21
1622,yaaA,13230,13230,12918,312,80,utRho21
1623,yaaI,23876,23876,23572,304,4,utRho21
1624,yaaJ,16034,16034,15918,116,84,utRho21
1625,yaaU,91184,91614,91184,430,4,utRho21
1626,yaaW,23084,23084,22712,372,4,utRho21
1627,yaaX,10060,10468,10060,408,98,utRho21
1628,yabI,142542,142702,142542,160,436,utRho21
1629,yacC,273880,273880,273834,46,336,utRho21
1630,yacH,262932,262932,262520,412,136,utRho21
1631,yacL,268678,268776,268678,98,4,utRho21
1632,yadD,293796,293936,293796,140,0,utRho21
1633,yadE,289930,290162,289930,232,586,utRho21
1634,yadN,314110,314110,313766,344,0,utRho21
1635,yadS,355572,355572,355248,324,18,utRho21
1636,yadV,312470,312470,312402,68,248,utRho21
1637,yaeF,434270,434270,434006,264,0,utRho21
1638,yaeP,428374,428374,428250,124,0,utRho21
1639,yaeQ,428176,428582,428176,406,84,utRho21
1640,yaeR,423716,423754,423716,38,260,utRho21
1641,yafC,462166,462166,461762,404,300,utRho21
1642,yafD,462128,462244,462128,116,4,utRho21
1643,yafK,491986,491986,491610,376,998,utRho21
1644,yafL,493282,493424,493282,142,30,utRho21
1645,yafN,503938,504010,503938,72,0,utRho21
1646,yafS,469568,469632,469568,64,1292,utRho21
1647,yafT,474470,474670,474470,200,0,utRho21
1648,yafV,480432,480432,480378,54,36,utRho21
1649,yafZ,536052,536052,536010,42,120,utRho21
1650,yagE,564446,564556,564446,110,2,utRho21
1651,yagG,570414,570790,570414,376,8,utRho21
1652,yagI,578384,578384,578324,60,0,utRho21
1653,yagK,586236,586236,585896,340,84,utRho21
1654,yagL,588062,588062,587836,226,4,utRho21
1655,yagN,591342,591342,591158,184,4574,utRho21
1656,yahA,663746,664742,663746,996,364,utRho21
1657,yahC,670136,670136,670044,92,10,utRho21
1658,yahE,671478,671850,671478,372,0,utRho21
1659,yahM,690504,690808,690504,304,18,utRho21
1660,yahN,692872,692872,692674,198,78,utRho21
1661,yahO,692864,692968,692864,104,78,utRho21
1662,yaiE,816296,816354,816296,58,244,utRho21
1663,yaiI,811396,811528,811396,132,0,utRho21
1664,yaiO,761946,761946,761684,262,16,utRho21
1665,yaiP,767970,767970,767870,100,0,utRho21
1666,yaiS,769660,769660,769232,428,12,utRho21
1667,yaiV,788922,788922,788922,0,0,utRho21
1668,yaiY,799094,799094,798666,428,12,utRho21
1669,yaiZ,798888,799186,798888,298,0,utRho21
1670,yajC,854410,854574,854410,164,802,utRho21
1671,yajD,860938,861210,860938,272,372,utRho21
1672,yajI,866068,866068,865702,366,682,utRho21
1673,yajL,887496,887496,887282,214,772,utRho21
1674,yajQ,889316,889366,889316,50,114,utRho21
1675,yajR,893374,893374,893332,42,0,utRho21
1676,ybaB,987418,988152,987418,734,2348,utRho21
1677,ybaL,1006590,1006590,1006476,114,4,utRho21
1678,ybaM,980648,980648,980542,106,252,utRho21
1679,ybaN,981436,981764,981436,328,1070,utRho21
1680,ybaO,936704,936766,936704,62,0,utRho21
1681,ybaP,1016568,1016568,1016160,408,1454,utRho21
1682,ybaQ,1016348,1016436,1016348,88,58,utRho21
1683,ybaS,1023146,1023282,1023146,136,446,utRho21
1684,ybaV,927504,927874,927504,370,2,utRho21
1685,ybaY,950490,950758,950490,268,2938,utRho21
1686,ybbB,1062724,1062724,1062452,272,68,utRho21
1687,ybbJ,1030154,1030154,1029718,436,560,utRho21
1688,ybbL,1031784,1031838,1031784,54,0,utRho21
1689,ybbN,1037136,1037136,1036558,578,2804,utRho21
1690,ybbO,1038658,1038658,1038298,360,1486,utRho21
1691,ybbY,1080718,1081130,1080718,412,1526,utRho21
1692,ybcH,1176140,1176140,1175962,178,2,utRho21
1693,ybcI,1113264,1113264,1113106,158,112,utRho21
1694,ybcJ,1114050,1114050,1113746,304,328,utRho21
1695,ybcK,1137502,1137804,1137502,302,2,utRho21
1696,ybcL,1141690,1141786,1141690,96,0,utRho21
1697,ybcN,1144628,1144932,1144628,304,0,utRho21
1698,ybcQ,1147548,1147912,1147548,364,14,utRho21
1699,ybcW,1159610,1159760,1159610,150,0,utRho21
1700,ybdD,1263982,1264364,1263982,382,278,utRho21
1701,ybdF,1212106,1212106,1211772,334,170,utRho21
1702,ybdH,1267048,1267048,1266954,94,0,utRho21
1703,ybdJ,1212822,1212822,1212398,424,2,utRho21
1704,ybdK,1215122,1215122,1214766,356,4,utRho21
1705,ybdL,1267114,1267172,1267114,58,0,utRho21
1706,ybdM,1271110,1271110,1270752,358,10,utRho21
1707,ybdN,1273372,1273372,1273138,234,0,utRho21
1708,ybdR,1283844,1284176,1283844,332,1288,utRho21
1709,ybeD,1325412,1325412,1325284,128,220,utRho21
1710,ybeF,1323090,1323090,1322756,334,56,utRho21
1711,ybeL,1349986,1350036,1349986,50,950,utRho21
1712,ybeQ,1353412,1353412,1353094,318,0,utRho21
1713,ybeR,1353120,1353422,1353120,302,0,utRho21
1714,ybeT,1358832,1358832,1358812,20,0,utRho21
1715,ybeU,1358924,1359016,1358924,92,0,utRho21
1716,ybeZ,1386938,1386938,1386834,104,1142,utRho21
1717,ybfA,1458074,1458268,1458074,194,6,utRho21
1718,ybfE,1423878,1423878,1423796,82,20,utRho21
1719,ybfF,1425692,1425692,1425604,88,228,utRho21
1720,ybfH,1433282,1433282,1433194,88,0,utRho21
1721,ybgA,1477840,1478002,1477840,162,0,utRho21
1722,ybgC,1549288,1549504,1549288,216,0,utRho21
1723,ybgD,1505916,1505916,1505590,326,12,utRho21
1724,ybgI,1485238,1485654,1485238,416,0,utRho21
1725,ybgO,1498370,1498370,1497964,406,0,utRho21
1726,ybgS,1570992,1570992,1570634,358,1372,utRho21
1727,ybhA,1597184,1597184,1596862,322,208,utRho21
1728,ybhB,1616070,1616070,1615818,252,60,utRho21
1729,ybhC,1614642,1614642,1614562,80,3112,utRho21
1730,ybhD,1601418,1601418,1601276,142,0,utRho21
1731,ybhH,1601104,1601518,1601104,414,0,utRho21
1732,ybhK,1633384,1633384,1633294,90,2,utRho21
1733,ybhM,1641556,1641586,1641556,30,0,utRho21
1734,ybhN,1645296,1645296,1644996,300,516,utRho21
1735,ybhQ,1649202,1649260,1649202,58,0,utRho21
1736,ybiA,1665920,1665920,1665900,20,0,utRho21
1737,ybiI,1676968,1676968,1676912,56,150,utRho21
1738,ybiO,1691328,1691328,1690960,368,124,utRho21
1739,ybiP,1705252,1705252,1705194,58,46,utRho21
1740,ybiS,1711572,1711572,1711488,84,508,utRho21
1741,ybiT,1711894,1711926,1711894,32,0,utRho21
1742,ybiU,1718212,1718212,1718122,90,0,utRho21
1743,ybiV,1720176,1720176,1720056,120,0,utRho21
1744,ybiW,1725566,1725566,1725212,354,1456,utRho21
1745,ybiX,1678548,1678548,1678414,134,164,utRho21
1746,ybjC,1781784,1781826,1781784,42,0,utRho21
1747,ybjE,1830154,1830154,1829714,440,470,utRho21
1748,ybjG,1767016,1767016,1766776,240,1374,utRho21
1749,ybjL,1779882,1779882,1779638,244,4,utRho21
1750,ybjM,1779770,1780178,1779770,408,2,utRho21
1751,ybjO,1795704,1795978,1795704,274,0,utRho21
1752,ybjP,1809046,1809046,1808934,112,110,utRho21
1753,ybjQ,1809034,1809186,1809034,152,410,utRho21
1754,ybjS,1813796,1813796,1813506,290,152,utRho21
1755,ybjX,1838206,1838206,1838168,38,0,utRho21
1756,ycaD,1891438,1891742,1891438,304,0,utRho21
1757,ycaI,1928210,1928640,1928210,430,0,utRho21
1758,ycaK,1899094,1899336,1899094,242,26,utRho21
1759,ycaL,1920264,1920528,1920264,264,0,utRho21
1760,ycaM,1894240,1894458,1894240,218,164,utRho21
1761,ycaR,1941284,1941346,1941284,62,648,utRho21
1762,ycbB,1961862,1962094,1961862,232,4,utRho21
1763,ycbJ,1943344,1943504,1943344,160,0,utRho21
1764,ycbK,1966046,1966150,1966046,104,578,utRho21
1765,ycbZ,2036920,2036920,2036598,322,18,utRho21
1766,yccA,2062886,2062886,2062836,50,28,utRho21
1767,yccF,2048730,2048730,2048696,34,0,utRho21
1768,yccS,2047988,2047988,2047766,222,68,utRho21
1769,yccT,2055674,2055674,2055546,128,90,utRho21
1770,yccX,2059960,2060128,2059960,168,30,utRho21
1771,ycdT,2185682,2185752,2185682,70,0,utRho21
1772,ycdU,2191266,2191686,2191266,420,4,utRho21
1773,ycdZ,2200504,2200592,2200504,88,128,utRho21
1774,yceA,2233544,2233614,2233544,70,52,utRho21
1775,yceD,2293298,2293588,2293298,290,1992,utRho21
1776,yceF,2293522,2293522,2293190,332,1154,utRho21
1777,yceH,2252154,2252314,2252154,160,6512,utRho21
1778,yceI,2237282,2237282,2236952,330,948,utRho21
1779,yceJ,2238142,2238142,2238092,50,0,utRho21
1780,yceM,2253208,2253612,2253208,404,638,utRho21
1781,yceO,2239264,2239264,2238894,370,192,utRho21
1782,yceQ,2288760,2289004,2288760,244,9404,utRho21
1783,ycfD,2376540,2376540,2376480,60,212,utRho21
1784,ycfJ,2334814,2335198,2334814,384,4,utRho21
1785,ycfS,2340834,2340834,2340748,86,28,utRho21
1786,ycfT,2350658,2350658,2350330,328,24,utRho21
1787,ycfZ,2362760,2362760,2362534,226,0,utRho21
1788,ycgB,2474570,2474570,2474482,88,2,utRho21
1789,ycgG,2434614,2434656,2434614,42,412,utRho21
1790,ycgJ,2452956,2453200,2452956,244,4,utRho21
1791,ycgL,2455218,2455362,2455218,144,162,utRho21
1792,ycgN,2457366,2457660,2457366,294,92,utRho21
1793,ycgR,2489112,2489112,2489054,58,0,utRho21
1794,ycgV,2512222,2512222,2511904,318,338,utRho21
1795,ycgX,2426568,2426568,2426214,354,816,utRho21
1796,ycgY,2490166,2490320,2490166,154,4,utRho21
1797,ycgZ,2431504,2431578,2431504,74,0,utRho21
1798,ychE,2596904,2597196,2596904,292,0,utRho21
1799,ychF,2515764,2515764,2515624,140,66,utRho21
1800,ychH,2517476,2517582,2517476,106,162,utRho21
1801,ychJ,2578354,2578354,2578264,90,0,utRho21
1802,ychN,2547310,2547310,2547198,112,0,utRho21
1803,ychO,2547520,2547850,2547520,330,144,utRho21
1804,ychQ,2533798,2533848,2533798,50,0,utRho21
1805,yciA,2624828,2624828,2624492,336,122,utRho21
1806,yciB,2626110,2626110,2625780,330,5916,utRho21
1807,yciC,2627396,2627396,2627326,70,0,utRho21
1808,yciE,2630794,2630794,2630448,346,1048,utRho21
1809,yciG,5264368,5264368,5264140,228,0,utRho21
1810,yciI,2621784,2621784,2621730,54,0,utRho21
1811,yciN,2661606,2661606,2661336,270,252,utRho21
1812,yciS,2680270,2680486,2680270,216,0,utRho21
1813,yciT,2689088,2689088,2688692,396,454,utRho21
1814,yciU,2614718,2614718,2614300,418,566,utRho21
1815,yciV,2646376,2646440,2646376,64,0,utRho21
1816,yciW,2700472,2700472,2700214,258,132,utRho21
1817,yciZ,2689276,2689276,2689218,58,160,utRho21
1818,ycjD,2703792,2703792,2703520,272,0,utRho21
1819,ycjG,2777748,2777860,2777748,112,150,utRho21
1820,ycjM,2740006,2740432,2740006,426,0,utRho21
1821,ycjW,2767982,2767982,2767922,60,24,utRho21
1822,ycjX,2768138,2768234,2768138,96,80,utRho21
1823,ycjY,5568288,5568288,5567460,828,96,utRho21
1824,ydaE,2836438,2836438,2836016,422,0,utRho21
1825,ydaN,2816048,2816100,2816048,52,114,utRho21
1826,ydaS,2840340,2840730,2840340,390,150,utRho21
1827,ydbC,2948376,2948442,2948376,66,0,utRho21
1828,ydbD,2950132,2950288,2950132,156,0,utRho21
1829,ydbH,2885800,2886102,2885800,302,254,utRho21
1830,ydbJ,2881712,2882116,2881712,404,24,utRho21
1831,ydbK,2881692,2881692,2881568,124,44,utRho21
1832,ydcA,2983294,2983354,2983294,60,52,utRho21
1833,ydcF,2974404,2974470,2974404,66,82,utRho21
1834,ydcI,2990268,2990268,2990142,126,0,utRho21
1835,ydcJ,2990266,2990576,2990266,310,0,utRho21
1836,ydcK,3001280,3001280,3000898,382,0,utRho21
1837,ydcL,3004646,3004914,3004646,268,0,utRho21
1838,ydcN,3012308,3012344,3012308,36,72,utRho21
1839,ydcP,3013508,3013562,3013508,54,118,utRho21
1840,ydcR,3019956,3020006,3019956,50,78,utRho21
1841,ydcS,3022906,3023308,3022906,402,34,utRho21
1842,ydcX,3034442,3034778,3034442,336,0,utRho21
1843,ydcY,3035220,3035296,3035220,76,0,utRho21
1844,ydcZ,3036750,3036750,3036662,88,158,utRho21
1845,yddB,3155332,3155332,3155238,94,26,utRho21
1846,yddE,3071738,3071738,3071716,22,0,utRho21
1847,yddG,3094410,3094410,3094338,72,0,utRho21
1848,yddJ,3089732,3089732,3089438,294,0,utRho21
1849,yddW,3137704,3137704,3137646,58,0,utRho21
1850,ydeA,3233910,3234056,3233910,146,74,utRho21
1851,ydeE,3242528,3242664,3242528,136,2,utRho21
1852,ydeI,3249118,3249118,3248994,124,4,utRho21
1853,ydeJ,3249376,3249546,3249376,170,30,utRho21
1854,ydeN,3165458,3165458,3165048,410,0,utRho21
1855,ydeP,3173328,3173328,3172972,356,48,utRho21
1856,ydeR,3176596,3176596,3176592,4,4,utRho21
1857,ydfA,3296872,3297016,3296872,144,62,utRho21
1858,ydfG,3254982,3255034,3254982,52,0,utRho21
1859,ydfH,3256652,3256704,3256652,52,18,utRho21
1860,ydfK,3265446,3266144,3265446,698,244,utRho21
1861,ydgA,3379588,3379704,3379588,116,232,utRho21
1862,ydgC,3364124,3364124,3364060,64,56,utRho21
1863,ydgD,3343906,3343920,3343906,14,0,utRho21
1864,ydgH,3356754,3356854,3356754,100,52,utRho21
1865,ydgJ,3408798,3408798,3408616,182,120,utRho21
1866,ydgK,3410414,3410500,3410414,86,238,utRho21
1867,ydhB,3479618,3479618,3479596,22,0,utRho21
1868,ydhC,3479698,3479822,3479698,124,0,utRho21
1869,ydhF,3451310,3451310,3451264,46,0,utRho21
1870,ydhI,3441996,3442050,3441996,54,0,utRho21
1871,ydhL,3451864,3451864,3451840,24,2,utRho21
1872,ydhQ,3492404,3492404,3492254,150,0,utRho21
1873,ydhS,3494136,3494262,3494136,126,52,utRho21
1874,ydhT,3499138,3499138,3499118,20,0,utRho21
1875,ydhY,3509284,3509284,3508954,330,0,utRho21
1876,ydhZ,3510418,3510418,3510282,136,4,utRho21
1877,ydiE,3579206,3579226,3579206,20,0,utRho21
1878,ydiH,3530582,3530582,3530406,176,68,utRho21
1879,ydiM,3541852,3542142,3541852,290,418,utRho21
1880,ydiN,3544818,3545024,3544818,206,0,utRho21
1881,ydiP,3558656,3558656,3558602,54,2,utRho21
1882,ydiU,3582508,3582508,3582488,20,0,utRho21
1883,ydiV,3584174,3584174,3584040,134,352,utRho21
1884,ydiY,3612500,3612500,3612166,334,0,utRho21
1885,ydjA,3697400,3697400,3697352,48,74,utRho21
1886,ydjE,3708082,3708082,3707958,124,0,utRho21
1887,ydjF,3709848,3709848,3709708,140,0,utRho21
1888,ydjM,3620340,3620422,3620340,82,0,utRho21
1889,ydjO,3626696,3626696,3626288,408,0,utRho21
1890,ydjX,3666434,3666802,3666434,368,780,utRho21
1891,yeaE,3731448,3731448,3731272,176,2,utRho21
1892,yeaG,3733530,3733816,3733530,286,354,utRho21
1893,yeaI,3740486,3740770,3740486,284,0,utRho21
1894,yeaJ,3743874,3744082,3743874,208,182,utRho21
1895,yeaL,3748646,3748704,3748646,58,514,utRho21
1896,yeaM,3751296,3751296,3751152,144,0,utRho21
1897,yeaN,3750926,3751346,3750926,420,316,utRho21
1898,yeaO,3753554,3753818,3753554,264,20,utRho21
1899,yeaP,3755314,3755430,3755314,116,1084,utRho21
1900,yeaQ,3758780,3758780,3758510,270,144,utRho21
1901,yeaR,3759988,3759988,3759896,92,0,utRho21
1902,yeaY,3781122,3781122,3781064,58,228,utRho21
1903,yebB,3892220,3892502,3892220,282,0,utRho21
1904,yebC,3896370,3896370,3896302,68,2,utRho21
1905,yebE,3859464,3859464,3859414,50,0,utRho21
1906,yebG,3861530,3861530,3861494,36,0,utRho21
1907,yebK,3873180,3873304,3873180,124,98,utRho21
1908,yebQ,3820314,3820552,3820314,238,42,utRho21
1909,yebS,3832238,3832516,3832238,278,0,utRho21
1910,yebV,3843430,3843560,3843430,130,0,utRho21
1911,yebW,3843914,3844242,3843914,328,18222,utRho21
1912,yecC,3995646,3995646,3995628,18,0,utRho21
1913,yecD,3901272,3901664,3901272,392,128,utRho21
1914,yecF,3991434,3991636,3991434,202,0,utRho21
1915,yecH,3979304,3979304,3978980,324,0,utRho21
1916,yecJ,3975604,3975604,3975516,88,0,utRho21
1917,yecM,3919968,3919968,3919692,276,2,utRho21
1918,yecR,3976400,3976444,3976400,44,0,utRho21
1919,yecT,3923862,3923944,3923862,82,0,utRho21
1920,yedD,4016522,4016522,4016180,342,22,utRho21
1921,yedE,4016310,4016554,4016310,244,48,utRho21
1922,yedI,4058922,4058922,4058732,190,0,utRho21
1923,yedJ,4066446,4066446,4066158,288,60,utRho21
1924,yedV,4076404,4076404,4076304,100,142,utRho21
1925,yedX,4077680,4077912,4077680,232,0,utRho21
1926,yedY,4078572,4078956,4078572,384,0,utRho21
1927,yeeA,4161322,4161322,4161182,140,68,utRho21
1928,yeeE,4171104,4171104,4171050,54,0,utRho21
1929,yeeJ,4089526,4089822,4089526,296,0,utRho21
1930,yeeN,4113508,4113716,4113508,208,0,utRho21
1931,yeeO,4119444,4119444,4119692,248,0,utRho21
1932,yeeX,4158834,4158834,4158722,112,598,utRho21
1933,yeeZ,4178422,4178422,4178256,166,0,utRho21
1934,yefM,4179466,4179466,4179426,40,106,utRho21
1935,yegD,4295288,4295348,4295288,60,154,utRho21
1936,yegH,4275726,4275804,4275726,78,56,utRho21
1937,yegI,4302154,4302154,4301970,184,0,utRho21
1938,yegJ,4302032,4302370,4302032,338,0,utRho21
1939,yegQ,4331182,4331336,4331182,154,94,utRho21
1940,yegR,4336698,4336698,4336612,86,2,utRho21
1941,yegS,4337086,4337424,4337086,338,0,utRho21
1942,yegT,4357562,4357642,4357562,80,0,utRho21
1943,yegX,4367640,4367640,4367302,338,0,utRho21
1944,yehA,4376944,4376944,4376828,116,116,utRho21
1945,yehE,4385818,4385818,4385592,226,258,utRho21
1946,yehK,4407568,4407944,4407568,376,0,utRho21
1947,yehL,4408804,4409192,4408804,388,0,utRho21
1948,yeiB,4486146,4486146,4485934,212,118,utRho21
1949,yeiE,4499422,4499422,4499236,186,0,utRho21
1950,yeiG,4487776,4487820,4487776,44,674,utRho21
1951,yeiH,4499332,4499434,4499332,102,154,utRho21
1952,yeiI,4503306,4503400,4503306,94,606,utRho21
1953,yeiL,4510580,4510710,4510580,130,0,utRho21
1954,yeiP,4530834,4530900,4530834,66,486,utRho21
1955,yeiQ,4532328,4532490,4532328,162,102,utRho21
1956,yeiR,4535484,4535658,4535484,174,266,utRho21
1957,yeiW,4530840,4530840,4530590,250,820,utRho21
1958,yejA,4544624,4544728,4544624,104,0,utRho21
1959,yejG,4556892,4556892,4556474,418,918,utRho21
1960,yejH,4561244,4561264,4561244,20,0,utRho21
1961,yejK,4568218,4568218,4567894,324,700,utRho21
1962,yejO,4578352,4578352,4577800,552,222,utRho21
1963,yfaD,4713380,4713808,4713380,428,0,utRho21
1964,yfaE,4696676,4697028,4696676,352,1212,utRho21
1965,yfaL,4688568,4688568,4688338,230,0,utRho21
1966,yfaP,4656398,4656398,4656286,112,0,utRho21
1967,yfaU,4717892,4717892,4717690,202,0,utRho21
1968,yfaY,4727310,4727310,4727266,44,0,utRho21
1969,yfaZ,4728744,4728744,4728550,194,62,utRho21
1970,yfbK,4771810,4771810,4771444,366,6,utRho21
1971,yfbL,4771500,4771720,4771500,220,4,utRho21
1972,yfbN,4777174,4777174,4776852,322,0,utRho21
1973,yfbO,4776916,4777162,4776916,246,0,utRho21
1974,yfbP,4777990,4778232,4777990,242,170,utRho21
1975,yfbR,4817662,4817724,4817662,62,22,utRho21
1976,yfcI,4847424,4847424,4847078,346,258,utRho21
1977,yfcJ,4880482,4880482,4880240,242,152,utRho21
1978,yfcL,4888502,4888502,4888338,164,0,utRho21
1979,yfcV,4911642,4911642,4911292,350,0,utRho21
1980,yfcZ,4921958,4921958,4921868,90,436,utRho21
1981,yfdF,4925604,4926024,4925604,420,0,utRho21
1982,yfdG,4935474,4935710,4935474,236,0,utRho21
1983,yfdP,4946844,4947040,4946844,196,0,utRho21
1984,yfdX,4988866,4988866,4988804,62,0,utRho21
1985,yfdY,4990672,4990672,4990584,88,2,utRho21
1986,yfeA,5035784,5035784,5035664,120,13386,utRho21
1987,yfeC,5036668,5036934,5036668,266,76,utRho21
1988,yfeH,5053818,5053892,5053818,74,0,utRho21
1989,yfeK,5074630,5074684,5074630,54,0,utRho21
1990,yfeO,5018906,5019260,5018906,354,240,utRho21
1991,yfeR,5054078,5054078,5053712,366,16,utRho21
1992,yfeX,5101356,5101356,5101090,266,312,utRho21
1993,yfeY,5102486,5102486,5102432,54,0,utRho21
1994,yfeZ,5103842,5103842,5103452,390,0,utRho21
1995,yffO,5123804,5124222,5123804,418,0,utRho21
1996,yffQ,5126778,5127154,5126778,376,314,utRho21
1997,yffS,5128800,5128986,5128800,186,44,utRho21
1998,yfgC,5232052,5232188,5232052,136,314,utRho21
1999,yfgF,5258062,5258062,5257876,186,82,utRho21
2000,yfgG,5258170,5258580,5258170,410,82,utRho21
2001,yfgH,5259344,5259584,5259344,240,0,utRho21
2002,yfgM,5278866,5278866,5278566,300,662,utRho21
2003,yfhH,5397414,5397518,5397414,104,28,utRho21
2004,yfhM,5304648,5304648,5304574,74,0,utRho21
2005,yfhR,5328408,5328726,5328408,318,8,utRho21
2006,yfiC,5425610,5425610,5425528,82,0,utRho21
2007,yfiE,5430688,5430688,5430640,48,0,utRho21
2008,yfiL,5482630,5482720,5482630,90,2,utRho21
2009,yfiM,5448066,5448358,5448066,292,1958,utRho21
2010,yfiR,5483354,5483750,5483354,396,586,utRho21
2011,yfjH,5517326,5517326,5517200,126,0,utRho21
2012,yfjI,5517710,5517970,5517710,260,4,utRho21
2013,yfjJ,5521014,5521094,5521014,80,0,utRho21
2014,yfjM,5531970,5531970,5531552,418,1256,utRho21
2015,yfjP,5535080,5535420,5535080,340,4,utRho21
2016,yfjW,5546570,5546636,5546570,66,0,utRho21
2017,yfjX,5551776,5551838,5551776,62,0,utRho21
2018,ygaC,5601180,5601180,5599988,1192,310,utRho21
2019,ygaM,5600242,5600292,5600242,50,0,utRho21
2020,ygaU,5593628,5593628,5593572,56,378,utRho21
2021,ygaZ,5619190,5619234,5619190,44,62,utRho21
2022,ygbA,5713656,5713656,5713612,44,0,utRho21
2023,ygbE,5746784,5746784,5746674,110,118,utRho21
2024,ygbI,5722882,5722882,5722528,354,0,utRho21
2025,ygbK,5724394,5724670,5724394,276,4354,utRho21
2026,ygbL,5727074,5727186,5727074,112,422,utRho21
2027,ygbN,5729814,5730202,5729814,388,1024,utRho21
2028,ygcG,5811210,5811422,5811210,212,0,utRho21
2029,ygcN,5785144,5785314,5785144,170,34,utRho21
2030,ygcU,5799214,5799214,5798836,378,2,utRho21
2031,ygcW,5800942,5800942,5800546,396,0,utRho21
2032,ygdD,5883442,5883442,5883262,180,198,utRho21
2033,ygdG,5861746,5861930,5861746,184,168,utRho21
2034,ygdI,5886526,5886526,5886290,236,38,utRho21
2035,ygdQ,5940784,5940840,5940784,56,0,utRho21
2036,ygdR,5942494,5942542,5942494,48,0,utRho21
2037,ygeA,5961606,5961606,5961270,336,2,utRho21
2038,ygeH,5983758,5984188,5983758,430,4,utRho21
2039,ygeI,5987162,5987276,5987162,114,14,utRho21
2040,ygeR,6000078,6000078,5999782,296,0,utRho21
2041,ygeV,6011694,6011694,6011572,122,48,utRho21
2042,ygeW,6012234,6012524,6012234,290,0,utRho21
2043,ygfB,6110946,6110946,6110888,58,48,utRho21
2044,ygfK,6031984,6032120,6031984,136,0,utRho21
2045,ygfS,6058328,6058328,6058024,304,2,utRho21
2046,ygfZ,6082564,6082626,6082564,62,342,utRho21
2047,yggC,6149512,6149512,6149378,134,132,utRho21
2048,yggE,6136370,6136370,6136160,210,446,utRho21
2049,yggI,6179176,6179510,6179176,334,358,utRho21
2050,yggL,6204508,6204508,6204266,242,0,utRho21
2051,yggM,6199514,6199514,6199130,384,30,utRho21
2052,yggN,6203596,6203596,6203246,350,64,utRho21
2053,yggX,18623958,18624558,18623958,600,816,utRho21
2054,yghA,6298966,6299324,6298966,358,92,utRho21
2055,yghB,6307058,6307126,6307058,68,114,utRho21
2056,yghD,6222614,6222614,6222252,362,118,utRho21
2057,yghF,6225798,6225798,6225840,42,0,utRho21
2058,yghJ,6238640,6238640,6238224,416,218,utRho21
2059,yghQ,6265186,6265186,6264816,370,2,utRho21
2060,yghT,6267830,6268262,6267830,432,0,utRho21
2061,yghU,6277400,6277454,6277400,54,228,utRho21
2062,yghW,6293506,6293506,6293474,32,0,utRho21
2063,yghZ,6295562,6295794,6295562,232,36,utRho21
2064,ygiD,6365122,6365122,6364868,254,364,utRho21
2065,ygiH,6409066,6409388,6409066,322,2,utRho21
2066,ygiL,6370622,6370828,6370622,206,0,utRho21
2067,ygiM,6402084,6402414,6402084,330,400,utRho21
2068,ygiN,6346156,6346284,6346156,128,5298,utRho21
2069,ygiQ,6322620,6322620,6322292,328,132,utRho21
2070,ygiS,6335462,6335462,6335436,26,0,utRho21
2071,ygiV,6338582,6338582,6338462,120,566,utRho21
2072,ygiW,6339774,6339774,6339352,422,254,utRho21
2073,ygiZ,6344506,6344506,6344422,84,0,utRho21
2074,ygjH,6442528,6442528,6442494,34,0,utRho21
2075,ygjI,6452140,6452468,6452140,328,0,utRho21
2076,ygjQ,6472730,6473080,6472730,350,168,utRho21
2077,ygjR,6474564,6474586,6474564,22,2,utRho21
2078,ygjV,6483638,6483638,6483488,150,2,utRho21
2079,yhaB,6535632,6535708,6535632,76,0,utRho21
2080,yhaH,6504498,6504608,6504498,110,2,utRho21
2081,yhaI,6505400,6505822,6505400,422,48,utRho21
2082,yhaJ,6508560,6508560,6508428,132,8,utRho21
2083,yhaK,6508538,6508638,6508538,100,8,utRho21
2084,yhbQ,6599878,6599932,6599878,54,24,utRho21
2085,yhbT,6602736,6602736,6602552,184,14,utRho21
2086,yhbU,6602558,6602970,6602558,412,14,utRho21
2087,yhbX,6643302,6643302,6643226,76,0,utRho21
2088,yhbY,6655518,6655580,6655518,62,278,utRho21
2089,yhcA,6723956,6724224,6723956,268,0,utRho21
2090,yhcB,6760364,6760382,6760364,18,404,utRho21
2091,yhcC,6708470,6708470,6708100,370,8,utRho21
2092,yhcF,6733440,6733852,6733440,412,222,utRho21
2093,yhcH,6739124,6739124,6738956,168,162,utRho21
2094,yhcM,6760312,6760312,6759994,318,42,utRho21
2095,yhcN,6770812,6771076,6770812,264,146,utRho21
2096,yhcO,6772606,6772606,6772258,348,0,utRho21
2097,yhdH,6806560,6806968,6806560,408,512,utRho21
2098,yhdJ,6823234,6823306,6823234,72,0,utRho21
2099,yhdN,6879092,6879092,6879018,74,514,utRho21
2100,yhdT,6814702,6814750,6814702,48,0,utRho21
2101,yhdU,6824994,6825242,6824994,248,258,utRho21
2102,yhdV,6836392,6836780,6836392,388,4,utRho21
2103,yhdW,6837944,6838298,6837944,354,0,utRho21
2104,yheO,6953082,6953082,6952880,202,1226,utRho21
2105,yheV,6957970,6957970,6957584,386,116,utRho21
2106,yhfA,6971902,6971902,6971636,266,222,utRho21
2107,yhfG,6983294,6983294,6983240,54,88,utRho21
2108,yhfL,6998622,6998896,6998622,274,0,utRho21
2109,yhfY,7023244,7023244,7022844,400,16,utRho21
2110,yhgA,7086294,7086334,7086294,40,0,utRho21
2111,yhgE,7065176,7065176,7064878,298,464,utRho21
2112,yhgF,7074352,7074770,7074352,418,4062,utRho21
2113,yhhA,7173458,7173886,7173458,428,10,utRho21
2114,yhhI,7248346,7248756,7248346,410,0,utRho21
2115,yhhJ,7253696,7253696,7253606,90,214,utRho21
2116,yhhM,7211588,7211588,7211220,368,10,utRho21
2117,yhhN,7211150,7211502,7211150,352,42,utRho21
2118,yhhQ,7218238,7218434,7218238,196,368,utRho21
2119,yhhT,7223682,7223730,7223682,48,0,utRho21
2120,yhhX,7162032,7162032,7161610,422,0,utRho21
2121,yhhY,7162222,7162276,7162222,54,0,utRho21
2122,yhhZ,7163516,7163726,7163516,210,2,utRho21
2123,yhiD,7312220,7312220,7311804,416,159546,utRho21
2124,yhiJ,7265190,7265190,7265180,10,0,utRho21
2125,yhiM,7269270,7269682,7269270,412,66,utRho21
2126,yhiN,7275000,7275000,7274820,180,296,utRho21
2127,yhjA,7338522,7338522,7338376,146,8,utRho21
2128,yhjB,7344090,7344090,7343788,302,0,utRho21
2129,yhjC,7344272,7344684,7344272,412,0,utRho21
2130,yhjD,7346660,7346724,7346660,64,226,utRho21
2131,yhjE,7349274,7349572,7349274,298,22,utRho21
2132,yhjG,7356824,7356824,7356730,94,0,utRho21
2133,yhjH,7358458,7358458,7358374,84,0,utRho21
2134,yhjJ,7364032,7364032,7363880,152,0,utRho21
2135,yhjK,7371296,7371296,7371158,138,90,utRho21
2136,yhjR,7392750,7392750,7392370,380,4,utRho21
2137,yhjV,7400796,7401126,7400796,330,6,utRho21
2138,yhjX,7424194,7424194,7424014,180,0,utRho21
2139,yhjY,7425966,7425966,7425868,98,50,utRho21
2140,yiaB,7455654,7455654,7455496,158,0,utRho21
2141,yiaD,7432712,7433094,7432712,382,190,utRho21
2142,yiaF,7438194,7438194,7438088,106,4,utRho21
2143,yiaG,7438862,7438956,7438862,94,1350,utRho21
2144,yiaJ,7485236,7485236,7485064,172,2,utRho21
2145,yiaK,7485348,7485466,7485348,118,92,utRho21
2146,yiaT,7503924,7503924,7503736,188,0,utRho21
2147,yiaU,7503792,7503984,7503792,192,0,utRho21
2148,yiaY,7515856,7515856,7515654,202,0,utRho21
2149,yibF,7523950,7523950,7523910,40,0,utRho21
2150,yibG,7536128,7536354,7536128,226,0,utRho21
2151,yibL,7553194,7553330,7553194,136,424,utRho21
2152,yibN,7570112,7570112,7570030,82,424,utRho21
2153,yibT,7552848,7552848,7552760,88,256,utRho21
2154,yicC,7633290,7633352,7633290,62,48,utRho21
2155,yicH,7660862,7660914,7660862,52,0,utRho21
2156,yicJ,7673328,7673328,7671858,1470,732,utRho21
2157,yicN,7685018,7685018,7684804,214,2,utRho21
2158,yicO,7687914,7687914,7687578,336,0,utRho21
2159,yicR,15250308,15250308,15250236,72,0,utRho21
2160,yidB,7755230,7755230,7754930,300,24,utRho21
2161,yidE,7732780,7732780,7732546,234,0,utRho21
2162,yidF,7711580,7711580,7711222,358,126,utRho21
2163,yidQ,7735088,7735456,7735088,368,3268,utRho21
2164,yidR,7738824,7738824,7738618,206,0,utRho21
2165,yieE,7787658,7787738,7787658,80,130,utRho21
2166,yieH,7793314,7793548,7793314,234,0,utRho21
2167,yieK,7798928,7798928,7798786,142,0,utRho21
2168,yifB,7900350,7900350,7899998,352,26,utRho21
2169,yifL,7988984,7989044,7988984,60,28,utRho21
2170,yigF,8005750,8005750,8005598,152,84,utRho21
2171,yigI,8009448,8009448,8009394,54,2,utRho21
2172,yigM,8022100,8022152,8022100,52,112,utRho21
2173,yihA,8101970,8101970,8101458,512,0,utRho21
2174,yihD,8084098,8084138,8084098,40,0,utRho21
2175,yihF,8088110,8088398,8088110,288,88,utRho21
2176,yihG,8093304,8093304,8093204,100,0,utRho21
2177,yihI,8102616,8102694,8102616,78,22,utRho21
2178,yihL,8120506,8120894,8120506,388,0,utRho21
2179,yihN,8124332,8124494,8124332,162,0,utRho21
2180,yihO,8131942,8131942,8131532,410,0,utRho21
2181,yihQ,8138892,8138892,8138552,340,0,utRho21
2182,yihV,8147064,8147478,8147064,414,0,utRho21
2183,yihX,8151096,8151106,8151096,10,266,utRho21
2184,yiiE,8158192,8158582,8158192,390,46,utRho21
2185,yiiF,8159124,8159502,8159124,378,0,utRho21
2186,yiiG,8173762,8174004,8173762,242,0,utRho21
2187,yiiM,8205506,8205644,8205506,138,16,utRho21
2188,yiiQ,8224624,8224624,8224428,196,0,utRho21
2189,yiiS,8225738,8225934,8225738,196,0,utRho21
2190,yijE,8272178,8272216,8272178,38,72,utRho21
2191,yijF,8275728,8275728,8275314,414,88,utRho21
2192,yijO,8296858,8296858,8296634,224,0,utRho21
2193,yjaA,8426240,8426468,8426240,228,118820,utRho21
2194,yjaB,8428312,8428312,8428246,66,0,utRho21
2195,yjaG,8398746,8399008,8398746,262,2348,utRho21
2196,yjaH,8401022,8401132,8401022,110,568,utRho21
2197,yjaZ,8379506,8379572,8379506,66,0,utRho21
2198,yjbB,8455204,8455462,8455204,258,0,utRho21
2199,yjbE,16943432,16943624,16943432,192,112,utRho21
2200,yjbL,8520318,8520642,8520318,324,0,utRho21
2201,yjbQ,8540428,8540476,8540428,48,136,utRho21
2202,yjcB,8550328,8550328,8550082,246,102,utRho21
2203,yjcC,8550836,8550942,8550836,106,340,utRho21
2204,yjcD,8556628,8556958,8556628,330,0,utRho21
2205,yjcE,8559658,8559960,8559658,302,2,utRho21
2206,yjcF,8566212,8566212,8566150,62,0,utRho21
2207,yjcO,8594660,8594660,8594250,410,68,utRho21
2208,yjdA,8654128,8654270,8654128,142,8,utRho21
2209,yjdC,8726660,8726660,8726616,44,30,utRho21
2210,yjdK,8704780,8705168,8704780,388,672,utRho21
2211,yjdL,8713034,8713034,8712822,212,0,utRho21
2212,yjdM,8653672,8653672,8653468,204,2090,utRho21
2213,yjeF,8787354,8788132,8787354,778,13478,utRho21
2214,yjeI,8745522,8745618,8745522,96,0,utRho21
2215,yjeJ,8748806,8748806,8748468,338,62,utRho21
2216,yjeV,8785472,8785784,8785472,312,28,utRho21
2217,yjfP,8833512,8833904,8833512,392,0,utRho21
2218,yjfY,8849656,8849656,8849582,74,0,utRho21
2219,yjfZ,8855052,8855052,8854844,208,0,utRho21
2220,yjgA,8916162,8916162,8915730,432,70,utRho21
2221,yjgL,8950802,8950874,8950802,72,0,utRho21
2222,yjgM,8959342,8959342,8959074,268,0,utRho21
2223,yjgN,8959132,8959460,8959132,328,0,utRho21
2224,yjgR,8980170,8980170,8980126,44,222,utRho21
2225,yjgZ,9002116,9002520,9002116,404,6,utRho21
2226,yjhB,9007764,9008116,9007764,352,134,utRho21
2227,yjhG,9048452,9048452,9048188,264,4080,utRho21
2228,yjhU,9041080,9041080,9040648,432,1082,utRho21
2229,yjiA,9178096,9178096,9177730,366,1070,utRho21
2230,yjiJ,9125364,9125364,9125350,14,0,utRho21
2231,yjiK,9127270,9127270,9127422,152,44,utRho21
2232,yjiL,9129604,9129604,9129378,226,0,utRho21
2233,yjiS,9143410,9143502,9143410,92,0,utRho21
2234,yjiY,9182734,9182734,9182558,176,4,utRho21
2235,yjjA,9200674,9200674,9200378,296,126,utRho21
2236,yjjB,18408708,18408708,18407800,908,132,utRho21
2237,yjjJ,9243314,9243538,9243314,224,62,utRho21
2238,yjjK,9261132,9261132,9261044,88,156,utRho21
2239,yjjL,9189764,9189764,9189444,320,24,utRho21
2240,yjjM,9191894,9191894,9191702,192,4,utRho21
2241,yjjP,9206068,9206068,9205716,352,12,utRho21
2242,yjjQ,9206638,9206954,9206638,316,16,utRho21
2243,yjjX,9267798,9267798,9267490,308,632,utRho21
2244,yjjY,9280716,9280804,9280716,88,1914,utRho21
2245,yjjZ,9211554,9211608,9211554,54,50,utRho21
2246,yjtD,9281676,9281884,9281676,208,8,utRho21
2247,ykfB,532454,532454,532174,280,280,utRho21
2248,ykfI,527636,527636,527338,298,14,utRho21
2249,ykgB,637050,637050,636638,412,0,utRho21
2250,ykgC,640430,640430,640002,428,0,utRho21
2251,ykgD,640232,640454,640232,222,0,utRho21
2252,ykgE,642962,643216,642962,254,60,utRho21
2253,ykgJ,608524,608524,608364,160,1250,utRho21
2254,ykgL,623878,624224,623878,346,2,utRho21
2255,ykgM,625610,625610,625554,56,68,utRho21
2256,ykgR,626570,626570,626484,86,0,utRho21
2257,ylaC,958576,958576,958502,74,852,utRho21
2258,yliE,1745938,1745958,1745938,20,0,utRho21
2259,ymcE,2103660,2103694,2103660,34,0,utRho21
2260,ymdA,2210450,2210828,2210450,378,2,utRho21
2261,ymdB,2211428,2211640,2211428,212,0,utRho21
2262,ymfD,2395322,2395322,2395064,258,724,utRho21
2263,ymfI,2402880,2402994,2402880,114,0,utRho21
2264,ymfJ,2404518,2404518,2404168,350,392,utRho21
2265,ymfK,2406176,2406176,2405866,310,0,utRho21
2266,ymfT,2405766,2406048,2405766,282,122,utRho21
2267,ymgE,2489110,2489456,2489110,346,244,utRho21
2268,ymgF,2437628,2437966,2437628,338,0,utRho21
2269,ymiA,2670112,2670320,2670112,208,48,utRho21
2270,ymjA,2715620,2715620,2715336,284,342,utRho21
2271,ynaI,2791946,2791946,2791844,102,0,utRho21
2272,ynaK,2850438,2850754,2850438,316,72,utRho21
2273,ynbA,2954924,2955242,2954924,318,0,utRho21
2274,yncD,3046552,3046552,3046130,422,30,utRho21
2275,yncE,3046454,3046614,3046454,160,68,utRho21
2276,yncG,3052456,3052494,3052456,38,52,utRho21
2277,yncL,3034492,3034492,3034388,104,18,utRho21
2278,yneE,3218364,3218364,3218044,320,0,utRho21
2279,yneF,3223748,3223748,3223708,40,0,utRho21
2280,yneJ,3229560,3229608,3229560,48,122,utRho21
2281,yneK,3231100,3231526,3231100,426,0,utRho21
2282,yneM,3245176,3245292,3245176,116,0,utRho21
2283,ynfA,3311398,3311398,3311346,52,0,utRho21
2284,ynfB,3311418,3311616,3311418,198,152,utRho21
2285,ynfC,3315094,3315094,3314914,180,36,utRho21
2286,ynfD,3314828,3315130,3314828,302,96,utRho21
2287,ynfE,3316006,3316138,3316006,132,0,utRho21
2288,ynfK,3334670,3334670,3334438,232,228,utRho21
2289,ynfL,3339304,3339304,3339184,120,0,utRho21
2290,ynfM,3339260,3339398,3339260,138,0,utRho21
2291,ynfN,3276598,3276598,3276218,380,4,utRho21
2292,ynfO,3273454,3273512,3273454,58,4,utRho21
2293,ynhG,3517890,3517890,3517450,440,536,utRho21
2294,yniA,3615158,3615592,3615158,434,804,utRho21
2295,yniB,3618526,3618526,3618466,60,0,utRho21
2296,yniC,3618652,3618760,3618652,108,6,utRho21
2297,yniD,3610202,3610330,3610202,128,0,utRho21
2298,ynjE,3678880,3678934,3678880,54,0,utRho21
2299,ynjF,3683222,3683222,3682806,416,88,utRho21
2300,ynjH,3684376,3684376,3684270,106,156,utRho21
2301,ynjI,3690022,3690022,3689742,280,48,utRho21
2302,yoaB,3786642,3786734,3786642,92,126,utRho21
2303,yoaC,3787932,3788146,3787932,214,56,utRho21
2304,yoaE,3803544,3803544,3803170,374,766,utRho21
2305,yoaF,3755444,3755444,3755064,380,1140,utRho21
2306,yoaH,3789866,3789866,3789462,404,916,utRho21
2307,yobB,3850418,3850880,3850418,462,3142,utRho21
2308,yobF,3815586,3815586,3815182,404,36,utRho21
2309,yobH,3817800,3817850,3817800,50,0,utRho21
2310,yodB,4084352,4084736,4084352,384,14,utRho21
2311,yodC,4057008,4057008,4056740,268,0,utRho21
2312,yohC,4451358,4451358,4451262,96,0,utRho21
2313,yohD,4451526,4451602,4451526,76,2,utRho21
2314,yohJ,4460986,4461248,4460986,262,0,utRho21
2315,yohO,4431172,4431314,4431172,142,210,utRho21
2316,yojI,4617282,4617282,4617230,52,0,utRho21
2317,ypdI,4988988,4989396,4988988,408,54,utRho21
2318,ypfG,5165786,5165786,5165554,232,62,utRho21
2319,ypfM,5182140,5182140,5181732,408,872,utRho21
2320,yphB,5349590,5349590,5349376,214,44,utRho21
2321,ypjA,5565644,5565644,5565452,192,2,utRho21
2322,ypjB,5569636,5569636,5568858,778,0,utRho21
2323,ypjD,5495860,5495774,5495860,86,0,utRho21
2324,yqaE,5594170,5594170,5594056,114,168,utRho21
2325,yqcA,5846100,5846100,5845968,132,0,utRho21
2326,yqcE,5800944,5801184,5800944,240,0,utRho21
2327,yqeC,6030468,6030468,6030114,354,0,utRho21
2328,yqeF,5971618,5971618,5971184,434,36,utRho21
2329,yqeG,5971438,5971694,5971438,256,22,utRho21
2330,yqeH,5975016,5975072,5975016,56,22,utRho21
2331,yqeI,5976688,5977004,5976688,316,0,utRho21
2332,yqeK,5981140,5981140,5980720,420,4,utRho21
2333,yqfA,6086728,6086728,6086296,432,1560,utRho21
2334,yqgA,6219042,6219106,6219042,64,0,utRho21
2335,yqgB,6172500,6172500,6172102,398,560,utRho21
2336,yqgE,6185768,6185874,6185768,106,64,utRho21
2337,yqhA,6299150,6299150,6298942,208,0,utRho21
2338,yqhC,6310768,6310768,6310436,332,520,utRho21
2339,yqhD,6310604,6310710,6310604,106,284,utRho21
2340,yqhH,6316842,6317254,6316842,412,258,utRho21
2341,yqiC,6369662,6369680,6369662,18,160,utRho21
2342,yqiJ,6384108,6384416,6384108,308,0,utRho21
2343,yqjA,6495096,6495546,6495096,450,1534,utRho21
2344,yqjF,6500932,6501124,6500932,192,1694,utRho21
2345,yqjG,6501948,6502048,6501948,100,0,utRho21
2346,yqjH,6433078,6433078,6432982,96,0,utRho21
2347,yqjI,6433506,6433558,6433506,52,0,utRho21
2348,yraH,6574552,6574852,6574552,300,0,utRho21
2349,yraP,6592144,6592818,6592144,674,726,utRho21
2350,yraQ,6596414,6596414,6596276,138,0,utRho21
2351,yraR,6598024,6598024,6597692,332,538,utRho21
2352,yrbG,13360844,13361100,13360844,256,0,utRho21
2353,yrbL,6696842,6696904,6696842,62,50,utRho21
2354,yrbN,6616172,6616172,6615866,306,142,utRho21
2355,yrdB,6860176,6860176,6860046,130,0,utRho21
2356,yrfF,7052548,7052938,7052548,390,766,utRho21
2357,yrhB,7169440,7169518,7169440,78,0,utRho21
2358,ysaB,7451804,7451804,7451424,380,0,utRho21
2359,ysgA,8032686,8032686,8032338,348,84,utRho21
2360,ytfB,8857638,8857638,8857434,204,0,utRho21
2361,ytfE,8864018,8864018,8863966,52,0,utRho21
2362,ytfF,8866296,8866296,8866130,166,56,utRho21
2363,ytfH,8868164,8868226,8868164,62,0,utRho21
2364,ytfI,8875234,8875414,8875234,180,60,utRho21
2365,ytfJ,8878572,8878572,8878524,48,74,utRho21
2366,ytfK,8879022,8879174,8879022,152,492,utRho21
2367,ytfL,8882642,8882642,8882430,212,64,utRho21
2368,ytfQ,8899634,8899924,8899634,290,1692,utRho21
2369,ytjB,9249598,9249598,9249578,20,0,utRho21
2370,yzfA,8896588,8896588,8896490,98,2,utRho21
2371,zapA,6111102,6111224,6111102,122,1424,utRho21
2372,zapB,8236772,8237030,8236772,258,1080,utRho21
2373,zapC,2011700,2011904,2011700,204,0,utRho21
2374,zinT,4082692,4082750,4082692,58,2,utRho21
2375,zipA,5062814,5062814,5062466,348,194,utRho21
2376,zitB,1569716,1569716,1569646,70,0,utRho21
2377,zntA,7212844,7212902,7212844,58,0,utRho21
2378,zntR,6878336,6878336,6878260,76,0,utRho21
2379,znuA,3885322,3885322,3885166,156,0,utRho21
2380,znuC,3885268,3885324,3885268,56,0,utRho21
2381,zraP,8403424,8403424,8403376,48,0,utRho21
2382,zraS,8403810,8403852,8403810,42,0,utRho21
2383,zupT,6364866,6365100,6364866,234,364,utRho21
2384,zur,8520282,8520282,8520006,276,686,utRho21
2385,zwf,3872752,3872752,3872628,124,222,utRho21
0,C0343,2818676,2818728,2818676,52,0,utRho22
1,aaeB,6776526,6776526,6776376,150,218,utRho22
2,aaeR,6778762,6779040,6778762,278,948,utRho22
3,aaeX,6778860,6778860,6778674,186,1152,utRho22
4,aat,1854920,1854920,1854864,56,10,utRho22
5,accA,416822,417242,416822,420,1358,utRho22
6,accB,6810280,6810872,6810280,592,2414,utRho22
7,accD,4868030,4868030,4867852,178,236,utRho22
8,aceB,8430804,8430956,8430804,152,1682,utRho22
9,aceE,245938,246034,245938,96,156,utRho22
10,ackA,4826918,4826940,4826918,22,270,utRho22
11,acnA,2670848,2671662,2670848,814,1510,utRho22
12,acnB,263038,263230,263038,192,508,utRho22
13,acpP,2303148,2303230,2303148,82,76,utRho22
14,acpS,5402324,5402324,5401996,328,314,utRho22
15,acrA,971396,971396,971238,158,106,utRho22
16,acrB,969370,969370,968806,564,1776,utRho22
17,acrD,5174950,5175190,5174950,240,330,utRho22
18,acrE,6827404,6827728,6827404,324,460,utRho22
19,acrR,971398,971522,971398,124,176,utRho22
20,acrZ,1589502,1589546,1589502,44,234,utRho22
21,acs,8575190,8575190,8574742,448,4268,utRho22
22,actP,8569870,8569870,8569804,66,0,utRho22
23,ada,4620854,4620854,4620810,44,0,utRho22
24,add,3404404,3404466,3404404,62,114,utRho22
25,ade,7687802,7687928,7687802,126,212,utRho22
26,adhE,2596826,2596826,2596242,584,0,utRho22
27,adhP,3107988,3107988,3107676,312,882,utRho22
28,adiA,8681112,8681112,8681042,70,66,utRho22
29,adiC,8674404,8674404,8674062,342,264,utRho22
30,adiY,8676084,8676084,8675858,226,124,utRho22
31,adk,994278,994350,994278,72,1082,utRho22
32,adrA,807374,807406,807374,32,164,utRho22
33,aer,6438240,6438240,6438152,88,2,utRho22
34,aes,1000102,1000102,999946,156,4212,utRho22
35,agaR,6557406,6557406,6557330,76,66,utRho22
36,agaS,6563778,6563952,6563778,174,88,utRho22
37,agp,2131118,2131170,2131118,52,98,utRho22
38,agrA,7296126,7296126,7296126,0,0,utRho22
39,agrB,7296588,7296588,7296588,0,0,utRho22
40,ahpC,1277386,1277890,1277386,504,698,utRho22
41,ahpF,1278004,1279506,1278004,1502,71142,utRho22
42,ahr,8992698,8992698,8992418,280,1224,utRho22
43,aidB,8828494,8828550,8828494,56,40,utRho22
44,ais,4731512,4731512,4731240,272,304,utRho22
45,alaA,4814816,4815122,4814816,306,350,utRho22
46,alaC,4996798,4996798,4996590,208,150,utRho22
47,alaE,5598140,5598328,5598140,188,458,utRho22
48,alaS,5644180,5644180,5644022,158,1030,utRho22
49,alaW,5036612,5036612,5036462,150,0,utRho22
50,aldA,2976380,2976464,2976380,84,442,utRho22
51,aldB,7513070,7513070,7513022,48,560,utRho22
52,alkA,4295118,4295118,4295080,38,534,utRho22
53,alkB,4618890,4618890,4618682,208,228,utRho22
54,allA,1064780,1064902,1064780,122,216,utRho22
55,allD,1092822,1092822,1092726,96,48,utRho22
56,allE,1088112,1088112,1088092,20,288,utRho22
57,allS,1064600,1064600,1064442,158,718,utRho22
58,alr,8531178,8531564,8531178,386,1340,utRho22
59,alsE,8617334,8617334,8616956,378,716,utRho22
60,alsK,8615990,8615990,8615598,392,2026,utRho22
61,alx,6476740,6477160,6476740,420,122,utRho22
62,amiA,5104482,5104704,5104482,222,44,utRho22
63,amiC,5898378,5898378,5898020,358,358,utRho22
64,amn,4110062,4110122,4110062,60,0,utRho22
65,ampC,8758006,8758006,8757888,118,148,utRho22
66,ampD,237362,237466,237362,104,202,utRho22
67,ampG,907372,907372,907090,282,174,utRho22
68,ampH,792726,792726,792574,152,168,utRho22
69,amyA,4012230,4012312,4012230,82,266,utRho22
70,anmK,3439346,3439346,3439204,142,150,utRho22
71,ansB,6201580,6201580,6201456,124,1530,utRho22
72,ansP,3052040,3052040,3051960,80,522,utRho22
73,apaG,104068,104068,103212,856,3044,utRho22
74,apaH,102586,102586,102444,142,5540,utRho22
75,apbE,4623188,4623188,4623068,120,0,utRho22
76,appA,2081198,2081234,2081198,36,0,utRho22
77,appC,2075420,2075480,2075420,60,6,utRho22
78,appY,1167134,1167362,1167134,228,76,utRho22
79,apt,982620,982824,982620,204,46,utRho22
80,aqpZ,1832424,1832424,1832094,330,284,utRho22
81,araB,140150,140150,140096,54,0,utRho22
82,araC,140482,140774,140482,292,724,utRho22
83,araE,5964416,5964416,5964364,52,62,utRho22
84,araF,3972476,3972476,3972256,220,708,utRho22
85,araH,3967120,3967120,3967086,34,1346,utRho22
86,araJ,825058,825058,824962,96,7374,utRho22
87,arcA,9281602,9281602,9280612,990,1934,utRho22
88,arcB,6706098,6706098,6706050,48,410,utRho22
89,arcZ,6701154,6701154,6701154,0,0,utRho22
90,arfA,6877346,6877346,6877298,48,1110,utRho22
91,argA,5898312,5898484,5898312,172,192,utRho22
92,argC,8309770,8310002,8309770,232,208,utRho22
93,argD,6980442,6980442,6980360,82,210,utRho22
94,argE,8310156,8310156,8309694,462,436,utRho22
95,argF,580680,580680,580610,70,134,utRho22
96,argG,6637124,6637274,6637124,150,396,utRho22
97,argI,8956688,8956688,8956622,66,218,utRho22
98,argO,6137672,6137672,6137616,56,170,utRho22
99,argP,6119460,6119506,6119460,46,510,utRho22
100,argR,6769204,6769406,6769204,202,110,utRho22
101,argS,3920002,3920124,3920002,122,172,utRho22
102,argT,4855698,4855698,4855582,116,308,utRho22
103,argU,1129406,1129446,1129406,40,0,utRho22
104,argW,4932616,4932618,4932616,2,0,utRho22
105,argX,7964728,7964750,7964728,22,16,utRho22
106,aroF,5482402,5482402,5482300,102,78,utRho22
107,aroG,1571182,1571266,1571182,84,170,utRho22
108,aroH,3576636,3576870,3576636,234,386,utRho22
109,aroK,7038760,7038760,7038128,632,1084,utRho22
110,aroL,812560,812810,812560,250,2698,utRho22
111,aroP,243342,243342,243102,240,92,utRho22
112,arpA,8445382,8445382,8444974,408,464,utRho22
113,arrS,7316108,7316108,7316108,0,0,utRho22
114,arsR,7297024,7297056,7297024,32,260,utRho22
115,artJ,1801252,1801252,1801150,102,0,utRho22
116,artP,1807686,1807686,1807468,218,7872,utRho22
117,ascF,5678858,5679048,5678858,190,186,utRho22
118,ascG,5678574,5678574,5678528,46,266,utRho22
119,aslB,7965562,7965916,7965562,354,662,utRho22
120,asnA,7854258,7854310,7854258,52,1588,utRho22
121,asnB,1398444,1398444,1398354,90,2422,utRho22
122,asnC,23562186,23562186,23562018,168,960,utRho22
123,asnS,1978088,1978088,1977970,118,1812,utRho22
124,asnT,4089082,4089098,4089082,16,130,utRho22
125,asnU,4119690,4119702,4119690,12,10,utRho22
126,asnV,4124504,4124520,4124504,16,94,utRho22
127,aspA,17473728,17473728,17473308,420,348,utRho22
128,aspC,1971486,1971486,1971418,68,246,utRho22
129,aspS,3901402,3901402,3901044,358,304,utRho22
130,aspT,7893560,7893744,7893560,184,66590,utRho22
131,aspV,473826,473862,473826,36,22,utRho22
132,asr,3342654,3342752,3342654,98,96,utRho22
133,astC,3664088,3664088,3663964,124,142,utRho22
134,astE,3654138,3654138,3653846,292,374,utRho22
135,atoD,4646824,4646894,4646824,70,1622,utRho22
136,atpB,7844540,7844540,7844102,438,30,utRho22
137,atpC,7832118,7832118,7831944,174,378,utRho22
138,atpI,7845050,7845050,7844880,170,0,utRho22
139,avtA,7479348,7479410,7479348,62,938,utRho22
140,azoR,2965982,2965982,2965720,262,508,utRho22
141,azuC,3976002,3976002,3975918,84,0,utRho22
142,bacA,6408350,6408350,6408262,88,818,utRho22
143,bamA,394052,395856,394052,1804,860,utRho22
144,bamB,5277950,5277950,5277304,646,258,utRho22
145,bamC,5198028,5198028,5197730,298,758,utRho22
146,bamD,5471922,5472292,5471922,370,2554,utRho22
147,bamE,5506972,5507210,5506972,238,86,utRho22
148,basS,8666954,8666954,8666544,410,2008,utRho22
149,bax,7474468,7474468,7474354,114,328,utRho22
150,bcp,5200874,5200956,5200874,82,1042,utRho22
151,bcsB,7385346,7385346,7385214,132,152,utRho22
152,bcsE,7392644,7392916,7392644,272,56,utRho22
153,bdcA,8948128,8948128,8948106,22,984,utRho22
154,bdcR,8948192,8948248,8948192,56,546,utRho22
155,bdm,3112680,3112680,3112560,120,136,utRho22
156,betA,654522,654522,654494,28,116,utRho22
157,betI,658722,658722,658668,54,174,utRho22
158,betT,658842,658926,658842,84,292,utRho22
159,bfr,6933498,6933498,6933450,48,116,utRho22
160,bglG,23440182,23440182,23439402,780,2370,utRho22
161,bglX,4444240,4444240,4443978,262,64,utRho22
162,bhsA,2337962,2338146,2337962,184,470,utRho22
163,bioA,1618584,1618584,1618514,70,0,utRho22
164,bioB,1618604,1618688,1618604,84,0,utRho22
165,bioH,7089716,7089716,7089688,28,86,utRho22
166,bisC,7433026,7433026,7432788,238,310,utRho22
167,blc,8755490,8755490,8755444,46,16,utRho22
168,blr,3409024,3409102,3409024,78,398,utRho22
169,bluF,2431226,2431226,2430950,276,138,utRho22
170,bluR,2428226,2428226,2428118,108,38,utRho22
171,bolA,908698,908944,908698,246,134,utRho22
172,borD,1157842,1157842,1157786,56,702,utRho22
173,brnQ,838976,839182,838976,206,860,utRho22
174,bssR,1756492,1756496,1756492,4,0,utRho22
175,bssS,2242116,2242116,2241910,206,706,utRho22
176,btuB,8326798,8327278,8326798,480,3504,utRho22
177,cadB,8720212,8720212,8720062,150,116,utRho22
178,cadC,8723926,8723926,8723868,58,0,utRho22
179,caiE,70998,70998,70742,256,758,utRho22
180,caiF,68436,68600,68436,164,2970,utRho22
181,caiT,84074,84074,83862,212,266,utRho22
182,can,285406,285406,285340,66,248,utRho22
183,carA,59102,59302,59102,200,998,utRho22
184,carB,61550,61634,61550,84,196,utRho22
185,cas2,5757830,5757830,5757706,124,604,utRho22
186,casA,5768638,5768638,5768276,362,210,utRho22
187,cbl,4121882,4121882,4121828,54,2234,utRho22
188,cbpA,2128074,2128074,2127550,524,912,utRho22
189,cbrA,7738628,7738754,7738628,126,16,utRho22
190,cbrB,7794958,7795012,7794958,54,674,utRho22
191,ccmH,4585242,4585242,4584820,422,222,utRho22
192,cdaR,364894,364926,364894,32,168,utRho22
193,cdd,4463638,4463688,4463638,50,42,utRho22
194,cdh,8219814,8219860,8219814,46,1418,utRho22
195,cdsA,391110,391354,391110,244,340,utRho22
196,cedA,3627484,3627484,3627326,158,702,utRho22
197,cfa,3482402,3482826,3482402,424,446,utRho22
198,chaC,2544844,2544972,2544844,128,1410,utRho22
199,chbB,3643452,3643452,3643238,214,276,utRho22
200,chbG,3634624,3634624,3634270,354,208,utRho22
201,cheW,3946924,3946924,3946678,246,278,utRho22
202,chiA,6939792,6939792,6939706,86,390,utRho22
203,chiP,1416472,1416668,1416472,196,124,utRho22
204,cho,3646984,3647030,3646984,46,36,utRho22
205,chpS,8896804,8896894,8896804,90,140,utRho22
206,cirA,4493884,4493884,4493538,346,398,utRho22
207,citC,1304078,1304078,1303712,366,2642,utRho22
208,citT,1293264,1293264,1293160,104,100,utRho22
209,clcA,350104,350214,350104,110,32,utRho22
210,clpA,1846160,1846528,1846160,368,26,utRho22
211,clpB,5468410,5468410,5468346,64,296,utRho22
212,clpP,913154,913354,913154,200,120,utRho22
213,clpS,1845500,1845826,1845500,326,120,utRho22
214,clpX,914404,914852,914404,448,882,utRho22
215,clsA,2617346,2617346,2617290,56,364,utRho22
216,clsC,2212584,2212710,2212584,126,212,utRho22
217,cmk,1922330,1922402,1922330,72,66,utRho22
218,cnu,3409522,3409898,3409522,376,2464,utRho22
219,coaA,8350214,8350214,8350052,162,872,utRho22
220,cobC,1340092,1340092,1339814,278,810,utRho22
221,cobT,4129202,4129202,4128934,268,92,utRho22
222,cobU,4131944,4131944,4131528,416,138,utRho22
223,codB,709768,709844,709768,76,818,utRho22
224,comR,2337726,2337726,2337664,62,12,utRho22
225,copA,1022822,1022822,1022758,64,250,utRho22
226,corA,8002388,8002852,8002388,464,29076,utRho22
227,cpdB,8873258,8873258,8873130,128,820,utRho22
228,cptB,6082198,6082198,6082140,58,66,utRho22
229,cpxA,8210202,8210202,8209950,252,772,utRho22
230,cpxP,8211570,8211640,8211570,70,218,utRho22
231,cpxR,8211372,8211372,8211340,32,76,utRho22
232,cra,175894,176056,175894,162,64,utRho22
233,crcB,1316016,1316016,1315876,140,94,utRho22
234,creA,9270486,9271042,9270486,556,856,utRho22
235,creD,9276320,9276356,9276320,36,276,utRho22
236,crl,515620,515658,515620,38,2048,utRho22
237,crp,6971906,6972240,6971906,334,2144,utRho22
238,crr,5070960,5071668,5070960,708,1718,utRho22
239,csdA,5886414,5886674,5886414,260,140,utRho22
240,csgB,2207718,2207902,2207718,184,136,utRho22
241,csgD,2206688,2206688,2206392,296,966,utRho22
242,csgG,2203510,2203510,2203368,142,952,utRho22
243,csiD,5577854,5577970,5577854,116,78,utRho22
244,csiE,5330802,5330870,5330802,68,248,utRho22
245,csiR,5590942,5591348,5590942,406,268,utRho22
246,cspA,7439778,7440098,7439778,320,4108,utRho22
247,cspB,3283430,3283430,3283108,322,4,utRho22
248,cspC,3815018,3815018,3814870,148,52,utRho22
249,cspD,1845352,1845352,1845180,172,2182,utRho22
250,cspE,1314294,1314584,1314294,290,198,utRho22
251,cspF,3283380,3283710,3283380,330,546,utRho22
252,cspG,2102610,2102922,2102610,312,710,utRho22
253,cspH,2102746,2102746,2102350,396,446,utRho22
254,cspI,3277624,3277624,3277334,290,36,utRho22
255,csrA,5638746,5638746,5638292,454,452,utRho22
256,csrB,5849048,5849048,5849048,0,0,utRho22
257,csrC,8102072,8102072,8102072,0,0,utRho22
258,csrD,6806850,6806850,6806664,186,160,utRho22
259,cstA,1259710,1259788,1259710,78,158,utRho22
260,cueO,274090,274166,274090,76,0,utRho22
261,cueR,1027948,1027986,1027948,38,12,utRho22
262,curA,3037784,3038054,3037784,270,2146,utRho22
263,cusC,1191146,1191200,1191146,54,378,utRho22
264,cusR,1190924,1190924,1190886,38,318,utRho22
265,cutA,8730784,8730784,8730712,72,526,utRho22
266,cutC,3918534,3918534,3917920,614,2086,utRho22
267,cvpA,4861600,4861600,4861526,74,0,utRho22
268,cvrA,2484328,2484328,2484142,186,154,utRho22
269,cyaA,7981548,7982306,7981548,758,884,utRho22
270,cyaR,4334228,4334224,4334228,4,0,utRho22
271,cyaY,7988166,7988166,7988118,48,236,utRho22
272,cybB,2981522,2981804,2981522,282,920,utRho22
273,cycA,8859560,8859728,8859560,168,424,utRho22
274,cydA,1542340,1542916,1542340,576,1128,utRho22
275,cydC,1858800,1858800,1858390,410,214,utRho22
276,cydD,1862062,1862062,1861924,138,78,utRho22
277,cydX,1548300,1548392,1548300,92,140,utRho22
278,cynR,717418,717418,717380,38,190,utRho22
279,cynT,1435092,1435196,1435092,104,68,utRho22
280,cyoA,903306,903306,903220,86,1828,utRho22
281,cyoE,895540,895540,895410,130,80,utRho22
282,cysB,2667576,2667710,2667576,134,460,utRho22
283,cysC,5748056,5748056,5747984,72,348,utRho22
284,cysD,5752736,5752736,5752658,78,270,utRho22
285,cysE,7565362,7565362,7565124,238,520,utRho22
286,cysG,6995508,6995656,6995508,148,3516,utRho22
287,cysJ,5783928,5783928,5783796,132,6184,utRho22
288,cysK,5064688,5064818,5064688,130,108,utRho22
289,cysP,5087114,5087114,5087056,58,766,utRho22
290,cysS,1109154,1109222,1109154,68,14,utRho22
291,cysT,3984100,3984100,3983974,126,2,utRho22
292,cysZ,5062766,5062926,5062766,160,450,utRho22
293,cytR,8249018,8249018,8248912,106,220,utRho22
294,dacA,1328002,1328002,1327926,76,74,utRho22
295,dacB,6657714,6657926,6657714,212,32,utRho22
296,dacC,1761306,1761454,1761306,148,722,utRho22
297,dadA,2475018,2475142,2475018,124,66,utRho22
298,dam,7032504,7032504,7031826,678,1510,utRho22
299,damX,7035200,7035200,7034612,588,808,utRho22
300,dapA,5199568,5199568,5199520,48,40,utRho22
301,dapB,56576,56748,56576,172,1102,utRho22
302,dapD,371954,371954,371894,60,240,utRho22
303,dapE,5183120,5183214,5183120,94,880,utRho22
304,dcp,3254844,3254844,3254760,84,276,utRho22
305,dcrB,7219534,7219910,7219534,376,1830,utRho22
306,dctA,7366996,7366996,7366894,102,368,utRho22
307,dcuA,8733686,8733686,8733546,140,114,utRho22
308,dcuB,8698182,8698182,8697488,694,5588,utRho22
309,dcuC,1312166,1312166,1311936,230,2122,utRho22
310,dcuD,6749166,6749738,6749166,572,1686,utRho22
311,dcuR,8701130,8701130,8700068,1062,2418,utRho22
312,dcuS,8703370,8703370,8703324,46,1412,utRho22
313,dcyD,3999016,3999016,3998960,56,0,utRho22
314,ddpX,3126498,3126498,3126152,346,272,utRho22
315,deaD,6615818,6615818,6615720,98,514,utRho22
316,dedA,4869880,4869880,4869482,398,5318,utRho22
317,dedD,4863750,4863750,4863368,382,80,utRho22
318,def,6867300,6867380,6867300,80,528,utRho22
319,degP,361690,361768,361690,78,100,utRho22
320,degQ,6761308,6761486,6761308,178,5884,utRho22
321,deoB,9239134,9239206,9239134,72,0,utRho22
322,deoC,9233358,9234646,9233358,1288,2014,utRho22
323,dfp,7625406,7625462,7625406,56,26,utRho22
324,dgcZ,3247758,3247758,3247700,58,82,utRho22
325,dgkA,8512914,8513274,8512914,360,156,utRho22
326,dgt,358392,358474,358392,82,1764,utRho22
327,dhaK,2501888,2501888,2501676,212,322,utRho22
328,dhaR,2502006,2502132,2502006,126,370,utRho22
329,dicB,3299194,3299218,3299194,24,20,utRho22
330,dicC,3295752,3295752,3295700,52,0,utRho22
331,dinB,501760,501796,501760,36,0,utRho22
332,dinD,7635398,7635520,7635398,122,330,utRho22
333,dinG,1666146,1666140,1666146,6,20,utRho22
334,dinI,2243018,2243018,2242974,44,336,utRho22
335,dinJ,493230,493230,493004,226,292,utRho22
336,dinQ,7295964,7295964,7295576,388,486,utRho22
337,djlA,114536,114728,114536,192,676,utRho22
338,dkgA,6313142,6313246,6313142,104,350,utRho22
339,dkgB,458196,458334,458196,138,0,utRho22
340,dksA,321502,321502,321208,294,448,utRho22
341,dld,4444164,4444370,4444164,206,110,utRho22
342,dmlA,3763424,3763824,3763424,400,1556,utRho22
343,dmlR,3763710,3763710,3763618,92,534,utRho22
344,dmsA,1881646,1881918,1881646,272,0,utRho22
345,dnaA,7767922,7767922,7767458,464,718,utRho22
346,dnaB,8528566,8528628,8528566,62,64,utRho22
347,dnaK,24096,24326,24096,230,8256,utRho22
348,dnaN,7765466,7765466,7764642,824,352,utRho22
349,dnaQ,471868,472134,471868,266,4462,utRho22
350,dnaT,18406460,18406460,18406068,392,5268,utRho22
351,dnaX,984112,984184,984112,72,240,utRho22
352,dosP,3131486,3131486,3131466,20,166,utRho22
353,dpiB,1303968,1304470,1303968,502,1682,utRho22
354,dppA,7415740,7415740,7415410,330,2700,utRho22
355,dps,1697900,1697900,1697822,78,82,utRho22
356,dsbA,8086754,8086836,8086754,82,1222,utRho22
357,dsbB,2466294,2466294,2466060,234,316,utRho22
358,dsbC,6079266,6079266,6077644,1622,2042,utRho22
359,dsbG,1277600,1277600,1277146,454,458,utRho22
360,dsdA,4958242,4958404,4958242,162,208,utRho22
361,dsdC,4955492,4955492,4955258,234,342,utRho22
362,dsdX,4955642,4955694,4955642,52,852,utRho22
363,dsrA,4050626,4050626,4050626,0,0,utRho22
364,dsrB,4049686,4049686,4049646,40,946,utRho22
365,dtpD,1485340,1485340,1485112,228,750,utRho22
366,dusA,8523200,8523338,8523200,138,2274,utRho22
367,dusB,6820492,6820560,6820492,68,26,utRho22
368,dusC,4460790,4460790,4460770,20,0,utRho22
369,dut,7627704,7627864,7627704,160,560,utRho22
370,dxr,386670,387042,386670,372,94,utRho22
371,ebgA,6445102,6445266,6445102,164,4,utRho22
372,ebgR,6442874,6442932,6442874,58,144,utRho22
373,ecnB,8753018,8753106,8753018,88,342,utRho22
374,eco,4607594,4607810,4607594,216,6,utRho22
375,ecpA,621594,621594,621342,252,826,utRho22
376,ecpB,620238,620238,620052,186,852,utRho22
377,ecpR,622964,622964,622672,292,316,utRho22
378,eda,3866218,3866218,3865512,706,270,utRho22
379,edd,3869426,3869426,3869208,218,76,utRho22
380,efeO,2164308,2164486,2164308,178,38,utRho22
381,efeU_1,2162614,2162712,2162614,98,122,utRho22
382,efp,8751134,8751398,8751134,264,1958,utRho22
383,elaA,4763372,4763372,4763086,286,368,utRho22
384,elaD,4765308,4765426,4765308,118,146,utRho22
385,elfA,1995530,1995736,1995530,206,136,utRho22
386,elfD,1996642,1996980,1996642,338,232,utRho22
387,emrD,7707690,7707844,7707690,154,202,utRho22
388,emrK,4966896,4966896,4966678,218,102,utRho22
389,emrY,4964668,4964668,4964352,316,738,utRho22
390,emtA,2486250,2486360,2486250,110,232,utRho22
391,endA,12361100,12361388,12361100,288,140,utRho22
392,eno,5817692,5817692,5815882,1810,1740,utRho22
393,entC,1249662,1249770,1249662,108,300,utRho22
394,entD,1220508,1220508,1220158,350,312,utRho22
395,entH,1258584,1258600,1258584,16,26,utRho22
396,entS,1244506,1244600,1244506,94,156,utRho22
397,envR,6827266,6827266,6826930,336,0,utRho22
398,epd,12295292,12295292,12294764,528,468,utRho22
399,epmA,8765236,8765286,8765236,50,452,utRho22
400,epmB,8751406,8751406,8751314,92,524,utRho22
401,eptB,7421162,7421162,7420950,212,84,utRho22
402,eptC,8300622,8300622,8300530,92,1348,utRho22
403,erfK,4126708,4126708,4126646,62,326,utRho22
404,erpA,353122,353220,353122,98,60,utRho22
405,esrE,8039956,8039956,8039956,0,0,utRho22
406,essD,1153746,1154796,1153746,1050,3578,utRho22
407,etk,2088606,2088606,2088420,186,1838,utRho22
408,evgA,4967262,4967510,4967262,248,212,utRho22
409,exbB,6304028,6304028,6303968,60,132,utRho22
410,exbD,6302780,6302780,6302486,294,60,utRho22
411,exuR,6493016,6493304,6493016,288,168,utRho22
412,exuT,6490004,6490208,6490004,204,50,utRho22
413,fabA,2032996,2032996,2032940,56,0,utRho22
414,fabB,4883282,4883282,4883210,72,94,utRho22
415,fabH,2297032,2297518,2297032,486,384,utRho22
416,fabI,2702236,2702236,2702078,158,258,utRho22
417,fadB,8062026,8062026,8061942,84,104,utRho22
418,fadD,3779614,3779614,3779492,122,148,utRho22
419,fadE,486812,486812,486606,206,132,utRho22
420,fadH,6463248,6463330,6463248,82,258,utRho22
421,fadI,4921022,4921022,4920938,84,424,utRho22
422,fadL,4922410,4922600,4922410,190,260,utRho22
423,fadM,928720,928804,928720,84,0,utRho22
424,fadR,2469810,2469876,2469810,66,0,utRho22
425,fbaB,4357334,4357334,4357128,206,280,utRho22
426,fdhE,8162722,8162722,8162456,266,490,utRho22
427,fdhF,8598814,8598814,8598732,82,126,utRho22
428,fdnG,3094744,3094802,3094744,58,194,utRho22
429,fdrA,1093012,1093360,1093012,348,362,utRho22
430,feaB,2894994,2895038,2894994,44,0,utRho22
431,feaR,2894734,2894734,2894566,168,80,utRho22
432,fecA,9033454,9033454,9033354,100,228,utRho22
433,fecE,9023288,9023288,9022914,374,1900,utRho22
434,fecI,9036564,9036564,9036470,94,1438,utRho22
435,feoA,7080114,7080326,7080114,212,838,utRho22
436,fepA,1225334,1225334,1224988,346,760,utRho22
437,fepB,1249454,1249454,1249020,434,418,utRho22
438,fepD,1244468,1244468,1244378,90,4,utRho22
439,fes,1225374,1225630,1225374,256,930,utRho22
440,ffh,5495706,5495706,5495590,116,504,utRho22
441,ffs,952576,952848,952576,272,7686,utRho22
442,fhuA,334884,334968,334884,84,408,utRho22
443,fhuE,2323294,2323294,2323102,192,734,utRho22
444,fhuF,9211504,9211504,9211326,178,66918,utRho22
445,fic,6983296,6983296,6982926,370,3356,utRho22
446,fieF,8212864,8212938,8212864,74,584,utRho22
447,fimA,9085388,9086230,9085388,842,1790,utRho22
448,fimB,9081334,9081914,9081334,580,7958,utRho22
449,fimE,9083742,9084074,9083742,332,3026,utRho22
450,fimZ,1129214,1129214,1128960,254,0,utRho22
451,fiu,1683296,1683296,1683062,234,326,utRho22
452,fixA,84650,84806,84650,156,208,utRho22
453,fkpA,6955050,6955050,6954838,212,1448,utRho22
454,fldA,2846084,2846084,2845860,224,2464,utRho22
455,fldB,6079644,6079710,6079644,66,180,utRho22
456,flgA,2261770,2261770,2261726,44,2742,utRho22
457,flgB,2261986,2262036,2261986,50,444,utRho22
458,flgK,2276702,2276756,2276702,54,404,utRho22
459,flgM,2260330,2260330,2260256,74,192,utRho22
460,flgN,2259828,2259828,2259660,168,168,utRho22
461,flhB,3932432,3932432,3932382,50,770,utRho22
462,flhC,3955864,3955864,3955688,176,86,utRho22
463,flhD,3957154,3957154,3956394,760,4252,utRho22
464,fliA,4003638,4003638,4003578,60,16,utRho22
465,fliC,4007352,4007352,4007212,140,136,utRho22
466,fliD,4007634,4007744,4007634,110,1898,utRho22
467,fliE,4026186,4026186,4026028,158,2504,utRho22
468,fliF,4026292,4026458,4026292,166,1966,utRho22
469,fliL,4039168,4039236,4039168,68,154,utRho22
470,flk,4875824,4875900,4875824,76,146,utRho22
471,flu,4142634,4143078,4142634,444,386,utRho22
472,flxA,3292776,3292810,3292776,34,396,utRho22
473,fnr,2799104,2799104,2799052,52,214,utRho22
474,fnrS,2818258,2818258,2818258,0,0,utRho22
475,focA,1909628,1909628,1908932,696,812,utRho22
476,folA,99598,99646,99598,48,190,utRho22
477,folB,6409296,6409296,6409178,118,18,utRho22
478,folD,1115562,1115562,1115482,80,54,utRho22
479,folE,4487696,4487696,4487304,392,1858,utRho22
480,fpr,8228998,8228998,8228944,54,120,utRho22
481,frc,4986878,4986878,4986508,370,858,utRho22
482,frdA,8764824,8764824,8764636,188,1600,utRho22
483,frdD,8758948,8758948,8758732,216,6862,utRho22
484,fre,8052886,8053054,8052886,168,862,utRho22
485,frlA,6999518,6999820,6999518,302,512,utRho22
486,frr,385624,385744,385624,120,218,utRho22
487,frsA,513004,513054,513004,50,4,utRho22
488,fruB,4527194,4527194,4526990,204,10,utRho22
489,frvR,8179804,8179804,8179710,94,38,utRho22
490,fryA,5008986,5008986,5008970,16,528,utRho22
491,fsaA,1727060,1727284,1727060,224,944,utRho22
492,fsr,1009710,1009710,1009392,318,532,utRho22
493,ftnA,3977364,3977432,3977364,68,58,utRho22
494,ftnB,3973550,3973850,3973550,300,588,utRho22
495,ftsA,207122,207964,207122,842,510,utRho22
496,ftsB,5745802,5745802,5745640,162,384,utRho22
497,ftsH,6654204,6654204,6653870,334,194,utRho22
498,ftsK,1865858,1866448,1865858,590,1088,utRho22
499,ftsL,181376,182064,181376,688,2034,utRho22
500,ftsP,6325732,6325732,6325338,394,600,utRho22
501,ftsQ,205484,206310,205484,826,174,utRho22
502,ftsX,7204512,7204512,7204172,340,956,utRho22
503,ftsZ,209272,210610,209272,1338,2,utRho22
504,fucA,5867708,5867708,5867376,332,6192,utRho22
505,fucP,5868238,5868470,5868238,232,610,utRho22
506,fumA,6753760,6753760,6753508,252,1324,utRho22
507,fumB,8694696,8694696,8694652,44,92,utRho22
508,fumC,3373418,3373418,3373176,242,62,utRho22
509,fur,2842892,2842892,2842584,308,2460,utRho22
510,fusA,6947370,6947370,6947028,342,4628,utRho22
511,fxsA,8737206,8737328,8737206,122,162,utRho22
512,gabD,5581824,5582546,5581824,722,6972,utRho22
513,gadA,7335214,7335214,7335160,54,0,utRho22
514,gadB,3144144,3144144,3144090,54,748,utRho22
515,gadC,3141168,3141168,3140978,190,452,utRho22
516,gadE,7315600,7316732,7315600,1132,4596,utRho22
517,gadW,7329562,7329562,7329236,326,56,utRho22
518,gadX,14663356,14663356,14663240,116,1316,utRho22
519,gadY,7329728,7329728,7329728,0,0,utRho22
520,galE,1584354,1584354,1584110,244,322,utRho22
521,galF,4228702,4228702,4228654,48,208,utRho22
522,galM,1577796,1577796,1577674,122,1264,utRho22
523,galP,6176510,6176568,6176510,58,22,utRho22
524,galR,5953138,5953198,5953138,60,228,utRho22
525,galS,4483420,4483420,4483336,84,60,utRho22
526,galU,2582810,2582914,2582810,104,194,utRho22
527,gapA,3724480,3725542,3724480,1062,1422,utRho22
528,garP,6549868,6549868,6549814,54,1428,utRho22
529,gatY,4354468,4354468,4354408,60,0,utRho22
530,gatZ,4352864,4352864,4352642,222,9376,utRho22
531,gcd,282558,282558,282450,108,2,utRho22
532,gcl,1067814,1067832,1067814,18,0,utRho22
533,gcvA,5885278,5885278,5885134,144,76,utRho22
534,gcvB,5885392,5885392,5885392,0,0,utRho22
535,gcvR,5199758,5199812,5199758,54,26,utRho22
536,gcvT,6101544,6101544,6101334,210,586,utRho22
537,gdhA,3684616,3684742,3684616,126,38,utRho22
538,gfcA,2099668,2099668,2099488,180,1936,utRho22
539,gfcD,2096236,2096236,2095890,346,3770,utRho22
540,ghrA,2195648,2195772,2195648,124,242,utRho22
541,ghrB,7434378,7434620,7434378,242,2448,utRho22
542,glcA,6242728,6242728,6242558,170,1516,utRho22
543,glcC,6256412,6256544,6256412,132,106,utRho22
544,glcD,6256152,6256152,6256042,110,274,utRho22
545,gldA,8278092,8278092,8278070,22,222,utRho22
546,glgA,7136784,7136784,7136066,718,1976,utRho22
547,glgB,7147314,7147314,7147004,310,142,utRho22
548,glgC,7139142,7139142,7138656,486,596,utRho22
549,glgP,7133546,7133546,7133162,384,518,utRho22
550,glgS,6384024,6384024,6383878,146,188,utRho22
551,glgX,7142838,7142838,7142638,200,154,utRho22
552,glk,5018922,5018922,5018852,70,140,utRho22
553,glmS,7827622,7827622,7827336,286,1200,utRho22
554,glmU,7830652,7830652,7830400,252,20,utRho22
555,glmY,10765360,10765360,10765360,0,0,utRho22
556,glmZ,7972864,7972864,7972864,0,0,utRho22
557,glnA,16232888,16232888,16232136,752,28,utRho22
558,glnB,5375052,5375052,5374816,236,366,utRho22
559,glnD,377310,377310,377300,10,148,utRho22
560,glnE,6399602,6399602,6399282,320,150,utRho22
561,glnH,1696396,1696396,1696008,388,1746,utRho22
562,glnK,945112,945196,945112,84,1430,utRho22
563,glnL,8112742,8112742,8112678,64,0,utRho22
564,glnQ,1693262,1693262,1692926,336,348,utRho22
565,glnS,1411998,1412186,1411998,188,1872,utRho22
566,gloA,3455602,3455674,3455602,72,34,utRho22
567,gloB,469852,469852,469564,288,1004,utRho22
568,glpA,4705166,4705294,4705166,128,66,utRho22
569,glpD,7123942,7124026,7123942,84,548,utRho22
570,glpE,7123698,7123698,7123646,52,98,utRho22
571,glpF,8236322,8236322,8236180,142,1742,utRho22
572,glpG,7122960,7122960,7122904,56,82,utRho22
573,glpR,7121782,7121782,7121210,572,5140,utRho22
574,glpT,4704902,4704902,4704748,154,1320,utRho22
575,glpX,8231212,8231212,8231158,54,448,utRho22
576,glrK,5382246,5382246,5382196,50,226,utRho22
577,gltA,1509534,1509534,1508936,598,15200,utRho22
578,gltB,6709018,6709264,6709018,246,1290,utRho22
579,gltI,1375792,1375792,1375494,298,3170,utRho22
580,gltP,8588536,8588962,8588536,426,1446,utRho22
581,gltS,7657382,7657382,7657330,52,1932,utRho22
582,gltX,5041568,5041568,5041344,224,70,utRho22
583,gluQ,320286,320286,320224,62,0,utRho22
584,glyA,5371148,5371148,5371014,134,130,utRho22
585,glyQ,7450708,7450708,7450636,72,992,utRho22
586,glyS,7448990,7448990,7448794,196,974,utRho22
587,glyU,5998128,5998128,5998114,14,0,utRho22
588,glyV,8784626,8784720,8784626,94,264,utRho22
589,glyW,3984360,3984360,3984234,126,18,utRho22
590,gmhB,445612,445666,445612,54,256,utRho22
591,gmk,7642776,7642856,7642776,80,162,utRho22
592,gmr,2693686,2693686,2693484,202,756,utRho22
593,gnd,4202648,4202648,4202536,112,562,utRho22
594,gnsB,3275692,3275692,3275564,128,88,utRho22
595,gntK,14310580,14310580,14310368,212,1076,utRho22
596,gntP,9102668,9102668,9102592,76,448,utRho22
597,gntR,7157760,7157760,7157452,308,354,utRho22
598,gntT,7092810,7093118,7092810,308,3090,utRho22
599,gntU,7154170,7154170,7154122,48,362,utRho22
600,gntX,7089334,7089764,7089334,430,180,utRho22
601,gor,7292224,7292598,7292224,374,270,utRho22
602,gpmA,1575340,1575340,1575190,150,156,utRho22
603,gpmM,7570374,7570520,7570374,146,20,utRho22
604,gpsA,7567620,7567620,7567322,298,1512,utRho22
605,gpt,511828,511954,511828,126,336,utRho22
606,grcA,5433046,5433046,5432898,148,1618,utRho22
607,greA,6657728,6657728,6657430,298,256,utRho22
608,greB,7073488,7073624,7073488,136,0,utRho22
609,groL,8741566,8742050,8741566,484,9142,utRho22
610,groS,8741232,8741376,8741232,144,8356,utRho22
611,grpE,5501494,5501494,5501416,78,364,utRho22
612,grxA,1781552,1781552,1781506,46,60,utRho22
613,grxB,2248206,2248206,2248108,98,1040,utRho22
614,grxC,7569152,7569152,7568884,268,860,utRho22
615,grxD,3468324,3468324,3468202,122,500,utRho22
616,gspA,6911268,6911268,6910796,472,1126,utRho22
617,gspC,6910964,6911156,6910964,192,198,utRho22
618,gss,6277220,6277220,6277044,176,350,utRho22
619,gstA,3428654,3428754,3428654,100,0,utRho22
620,gstB,1761038,1761038,1760960,78,670,utRho22
621,guaB,5268214,5268214,5268140,74,8,utRho22
622,gudD,5839026,5839026,5838770,256,176,utRho22
623,gyrA,4678914,4678914,4678840,74,528,utRho22
624,gyrB,7760300,7760300,7760238,62,182,utRho22
625,hcaE,5337964,5338064,5337964,100,11190,utRho22
626,hcaR,5337928,5337928,5337792,136,14432,utRho22
627,hcaT,5336106,5336106,5335692,414,944,utRho22
628,hchA,4071260,4071670,4071260,410,44,utRho22
629,hcp,1828258,1828258,1827628,630,2252,utRho22
630,hcr,1824400,1824400,1824300,100,40,utRho22
631,hdeA,7313582,7313582,7313480,102,2,utRho22
632,hdeD,7313920,7313990,7313920,70,4240,utRho22
633,hdfR,7896320,7896320,7895934,386,44,utRho22
634,hdhA,3396244,3396244,3396080,164,180,utRho22
635,helD,2048876,2048942,2048876,66,248,utRho22
636,hemA,2527166,2527428,2527166,262,190,utRho22
637,hemB,779722,779722,779454,268,4820,utRho22
638,hemF,5106410,5106450,5106410,40,2,utRho22
639,hemH,996062,996110,996062,48,1372,utRho22
640,hemL,349882,349882,349764,118,22,utRho22
641,hemN,8103886,8104090,8103886,204,400,utRho22
642,hepA,127176,127176,126528,648,3714,utRho22
643,hflD,2385372,2385372,2385262,110,26,utRho22
644,hfq,8799602,8800576,8799602,974,4506,utRho22
645,hha,961006,961006,960616,390,352,utRho22
646,hicA,3018442,3018572,3018442,130,118,utRho22
647,higA,6468682,6468682,6468288,394,3736,utRho22
648,higB,6468960,6468960,6468910,50,224,utRho22
649,hinT,2323642,2323770,2323642,128,0,utRho22
650,hipB,3184964,3184964,3184884,80,92,utRho22
651,hisB,4186720,4186936,4186720,216,264,utRho22
652,hisJ,4853674,4853674,4853576,98,128,utRho22
653,hisL,8359856,8359984,8359856,128,1176,utRho22
654,hisS,5281284,5281284,5281150,134,0,utRho22
655,hlpA,400910,400964,400910,54,10,utRho22
656,hlyE,2460932,2460932,2460788,144,1734,utRho22
657,hmp,5371594,5371670,5371594,76,0,utRho22
658,hns,2585916,2585916,2585844,72,802,utRho22
659,hofM,7045856,7045856,7045502,354,168,utRho22
660,hokA,7441620,7441620,7441200,420,844,utRho22
661,hokC,33902,33902,33806,96,262,utRho22
662,hokE,1215462,1215672,1215462,210,116,utRho22
663,holC,8968546,8968546,8968560,14,370,utRho22
664,holD,9215562,9215606,9215562,44,34,utRho22
665,holE,3850040,3850216,3850040,176,3368,utRho22
666,hpt,282720,282862,282720,142,1752,utRho22
667,hrpB,324150,324210,324150,60,100,utRho22
668,hscB,5319048,5319048,5318934,114,492,utRho22
669,hscC,1367188,1367188,1366786,402,492,utRho22
670,hsdS,9163004,9163004,9162924,80,542,utRho22
671,hslJ,2883560,2883560,2883486,74,728,utRho22
672,hslO,7059344,7059548,7059344,204,10640,utRho22
673,hslR,7058220,7058696,7058220,476,1936,utRho22
674,hslV,8244708,8244708,8244574,134,140,utRho22
675,hsrA,7881412,7881412,7881224,188,218,utRho22
676,htgA,21286,21660,21286,374,21858,utRho22
677,htpG,989634,990240,989634,606,24248,utRho22
678,htpX,3825236,3825236,3825152,84,4,utRho22
679,htrE,311036,311036,310852,184,1194,utRho22
680,htrL,7587668,7587668,7587366,302,294,utRho22
681,hupA,8400352,8400562,8400352,210,0,utRho22
682,hupB,1845220,1845804,1845220,584,1272,utRho22
683,hyaA,2063968,2064278,2063968,310,144,utRho22
684,hybO,6292726,6292726,6292522,204,12826,utRho22
685,hycA,5700922,5700922,5700870,52,228,utRho22
686,hycI,5686204,5686204,5686086,118,3490,utRho22
687,hydN,5676264,5676264,5676210,54,58,utRho22
688,hyfA,5202342,5202402,5202342,60,314,utRho22
689,hypA,11402508,11402588,11402508,80,1060,utRho22
690,hypB,11403356,11404004,11403356,648,1176,utRho22
691,hypF,5676210,5676210,5674850,1360,7196,utRho22
692,hypT,9116634,9116634,9116578,56,0,utRho22
693,hyuA,6019660,6020056,6019660,396,1124,utRho22
694,iaaA,1733074,1733136,1733074,62,148,utRho22
695,iadA,9119074,9119074,9119052,22,420,utRho22
696,iap,5753072,5753162,5753072,90,180,utRho22
697,ibaG,6673966,6673966,6673606,360,86,utRho22
698,ibpA,7735036,7735036,7734844,192,2192,utRho22
699,ibpB,7733962,7733962,7733794,168,15204,utRho22
700,icd,2389922,2390246,2389922,324,188,utRho22
701,iclR,8447304,8447304,8447256,48,242,utRho22
702,idi,6065876,6066130,6065876,254,60,utRho22
703,idnD,8988870,8988870,8988812,58,198,utRho22
704,idnK,8989194,8989246,8989194,52,598,utRho22
705,ihfA,3591442,3591442,3591104,338,334,utRho22
706,ihfB,1927498,1927656,1927498,158,162,utRho22
707,ileS,43666,44782,43666,1116,2898,utRho22
708,ileX,6431194,6431196,6431194,2,0,utRho22
709,ilvA,15820940,15821324,15820940,384,932,utRho22
710,ilvC,7915824,7915940,7915824,116,206,utRho22
711,ilvE,15809552,15809936,15809552,384,1192,utRho22
712,ilvI,170840,171260,170840,420,716,utRho22
713,ilvL,23701308,23701932,23701308,624,90,utRho22
714,ilvY,7915734,7915734,7915640,94,148,utRho22
715,inaA,4698998,4698998,4698944,54,1698,utRho22
716,infA,1853370,1853370,1852886,484,328,utRho22
717,infC,3602692,3602692,3601276,1416,1384,utRho22
718,insA-5,3958452,3958452,3958430,22,142,utRho22
719,insA-7,9036758,9037054,9036758,296,2374,utRho22
720,insC-5,6372080,6372284,6372080,204,6966,utRho22
721,insEF-2,785238,785238,785820,582,3470,utRho22
722,insEF-4,2190310,2190310,2190892,582,3432,utRho22
723,insG,9007098,9007098,9006862,236,192,utRho22
724,insH-1,550596,550596,550234,362,35130,utRho22
725,insH-11,7306538,7306538,7306396,142,300,utRho22
726,insH-2,1151548,1151548,1151506,42,670,utRho22
727,insH-3,1378444,1378444,1378026,418,664,utRho22
728,insH-4,2791942,2792152,2791942,210,412,utRho22
729,insH-5,2857852,2857852,2857452,400,896,utRho22
730,insH-6,4135022,4135022,4134642,380,1748,utRho22
731,insH-7,4206186,4206186,4205822,364,2642,utRho22
732,insH-9,6260050,6260356,6260050,306,1912,utRho22
733,insI-3,9017372,9017372,9017234,138,696,utRho22
734,insJ,7441188,7441360,7441188,172,406,utRho22
735,insK,7442130,7442308,7442130,178,34,utRho22
736,insL-1,30760,30890,30760,130,2634,utRho22
737,insL-2,1216112,1216130,1216112,18,210,utRho22
738,insL-3,5028644,5028662,5028644,18,244,utRho22
739,insN-1,540452,540484,540452,32,190,utRho22
740,intD,1132202,1132202,1131956,246,18078,utRho22
741,intR,2826520,2826520,2826470,50,36,utRho22
742,intS,4933026,4933090,4933026,64,3248,utRho22
743,intZ,5117386,5117542,5117386,156,8536,utRho22
744,iraD,9113152,9113986,9113152,834,1066,utRho22
745,iraM,2424246,2424246,2424006,240,232,utRho22
746,iraP,802638,802772,802638,134,0,utRho22
747,iscA,5319924,5319924,5319772,152,384,utRho22
748,iscR,5324398,5324398,5324262,136,5048,utRho22
749,iscX,5313834,5313834,5313472,362,1544,utRho22
750,ispF,5743968,5743968,5743560,408,2778,utRho22
751,ispG,5283908,5283908,5283608,300,156,utRho22
752,ispU,389568,389806,389568,238,190,utRho22
753,isrA,2811502,2811502,2811618,116,4,utRho22
754,istr-1,7706384,7706384,7706384,0,0,utRho22
755,istr-2,7706514,7706514,7706514,0,0,utRho22
756,ivbL,15412092,15412092,15411952,140,148,utRho22
757,ivy,480638,480686,480638,48,304,utRho22
758,katE,3627628,3627734,3627628,106,620,utRho22
759,katG,8267624,8267670,8267624,46,80,utRho22
760,kbaZ,6557732,6557828,6557732,96,78,utRho22
761,kbl,7585154,7585154,7585102,52,528,utRho22
762,kch,2621046,2621046,2620538,508,422,utRho22
763,kdgR,3820506,3820506,3820198,308,54,utRho22
764,kdpE,1443788,1443788,1443466,322,338,utRho22
765,kdpF,1457698,1457698,1457642,56,184,utRho22
766,kdsA,2535708,2536330,2535708,622,1248,utRho22
767,kdsC,6683438,6684546,6683438,1108,3804,utRho22
768,kduI,5968388,5968388,5968248,140,27412,utRho22
769,kefF,94160,94492,94160,332,2460,utRho22
770,kgtP,5451624,5451624,5451492,132,322,utRho22
771,kup,7862206,7862632,7862206,426,356,utRho22
772,lacI,735076,735076,735020,56,402,utRho22
773,lacZ,1465508,1465508,1465220,288,1604,utRho22
774,ldcA,2486394,2486394,2486160,234,512,utRho22
775,ldhA,2885830,2885830,2885686,144,66,utRho22
776,ldrA,2538954,2538954,2538550,404,1724,utRho22
777,ldrB,2540024,2540024,2539620,404,620,utRho22
778,ldrC,2541092,2541092,2540690,402,560,utRho22
779,ldrD,7400544,7400544,7400174,370,516,utRho22
780,lepA,5414392,5414392,5414248,144,64,utRho22
781,lepB,5410928,5410928,5410618,310,302,utRho22
782,leuD,159188,159188,158906,282,460,utRho22
783,leuE,3761600,3761600,3761518,82,270,utRho22
784,leuL,168048,168048,167416,632,202,utRho22
785,leuO,168308,168736,168308,428,292,utRho22
786,leuQ,9212864,9212864,9212802,62,0,utRho22
787,leuU,6644556,6644556,6644316,240,290,utRho22
788,leuV,9212546,9212546,9212330,216,560,utRho22
789,leuX,8992772,8992810,8992772,38,28,utRho22
790,lexA,8514174,8514230,8514174,56,498,utRho22
791,lhr,3456706,3458174,3456706,1468,4918,utRho22
792,ligA,5060402,5060402,5060352,50,8,utRho22
793,ligB,7642576,7642576,7642340,236,558,utRho22
794,lipA,1320602,1320602,1320432,170,554,utRho22
795,lipB,1324802,1324802,1324556,246,9460,utRho22
796,lit,2397032,2397390,2397032,358,4362,utRho22
797,livJ,7199524,7199524,7199316,208,2112,utRho22
798,livK,7195510,7195510,7195120,390,1362,utRho22
799,lldP,7554578,7554798,7554578,220,4438,utRho22
800,lnt,1381968,1381968,1381762,206,292,utRho22
801,loiP,6163784,6163826,6163784,42,24,utRho22
802,lolA,1874656,1874738,1874656,82,156,utRho22
803,lolB,2527112,2527112,2527000,112,162,utRho22
804,lolC,2350748,2350854,2350748,106,58,utRho22
805,lon,917630,917776,917630,146,66,utRho22
806,lpcA,486936,487086,486936,150,244,utRho22
807,lpd,255434,255824,255434,390,1230,utRho22
808,lplA,9248476,9248476,9248234,242,914,utRho22
809,lplT,5947878,5947878,5947724,154,58,utRho22
810,lpoA,6586422,6586800,6586422,378,1430,utRho22
811,lpp,3514592,3514842,3514592,250,100,utRho22
812,lptA,6686598,6686760,6686598,162,680,utRho22
813,lptB,6686792,6687888,6686792,1096,1620,utRho22
814,lptD,114672,114672,114218,454,1302,utRho22
815,lptF,8972244,8972436,8972244,192,198,utRho22
816,lpxC,213016,213114,213016,98,1192,utRho22
817,lpxD,401920,401942,401920,22,0,utRho22
818,lpxL,2233418,2233418,2233164,254,0,utRho22
819,lpxM,3880456,3880456,3880386,70,60,utRho22
820,lpxP,4991156,4991290,4991156,134,432,utRho22
821,lrhA,4813312,4813312,4813282,30,0,utRho22
822,lrp,1864656,1865190,1864656,534,936,utRho22
823,lspA,50028,50414,50028,386,296,utRho22
824,lsrA,3202920,3202980,3202920,60,54,utRho22
825,lsrR,3202514,3202514,3202482,32,64,utRho22
826,ltaE,1818640,1818640,1818588,52,0,utRho22
827,luxS,5630130,5630130,5629466,664,5080,utRho22
828,lysA,5957902,5957902,5957798,104,72,utRho22
829,lysC,8467232,8467232,8466466,766,1978,utRho22
830,lysP,4497120,4497120,4497064,56,310,utRho22
831,lysR,5957900,5958042,5957900,142,62,utRho22
832,lysT,1561028,1561108,1561028,80,138,utRho22
833,lysU,8709610,8709610,8709434,176,94,utRho22
834,macB,1840188,1840694,1840188,506,1526,utRho22
835,maeA,3111484,3111484,3111338,146,2148,utRho22
836,mak,820236,820288,820236,52,220,utRho22
837,malE,8492928,8492928,8492838,90,4,utRho22
838,malI,3398456,3398456,3398360,96,22,utRho22
839,malK,8493472,8493568,8493472,96,252,utRho22
840,malP,7105020,7105020,7104946,74,1380,utRho22
841,malQ,7100798,7100798,7100140,658,640,utRho22
842,malS,14949880,14949988,14949880,108,168,utRho22
843,malT,7106048,7106170,7106048,122,48,utRho22
844,malX,3398626,3398710,3398626,84,4,utRho22
845,malZ,1689980,1690072,1689980,92,1268,utRho22
846,manA,3377102,3377152,3377102,50,100,utRho22
847,manX,3803866,3804096,3803866,230,602,utRho22
848,marC,3237882,3237882,3237816,66,424,utRho22
849,marR,3238186,3238240,3238186,54,328,utRho22
850,matP,2036918,2036970,2036918,52,46,utRho22
851,mazE,5822736,5822736,5822678,58,204,utRho22
852,mazG,5821720,5821720,5821370,350,4910,utRho22
853,mcbA,1684306,1684306,1684112,194,28,utRho22
854,mcbR,3040192,3040524,3040192,332,26,utRho22
855,mcrA,2420278,2420692,2420278,414,572,utRho22
856,mcrC,9156124,9156124,9155916,208,1410,utRho22
857,mdaB,6344814,6345060,6344814,246,322,utRho22
858,mdfA,1767138,1767346,1767138,208,4,utRho22
859,mdh,6768940,6768940,6768536,404,204,utRho22
860,mdoB,9198988,9198988,9198882,106,8000,utRho22
861,mdoD,2993290,2993712,2993290,422,302,utRho22
862,mdoG,2218514,2218670,2218514,156,96,utRho22
863,mdtA,4307958,4308032,4307958,74,174,utRho22
864,mdtE,7318168,7318464,7318168,296,5352,utRho22
865,mdtK,3486538,3486914,3486538,376,4250,utRho22
866,mdtP,8602472,8602472,8602060,412,3246,utRho22
867,melA,8683774,8683822,8683774,48,12,utRho22
868,melR,8683300,8683300,8683256,44,1144,utRho22
869,menA,8240812,8240812,8240698,114,158,utRho22
870,menB,4753774,4753774,4753638,136,842,utRho22
871,mepH,3468714,3468870,3468714,156,60,utRho22
872,mepM,3883666,3883666,3883270,396,276,utRho22
873,mepS,4539840,4539958,4539840,118,162,utRho22
874,metA,8428318,8428560,8428318,242,138,utRho22
875,metB,8257272,8257344,8257272,72,1194,utRho22
876,metC,6304150,6304472,6304150,322,560,utRho22
877,metE,8025768,8026106,8025768,338,3202,utRho22
878,metF,8265092,8265232,8265092,140,158,utRho22
879,metG,4388538,4388600,4388538,62,70,utRho22
880,metH,8447010,8447656,8447010,646,4742,utRho22
881,metJ,8257116,8257116,8256790,326,776,utRho22
882,metK,6173154,6173412,6173154,258,92,utRho22
883,metN,445428,445428,445290,138,22,utRho22
884,metR,8025710,8025710,8025632,78,0,utRho22
885,metT,1394326,1394326,1394266,60,168,utRho22
886,metY,19910250,19910250,19909734,516,678,utRho22
887,metZ,11789528,11789548,11789528,20,264,utRho22
888,mfd,2348056,2348056,2347928,128,218,utRho22
889,mglA,4478782,4478782,4478578,204,458,utRho22
890,mglB,4481132,4481132,4480696,436,9906,utRho22
891,mglC,4475918,4475918,4475506,412,536,utRho22
892,mgrB,3817584,3817584,3817532,52,14,utRho22
893,mgrR,3245828,3245828,3245828,0,0,utRho22
894,mgsA,2054082,2054082,2054030,52,42,utRho22
895,mgtL,8934560,8934862,8934560,302,62,utRho22
896,mhpA,737038,737222,737038,184,912,utRho22
897,mhpR,737072,737072,736840,232,342,utRho22
898,mhpT,750772,750918,750772,146,64,utRho22
899,miaA,8797964,8798504,8797964,540,2282,utRho22
900,micA,5629604,5629604,5629604,0,0,utRho22
901,micC,2874242,2874238,2874242,4,0,utRho22
902,micF,4626168,4626168,4626168,0,0,utRho22
903,micM,1014408,1014408,1014408,0,0,utRho22
904,minE,2449422,2449422,2449090,332,1434,utRho22
905,mioC,7852950,7852950,7852910,40,122,utRho22
906,mipA,3733012,3733012,3732944,68,932,utRho22
907,mlaA,4930270,4930270,4930014,256,8,utRho22
908,mlc,3337206,3337206,3337128,78,140,utRho22
909,mlrA,4429498,4429732,4429498,234,314,utRho22
910,mltA,5894546,5894546,5894356,190,554,utRho22
911,mltD,468050,468050,467910,140,268,utRho22
912,mltF,5391534,5391602,5391534,68,0,utRho22
913,mmuP,550238,550650,550238,412,42458,utRho22
914,mngA,1531622,1531968,1531622,346,206,utRho22
915,mngR,1531852,1531852,1531750,102,200,utRho22
916,mnmG,7851348,7851348,7851266,82,2880,utRho22
917,mntH,5025470,5025470,5025412,58,40,utRho22
918,mntP,3810918,3811376,3810918,458,2390,utRho22
919,mntR,1706160,1706366,1706160,206,16,utRho22
920,mntS,1706128,1706128,1705994,134,60,utRho22
921,moaA,1633654,1634088,1633654,434,2616,utRho22
922,moaB,1635954,1636110,1635954,156,1678,utRho22
923,mobA,8084242,8084242,8083998,244,56,utRho22
924,mocA,6030112,6030320,6030112,208,340,utRho22
925,modA,1589990,1590178,1589990,188,180,utRho22
926,moeA,1732788,1732788,1732728,60,0,utRho22
927,mokB,2984610,2984610,2984258,352,406,utRho22
928,molR_1,4392888,4392948,4392888,60,286,utRho22
929,motA,3954604,3954604,3954278,326,74,utRho22
930,mpaA,2781278,2781278,2781196,82,1242,utRho22
931,mpl,8911456,8911570,8911456,114,318,utRho22
932,mppA,2786108,2786454,2786108,346,376,utRho22
933,mprA,5621494,5621540,5621494,46,674,utRho22
934,mqo,4613848,4613848,4613508,340,684,utRho22
935,mqsA,6336742,6336742,6336492,250,356,utRho22
936,mqsR,6337306,6337306,6337088,218,1388,utRho22
937,mraZ,179192,179268,179192,76,152,utRho22
938,mrcA,7045652,7045742,7045652,90,88,utRho22
939,mrcB,329442,329460,329442,18,0,utRho22
940,mreB,13605424,13605424,13604348,1076,964,utRho22
941,mreD,6798166,6798166,6797750,416,94,utRho22
942,mrp,4388360,4388360,4388336,24,116,utRho22
943,mscK,972984,973072,972984,88,116,utRho22
944,mscL,6876002,6876048,6876002,46,938,utRho22
945,mscS,6139742,6139742,6139614,128,218,utRho22
946,msrA,8884522,8884522,8884352,170,2024,utRho22
947,msrB,3725168,3725168,3724858,310,0,utRho22
948,msyB,2228426,2228426,2228362,64,336,utRho22
949,mtfA,4087236,4087302,4087236,66,752,utRho22
950,mtgA,6699662,6699662,6699618,44,1750,utRho22
951,mtlA,30177504,30178248,30177504,744,9056,utRho22
952,mtn,358366,358366,358306,60,3340,utRho22
953,mtr,6611864,6611864,6611634,230,216,utRho22
954,mug,6430992,6430992,6430946,46,132,utRho22
955,murQ,5091466,5091546,5091466,80,142,utRho22
956,murR,5091586,5091586,5091218,368,592,utRho22
957,mutH,5939164,5939324,5939164,160,250,utRho22
958,mutL,8794092,8794824,8794092,732,5880,utRho22
959,mutM,7622554,7622554,7622304,250,200,utRho22
960,mutS,5714038,5714186,5714038,148,2284,utRho22
961,mutY,18617466,18618078,18617466,612,1404,utRho22
962,nac,4123956,4123956,4123866,90,1528,utRho22
963,nadA,1564122,1564170,1564122,48,0,utRho22
964,nadB,5420714,5420840,5420714,126,126,utRho22
965,nadC,237326,237326,237290,36,320,utRho22
966,nadE,3644604,3644916,3644604,312,622,utRho22
967,nadK,5501526,5501662,5501526,136,406,utRho22
968,nagA,1406350,1406350,1405502,848,3756,utRho22
969,nagB,1407416,1407416,1407222,194,212,utRho22
970,nagC,1404016,1404016,1403188,828,162,utRho22
971,nagE,1407680,1407888,1407680,208,732,utRho22
972,nagK,2357080,2357186,2357080,106,106,utRho22
973,nanA,6747240,6747240,6747152,88,1194,utRho22
974,nanC,9079856,9079856,9079002,854,1372,utRho22
975,nanR,6749406,6749406,6748978,428,2032,utRho22
976,nanS,9075406,9075406,9075188,218,240,utRho22
977,napF,4607390,4607390,4606994,396,362,utRho22
978,narG,2559614,2559728,2559614,114,1294,utRho22
979,narK,2555642,2555914,2555642,272,618,utRho22
980,narP,4580844,4581000,4580844,156,494,utRho22
981,narQ,5171154,5171462,5171154,308,790,utRho22
982,narU,3088326,3088326,3088120,206,680,utRho22
983,narW,3077374,3077374,3074618,2756,4880,utRho22
984,narX,2555554,2555554,2555236,318,170,utRho22
985,narZ,3085380,3085380,3085180,200,0,utRho22
986,ndh,2331984,2332170,2331984,186,1036,utRho22
987,ndk,5289920,5289920,5289728,192,182,utRho22
988,nemR,6904084,6904092,6904084,8,4120,utRho22
989,nepI,7683542,7683542,7683478,64,214,utRho22
990,nfo,4501612,4501680,4501612,68,230,utRho22
991,nfsB,1210906,1210906,1210848,58,32,utRho22
992,nfuA,7090916,7091248,7090916,332,368,utRho22
993,nhaA,34634,34978,34634,344,714,utRho22
994,nhaB,2469534,2469534,2469434,100,316,utRho22
995,nhoA,3067926,3068048,3067926,122,108,utRho22
996,nikA,7226878,7227334,7226878,456,6374,utRho22
997,nikR,7237074,7237176,7237074,102,340,utRho22
998,nirB,6987974,6988022,6987974,48,134,utRho22
999,nlpA,7680034,7680034,7679986,48,74,utRho22
1000,nlpC,3585654,3585654,3585462,192,56,utRho22
1001,nlpD,5737658,5737658,5737506,152,16,utRho22
1002,nlpI,6618080,6618080,6617848,232,68,utRho22
1003,nmpC,1153740,1153740,1153650,90,16,utRho22
1004,nohA,3273206,3273206,3272734,472,1290,utRho22
1005,norR,5664614,5664614,5664578,36,100,utRho22
1006,norV,5664878,5664952,5664878,74,0,utRho22
1007,nrdA,4689510,4689730,4689510,220,7598,utRho22
1008,nrdD,8925676,8925676,8925320,356,2878,utRho22
1009,nrdH,5601312,5601446,5601312,134,618,utRho22
1010,nrdR,865954,866004,865954,50,50,utRho22
1011,nrfA,8575342,8575528,8575342,186,218,utRho22
1012,nsrR,8812088,8812380,8812088,292,5194,utRho22
1013,nudB,3897348,3897348,3897264,84,0,utRho22
1014,nudC,8393428,8393806,8393428,378,458,utRho22
1015,nudE,7052658,7052658,7052298,360,2074,utRho22
1016,nudG,3682876,3682980,3682876,104,0,utRho22
1017,nudI,4729050,4729108,4729050,58,138,utRho22
1018,nudJ,2388874,2388874,2388576,298,556,utRho22
1019,nuoA,4810670,4810670,4810144,526,1144,utRho22
1020,nuoN,4783434,4783434,4783010,424,610,utRho22
1021,nupC,5026018,5026084,5026018,66,20,utRho22
1022,nupG,6211302,6211428,6211302,126,322,utRho22
1023,ogrK,4335096,4335096,4335040,56,94,utRho22
1024,ogt,2800568,2800568,2800472,96,330,utRho22
1025,ohsC,5401036,5401040,5401036,4,0,utRho22
1026,ompA,2040382,2040382,2040106,276,10988,utRho22
1027,ompC,4625774,4625774,4625498,276,176,utRho22
1028,ompF,1974184,1974184,1973964,220,124,utRho22
1029,ompL,8128958,8128958,8128590,368,848,utRho22
1030,ompN,2874158,2874158,2873786,372,62,utRho22
1031,ompR,7073510,7073510,7073168,342,84,utRho22
1032,ompT,1171330,1171330,1171266,64,386,utRho22
1033,ompW,2627982,2628040,2627982,58,66,utRho22
1034,ompX,1700418,1700900,1700418,482,412,utRho22
1035,omrA,5952378,5952378,5952378,0,0,utRho22
1036,omrB,5952770,5952770,5952770,0,0,utRho22
1037,oppA,2602170,2602364,2602170,194,3502,utRho22
1038,orn,8783168,8783208,8783168,40,56,utRho22
1039,osmB,2686952,2686952,2686656,296,1690,utRho22
1040,osmC,3113192,3113250,3113192,58,288,utRho22
1041,osmE,3644566,3644566,3644512,54,74,utRho22
1042,osmF,4439046,4439046,4438962,84,2568,utRho22
1043,osmY,9222306,9222792,9222306,486,368,utRho22
1044,otsA,3963302,3963302,3963224,78,416,utRho22
1045,otsB,3964930,3964930,3964774,156,678,utRho22
1046,oxc,4984288,4984288,4983900,388,2478,utRho22
1047,oxyR,8316914,8316980,8316914,66,1970,utRho22
1048,oxyS,8316788,8316788,8316788,0,0,utRho22
1049,paaA,2907730,2907854,2907730,124,0,utRho22
1050,paaX,2927018,2927078,2927018,60,16,utRho22
1051,paaZ,2907340,2907340,2907284,56,88,utRho22
1052,pabA,6981702,6981702,6981658,44,186,utRho22
1053,pabB,3789256,3789610,3789256,354,792,utRho22
1054,pabC,2306186,2306600,2306186,414,376,utRho22
1055,pagP,1313052,1313114,1313052,62,62,utRho22
1056,panB,299260,299260,299202,58,7608,utRho22
1057,panC,297840,297840,297590,250,526,utRho22
1058,panD,293490,293490,293388,102,100,utRho22
1059,panZ,7195656,7195968,7195656,312,344,utRho22
1060,parC,6332060,6332060,6331946,114,1004,utRho22
1061,patA,6438916,6438988,6438916,72,38,utRho22
1062,patD,3030830,3031156,3030830,326,158,utRho22
1063,pbpC,5294986,5294986,5294650,336,128,utRho22
1064,pbpG,4450132,4450132,4449740,392,318,utRho22
1065,pck,7065358,7065636,7065358,278,4398,utRho22
1066,pcnB,318782,318782,318252,530,420,utRho22
1067,pdhR,244068,244184,244068,116,292,utRho22
1068,pdxB,4875768,4875768,4875702,66,140,utRho22
1069,pdxH,3436068,3436068,3436014,54,294,utRho22
1070,pdxJ,5403626,5403626,5403458,168,522,utRho22
1071,pdxK,5074638,5074638,5074474,164,86,utRho22
1072,pepA,8972278,8972278,8971902,376,312,utRho22
1073,pepD,511618,511618,511432,186,1106,utRho22
1074,pepN,1981182,1981244,1981182,62,406,utRho22
1075,pepQ,8062294,8062322,8062294,28,84,utRho22
1076,pepT,2371646,2371688,2371646,42,272,utRho22
1077,pfkA,8214948,8215104,8214948,156,844,utRho22
1078,pfkB,3612646,3612740,3612646,94,102,utRho22
1079,pflA,1902456,1902456,1902160,296,56,utRho22
1080,pflB,1907850,1907850,1907108,742,1928,utRho22
1081,pflD,8287716,8287990,8287716,274,126,utRho22
1082,pgaA,2185046,2185046,2184578,468,1492,utRho22
1083,pgi,8467444,8467516,8467444,72,62,utRho22
1084,pgk,12291428,12291428,12290488,940,4032,utRho22
1085,pgl,1597078,1597172,1597078,94,74,utRho22
1086,pgpB,2678324,2678660,2678324,336,616,utRho22
1087,pgpC,5397276,5397276,5397100,176,236,utRho22
1088,pgrR,2783744,2783982,2783744,238,968,utRho22
1089,pheL,5475158,5475198,5475158,40,8,utRho22
1090,pheM,7197204,7197204,7197080,124,0,utRho22
1091,pheP,1203858,1203918,1203858,60,322,utRho22
1092,pheU,8725254,8725254,8725252,2,0,utRho22
1093,pheV,6220730,6220732,6220730,2,0,utRho22
1094,phnC,8650412,8650412,8650330,82,500,utRho22
1095,phoA,803414,803494,803414,80,204,utRho22
1096,phoB,834202,834284,834202,82,134,utRho22
1097,phoE,520316,520316,520200,116,2034,utRho22
1098,phoH,2169730,2169984,2169730,254,652,utRho22
1099,phoP,2381016,2381016,2380894,122,2822,utRho22
1100,phoQ,2379880,2379880,2379552,328,1270,utRho22
1101,phoU,7815330,7815330,7815156,174,164,utRho22
1102,phr,1478842,1479014,1478842,172,710,utRho22
1103,pinE,2419054,2419370,2419054,316,2208,utRho22
1104,pinQ,3267168,3267244,3267168,76,424,utRho22
1105,pinR,2867424,2867424,2867348,76,498,utRho22
1106,pitA,7275224,7275284,7275224,60,164,utRho22
1107,pitB,6272806,6272806,6272742,64,682,utRho22
1108,pka,5439862,5439906,5439862,44,384,utRho22
1109,plaP,4174476,4174476,4174124,352,356,utRho22
1110,pldA,8009628,8009724,8009628,96,3660,utRho22
1111,pldB,8018028,8018340,8018028,312,4606,utRho22
1112,plsB,8513196,8513196,8512932,264,142,utRho22
1113,pmbA,8915890,8915918,8915890,28,0,utRho22
1114,pmrD,4747148,4747148,4747076,72,36,utRho22
1115,pncB,1980828,1980828,1980712,116,130,utRho22
1116,pncC,5648788,5648788,5648692,96,24,utRho22
1117,pnp,6622652,6622652,6622336,316,90,utRho22
1118,pntA,3355950,3355950,3355806,144,88,utRho22
1119,pntB,3353096,3353096,3352720,376,430,utRho22
1120,polA,8093880,8093932,8093880,52,470,utRho22
1121,polB,131606,131606,131560,46,0,utRho22
1122,potD,2365700,2365700,2365658,42,256,utRho22
1123,potE,1436688,1436688,1436530,158,140,utRho22
1124,potF,1787268,1787568,1787268,300,352,utRho22
1125,poxB,1822152,1822152,1822098,54,958,utRho22
1126,ppa,8899372,8899372,8899304,68,96,utRho22
1127,ppc,8306380,8306380,8306196,184,1914,utRho22
1128,ppdA,5928440,5928440,5928354,86,3120,utRho22
1129,ppdD,235410,235410,235098,312,494,utRho22
1130,pphA,3846770,3846770,3845938,832,3578,utRho22
1131,pphB,5719474,5719520,5719474,46,46,utRho22
1132,ppiA,6984898,6984898,6984594,304,156,utRho22
1133,ppiC,7919682,7919682,7919626,56,20,utRho22
1134,ppiD,923638,923830,923638,192,106,utRho22
1135,ppk,5245748,5246088,5245748,340,666,utRho22
1136,pppA,6228958,6228958,6228704,254,484,utRho22
1137,ppsA,3574322,3574322,3574224,98,0,utRho22
1138,ppsR,3574678,3574890,3574678,212,232,utRho22
1139,pptA,3065716,3066104,3065716,388,1668,utRho22
1140,pqiA,2023318,2024002,2023318,684,66,utRho22
1141,prc,3830054,3830054,3829632,422,4968,utRho22
1142,preT,4467978,4468066,4467978,88,2352,utRho22
1143,prfC,9218688,9218828,9218688,140,606,utRho22
1144,prkB,6968622,6968980,6968622,358,2914,utRho22
1145,prlC,7290476,7290476,7290364,112,500,utRho22
1146,prlF,6553944,6554004,6553944,60,638,utRho22
1147,proB,520432,520776,520432,344,1436,utRho22
1148,proC,811372,811372,811288,84,268,utRho22
1149,proK,7417388,7417388,7417384,4,0,utRho22
1150,proL,4572414,4572422,4572414,8,24,utRho22
1151,proP,8660640,8661004,8660640,364,682,utRho22
1152,proS,437674,437674,437550,124,534,utRho22
1153,proV,5609126,5609630,5609126,504,1486,utRho22
1154,prpB,697292,697364,697292,72,192,utRho22
1155,prpR,696942,696942,696886,56,104,utRho22
1156,prs,2524354,2524354,2523750,604,14200,utRho22
1157,psd,8781276,8781276,8780720,556,2046,utRho22
1158,psiE,8480600,8480650,8480600,50,66,utRho22
1159,pspA,2736076,2736158,2736076,82,32,utRho22
1160,pspF,2736080,2736080,2735824,256,64,utRho22
1161,pspG,8525632,8525680,8525632,48,24,utRho22
1162,pssA,5445156,5445454,5445156,298,4214,utRho22
1163,pstB,7817112,7817112,7816732,380,220,utRho22
1164,pstC,7821084,7821084,7820796,288,20,utRho22
1165,pstS,23469408,23469408,23469150,258,294,utRho22
1166,psuG,4517114,4517114,4516734,380,6590,utRho22
1167,psuT,4514992,4514992,4514670,322,0,utRho22
1168,pth,2517084,2517084,2517026,58,0,utRho22
1169,ptrA,5918022,5918022,5917768,254,0,utRho22
1170,ptrB,3857730,3857730,3857678,52,3612,utRho22
1171,ptsG,2315252,2315738,2315252,486,1344,utRho22
1172,ptsH,5066996,5067528,5066996,532,1546,utRho22
1173,purA,8809328,8809374,8809328,46,16,utRho22
1174,purC,5195562,5195562,5195236,326,286,utRho22
1175,purD,8411972,8411972,8411862,110,106,utRho22
1176,purE,1106284,1106284,1106200,84,618,utRho22
1177,purH,8415254,8415254,8415064,190,132,utRho22
1178,purL,5391178,5391178,5391086,92,314,utRho22
1179,purM,5242306,5242394,5242306,88,54,utRho22
1180,purR,3475378,3475688,3475378,310,484,utRho22
1181,purT,3861438,3861762,3861438,324,740,utRho22
1182,purU,2577512,2577512,2577248,264,192,utRho22
1183,putA,2157850,2157850,2157764,86,102,utRho22
1184,putP,2158336,2158610,2158336,274,214,utRho22
1185,puuA,2721936,2721936,2721816,120,0,utRho22
1186,puuC,2725456,2725486,2725456,30,4,utRho22
1187,puuD,2722104,2722240,2722104,136,122,utRho22
1188,puuP,2718746,2718746,2718374,372,1484,utRho22
1189,pykA,3874988,3875298,3874988,310,572,utRho22
1190,pykF,3510934,3511396,3510934,462,2986,utRho22
1191,pyrC,2245286,2245286,2245214,72,0,utRho22
1192,pyrD,2009464,2009536,2009464,72,422,utRho22
1193,pyrE,7631970,7631970,7631536,434,878,utRho22
1194,pyrF,2683740,2683842,2683740,102,56,utRho22
1195,pyrG,5819594,5819594,5819332,262,1296,utRho22
1196,pyrH,383624,383710,383624,86,378,utRho22
1197,pyrL,8945490,8945490,8945066,424,634,utRho22
1198,qmcA,1031646,1031646,1031546,100,922,utRho22
1199,qor,8528608,8528608,8528462,146,100,utRho22
1200,qseB,6339502,6339656,6339502,154,1862,utRho22
1201,queA,849970,850022,849970,52,362,utRho22
1202,queE,5811212,5811212,5810836,376,336,utRho22
1203,queF,5850642,5850696,5850642,54,124,utRho22
1204,queG,8788184,8788184,8788134,50,49492,utRho22
1205,racC,2835630,2835630,2835526,104,0,utRho22
1206,racR,2840898,2840898,2840482,416,376,utRho22
1207,raiA,5474208,5474308,5474208,100,88,utRho22
1208,rarD,8008594,8008594,8008356,238,722,utRho22
1209,ravA,7862256,7862256,7862186,70,158,utRho22
1210,rayT,495088,495274,495088,186,346,utRho22
1211,rbn,4763162,4763216,4763162,54,72,utRho22
1212,rbsD,7866644,7866702,7866644,58,0,utRho22
1213,rcnA,4371654,4371834,4371654,180,320,utRho22
1214,rcnB,4373768,4373920,4373768,152,254,utRho22
1215,rcnR,4371806,4371806,4371592,214,618,utRho22
1216,rcsA,4047672,4047936,4047672,264,7482,utRho22
1217,rcsB,4631390,4632354,4631390,964,574,utRho22
1218,rcsC,4640162,4640162,4639656,506,446,utRho22
1219,rcsD,4626904,4626976,4626904,72,914,utRho22
1220,rdgB,6193240,6193362,6193240,122,448,utRho22
1221,rdlA,2538646,2538646,2538646,0,0,utRho22
1222,rdlB,2539712,2539716,2539712,4,74,utRho22
1223,rdlC,2540782,2540786,2540782,4,2,utRho22
1224,rdlD,7400272,7400272,7400272,0,0,utRho22
1225,rdoA,8084782,8084830,8084782,48,74,utRho22
1226,recA,11295276,11295276,11295076,200,220,utRho22
1227,recC,5925014,5925014,5924856,158,0,utRho22
1228,recF,7763722,7763722,7762442,1280,3172,utRho22
1229,recN,5503518,5503590,5503518,72,54,utRho22
1230,recQ,8011666,8011728,8011666,62,40,utRho22
1231,relA,5828554,5828554,5827302,1252,1344,utRho22
1232,relB,3291806,3291806,3291744,62,0,utRho22
1233,rem,3289950,3289950,3289804,146,12,utRho22
1234,rep,7921294,7921354,7921294,60,218,utRho22
1235,rfaD,7587730,7587974,7587730,244,808,utRho22
1236,rfaE,6393852,6393852,6393506,346,184,utRho22
1237,rfaH,8049930,8049930,8049642,288,1894,utRho22
1238,rfbX,4219436,4219436,4219168,268,848,utRho22
1239,rfe,7935600,7935832,7935600,232,44,utRho22
1240,rhaB,8194944,8194944,8194896,48,114,utRho22
1241,rhaD,8188770,8188770,8188544,226,118,utRho22
1242,rhaS,8195422,8195472,8195422,50,158,utRho22
1243,rhaT,8201132,8201132,8201050,82,430,utRho22
1244,rhlE,1661566,1661744,1661566,178,182,utRho22
1245,rhoL,47593944,47594772,47593944,828,66792,utRho22
1246,rhsB,7238006,7238384,7238006,378,1516,utRho22
1247,rhsC,1458758,1459166,1458758,408,0,utRho22
1248,rhsD,1046132,1046522,1046132,390,280,utRho22
1249,rhtA,1700608,1700608,1700194,414,716,utRho22
1250,rhtC,8015478,8015514,8015478,36,1164,utRho22
1251,ribA,2678468,2678468,2678320,148,298,utRho22
1252,ribC,3486916,3486916,3486484,432,7628,utRho22
1253,ribE,869008,869294,869008,286,2626,utRho22
1254,ribF,42766,42814,42766,48,112,utRho22
1255,ridA,8941892,8941892,8941826,66,2,utRho22
1256,rihA,1369204,1369204,1368824,380,5150,utRho22
1257,rihB,4510504,4510504,4510372,132,128,utRho22
1258,rimJ,2251044,2251124,2251044,80,332,utRho22
1259,rimK,1783752,1783934,1783752,182,530,utRho22
1260,rimL,2997486,2997876,2997486,390,398,utRho22
1261,rimO,1756140,1756140,1756070,70,94,utRho22
1262,rimP,6636350,6636350,6636012,338,484,utRho22
1263,rlmA,3814172,3814172,3814120,52,290,utRho22
1264,rlmD,5830086,5830086,5830000,86,26,utRho22
1265,rlmE,6655520,6655520,6655328,192,220,utRho22
1266,rlmF,1684384,1684664,1684384,280,614,utRho22
1267,rlmG,6471784,6471784,6471750,34,156,utRho22
1268,rlmI,2060002,2060002,2059938,64,92,utRho22
1269,rlmJ,7290700,7290770,7290700,70,30,utRho22
1270,rlmL,2015344,2015688,2015344,344,2678,utRho22
1271,rlpA,1330444,1330444,1330380,64,120,utRho22
1272,rluA,120900,120900,120692,208,374,utRho22
1273,rluF,8460324,8460708,8460324,384,254,utRho22
1274,rmf,2031006,2031430,2031006,424,534,utRho22
1275,rna,1290068,1290068,1290006,62,52,utRho22
1276,rnb,2698258,2698258,2697824,434,5044,utRho22
1277,rnc,10816892,10816892,10816252,640,6704,utRho22
1278,rnd,3776122,3776122,3775982,140,66,utRho22
1279,rne,2289746,2289746,2288734,1012,5510,utRho22
1280,rnhA,472082,472082,472004,78,1260,utRho22
1281,rnk,1288360,1288360,1287934,426,112,utRho22
1282,rnlA,5531788,5531836,5531788,48,1926,utRho22
1283,rnlB,5533414,5533968,5533414,554,1554,utRho22
1284,rnpB,19623552,19623552,19623552,0,0,utRho22
1285,rob,9270706,9270706,9270620,86,104,utRho22
1286,rodZ,5285868,5285868,5285688,180,138,utRho22
1287,rpe,7030306,7030306,7030118,188,116,utRho22
1288,rph,15266320,15266320,15266196,124,148,utRho22
1289,rpiA,6118706,6118706,6118650,56,1910,utRho22
1290,rpiB,8626514,8626700,8626514,186,770,utRho22
1291,rpiR,8626274,8626274,8625982,292,340,utRho22
1292,rplJ,8359246,8359992,8359246,746,1324,utRho22
1293,rplK,8356708,8356894,8356708,186,82,utRho22
1294,rplM,6757344,6757344,6757302,42,692,utRho22
1295,rplN,6896444,6896444,6896298,146,426,utRho22
1296,rplS,5489284,5489284,5489060,224,2092,utRho22
1297,rplT,7199052,7199052,7198996,56,52,utRho22
1298,rplU,6667036,6667036,6666902,134,72,utRho22
1299,rplY,4564866,4565034,4564866,168,148,utRho22
1300,rpmA,6666450,6666450,6666238,212,152,utRho22
1301,rpmB,15247980,15247980,15246696,1284,18212,utRho22
1302,rpmE,8253816,8254026,8253816,210,342,utRho22
1303,rpmF,2294676,2294734,2294676,58,4306,utRho22
1304,rpmH,7768130,7768672,7768130,542,872,utRho22
1305,rpmI,3600854,3600854,3599998,856,2390,utRho22
1306,rpoB,8362126,8362490,8362126,364,58,utRho22
1307,rpoD,6424946,6426094,6424946,1148,22266,utRho22
1308,rpoE,5420372,5420372,5420024,348,140,utRho22
1309,rpoH,7202006,7202006,7201566,440,5976,utRho22
1310,rpoN,6689324,6689434,6689324,110,14,utRho22
1311,rpoS,5736236,5736236,5735102,1134,3802,utRho22
1312,rpoZ,7644154,7644212,7644154,58,598,utRho22
1313,rppH,5937986,5937986,5937954,32,46,utRho22
1314,rprA,3540744,3540744,3540744,0,0,utRho22
1315,rpsA,1923434,1923990,1923434,556,17452,utRho22
1316,rpsF,8850050,8850236,8850050,186,2160,utRho22
1317,rpsI,6756580,6756580,6756414,166,638,utRho22
1318,rpsJ,6906884,6906884,6906540,344,812,utRho22
1319,rpsL,6949242,6949242,6949104,138,522,utRho22
1320,rpsM,6885130,6885130,6884942,188,152,utRho22
1321,rpsO,13247144,13247144,13246736,408,296,utRho22
1322,rpsP,5492508,5492508,5492370,138,0,utRho22
1323,rpsT,42420,42420,42156,264,458,utRho22
1324,rpsU,12842584,12843124,12842584,540,596,utRho22
1325,rraA,8238716,8238716,8238660,56,44,utRho22
1326,rraB,8956768,8956946,8956768,178,246,utRho22
1327,rrsA,8070478,8071062,8070478,584,2908,utRho22
1328,rrsB,16665468,16666636,16665468,1168,5992,utRho22
1329,rrsC,7883032,7883616,7883032,584,2532,utRho22
1330,rrsD,6858094,6858094,6857524,570,738,utRho22
1331,rrsE,8415726,8416294,8415726,568,294,utRho22
1332,rrsG,5462896,5462896,5462314,582,2946,utRho22
1333,rrsH,446970,447542,446970,572,324,utRho22
1334,rsd,8393908,8393908,8393616,292,1058,utRho22
1335,rseA,5419264,5419264,5418808,456,190,utRho22
1336,rseP,392940,393092,392940,152,98,utRho22
1337,rseX,4067298,4067298,4067298,0,0,utRho22
1338,rsfS,1338144,1338144,1338072,72,82,utRho22
1339,rsgA,8783132,8783132,8783018,114,190,utRho22
1340,rsmA,105176,105176,104860,316,2406,utRho22
1341,rsmB,6869982,6870414,6869982,432,196,utRho22
1342,rsmC,9215736,9215736,9215400,336,248,utRho22
1343,rsmD,7208594,7208786,7208594,192,76,utRho22
1344,rsmE,6182036,6182268,6182036,232,1124,utRho22
1345,rsmG,7847512,7847512,7847360,152,1318,utRho22
1346,rsmH,180020,180188,180020,168,206,utRho22
1347,rsmI,6587106,6587106,6586670,436,2418,utRho22
1348,rssA,2578212,2578412,2578212,200,1058,utRho22
1349,rssB,2580440,2580484,2580440,44,188,utRho22
1350,rstA,3364276,3364300,3364276,24,0,utRho22
1351,rsuA,4561096,4561096,4560966,130,104,utRho22
1352,rsxA,3411510,3411534,3411510,24,174,utRho22
1353,rtcA,7114004,7114004,7113698,306,3222,utRho22
1354,rtcB,7116214,7116214,7116158,56,188,utRho22
1355,rtn,4541356,4541452,4541356,96,4,utRho22
1356,rutA,2148052,2148052,2148022,30,102,utRho22
1357,rutG,2140090,2140090,2139678,412,882,utRho22
1358,rutR,2148226,2148484,2148226,258,848,utRho22
1359,ruvA,7784096,7784096,7783904,192,164,utRho22
1360,ruvB,7782176,7782176,7781424,752,496,utRho22
1361,ruvC,3894878,3894878,3894752,126,30,utRho22
1362,rybB,1776114,1776114,1776114,0,0,utRho22
1363,rydB,3529860,3529860,3529322,538,638,utRho22
1364,rydC,2983012,2983012,2983012,0,0,utRho22
1365,ryfA,5307398,5307710,5307398,312,118,utRho22
1366,ryfD,5468590,5468590,5468590,0,0,utRho22
1367,ryhB,7162032,7162032,7162032,0,0,utRho22
1368,ryjA,8556132,8556132,8556132,0,0,utRho22
1369,ryjB,9055954,9055954,9055954,0,0,utRho22
1370,sad,3229598,3229598,3229406,192,486,utRho22
1371,safA,3168056,3168056,3167918,138,1794,utRho22
1372,sanA,4465368,4465756,4465368,388,222,utRho22
1373,sapF,2705314,2705314,2705268,46,230,utRho22
1374,sbcB,4165456,4165512,4165456,56,0,utRho22
1375,sbcC,831694,831694,831506,188,202,utRho22
1376,sbcD,833954,833954,833904,50,102,utRho22
1377,sbmA,793106,793278,793106,172,3978,utRho22
1378,sbmC,4162650,4162650,4162524,126,82,utRho22
1379,sdaA,3793618,3793864,3793618,246,120,utRho22
1380,sdaC,5856070,5856458,5856070,388,582,utRho22
1381,sdhC,1509916,1510354,1509916,438,20744,utRho22
1382,sdhD,1510808,1511120,1510808,312,8288,utRho22
1383,sdiA,3993834,3993834,3993664,170,330,utRho22
1384,secE,8354354,8354716,8354354,362,90,utRho22
1385,secG,6645180,6645180,6645010,170,144,utRho22
1386,selA,7522594,7522594,7522498,96,1050,utRho22
1387,selB,7519850,7519850,7519722,128,494,utRho22
1388,selC,7672396,7672444,7672396,48,0,utRho22
1389,selD,3696058,3696058,3696016,42,3746,utRho22
1390,seqA,1425884,1425974,1425884,90,268,utRho22
1391,serA,6117098,6117098,6116820,278,180,utRho22
1392,serB,9249712,9249790,9249712,78,330,utRho22
1393,serC,3830380,3830612,3830380,232,44,utRho22
1394,serS,1878730,1878856,1878730,126,1072,utRho22
1395,serT,2063438,2063438,2063424,14,0,utRho22
1396,serU,4087124,4087124,4087114,10,208,utRho22
1397,serV,5637394,5637394,5637290,104,276,utRho22
1398,serW,1852014,1852014,1851942,72,86,utRho22
1399,serX,2195352,2195352,2195304,48,104,utRho22
1400,setB,4527426,4527726,4527426,300,0,utRho22
1401,setC,7673488,7673906,7673488,418,3054,utRho22
1402,sfmA,1116124,1116424,1116124,300,446,utRho22
1403,sfmC,1117606,1117948,1117606,342,66,utRho22
1404,sfsA,323030,323030,322972,58,372,utRho22
1405,sfsB,6669592,6669818,6669592,226,458,utRho22
1406,sgrR,154676,154676,154598,78,390,utRho22
1407,sgrS,154734,154734,154734,0,0,utRho22
1408,shiA,4107068,4107286,4107068,218,362,utRho22
1409,sibA,4306622,4306622,4306622,0,0,utRho22
1410,sibB,4307292,4307292,4307292,0,0,utRho22
1411,sibC,6113702,6113702,6113702,0,0,utRho22
1412,sibD,6389730,6389730,6389730,0,0,utRho22
1413,sibE,6390480,6390480,6390480,0,0,utRho22
1414,sixA,4913998,4913998,4913624,374,102,utRho22
1415,slp,7307872,7307922,7307872,50,76,utRho22
1416,slt,9261400,9261466,9261400,66,140,utRho22
1417,slyA,3442028,3442028,3441648,380,352,utRho22
1418,slyB,3439496,3439752,3439496,256,130,utRho22
1419,slyD,6957398,6957398,6956994,404,668,utRho22
1420,slyX,6954862,6955280,6954862,418,1406,utRho22
1421,smf,6867372,6867372,6867120,252,836,utRho22
1422,smpB,5509534,5509792,5509534,258,1210,utRho22
1423,smrA,2811872,2811958,2811872,86,628,utRho22
1424,smrB,4896872,4897212,4896872,340,1996,utRho22
1425,smtA,1946808,1947074,1946808,266,596,utRho22
1426,sodA,8201518,8201620,8201518,102,1330,utRho22
1427,sodB,3470646,3470756,3470646,110,556,utRho22
1428,sodC,3449358,3449358,3449310,48,112,utRho22
1429,sohB,2658568,2658664,2658568,96,1092,utRho22
1430,sokB,2984232,2984238,2984232,6,178,utRho22
1431,solA,2241218,2241218,2241172,46,18,utRho22
1432,soxR,8554894,8554938,8554894,44,264,utRho22
1433,soxS,8554846,8554846,8554766,80,14,utRho22
1434,speA,6172096,6172096,6171822,274,174,utRho22
1435,speB,6167892,6167892,6167594,298,212,utRho22
1436,speC,6218350,6218350,6218310,40,14,utRho22
1437,spf,8099798,8099798,8099798,0,0,utRho22
1438,sppA,3697422,3697674,3697422,252,3258,utRho22
1439,spy,3651376,3651376,3651250,126,338,utRho22
1440,sra,3112092,3112092,3111926,166,0,utRho22
1441,sraB,2293178,2293178,2293178,0,0,utRho22
1442,sraC,3846132,3846132,3846132,0,0,utRho22
1443,srlA,5651582,5651664,5651582,82,62,utRho22
1444,srlR,5657720,5658094,5657720,374,12232,utRho22
1445,srmB,5425752,5425792,5425752,40,272,utRho22
1446,sroA,151216,151216,151216,0,0,utRho22
1447,sroG,6369436,6369436,6369436,0,0,utRho22
1448,sroH,8380974,8380974,8380974,0,0,utRho22
1449,ssb,8548022,8548250,8548022,228,110,utRho22
1450,sseA,5304782,5304988,5304782,206,3524,utRho22
1451,sspA,6755138,6755138,6754840,298,364,utRho22
1452,ssrA,5511014,5511186,5511014,172,100,utRho22
1453,ssrS,12223036,12223932,12223036,896,756,utRho22
1454,sstT,6479726,6479888,6479726,162,242,utRho22
1455,ssuB,1988282,1988282,1988088,194,478,utRho22
1456,ssuE,1995126,1995126,1995024,102,0,utRho22
1457,sthA,8321604,8321604,8321580,24,1758,utRho22
1458,stpA,5597156,5597156,5596990,166,202,utRho22
1459,sucA,3034344,3034824,3034344,480,2500,utRho22
1460,sufA,3528836,3528836,3528772,64,18,utRho22
1461,sufE,3518962,3518962,3518580,382,154,utRho22
1462,sugE,8753588,8753750,8753588,162,1048,utRho22
1463,sulA,2041894,2041894,2041838,56,3402,utRho22
1464,syd,5850738,5850738,5850560,178,186,utRho22
1465,symE,9159834,9159834,9159680,154,958,utRho22
1466,symR,9159670,9159670,9159670,0,0,utRho22
1467,tabA,8949566,8949724,8949566,158,6,utRho22
1468,talA,5157140,5157332,5157140,192,198,utRho22
1469,talB,16382,16476,16382,94,6916,utRho22
1470,tam,3214442,3214692,3214442,250,516,utRho22
1471,tamA,8884540,8884764,8884540,224,1998,utRho22
1472,tar,3945432,3945432,3945382,50,2,utRho22
1473,tas,5943138,5943194,5943138,56,2884,utRho22
1474,tatA,16087636,16087780,16087636,144,576,utRho22
1475,tatE,1317742,1317894,1317742,152,162,utRho22
1476,tauA,770410,770464,770410,54,268,utRho22
1477,tdcA,6534186,6534186,6534130,56,32,utRho22
1478,tdcG,6519652,6519652,6519298,354,1522,utRho22
1479,tdcR,6534380,6534760,6534380,380,92,utRho22
1480,tdk,2586986,2587054,2586986,68,94,utRho22
1481,tehA,3001072,3001146,3001072,74,58,utRho22
1482,tesA,1039898,1039898,1039530,368,1076,utRho22
1483,tesB,950402,950402,950322,80,0,utRho22
1484,tfaE,2418532,2418532,2418238,294,2408,utRho22
1485,tfaQ,3269912,3269912,3269770,142,1138,utRho22
1486,tff,379424,379256,379424,168,226,utRho22
1487,tgt,852110,852274,852110,164,4,utRho22
1488,thiD,4369346,4369346,4369032,314,158,utRho22
1489,thiI,882936,883098,882936,162,70,utRho22
1490,thiM,4370902,4370902,4370602,300,832,utRho22
1491,thiQ,146170,146170,145854,316,7360,utRho22
1492,thrL,592,760,592,168,160,utRho22
1493,thrS,7210932,7210932,7210280,652,884,utRho22
1494,thrU,8350762,8350776,8350762,14,2,utRho22
1495,thrV,6847414,6847414,6847310,104,156778,utRho22
1496,thrW,525682,525742,525682,60,7706,utRho22
1497,thyA,5930696,5930696,5930310,386,2126,utRho22
1498,tig,909986,910266,909986,280,68,utRho22
1499,tisB,7706674,7707106,7706674,432,322,utRho22
1500,tktA,6163414,6163414,6163270,144,98,utRho22
1501,tktB,5158616,5159272,5158616,656,5772,utRho22
1502,tldD,6784368,6784368,6784056,312,0,utRho22
1503,tmcA,5191876,5191876,5191718,158,1606,utRho22
1504,tnaC,15553644,15553740,15553644,96,8024,utRho22
1505,tolB,1555074,1555480,1555074,406,428,utRho22
1506,tolC,6356008,6356230,6356008,222,204,utRho22
1507,tomB,961588,961588,961416,172,1632,utRho22
1508,tonB,2622108,2622178,2622108,70,16,utRho22
1509,topA,2661578,2662096,2661578,518,136,utRho22
1510,torC,2116112,2116168,2116112,56,818,utRho22
1511,torR,2115968,2115968,2115908,60,880,utRho22
1512,torS,2112364,2112364,2112356,8,36,utRho22
1513,torT,2112414,2112522,2112414,108,36,utRho22
1514,tpiA,8223138,8223138,8223014,124,186,utRho22
1515,tppB,3425342,3425538,3425342,196,2810,utRho22
1516,tpr,2574376,2574376,2574376,0,0,utRho22
1517,tpx,2777688,2777688,2777622,66,990,utRho22
1518,tqsA,3347780,3347826,3347780,46,292,utRho22
1519,treA,2494850,2494850,2494752,98,1168,utRho22
1520,treB,8932420,8932420,8932360,60,128,utRho22
1521,treF,7339102,7339184,7339102,82,72,utRho22
1522,treR,8934694,8934694,8934492,202,0,utRho22
1523,trg,2984878,2984940,2984878,62,42,utRho22
1524,trkG,2847342,2847564,2847342,222,1478,utRho22
1525,trmA,8326590,8326590,8326540,50,292,utRho22
1526,trpA,2634678,2634678,2634444,234,626,utRho22
1527,trpC,2639888,2639888,2639570,318,116,utRho22
1528,trpL,5292432,5292432,5292328,104,0,utRho22
1529,trpR,9265408,9265520,9265408,112,438,utRho22
1530,trpS,7027394,7027394,7027276,118,1626,utRho22
1531,trpT,7893560,7893914,7893560,354,66662,utRho22
1532,trxA,7931294,7931522,7931294,228,608,utRho22
1533,trxB,1864156,1864156,1864100,56,44,utRho22
1534,trxC,5437350,5437470,5437350,120,972,utRho22
1535,tsaD,6421256,6421256,6421086,170,350,utRho22
1536,tsgA,6985038,6985136,6985038,98,574,utRho22
1537,tsr,9182824,9183314,9182824,490,5694,utRho22
1538,tsx,864490,864490,864026,464,1174,utRho22
1539,ttcA,2823970,2823970,2823896,74,2576,utRho22
1540,ttdA,6412848,6412926,6412848,78,32,utRho22
1541,ttdR,6412760,6412760,6412512,248,204,utRho22
1542,tufA,6943448,6943448,6942658,790,31586,utRho22
1543,tus,3368346,3368518,3368346,172,100,utRho22
1544,tusA,7218040,7218040,7217992,48,388,utRho22
1545,tusB,6950218,6950218,6949930,288,960,utRho22
1546,tynA,2902996,2902996,2902698,298,28,utRho22
1547,typA,8116460,8116814,8116460,354,2934,utRho22
1548,tyrB,8534164,8534228,8534164,64,1312,utRho22
1549,tyrP,3979004,3979362,3979004,358,1140,utRho22
1550,tyrR,2773384,2773440,2773384,56,160,utRho22
1551,tyrS,3434566,3434566,3434444,122,34,utRho22
1552,tyrT,2575330,2575330,2575244,86,44,utRho22
1553,uacT,6062378,6062734,6062378,356,3378,utRho22
1554,ubiC,8504886,8505012,8504886,126,320,utRho22
1555,ubiD,8049618,8049976,8049618,358,1958,utRho22
1556,ubiE,8037494,8037710,8037494,216,306,utRho22
1557,ubiG,4679078,4679134,4679078,56,52,utRho22
1558,ucpA,5089342,5089342,5089246,96,4,utRho22
1559,udp,8032782,8032862,8032782,80,230,utRho22
1560,ugd,4199470,4199470,4199226,244,60,utRho22
1561,ugpB,7184852,7184852,7184650,202,4220,utRho22
1562,ugpQ,7176600,7176600,7176226,374,338,utRho22
1563,uhpT,7694396,7694396,7694334,62,46,utRho22
1564,uidA,3392304,3392304,3392142,162,28,utRho22
1565,uidC,3386012,3386012,3385702,310,2,utRho22
1566,uidR,3394150,3394150,3394104,46,20,utRho22
1567,ulaA,8839854,8839960,8839854,106,310,utRho22
1568,ulaG,8839350,8839350,8839250,100,264,utRho22
1569,ulaR,8837124,8837124,8836906,218,56,utRho22
1570,umpG,5741372,5741372,5740548,824,204,utRho22
1571,umpH,1400704,1400704,1400652,52,64,utRho22
1572,umuD,2461476,2461534,2461476,58,0,utRho22
1573,ung,5433476,5433508,5433476,32,472,utRho22
1574,uof,2843316,2843316,2842900,416,2648,utRho22
1575,upp,5241818,5241818,5241744,74,8,utRho22
1576,usg,4873780,4873780,4873298,482,348,utRho22
1577,ushA,1009772,1009828,1009772,56,164,utRho22
1578,uspA,7279966,7280222,7279966,256,926,utRho22
1579,uspB,7279696,7279696,7279440,256,200,utRho22
1580,uspC,3959172,3959506,3959172,334,132,utRho22
1581,uspE,2797318,2797318,2797244,74,0,utRho22
1582,uspF,2871282,2871282,2871238,44,348,utRho22
1583,uspG,1283806,1283806,1283734,72,3706,utRho22
1584,uvrA,8547872,8547872,8547742,130,164,utRho22
1585,uvrB,1626304,1627052,1626304,748,1452,utRho22
1586,uvrC,3989758,3989758,3989412,346,140,utRho22
1587,uvrD,7995814,7995966,7995814,152,626,utRho22
1588,uvrY,3990812,3990812,3990718,94,284,utRho22
1589,uxaB,3221474,3221474,3221360,114,14,utRho22
1590,uxaC,6489714,6489714,6489482,232,256,utRho22
1591,uxuA,9103036,9103272,9103036,236,3430,utRho22
1592,uxuR,9108916,9109152,9108916,236,208,utRho22
1593,valS,8967854,8967854,8967674,180,248,utRho22
1594,valU,5041848,5041862,5041848,14,0,utRho22
1595,valV,3492830,3492870,3492830,40,260,utRho22
1596,ves,3649968,3649968,3649874,94,144,utRho22
1597,waaA,7616512,7617080,7616512,568,1164,utRho22
1598,waaH,7580298,7580298,7580162,136,236,utRho22
1599,waaQ,7616476,7616476,7616196,280,1084,utRho22
1600,waaU,7598996,7598996,7598624,372,178,utRho22
1601,waaY,7602272,7602272,7601930,342,10274,utRho22
1602,wbbH,4214888,4214888,4214452,436,1826,utRho22
1603,wbbK,4209212,4209212,4209018,194,336,utRho22
1604,wcaM,4231868,4231868,4231792,76,50,utRho22
1605,wrbA,2135516,2135516,2135416,100,160,utRho22
1606,wza,4275166,4275166,4274486,680,500,utRho22
1607,wzxC,4240674,4240674,4240316,358,106,utRho22
1608,wzzB,4196950,4196950,4196602,348,36,utRho22
1609,xanP,7657642,7657890,7657642,248,372,utRho22
1610,xanQ,6048520,6048702,6048520,182,158,utRho22
1611,xapA,5049820,5049820,5049756,64,140,utRho22
1612,xapR,10090252,10090252,10089908,344,0,utRho22
1613,xdhA,6000514,6000690,6000514,176,2650,utRho22
1614,xerD,6079702,6079702,6079486,216,344,utRho22
1615,xseA,5268394,5268464,5268394,70,398,utRho22
1616,xseB,882746,882746,882686,60,204,utRho22
1617,xthA,3664798,3664856,3664798,58,0,utRho22
1618,xylA,7461614,7461614,7461530,84,17218,utRho22
1619,xylE,8484540,8484540,8484508,32,0,utRho22
1620,xylF,7462138,7462262,7462138,124,1424,utRho22
1621,xylR,7469812,7469958,7469812,146,122,utRho22
1622,yaaA,13230,13230,12918,312,312,utRho22
1623,yaaI,23876,23876,23572,304,1782,utRho22
1624,yaaJ,16034,16034,15918,116,324,utRho22
1625,yaaU,91184,91614,91184,430,1846,utRho22
1626,yaaW,23084,23084,22712,372,806,utRho22
1627,yaaX,10060,10468,10060,408,314,utRho22
1628,yabI,142542,142702,142542,160,500,utRho22
1629,yacC,273880,273880,273834,46,746,utRho22
1630,yacH,262932,262932,262520,412,4,utRho22
1631,yacL,268678,268776,268678,98,514,utRho22
1632,yadD,293796,293936,293796,140,270,utRho22
1633,yadE,289930,290162,289930,232,274,utRho22
1634,yadN,314110,314110,313766,344,126,utRho22
1635,yadS,355572,355572,355248,324,8304,utRho22
1636,yadV,312470,312470,312402,68,666,utRho22
1637,yaeF,434270,434270,434006,264,188,utRho22
1638,yaeP,428374,428374,428250,124,1256,utRho22
1639,yaeQ,428176,428582,428176,406,2320,utRho22
1640,yaeR,423716,423754,423716,38,126,utRho22
1641,yafC,462166,462166,461762,404,54,utRho22
1642,yafD,462128,462244,462128,116,28,utRho22
1643,yafK,491986,491986,491610,376,2632,utRho22
1644,yafL,493282,493424,493282,142,290,utRho22
1645,yafN,503938,504010,503938,72,64,utRho22
1646,yafS,469568,469632,469568,64,498,utRho22
1647,yafT,474470,474670,474470,200,108,utRho22
1648,yafV,480432,480432,480378,54,182,utRho22
1649,yafZ,536052,536052,536010,42,814,utRho22
1650,yagE,564446,564556,564446,110,2452,utRho22
1651,yagG,570414,570790,570414,376,2938,utRho22
1652,yagI,578384,578384,578324,60,638,utRho22
1653,yagK,586236,586236,585896,340,22542,utRho22
1654,yagL,588062,588062,587836,226,4570,utRho22
1655,yagN,591342,591342,591158,184,1824,utRho22
1656,yahA,663746,664742,663746,996,8358,utRho22
1657,yahC,670136,670136,670044,92,4372,utRho22
1658,yahE,671478,671850,671478,372,776,utRho22
1659,yahM,690504,690808,690504,304,444,utRho22
1660,yahN,692872,692872,692674,198,2792,utRho22
1661,yahO,692864,692968,692864,104,290,utRho22
1662,yaiE,816296,816354,816296,58,202,utRho22
1663,yaiI,811396,811528,811396,132,398,utRho22
1664,yaiO,761946,761946,761684,262,632,utRho22
1665,yaiP,767970,767970,767870,100,346,utRho22
1666,yaiS,769660,769660,769232,428,1320,utRho22
1667,yaiV,788922,788922,788922,0,0,utRho22
1668,yaiY,799094,799094,798666,428,422,utRho22
1669,yaiZ,798888,799186,798888,298,414,utRho22
1670,yajC,854410,854574,854410,164,384,utRho22
1671,yajD,860938,861210,860938,272,360,utRho22
1672,yajI,866068,866068,865702,366,254,utRho22
1673,yajL,887496,887496,887282,214,602,utRho22
1674,yajQ,889316,889366,889316,50,60,utRho22
1675,yajR,893374,893374,893332,42,66,utRho22
1676,ybaB,987418,988152,987418,734,1408,utRho22
1677,ybaL,1006590,1006590,1006476,114,360,utRho22
1678,ybaM,980648,980648,980542,106,3024,utRho22
1679,ybaN,981436,981764,981436,328,1258,utRho22
1680,ybaO,936704,936766,936704,62,0,utRho22
1681,ybaP,1016568,1016568,1016160,408,1670,utRho22
1682,ybaQ,1016348,1016436,1016348,88,604,utRho22
1683,ybaS,1023146,1023282,1023146,136,1488,utRho22
1684,ybaV,927504,927874,927504,370,0,utRho22
1685,ybaY,950490,950758,950490,268,1484,utRho22
1686,ybbB,1062724,1062724,1062452,272,248,utRho22
1687,ybbJ,1030154,1030154,1029718,436,2828,utRho22
1688,ybbL,1031784,1031838,1031784,54,178,utRho22
1689,ybbN,1037136,1037136,1036558,578,2130,utRho22
1690,ybbO,1038658,1038658,1038298,360,806,utRho22
1691,ybbY,1080718,1081130,1080718,412,3562,utRho22
1692,ybcH,1176140,1176140,1175962,178,1112,utRho22
1693,ybcI,1113264,1113264,1113106,158,2132,utRho22
1694,ybcJ,1114050,1114050,1113746,304,10,utRho22
1695,ybcK,1137502,1137804,1137502,302,510,utRho22
1696,ybcL,1141690,1141786,1141690,96,0,utRho22
1697,ybcN,1144628,1144932,1144628,304,390,utRho22
1698,ybcQ,1147548,1147912,1147548,364,4622,utRho22
1699,ybcW,1159610,1159760,1159610,150,330,utRho22
1700,ybdD,1263982,1264364,1263982,382,2198,utRho22
1701,ybdF,1212106,1212106,1211772,334,398,utRho22
1702,ybdH,1267048,1267048,1266954,94,208,utRho22
1703,ybdJ,1212822,1212822,1212398,424,222,utRho22
1704,ybdK,1215122,1215122,1214766,356,3494,utRho22
1705,ybdL,1267114,1267172,1267114,58,316,utRho22
1706,ybdM,1271110,1271110,1270752,358,5814,utRho22
1707,ybdN,1273372,1273372,1273138,234,264,utRho22
1708,ybdR,1283844,1284176,1283844,332,4186,utRho22
1709,ybeD,1325412,1325412,1325284,128,114,utRho22
1710,ybeF,1323090,1323090,1322756,334,1448,utRho22
1711,ybeL,1349986,1350036,1349986,50,836,utRho22
1712,ybeQ,1353412,1353412,1353094,318,78,utRho22
1713,ybeR,1353120,1353422,1353120,302,78,utRho22
1714,ybeT,1358832,1358832,1358812,20,70,utRho22
1715,ybeU,1358924,1359016,1358924,92,198,utRho22
1716,ybeZ,1386938,1386938,1386834,104,2232,utRho22
1717,ybfA,1458074,1458268,1458074,194,1126,utRho22
1718,ybfE,1423878,1423878,1423796,82,316,utRho22
1719,ybfF,1425692,1425692,1425604,88,366,utRho22
1720,ybfH,1433282,1433282,1433194,88,64,utRho22
1721,ybgA,1477840,1478002,1477840,162,302,utRho22
1722,ybgC,1549288,1549504,1549288,216,68,utRho22
1723,ybgD,1505916,1505916,1505590,326,14470,utRho22
1724,ybgI,1485238,1485654,1485238,416,12,utRho22
1725,ybgO,1498370,1498370,1497964,406,250,utRho22
1726,ybgS,1570992,1570992,1570634,358,162,utRho22
1727,ybhA,1597184,1597184,1596862,322,80,utRho22
1728,ybhB,1616070,1616070,1615818,252,248,utRho22
1729,ybhC,1614642,1614642,1614562,80,1134,utRho22
1730,ybhD,1601418,1601418,1601276,142,170,utRho22
1731,ybhH,1601104,1601518,1601104,414,456,utRho22
1732,ybhK,1633384,1633384,1633294,90,560,utRho22
1733,ybhM,1641556,1641586,1641556,30,90,utRho22
1734,ybhN,1645296,1645296,1644996,300,488,utRho22
1735,ybhQ,1649202,1649260,1649202,58,3350,utRho22
1736,ybiA,1665920,1665920,1665900,20,0,utRho22
1737,ybiI,1676968,1676968,1676912,56,744,utRho22
1738,ybiO,1691328,1691328,1690960,368,1020,utRho22
1739,ybiP,1705252,1705252,1705194,58,536,utRho22
1740,ybiS,1711572,1711572,1711488,84,250,utRho22
1741,ybiT,1711894,1711926,1711894,32,0,utRho22
1742,ybiU,1718212,1718212,1718122,90,190,utRho22
1743,ybiV,1720176,1720176,1720056,120,0,utRho22
1744,ybiW,1725566,1725566,1725212,354,11342,utRho22
1745,ybiX,1678548,1678548,1678414,134,256,utRho22
1746,ybjC,1781784,1781826,1781784,42,0,utRho22
1747,ybjE,1830154,1830154,1829714,440,430,utRho22
1748,ybjG,1767016,1767016,1766776,240,1078,utRho22
1749,ybjL,1779882,1779882,1779638,244,284,utRho22
1750,ybjM,1779770,1780178,1779770,408,588,utRho22
1751,ybjO,1795704,1795978,1795704,274,34,utRho22
1752,ybjP,1809046,1809046,1808934,112,0,utRho22
1753,ybjQ,1809034,1809186,1809034,152,2,utRho22
1754,ybjS,1813796,1813796,1813506,290,210,utRho22
1755,ybjX,1838206,1838206,1838168,38,38,utRho22
1756,ycaD,1891438,1891742,1891438,304,78,utRho22
1757,ycaI,1928210,1928640,1928210,430,262,utRho22
1758,ycaK,1899094,1899336,1899094,242,256,utRho22
1759,ycaL,1920264,1920528,1920264,264,34,utRho22
1760,ycaM,1894240,1894458,1894240,218,260,utRho22
1761,ycaR,1941284,1941346,1941284,62,2452,utRho22
1762,ycbB,1961862,1962094,1961862,232,946,utRho22
1763,ycbJ,1943344,1943504,1943344,160,0,utRho22
1764,ycbK,1966046,1966150,1966046,104,108,utRho22
1765,ycbZ,2036920,2036920,2036598,322,166,utRho22
1766,yccA,2062886,2062886,2062836,50,102,utRho22
1767,yccF,2048730,2048730,2048696,34,54,utRho22
1768,yccS,2047988,2047988,2047766,222,794,utRho22
1769,yccT,2055674,2055674,2055546,128,264,utRho22
1770,yccX,2059960,2060128,2059960,168,568,utRho22
1771,ycdT,2185682,2185752,2185682,70,12,utRho22
1772,ycdU,2191266,2191686,2191266,420,490,utRho22
1773,ycdZ,2200504,2200592,2200504,88,148,utRho22
1774,yceA,2233544,2233614,2233544,70,24,utRho22
1775,yceD,2293298,2293588,2293298,290,748,utRho22
1776,yceF,2293522,2293522,2293190,332,420,utRho22
1777,yceH,2252154,2252314,2252154,160,1498,utRho22
1778,yceI,2237282,2237282,2236952,330,880,utRho22
1779,yceJ,2238142,2238142,2238092,50,568,utRho22
1780,yceM,2253208,2253612,2253208,404,508,utRho22
1781,yceO,2239264,2239264,2238894,370,216,utRho22
1782,yceQ,2288760,2289004,2288760,244,4230,utRho22
1783,ycfD,2376540,2376540,2376480,60,214,utRho22
1784,ycfJ,2334814,2335198,2334814,384,598,utRho22
1785,ycfS,2340834,2340834,2340748,86,0,utRho22
1786,ycfT,2350658,2350658,2350330,328,180,utRho22
1787,ycfZ,2362760,2362760,2362534,226,2016,utRho22
1788,ycgB,2474570,2474570,2474482,88,124,utRho22
1789,ycgG,2434614,2434656,2434614,42,1924,utRho22
1790,ycgJ,2452956,2453200,2452956,244,778,utRho22
1791,ycgL,2455218,2455362,2455218,144,112,utRho22
1792,ycgN,2457366,2457660,2457366,294,378,utRho22
1793,ycgR,2489112,2489112,2489054,58,32,utRho22
1794,ycgV,2512222,2512222,2511904,318,1380,utRho22
1795,ycgX,2426568,2426568,2426214,354,16312,utRho22
1796,ycgY,2490166,2490320,2490166,154,940,utRho22
1797,ycgZ,2431504,2431578,2431504,74,120,utRho22
1798,ychE,2596904,2597196,2596904,292,0,utRho22
1799,ychF,2515764,2515764,2515624,140,16,utRho22
1800,ychH,2517476,2517582,2517476,106,798,utRho22
1801,ychJ,2578354,2578354,2578264,90,336,utRho22
1802,ychN,2547310,2547310,2547198,112,138,utRho22
1803,ychO,2547520,2547850,2547520,330,1120,utRho22
1804,ychQ,2533798,2533848,2533798,50,30,utRho22
1805,yciA,2624828,2624828,2624492,336,154,utRho22
1806,yciB,2626110,2626110,2625780,330,952,utRho22
1807,yciC,2627396,2627396,2627326,70,98,utRho22
1808,yciE,2630794,2630794,2630448,346,1258,utRho22
1809,yciG,5264368,5264368,5264140,228,0,utRho22
1810,yciI,2621784,2621784,2621730,54,0,utRho22
1811,yciN,2661606,2661606,2661336,270,86,utRho22
1812,yciS,2680270,2680486,2680270,216,228,utRho22
1813,yciT,2689088,2689088,2688692,396,1720,utRho22
1814,yciU,2614718,2614718,2614300,418,1718,utRho22
1815,yciV,2646376,2646440,2646376,64,0,utRho22
1816,yciW,2700472,2700472,2700214,258,4172,utRho22
1817,yciZ,2689276,2689276,2689218,58,1176,utRho22
1818,ycjD,2703792,2703792,2703520,272,78,utRho22
1819,ycjG,2777748,2777860,2777748,112,20,utRho22
1820,ycjM,2740006,2740432,2740006,426,118,utRho22
1821,ycjW,2767982,2767982,2767922,60,0,utRho22
1822,ycjX,2768138,2768234,2768138,96,52,utRho22
1823,ycjY,5568288,5568288,5567460,828,2392,utRho22
1824,ydaE,2836438,2836438,2836016,422,736,utRho22
1825,ydaN,2816048,2816100,2816048,52,252,utRho22
1826,ydaS,2840340,2840730,2840340,390,242,utRho22
1827,ydbC,2948376,2948442,2948376,66,72,utRho22
1828,ydbD,2950132,2950288,2950132,156,0,utRho22
1829,ydbH,2885800,2886102,2885800,302,314,utRho22
1830,ydbJ,2881712,2882116,2881712,404,2230,utRho22
1831,ydbK,2881692,2881692,2881568,124,650,utRho22
1832,ydcA,2983294,2983354,2983294,60,382,utRho22
1833,ydcF,2974404,2974470,2974404,66,8,utRho22
1834,ydcI,2990268,2990268,2990142,126,52,utRho22
1835,ydcJ,2990266,2990576,2990266,310,116,utRho22
1836,ydcK,3001280,3001280,3000898,382,280,utRho22
1837,ydcL,3004646,3004914,3004646,268,8,utRho22
1838,ydcN,3012308,3012344,3012308,36,2216,utRho22
1839,ydcP,3013508,3013562,3013508,54,148,utRho22
1840,ydcR,3019956,3020006,3019956,50,0,utRho22
1841,ydcS,3022906,3023308,3022906,402,996,utRho22
1842,ydcX,3034442,3034778,3034442,336,826,utRho22
1843,ydcY,3035220,3035296,3035220,76,74,utRho22
1844,ydcZ,3036750,3036750,3036662,88,6220,utRho22
1845,yddB,3155332,3155332,3155238,94,544,utRho22
1846,yddE,3071738,3071738,3071716,22,14,utRho22
1847,yddG,3094410,3094410,3094338,72,104,utRho22
1848,yddJ,3089732,3089732,3089438,294,2556,utRho22
1849,yddW,3137704,3137704,3137646,58,42,utRho22
1850,ydeA,3233910,3234056,3233910,146,1714,utRho22
1851,ydeE,3242528,3242664,3242528,136,182,utRho22
1852,ydeI,3249118,3249118,3248994,124,134,utRho22
1853,ydeJ,3249376,3249546,3249376,170,76,utRho22
1854,ydeN,3165458,3165458,3165048,410,282,utRho22
1855,ydeP,3173328,3173328,3172972,356,1144,utRho22
1856,ydeR,3176596,3176596,3176592,4,560,utRho22
1857,ydfA,3296872,3297016,3296872,144,4,utRho22
1858,ydfG,3254982,3255034,3254982,52,278,utRho22
1859,ydfH,3256652,3256704,3256652,52,122,utRho22
1860,ydfK,3265446,3266144,3265446,698,11442,utRho22
1861,ydgA,3379588,3379704,3379588,116,0,utRho22
1862,ydgC,3364124,3364124,3364060,64,0,utRho22
1863,ydgD,3343906,3343920,3343906,14,604,utRho22
1864,ydgH,3356754,3356854,3356754,100,58,utRho22
1865,ydgJ,3408798,3408798,3408616,182,644,utRho22
1866,ydgK,3410414,3410500,3410414,86,1052,utRho22
1867,ydhB,3479618,3479618,3479596,22,0,utRho22
1868,ydhC,3479698,3479822,3479698,124,2,utRho22
1869,ydhF,3451310,3451310,3451264,46,58,utRho22
1870,ydhI,3441996,3442050,3441996,54,0,utRho22
1871,ydhL,3451864,3451864,3451840,24,1318,utRho22
1872,ydhQ,3492404,3492404,3492254,150,224,utRho22
1873,ydhS,3494136,3494262,3494136,126,1376,utRho22
1874,ydhT,3499138,3499138,3499118,20,174,utRho22
1875,ydhY,3509284,3509284,3508954,330,1438,utRho22
1876,ydhZ,3510418,3510418,3510282,136,1630,utRho22
1877,ydiE,3579206,3579226,3579206,20,0,utRho22
1878,ydiH,3530582,3530582,3530406,176,80,utRho22
1879,ydiM,3541852,3542142,3541852,290,274,utRho22
1880,ydiN,3544818,3545024,3544818,206,234,utRho22
1881,ydiP,3558656,3558656,3558602,54,612,utRho22
1882,ydiU,3582508,3582508,3582488,20,968,utRho22
1883,ydiV,3584174,3584174,3584040,134,240,utRho22
1884,ydiY,3612500,3612500,3612166,334,270,utRho22
1885,ydjA,3697400,3697400,3697352,48,684,utRho22
1886,ydjE,3708082,3708082,3707958,124,106,utRho22
1887,ydjF,3709848,3709848,3709708,140,238,utRho22
1888,ydjM,3620340,3620422,3620340,82,0,utRho22
1889,ydjO,3626696,3626696,3626288,408,462,utRho22
1890,ydjX,3666434,3666802,3666434,368,1714,utRho22
1891,yeaE,3731448,3731448,3731272,176,358,utRho22
1892,yeaG,3733530,3733816,3733530,286,114,utRho22
1893,yeaI,3740486,3740770,3740486,284,202,utRho22
1894,yeaJ,3743874,3744082,3743874,208,482,utRho22
1895,yeaL,3748646,3748704,3748646,58,836,utRho22
1896,yeaM,3751296,3751296,3751152,144,0,utRho22
1897,yeaN,3750926,3751346,3750926,420,96,utRho22
1898,yeaO,3753554,3753818,3753554,264,296,utRho22
1899,yeaP,3755314,3755430,3755314,116,1170,utRho22
1900,yeaQ,3758780,3758780,3758510,270,952,utRho22
1901,yeaR,3759988,3759988,3759896,92,130,utRho22
1902,yeaY,3781122,3781122,3781064,58,0,utRho22
1903,yebB,3892220,3892502,3892220,282,298,utRho22
1904,yebC,3896370,3896370,3896302,68,66,utRho22
1905,yebE,3859464,3859464,3859414,50,1956,utRho22
1906,yebG,3861530,3861530,3861494,36,280,utRho22
1907,yebK,3873180,3873304,3873180,124,68,utRho22
1908,yebQ,3820314,3820552,3820314,238,64,utRho22
1909,yebS,3832238,3832516,3832238,278,36,utRho22
1910,yebV,3843430,3843560,3843430,130,0,utRho22
1911,yebW,3843914,3844242,3843914,328,1516,utRho22
1912,yecC,3995646,3995646,3995628,18,0,utRho22
1913,yecD,3901272,3901664,3901272,392,124,utRho22
1914,yecF,3991434,3991636,3991434,202,156,utRho22
1915,yecH,3979304,3979304,3978980,324,1630,utRho22
1916,yecJ,3975604,3975604,3975516,88,0,utRho22
1917,yecM,3919968,3919968,3919692,276,2510,utRho22
1918,yecR,3976400,3976444,3976400,44,150,utRho22
1919,yecT,3923862,3923944,3923862,82,6,utRho22
1920,yedD,4016522,4016522,4016180,342,762,utRho22
1921,yedE,4016310,4016554,4016310,244,786,utRho22
1922,yedI,4058922,4058922,4058732,190,610,utRho22
1923,yedJ,4066446,4066446,4066158,288,740,utRho22
1924,yedV,4076404,4076404,4076304,100,312,utRho22
1925,yedX,4077680,4077912,4077680,232,86,utRho22
1926,yedY,4078572,4078956,4078572,384,934,utRho22
1927,yeeA,4161322,4161322,4161182,140,76,utRho22
1928,yeeE,4171104,4171104,4171050,54,776,utRho22
1929,yeeJ,4089526,4089822,4089526,296,566,utRho22
1930,yeeN,4113508,4113716,4113508,208,444,utRho22
1931,yeeO,4119444,4119444,4119692,248,0,utRho22
1932,yeeX,4158834,4158834,4158722,112,416,utRho22
1933,yeeZ,4178422,4178422,4178256,166,172,utRho22
1934,yefM,4179466,4179466,4179426,40,0,utRho22
1935,yegD,4295288,4295348,4295288,60,432,utRho22
1936,yegH,4275726,4275804,4275726,78,768,utRho22
1937,yegI,4302154,4302154,4301970,184,8,utRho22
1938,yegJ,4302032,4302370,4302032,338,88,utRho22
1939,yegQ,4331182,4331336,4331182,154,1042,utRho22
1940,yegR,4336698,4336698,4336612,86,1024,utRho22
1941,yegS,4337086,4337424,4337086,338,624,utRho22
1942,yegT,4357562,4357642,4357562,80,1006,utRho22
1943,yegX,4367640,4367640,4367302,338,492,utRho22
1944,yehA,4376944,4376944,4376828,116,600,utRho22
1945,yehE,4385818,4385818,4385592,226,56,utRho22
1946,yehK,4407568,4407944,4407568,376,574,utRho22
1947,yehL,4408804,4409192,4408804,388,212,utRho22
1948,yeiB,4486146,4486146,4485934,212,60,utRho22
1949,yeiE,4499422,4499422,4499236,186,2,utRho22
1950,yeiG,4487776,4487820,4487776,44,134,utRho22
1951,yeiH,4499332,4499434,4499332,102,536,utRho22
1952,yeiI,4503306,4503400,4503306,94,128,utRho22
1953,yeiL,4510580,4510710,4510580,130,250,utRho22
1954,yeiP,4530834,4530900,4530834,66,206,utRho22
1955,yeiQ,4532328,4532490,4532328,162,58,utRho22
1956,yeiR,4535484,4535658,4535484,174,430,utRho22
1957,yeiW,4530840,4530840,4530590,250,252,utRho22
1958,yejA,4544624,4544728,4544624,104,186,utRho22
1959,yejG,4556892,4556892,4556474,418,8254,utRho22
1960,yejH,4561244,4561264,4561244,20,152,utRho22
1961,yejK,4568218,4568218,4567894,324,40,utRho22
1962,yejO,4578352,4578352,4577800,552,3822,utRho22
1963,yfaD,4713380,4713808,4713380,428,1094,utRho22
1964,yfaE,4696676,4697028,4696676,352,698,utRho22
1965,yfaL,4688568,4688568,4688338,230,164,utRho22
1966,yfaP,4656398,4656398,4656286,112,112,utRho22
1967,yfaU,4717892,4717892,4717690,202,0,utRho22
1968,yfaY,4727310,4727310,4727266,44,2608,utRho22
1969,yfaZ,4728744,4728744,4728550,194,600,utRho22
1970,yfbK,4771810,4771810,4771444,366,1500,utRho22
1971,yfbL,4771500,4771720,4771500,220,1182,utRho22
1972,yfbN,4777174,4777174,4776852,322,1460,utRho22
1973,yfbO,4776916,4777162,4776916,246,1346,utRho22
1974,yfbP,4777990,4778232,4777990,242,17718,utRho22
1975,yfbR,4817662,4817724,4817662,62,154,utRho22
1976,yfcI,4847424,4847424,4847078,346,1624,utRho22
1977,yfcJ,4880482,4880482,4880240,242,702,utRho22
1978,yfcL,4888502,4888502,4888338,164,86,utRho22
1979,yfcV,4911642,4911642,4911292,350,860,utRho22
1980,yfcZ,4921958,4921958,4921868,90,54,utRho22
1981,yfdF,4925604,4926024,4925604,420,9558,utRho22
1982,yfdG,4935474,4935710,4935474,236,42,utRho22
1983,yfdP,4946844,4947040,4946844,196,214,utRho22
1984,yfdX,4988866,4988866,4988804,62,178,utRho22
1985,yfdY,4990672,4990672,4990584,88,940,utRho22
1986,yfeA,5035784,5035784,5035664,120,8626,utRho22
1987,yfeC,5036668,5036934,5036668,266,4,utRho22
1988,yfeH,5053818,5053892,5053818,74,126,utRho22
1989,yfeK,5074630,5074684,5074630,54,0,utRho22
1990,yfeO,5018906,5019260,5018906,354,646,utRho22
1991,yfeR,5054078,5054078,5053712,366,250,utRho22
1992,yfeX,5101356,5101356,5101090,266,0,utRho22
1993,yfeY,5102486,5102486,5102432,54,18,utRho22
1994,yfeZ,5103842,5103842,5103452,390,554,utRho22
1995,yffO,5123804,5124222,5123804,418,680,utRho22
1996,yffQ,5126778,5127154,5126778,376,3380,utRho22
1997,yffS,5128800,5128986,5128800,186,28,utRho22
1998,yfgC,5232052,5232188,5232052,136,234,utRho22
1999,yfgF,5258062,5258062,5257876,186,3418,utRho22
2000,yfgG,5258170,5258580,5258170,410,5572,utRho22
2001,yfgH,5259344,5259584,5259344,240,528,utRho22
2002,yfgM,5278866,5278866,5278566,300,908,utRho22
2003,yfhH,5397414,5397518,5397414,104,0,utRho22
2004,yfhM,5304648,5304648,5304574,74,320,utRho22
2005,yfhR,5328408,5328726,5328408,318,5554,utRho22
2006,yfiC,5425610,5425610,5425528,82,66,utRho22
2007,yfiE,5430688,5430688,5430640,48,1354,utRho22
2008,yfiL,5482630,5482720,5482630,90,54,utRho22
2009,yfiM,5448066,5448358,5448066,292,9208,utRho22
2010,yfiR,5483354,5483750,5483354,396,662,utRho22
2011,yfjH,5517326,5517326,5517200,126,188,utRho22
2012,yfjI,5517710,5517970,5517710,260,620,utRho22
2013,yfjJ,5521014,5521094,5521014,80,288,utRho22
2014,yfjM,5531970,5531970,5531552,418,12348,utRho22
2015,yfjP,5535080,5535420,5535080,340,2026,utRho22
2016,yfjW,5546570,5546636,5546570,66,160,utRho22
2017,yfjX,5551776,5551838,5551776,62,0,utRho22
2018,ygaC,5601180,5601180,5599988,1192,3182,utRho22
2019,ygaM,5600242,5600292,5600242,50,594,utRho22
2020,ygaU,5593628,5593628,5593572,56,342,utRho22
2021,ygaZ,5619190,5619234,5619190,44,26,utRho22
2022,ygbA,5713656,5713656,5713612,44,408,utRho22
2023,ygbE,5746784,5746784,5746674,110,822,utRho22
2024,ygbI,5722882,5722882,5722528,354,1310,utRho22
2025,ygbK,5724394,5724670,5724394,276,492,utRho22
2026,ygbL,5727074,5727186,5727074,112,144,utRho22
2027,ygbN,5729814,5730202,5729814,388,2190,utRho22
2028,ygcG,5811210,5811422,5811210,212,150,utRho22
2029,ygcN,5785144,5785314,5785144,170,528,utRho22
2030,ygcU,5799214,5799214,5798836,378,798,utRho22
2031,ygcW,5800942,5800942,5800546,396,22,utRho22
2032,ygdD,5883442,5883442,5883262,180,450,utRho22
2033,ygdG,5861746,5861930,5861746,184,166,utRho22
2034,ygdI,5886526,5886526,5886290,236,22,utRho22
2035,ygdQ,5940784,5940840,5940784,56,72,utRho22
2036,ygdR,5942494,5942542,5942494,48,108,utRho22
2037,ygeA,5961606,5961606,5961270,336,596,utRho22
2038,ygeH,5983758,5984188,5983758,430,3054,utRho22
2039,ygeI,5987162,5987276,5987162,114,13736,utRho22
2040,ygeR,6000078,6000078,5999782,296,776,utRho22
2041,ygeV,6011694,6011694,6011572,122,64,utRho22
2042,ygeW,6012234,6012524,6012234,290,1386,utRho22
2043,ygfB,6110946,6110946,6110888,58,58,utRho22
2044,ygfK,6031984,6032120,6031984,136,8,utRho22
2045,ygfS,6058328,6058328,6058024,304,178,utRho22
2046,ygfZ,6082564,6082626,6082564,62,846,utRho22
2047,yggC,6149512,6149512,6149378,134,148,utRho22
2048,yggE,6136370,6136370,6136160,210,1032,utRho22
2049,yggI,6179176,6179510,6179176,334,1056,utRho22
2050,yggL,6204508,6204508,6204266,242,480,utRho22
2051,yggM,6199514,6199514,6199130,384,234,utRho22
2052,yggN,6203596,6203596,6203246,350,1094,utRho22
2053,yggX,18623958,18624558,18623958,600,738,utRho22
2054,yghA,6298966,6299324,6298966,358,186,utRho22
2055,yghB,6307058,6307126,6307058,68,1154,utRho22
2056,yghD,6222614,6222614,6222252,362,372,utRho22
2057,yghF,6225798,6225798,6225840,42,64,utRho22
2058,yghJ,6238640,6238640,6238224,416,340,utRho22
2059,yghQ,6265186,6265186,6264816,370,604,utRho22
2060,yghT,6267830,6268262,6267830,432,1094,utRho22
2061,yghU,6277400,6277454,6277400,54,412,utRho22
2062,yghW,6293506,6293506,6293474,32,128,utRho22
2063,yghZ,6295562,6295794,6295562,232,554,utRho22
2064,ygiD,6365122,6365122,6364868,254,3888,utRho22
2065,ygiH,6409066,6409388,6409066,322,350,utRho22
2066,ygiL,6370622,6370828,6370622,206,370,utRho22
2067,ygiM,6402084,6402414,6402084,330,230,utRho22
2068,ygiN,6346156,6346284,6346156,128,716,utRho22
2069,ygiQ,6322620,6322620,6322292,328,1588,utRho22
2070,ygiS,6335462,6335462,6335436,26,32,utRho22
2071,ygiV,6338582,6338582,6338462,120,212,utRho22
2072,ygiW,6339774,6339774,6339352,422,3888,utRho22
2073,ygiZ,6344506,6344506,6344422,84,34,utRho22
2074,ygjH,6442528,6442528,6442494,34,354,utRho22
2075,ygjI,6452140,6452468,6452140,328,36,utRho22
2076,ygjQ,6472730,6473080,6472730,350,2554,utRho22
2077,ygjR,6474564,6474586,6474564,22,38,utRho22
2078,ygjV,6483638,6483638,6483488,150,14,utRho22
2079,yhaB,6535632,6535708,6535632,76,78,utRho22
2080,yhaH,6504498,6504608,6504498,110,1070,utRho22
2081,yhaI,6505400,6505822,6505400,422,578,utRho22
2082,yhaJ,6508560,6508560,6508428,132,628,utRho22
2083,yhaK,6508538,6508638,6508538,100,792,utRho22
2084,yhbQ,6599878,6599932,6599878,54,716,utRho22
2085,yhbT,6602736,6602736,6602552,184,1912,utRho22
2086,yhbU,6602558,6602970,6602558,412,2638,utRho22
2087,yhbX,6643302,6643302,6643226,76,168,utRho22
2088,yhbY,6655518,6655580,6655518,62,36,utRho22
2089,yhcA,6723956,6724224,6723956,268,2402,utRho22
2090,yhcB,6760364,6760382,6760364,18,110,utRho22
2091,yhcC,6708470,6708470,6708100,370,1422,utRho22
2092,yhcF,6733440,6733852,6733440,412,3284,utRho22
2093,yhcH,6739124,6739124,6738956,168,4396,utRho22
2094,yhcM,6760312,6760312,6759994,318,102,utRho22
2095,yhcN,6770812,6771076,6770812,264,482,utRho22
2096,yhcO,6772606,6772606,6772258,348,48,utRho22
2097,yhdH,6806560,6806968,6806560,408,444,utRho22
2098,yhdJ,6823234,6823306,6823234,72,12,utRho22
2099,yhdN,6879092,6879092,6879018,74,198,utRho22
2100,yhdT,6814702,6814750,6814702,48,40,utRho22
2101,yhdU,6824994,6825242,6824994,248,410,utRho22
2102,yhdV,6836392,6836780,6836392,388,1820,utRho22
2103,yhdW,6837944,6838298,6837944,354,188,utRho22
2104,yheO,6953082,6953082,6952880,202,278,utRho22
2105,yheV,6957970,6957970,6957584,386,0,utRho22
2106,yhfA,6971902,6971902,6971636,266,2388,utRho22
2107,yhfG,6983294,6983294,6983240,54,1758,utRho22
2108,yhfL,6998622,6998896,6998622,274,216,utRho22
2109,yhfY,7023244,7023244,7022844,400,12,utRho22
2110,yhgA,7086294,7086334,7086294,40,0,utRho22
2111,yhgE,7065176,7065176,7064878,298,1922,utRho22
2112,yhgF,7074352,7074770,7074352,418,6084,utRho22
2113,yhhA,7173458,7173886,7173458,428,1414,utRho22
2114,yhhI,7248346,7248756,7248346,410,284,utRho22
2115,yhhJ,7253696,7253696,7253606,90,208,utRho22
2116,yhhM,7211588,7211588,7211220,368,2360,utRho22
2117,yhhN,7211150,7211502,7211150,352,1500,utRho22
2118,yhhQ,7218238,7218434,7218238,196,1674,utRho22
2119,yhhT,7223682,7223730,7223682,48,166,utRho22
2120,yhhX,7162032,7162032,7161610,422,130,utRho22
2121,yhhY,7162222,7162276,7162222,54,160,utRho22
2122,yhhZ,7163516,7163726,7163516,210,1774,utRho22
2123,yhiD,7312220,7312220,7311804,416,20426,utRho22
2124,yhiJ,7265190,7265190,7265180,10,8,utRho22
2125,yhiM,7269270,7269682,7269270,412,4272,utRho22
2126,yhiN,7275000,7275000,7274820,180,930,utRho22
2127,yhjA,7338522,7338522,7338376,146,258,utRho22
2128,yhjB,7344090,7344090,7343788,302,1626,utRho22
2129,yhjC,7344272,7344684,7344272,412,250,utRho22
2130,yhjD,7346660,7346724,7346660,64,100,utRho22
2131,yhjE,7349274,7349572,7349274,298,3792,utRho22
2132,yhjG,7356824,7356824,7356730,94,174,utRho22
2133,yhjH,7358458,7358458,7358374,84,350,utRho22
2134,yhjJ,7364032,7364032,7363880,152,458,utRho22
2135,yhjK,7371296,7371296,7371158,138,174,utRho22
2136,yhjR,7392750,7392750,7392370,380,60,utRho22
2137,yhjV,7400796,7401126,7400796,330,2036,utRho22
2138,yhjX,7424194,7424194,7424014,180,284,utRho22
2139,yhjY,7425966,7425966,7425868,98,98,utRho22
2140,yiaB,7455654,7455654,7455496,158,112,utRho22
2141,yiaD,7432712,7433094,7432712,382,812,utRho22
2142,yiaF,7438194,7438194,7438088,106,1062,utRho22
2143,yiaG,7438862,7438956,7438862,94,836,utRho22
2144,yiaJ,7485236,7485236,7485064,172,1634,utRho22
2145,yiaK,7485348,7485466,7485348,118,106,utRho22
2146,yiaT,7503924,7503924,7503736,188,32,utRho22
2147,yiaU,7503792,7503984,7503792,192,18,utRho22
2148,yiaY,7515856,7515856,7515654,202,698,utRho22
2149,yibF,7523950,7523950,7523910,40,188,utRho22
2150,yibG,7536128,7536354,7536128,226,1032,utRho22
2151,yibL,7553194,7553330,7553194,136,312,utRho22
2152,yibN,7570112,7570112,7570030,82,196,utRho22
2153,yibT,7552848,7552848,7552760,88,768,utRho22
2154,yicC,7633290,7633352,7633290,62,142,utRho22
2155,yicH,7660862,7660914,7660862,52,26,utRho22
2156,yicJ,7673328,7673328,7671858,1470,7070,utRho22
2157,yicN,7685018,7685018,7684804,214,1542,utRho22
2158,yicO,7687914,7687914,7687578,336,426,utRho22
2159,yicR,15250308,15250308,15250236,72,0,utRho22
2160,yidB,7755230,7755230,7754930,300,328,utRho22
2161,yidE,7732780,7732780,7732546,234,130,utRho22
2162,yidF,7711580,7711580,7711222,358,548,utRho22
2163,yidQ,7735088,7735456,7735088,368,802,utRho22
2164,yidR,7738824,7738824,7738618,206,32,utRho22
2165,yieE,7787658,7787738,7787658,80,1738,utRho22
2166,yieH,7793314,7793548,7793314,234,568,utRho22
2167,yieK,7798928,7798928,7798786,142,10,utRho22
2168,yifB,7900350,7900350,7899998,352,288,utRho22
2169,yifL,7988984,7989044,7988984,60,12054,utRho22
2170,yigF,8005750,8005750,8005598,152,42708,utRho22
2171,yigI,8009448,8009448,8009394,54,1776,utRho22
2172,yigM,8022100,8022152,8022100,52,158,utRho22
2173,yihA,8101970,8101970,8101458,512,722,utRho22
2174,yihD,8084098,8084138,8084098,40,40,utRho22
2175,yihF,8088110,8088398,8088110,288,272,utRho22
2176,yihG,8093304,8093304,8093204,100,324,utRho22
2177,yihI,8102616,8102694,8102616,78,106,utRho22
2178,yihL,8120506,8120894,8120506,388,976,utRho22
2179,yihN,8124332,8124494,8124332,162,1666,utRho22
2180,yihO,8131942,8131942,8131532,410,728,utRho22
2181,yihQ,8138892,8138892,8138552,340,276,utRho22
2182,yihV,8147064,8147478,8147064,414,1196,utRho22
2183,yihX,8151096,8151106,8151096,10,370,utRho22
2184,yiiE,8158192,8158582,8158192,390,2750,utRho22
2185,yiiF,8159124,8159502,8159124,378,534,utRho22
2186,yiiG,8173762,8174004,8173762,242,58,utRho22
2187,yiiM,8205506,8205644,8205506,138,6138,utRho22
2188,yiiQ,8224624,8224624,8224428,196,86,utRho22
2189,yiiS,8225738,8225934,8225738,196,202,utRho22
2190,yijE,8272178,8272216,8272178,38,2,utRho22
2191,yijF,8275728,8275728,8275314,414,4090,utRho22
2192,yijO,8296858,8296858,8296634,224,234,utRho22
2193,yjaA,8426240,8426468,8426240,228,62890,utRho22
2194,yjaB,8428312,8428312,8428246,66,172,utRho22
2195,yjaG,8398746,8399008,8398746,262,934,utRho22
2196,yjaH,8401022,8401132,8401022,110,176,utRho22
2197,yjaZ,8379506,8379572,8379506,66,0,utRho22
2198,yjbB,8455204,8455462,8455204,258,284,utRho22
2199,yjbE,16943432,16943624,16943432,192,552,utRho22
2200,yjbL,8520318,8520642,8520318,324,476,utRho22
2201,yjbQ,8540428,8540476,8540428,48,68,utRho22
2202,yjcB,8550328,8550328,8550082,246,526,utRho22
2203,yjcC,8550836,8550942,8550836,106,254,utRho22
2204,yjcD,8556628,8556958,8556628,330,1064,utRho22
2205,yjcE,8559658,8559960,8559658,302,966,utRho22
2206,yjcF,8566212,8566212,8566150,62,0,utRho22
2207,yjcO,8594660,8594660,8594250,410,336,utRho22
2208,yjdA,8654128,8654270,8654128,142,0,utRho22
2209,yjdC,8726660,8726660,8726616,44,0,utRho22
2210,yjdK,8704780,8705168,8704780,388,5106,utRho22
2211,yjdL,8713034,8713034,8712822,212,14,utRho22
2212,yjdM,8653672,8653672,8653468,204,1218,utRho22
2213,yjeF,8787354,8788132,8787354,778,80662,utRho22
2214,yjeI,8745522,8745618,8745522,96,64,utRho22
2215,yjeJ,8748806,8748806,8748468,338,788,utRho22
2216,yjeV,8785472,8785784,8785472,312,2240,utRho22
2217,yjfP,8833512,8833904,8833512,392,162,utRho22
2218,yjfY,8849656,8849656,8849582,74,860,utRho22
2219,yjfZ,8855052,8855052,8854844,208,658,utRho22
2220,yjgA,8916162,8916162,8915730,432,336,utRho22
2221,yjgL,8950802,8950874,8950802,72,198,utRho22
2222,yjgM,8959342,8959342,8959074,268,0,utRho22
2223,yjgN,8959132,8959460,8959132,328,62,utRho22
2224,yjgR,8980170,8980170,8980126,44,928,utRho22
2225,yjgZ,9002116,9002520,9002116,404,5420,utRho22
2226,yjhB,9007764,9008116,9007764,352,414,utRho22
2227,yjhG,9048452,9048452,9048188,264,39474,utRho22
2228,yjhU,9041080,9041080,9040648,432,1248,utRho22
2229,yjiA,9178096,9178096,9177730,366,1034,utRho22
2230,yjiJ,9125364,9125364,9125350,14,18,utRho22
2231,yjiK,9127270,9127270,9127422,152,322,utRho22
2232,yjiL,9129604,9129604,9129378,226,326,utRho22
2233,yjiS,9143410,9143502,9143410,92,1124,utRho22
2234,yjiY,9182734,9182734,9182558,176,1820,utRho22
2235,yjjA,9200674,9200674,9200378,296,1384,utRho22
2236,yjjB,18408708,18408708,18407800,908,1168,utRho22
2237,yjjJ,9243314,9243538,9243314,224,0,utRho22
2238,yjjK,9261132,9261132,9261044,88,1524,utRho22
2239,yjjL,9189764,9189764,9189444,320,4330,utRho22
2240,yjjM,9191894,9191894,9191702,192,264,utRho22
2241,yjjP,9206068,9206068,9205716,352,14858,utRho22
2242,yjjQ,9206638,9206954,9206638,316,15006,utRho22
2243,yjjX,9267798,9267798,9267490,308,2516,utRho22
2244,yjjY,9280716,9280804,9280716,88,250,utRho22
2245,yjjZ,9211554,9211608,9211554,54,49850,utRho22
2246,yjtD,9281676,9281884,9281676,208,230,utRho22
2247,ykfB,532454,532454,532174,280,16408,utRho22
2248,ykfI,527636,527636,527338,298,1458,utRho22
2249,ykgB,637050,637050,636638,412,282,utRho22
2250,ykgC,640430,640430,640002,428,446,utRho22
2251,ykgD,640232,640454,640232,222,424,utRho22
2252,ykgE,642962,643216,642962,254,2676,utRho22
2253,ykgJ,608524,608524,608364,160,592,utRho22
2254,ykgL,623878,624224,623878,346,4866,utRho22
2255,ykgM,625610,625610,625554,56,950,utRho22
2256,ykgR,626570,626570,626484,86,238,utRho22
2257,ylaC,958576,958576,958502,74,3520,utRho22
2258,yliE,1745938,1745958,1745938,20,0,utRho22
2259,ymcE,2103660,2103694,2103660,34,0,utRho22
2260,ymdA,2210450,2210828,2210450,378,344,utRho22
2261,ymdB,2211428,2211640,2211428,212,160,utRho22
2262,ymfD,2395322,2395322,2395064,258,1248,utRho22
2263,ymfI,2402880,2402994,2402880,114,0,utRho22
2264,ymfJ,2404518,2404518,2404168,350,856,utRho22
2265,ymfK,2406176,2406176,2405866,310,384,utRho22
2266,ymfT,2405766,2406048,2405766,282,572,utRho22
2267,ymgE,2489110,2489456,2489110,346,1774,utRho22
2268,ymgF,2437628,2437966,2437628,338,486,utRho22
2269,ymiA,2670112,2670320,2670112,208,434,utRho22
2270,ymjA,2715620,2715620,2715336,284,548,utRho22
2271,ynaI,2791946,2791946,2791844,102,338,utRho22
2272,ynaK,2850438,2850754,2850438,316,548,utRho22
2273,ynbA,2954924,2955242,2954924,318,0,utRho22
2274,yncD,3046552,3046552,3046130,422,414,utRho22
2275,yncE,3046454,3046614,3046454,160,130,utRho22
2276,yncG,3052456,3052494,3052456,38,1650,utRho22
2277,yncL,3034492,3034492,3034388,104,520,utRho22
2278,yneE,3218364,3218364,3218044,320,60,utRho22
2279,yneF,3223748,3223748,3223708,40,18,utRho22
2280,yneJ,3229560,3229608,3229560,48,84,utRho22
2281,yneK,3231100,3231526,3231100,426,1084,utRho22
2282,yneM,3245176,3245292,3245176,116,174,utRho22
2283,ynfA,3311398,3311398,3311346,52,90,utRho22
2284,ynfB,3311418,3311616,3311418,198,288,utRho22
2285,ynfC,3315094,3315094,3314914,180,0,utRho22
2286,ynfD,3314828,3315130,3314828,302,16,utRho22
2287,ynfE,3316006,3316138,3316006,132,378,utRho22
2288,ynfK,3334670,3334670,3334438,232,230,utRho22
2289,ynfL,3339304,3339304,3339184,120,0,utRho22
2290,ynfM,3339260,3339398,3339260,138,32,utRho22
2291,ynfN,3276598,3276598,3276218,380,126,utRho22
2292,ynfO,3273454,3273512,3273454,58,296,utRho22
2293,ynhG,3517890,3517890,3517450,440,120,utRho22
2294,yniA,3615158,3615592,3615158,434,1424,utRho22
2295,yniB,3618526,3618526,3618466,60,30,utRho22
2296,yniC,3618652,3618760,3618652,108,170,utRho22
2297,yniD,3610202,3610330,3610202,128,40,utRho22
2298,ynjE,3678880,3678934,3678880,54,44,utRho22
2299,ynjF,3683222,3683222,3682806,416,466,utRho22
2300,ynjH,3684376,3684376,3684270,106,180,utRho22
2301,ynjI,3690022,3690022,3689742,280,1022,utRho22
2302,yoaB,3786642,3786734,3786642,92,366,utRho22
2303,yoaC,3787932,3788146,3787932,214,774,utRho22
2304,yoaE,3803544,3803544,3803170,374,964,utRho22
2305,yoaF,3755444,3755444,3755064,380,1782,utRho22
2306,yoaH,3789866,3789866,3789462,404,1520,utRho22
2307,yobB,3850418,3850880,3850418,462,966,utRho22
2308,yobF,3815586,3815586,3815182,404,422,utRho22
2309,yobH,3817800,3817850,3817800,50,1532,utRho22
2310,yodB,4084352,4084736,4084352,384,1634,utRho22
2311,yodC,4057008,4057008,4056740,268,112,utRho22
2312,yohC,4451358,4451358,4451262,96,474,utRho22
2313,yohD,4451526,4451602,4451526,76,414,utRho22
2314,yohJ,4460986,4461248,4460986,262,1280,utRho22
2315,yohO,4431172,4431314,4431172,142,500,utRho22
2316,yojI,4617282,4617282,4617230,52,0,utRho22
2317,ypdI,4988988,4989396,4988988,408,562,utRho22
2318,ypfG,5165786,5165786,5165554,232,314,utRho22
2319,ypfM,5182140,5182140,5181732,408,640,utRho22
2320,yphB,5349590,5349590,5349376,214,486,utRho22
2321,ypjA,5565644,5565644,5565452,192,3126,utRho22
2322,ypjB,5569636,5569636,5568858,778,440,utRho22
2323,ypjD,5495860,5495774,5495860,86,22,utRho22
2324,yqaE,5594170,5594170,5594056,114,324,utRho22
2325,yqcA,5846100,5846100,5845968,132,546,utRho22
2326,yqcE,5800944,5801184,5800944,240,6,utRho22
2327,yqeC,6030468,6030468,6030114,354,774,utRho22
2328,yqeF,5971618,5971618,5971184,434,6592,utRho22
2329,yqeG,5971438,5971694,5971438,256,11102,utRho22
2330,yqeH,5975016,5975072,5975016,56,20696,utRho22
2331,yqeI,5976688,5977004,5976688,316,220,utRho22
2332,yqeK,5981140,5981140,5980720,420,7286,utRho22
2333,yqfA,6086728,6086728,6086296,432,1554,utRho22
2334,yqgA,6219042,6219106,6219042,64,48,utRho22
2335,yqgB,6172500,6172500,6172102,398,872,utRho22
2336,yqgE,6185768,6185874,6185768,106,346,utRho22
2337,yqhA,6299150,6299150,6298942,208,84,utRho22
2338,yqhC,6310768,6310768,6310436,332,430,utRho22
2339,yqhD,6310604,6310710,6310604,106,276,utRho22
2340,yqhH,6316842,6317254,6316842,412,930,utRho22
2341,yqiC,6369662,6369680,6369662,18,784,utRho22
2342,yqiJ,6384108,6384416,6384108,308,530,utRho22
2343,yqjA,6495096,6495546,6495096,450,14672,utRho22
2344,yqjF,6500932,6501124,6500932,192,1764,utRho22
2345,yqjG,6501948,6502048,6501948,100,58,utRho22
2346,yqjH,6433078,6433078,6432982,96,4,utRho22
2347,yqjI,6433506,6433558,6433506,52,48,utRho22
2348,yraH,6574552,6574852,6574552,300,332,utRho22
2349,yraP,6592144,6592818,6592144,674,630,utRho22
2350,yraQ,6596414,6596414,6596276,138,0,utRho22
2351,yraR,6598024,6598024,6597692,332,1208,utRho22
2352,yrbG,13360844,13361100,13360844,256,84,utRho22
2353,yrbL,6696842,6696904,6696842,62,3176,utRho22
2354,yrbN,6616172,6616172,6615866,306,1300,utRho22
2355,yrdB,6860176,6860176,6860046,130,66,utRho22
2356,yrfF,7052548,7052938,7052548,390,1090,utRho22
2357,yrhB,7169440,7169518,7169440,78,70,utRho22
2358,ysaB,7451804,7451804,7451424,380,378,utRho22
2359,ysgA,8032686,8032686,8032338,348,1404,utRho22
2360,ytfB,8857638,8857638,8857434,204,1002,utRho22
2361,ytfE,8864018,8864018,8863966,52,388,utRho22
2362,ytfF,8866296,8866296,8866130,166,482,utRho22
2363,ytfH,8868164,8868226,8868164,62,836,utRho22
2364,ytfI,8875234,8875414,8875234,180,240,utRho22
2365,ytfJ,8878572,8878572,8878524,48,52,utRho22
2366,ytfK,8879022,8879174,8879022,152,176,utRho22
2367,ytfL,8882642,8882642,8882430,212,92,utRho22
2368,ytfQ,8899634,8899924,8899634,290,960,utRho22
2369,ytjB,9249598,9249598,9249578,20,174,utRho22
2370,yzfA,8896588,8896588,8896490,98,0,utRho22
2371,zapA,6111102,6111224,6111102,122,782,utRho22
2372,zapB,8236772,8237030,8236772,258,384,utRho22
2373,zapC,2011700,2011904,2011700,204,116,utRho22
2374,zinT,4082692,4082750,4082692,58,678,utRho22
2375,zipA,5062814,5062814,5062466,348,436,utRho22
2376,zitB,1569716,1569716,1569646,70,66,utRho22
2377,zntA,7212844,7212902,7212844,58,84,utRho22
2378,zntR,6878336,6878336,6878260,76,292,utRho22
2379,znuA,3885322,3885322,3885166,156,12,utRho22
2380,znuC,3885268,3885324,3885268,56,12,utRho22
2381,zraP,8403424,8403424,8403376,48,108,utRho22
2382,zraS,8403810,8403852,8403810,42,0,utRho22
2383,zupT,6364866,6365100,6364866,234,3882,utRho22
2384,zur,8520282,8520282,8520006,276,576,utRho22
2385,zwf,3872752,3872752,3872628,124,122,utRho22
0,C0343,2818676,2818728,2818676,52,26,utRho23
1,aaeB,6776526,6776526,6776376,150,164,utRho23
2,aaeR,6778762,6779040,6778762,278,1282,utRho23
3,aaeX,6778860,6778860,6778674,186,1330,utRho23
4,aat,1854920,1854920,1854864,56,66,utRho23
5,accA,416822,417242,416822,420,1996,utRho23
6,accB,6810280,6810872,6810280,592,2006,utRho23
7,accD,4868030,4868030,4867852,178,214,utRho23
8,aceB,8430804,8430956,8430804,152,1386,utRho23
9,aceE,245938,246034,245938,96,96,utRho23
10,ackA,4826918,4826940,4826918,22,238,utRho23
11,acnA,2670848,2671662,2670848,814,866,utRho23
12,acnB,263038,263230,263038,192,560,utRho23
13,acpP,2303148,2303230,2303148,82,42,utRho23
14,acpS,5402324,5402324,5401996,328,448,utRho23
15,acrA,971396,971396,971238,158,78,utRho23
16,acrB,969370,969370,968806,564,2052,utRho23
17,acrD,5174950,5175190,5174950,240,502,utRho23
18,acrE,6827404,6827728,6827404,324,668,utRho23
19,acrR,971398,971522,971398,124,28,utRho23
20,acrZ,1589502,1589546,1589502,44,350,utRho23
21,acs,8575190,8575190,8574742,448,4696,utRho23
22,actP,8569870,8569870,8569804,66,44,utRho23
23,ada,4620854,4620854,4620810,44,38,utRho23
24,add,3404404,3404466,3404404,62,304,utRho23
25,ade,7687802,7687928,7687802,126,216,utRho23
26,adhE,2596826,2596826,2596242,584,78,utRho23
27,adhP,3107988,3107988,3107676,312,702,utRho23
28,adiA,8681112,8681112,8681042,70,38,utRho23
29,adiC,8674404,8674404,8674062,342,544,utRho23
30,adiY,8676084,8676084,8675858,226,158,utRho23
31,adk,994278,994350,994278,72,1016,utRho23
32,adrA,807374,807406,807374,32,172,utRho23
33,aer,6438240,6438240,6438152,88,42,utRho23
34,aes,1000102,1000102,999946,156,4736,utRho23
35,agaR,6557406,6557406,6557330,76,92,utRho23
36,agaS,6563778,6563952,6563778,174,142,utRho23
37,agp,2131118,2131170,2131118,52,28,utRho23
38,agrA,7296126,7296126,7296126,0,0,utRho23
39,agrB,7296588,7296588,7296588,0,0,utRho23
40,ahpC,1277386,1277890,1277386,504,1200,utRho23
41,ahpF,1278004,1279506,1278004,1502,78392,utRho23
42,ahr,8992698,8992698,8992418,280,1564,utRho23
43,aidB,8828494,8828550,8828494,56,108,utRho23
44,ais,4731512,4731512,4731240,272,278,utRho23
45,alaA,4814816,4815122,4814816,306,562,utRho23
46,alaC,4996798,4996798,4996590,208,90,utRho23
47,alaE,5598140,5598328,5598140,188,694,utRho23
48,alaS,5644180,5644180,5644022,158,1134,utRho23
49,alaW,5036612,5036612,5036462,150,0,utRho23
50,aldA,2976380,2976464,2976380,84,670,utRho23
51,aldB,7513070,7513070,7513022,48,1112,utRho23
52,alkA,4295118,4295118,4295080,38,124,utRho23
53,alkB,4618890,4618890,4618682,208,194,utRho23
54,allA,1064780,1064902,1064780,122,116,utRho23
55,allD,1092822,1092822,1092726,96,156,utRho23
56,allE,1088112,1088112,1088092,20,150,utRho23
57,allS,1064600,1064600,1064442,158,874,utRho23
58,alr,8531178,8531564,8531178,386,1254,utRho23
59,alsE,8617334,8617334,8616956,378,906,utRho23
60,alsK,8615990,8615990,8615598,392,1832,utRho23
61,alx,6476740,6477160,6476740,420,312,utRho23
62,amiA,5104482,5104704,5104482,222,6,utRho23
63,amiC,5898378,5898378,5898020,358,290,utRho23
64,amn,4110062,4110122,4110062,60,50,utRho23
65,ampC,8758006,8758006,8757888,118,58,utRho23
66,ampD,237362,237466,237362,104,318,utRho23
67,ampG,907372,907372,907090,282,46,utRho23
68,ampH,792726,792726,792574,152,212,utRho23
69,amyA,4012230,4012312,4012230,82,188,utRho23
70,anmK,3439346,3439346,3439204,142,64,utRho23
71,ansB,6201580,6201580,6201456,124,1156,utRho23
72,ansP,3052040,3052040,3051960,80,616,utRho23
73,apaG,104068,104068,103212,856,2926,utRho23
74,apaH,102586,102586,102444,142,4418,utRho23
75,apbE,4623188,4623188,4623068,120,0,utRho23
76,appA,2081198,2081234,2081198,36,44,utRho23
77,appC,2075420,2075480,2075420,60,36,utRho23
78,appY,1167134,1167362,1167134,228,130,utRho23
79,apt,982620,982824,982620,204,34,utRho23
80,aqpZ,1832424,1832424,1832094,330,354,utRho23
81,araB,140150,140150,140096,54,4,utRho23
82,araC,140482,140774,140482,292,752,utRho23
83,araE,5964416,5964416,5964364,52,0,utRho23
84,araF,3972476,3972476,3972256,220,324,utRho23
85,araH,3967120,3967120,3967086,34,1282,utRho23
86,araJ,825058,825058,824962,96,7226,utRho23
87,arcA,9281602,9281602,9280612,990,2654,utRho23
88,arcB,6706098,6706098,6706050,48,856,utRho23
89,arcZ,6701154,6701154,6701154,0,0,utRho23
90,arfA,6877346,6877346,6877298,48,830,utRho23
91,argA,5898312,5898484,5898312,172,100,utRho23
92,argC,8309770,8310002,8309770,232,242,utRho23
93,argD,6980442,6980442,6980360,82,148,utRho23
94,argE,8310156,8310156,8309694,462,392,utRho23
95,argF,580680,580680,580610,70,180,utRho23
96,argG,6637124,6637274,6637124,150,520,utRho23
97,argI,8956688,8956688,8956622,66,546,utRho23
98,argO,6137672,6137672,6137616,56,322,utRho23
99,argP,6119460,6119506,6119460,46,722,utRho23
100,argR,6769204,6769406,6769204,202,140,utRho23
101,argS,3920002,3920124,3920002,122,256,utRho23
102,argT,4855698,4855698,4855582,116,262,utRho23
103,argU,1129406,1129446,1129406,40,0,utRho23
104,argW,4932616,4932618,4932616,2,14,utRho23
105,argX,7964728,7964750,7964728,22,0,utRho23
106,aroF,5482402,5482402,5482300,102,0,utRho23
107,aroG,1571182,1571266,1571182,84,224,utRho23
108,aroH,3576636,3576870,3576636,234,238,utRho23
109,aroK,7038760,7038760,7038128,632,1496,utRho23
110,aroL,812560,812810,812560,250,2904,utRho23
111,aroP,243342,243342,243102,240,178,utRho23
112,arpA,8445382,8445382,8444974,408,506,utRho23
113,arrS,7316108,7316108,7316108,0,0,utRho23
114,arsR,7297024,7297056,7297024,32,104,utRho23
115,artJ,1801252,1801252,1801150,102,24,utRho23
116,artP,1807686,1807686,1807468,218,8800,utRho23
117,ascF,5678858,5679048,5678858,190,18,utRho23
118,ascG,5678574,5678574,5678528,46,336,utRho23
119,aslB,7965562,7965916,7965562,354,702,utRho23
120,asnA,7854258,7854310,7854258,52,1686,utRho23
121,asnB,1398444,1398444,1398354,90,2728,utRho23
122,asnC,23562186,23562186,23562018,168,816,utRho23
123,asnS,1978088,1978088,1977970,118,2862,utRho23
124,asnT,4089082,4089098,4089082,16,308,utRho23
125,asnU,4119690,4119702,4119690,12,0,utRho23
126,asnV,4124504,4124520,4124504,16,224,utRho23
127,aspA,17473728,17473728,17473308,420,536,utRho23
128,aspC,1971486,1971486,1971418,68,62,utRho23
129,aspS,3901402,3901402,3901044,358,238,utRho23
130,aspT,7893560,7893744,7893560,184,59168,utRho23
131,aspV,473826,473862,473826,36,0,utRho23
132,asr,3342654,3342752,3342654,98,358,utRho23
133,astC,3664088,3664088,3663964,124,54,utRho23
134,astE,3654138,3654138,3653846,292,390,utRho23
135,atoD,4646824,4646894,4646824,70,2104,utRho23
136,atpB,7844540,7844540,7844102,438,70,utRho23
137,atpC,7832118,7832118,7831944,174,464,utRho23
138,atpI,7845050,7845050,7844880,170,216,utRho23
139,avtA,7479348,7479410,7479348,62,1282,utRho23
140,azoR,2965982,2965982,2965720,262,486,utRho23
141,azuC,3976002,3976002,3975918,84,56,utRho23
142,bacA,6408350,6408350,6408262,88,1086,utRho23
143,bamA,394052,395856,394052,1804,688,utRho23
144,bamB,5277950,5277950,5277304,646,264,utRho23
145,bamC,5198028,5198028,5197730,298,762,utRho23
146,bamD,5471922,5472292,5471922,370,2822,utRho23
147,bamE,5506972,5507210,5506972,238,274,utRho23
148,basS,8666954,8666954,8666544,410,2216,utRho23
149,bax,7474468,7474468,7474354,114,380,utRho23
150,bcp,5200874,5200956,5200874,82,1588,utRho23
151,bcsB,7385346,7385346,7385214,132,48,utRho23
152,bcsE,7392644,7392916,7392644,272,72,utRho23
153,bdcA,8948128,8948128,8948106,22,1240,utRho23
154,bdcR,8948192,8948248,8948192,56,858,utRho23
155,bdm,3112680,3112680,3112560,120,46,utRho23
156,betA,654522,654522,654494,28,262,utRho23
157,betI,658722,658722,658668,54,150,utRho23
158,betT,658842,658926,658842,84,352,utRho23
159,bfr,6933498,6933498,6933450,48,110,utRho23
160,bglG,23440182,23440182,23439402,780,2382,utRho23
161,bglX,4444240,4444240,4443978,262,130,utRho23
162,bhsA,2337962,2338146,2337962,184,548,utRho23
163,bioA,1618584,1618584,1618514,70,18,utRho23
164,bioB,1618604,1618688,1618604,84,0,utRho23
165,bioH,7089716,7089716,7089688,28,4,utRho23
166,bisC,7433026,7433026,7432788,238,342,utRho23
167,blc,8755490,8755490,8755444,46,0,utRho23
168,blr,3409024,3409102,3409024,78,256,utRho23
169,bluF,2431226,2431226,2430950,276,204,utRho23
170,bluR,2428226,2428226,2428118,108,22,utRho23
171,bolA,908698,908944,908698,246,18,utRho23
172,borD,1157842,1157842,1157786,56,1114,utRho23
173,brnQ,838976,839182,838976,206,784,utRho23
174,bssR,1756492,1756496,1756492,4,8,utRho23
175,bssS,2242116,2242116,2241910,206,402,utRho23
176,btuB,8326798,8327278,8326798,480,3776,utRho23
177,cadB,8720212,8720212,8720062,150,184,utRho23
178,cadC,8723926,8723926,8723868,58,58,utRho23
179,caiE,70998,70998,70742,256,610,utRho23
180,caiF,68436,68600,68436,164,3812,utRho23
181,caiT,84074,84074,83862,212,242,utRho23
182,can,285406,285406,285340,66,238,utRho23
183,carA,59102,59302,59102,200,860,utRho23
184,carB,61550,61634,61550,84,226,utRho23
185,cas2,5757830,5757830,5757706,124,618,utRho23
186,casA,5768638,5768638,5768276,362,60,utRho23
187,cbl,4121882,4121882,4121828,54,2416,utRho23
188,cbpA,2128074,2128074,2127550,524,720,utRho23
189,cbrA,7738628,7738754,7738628,126,0,utRho23
190,cbrB,7794958,7795012,7794958,54,696,utRho23
191,ccmH,4585242,4585242,4584820,422,380,utRho23
192,cdaR,364894,364926,364894,32,260,utRho23
193,cdd,4463638,4463688,4463638,50,64,utRho23
194,cdh,8219814,8219860,8219814,46,1126,utRho23
195,cdsA,391110,391354,391110,244,290,utRho23
196,cedA,3627484,3627484,3627326,158,1662,utRho23
197,cfa,3482402,3482826,3482402,424,980,utRho23
198,chaC,2544844,2544972,2544844,128,1282,utRho23
199,chbB,3643452,3643452,3643238,214,178,utRho23
200,chbG,3634624,3634624,3634270,354,148,utRho23
201,cheW,3946924,3946924,3946678,246,410,utRho23
202,chiA,6939792,6939792,6939706,86,304,utRho23
203,chiP,1416472,1416668,1416472,196,0,utRho23
204,cho,3646984,3647030,3646984,46,158,utRho23
205,chpS,8896804,8896894,8896804,90,136,utRho23
206,cirA,4493884,4493884,4493538,346,388,utRho23
207,citC,1304078,1304078,1303712,366,1858,utRho23
208,citT,1293264,1293264,1293160,104,136,utRho23
209,clcA,350104,350214,350104,110,0,utRho23
210,clpA,1846160,1846528,1846160,368,54,utRho23
211,clpB,5468410,5468410,5468346,64,198,utRho23
212,clpP,913154,913354,913154,200,102,utRho23
213,clpS,1845500,1845826,1845500,326,150,utRho23
214,clpX,914404,914852,914404,448,574,utRho23
215,clsA,2617346,2617346,2617290,56,266,utRho23
216,clsC,2212584,2212710,2212584,126,208,utRho23
217,cmk,1922330,1922402,1922330,72,0,utRho23
218,cnu,3409522,3409898,3409522,376,1484,utRho23
219,coaA,8350214,8350214,8350052,162,698,utRho23
220,cobC,1340092,1340092,1339814,278,698,utRho23
221,cobT,4129202,4129202,4128934,268,254,utRho23
222,cobU,4131944,4131944,4131528,416,340,utRho23
223,codB,709768,709844,709768,76,892,utRho23
224,comR,2337726,2337726,2337664,62,110,utRho23
225,copA,1022822,1022822,1022758,64,38,utRho23
226,corA,8002388,8002852,8002388,464,29590,utRho23
227,cpdB,8873258,8873258,8873130,128,646,utRho23
228,cptB,6082198,6082198,6082140,58,218,utRho23
229,cpxA,8210202,8210202,8209950,252,674,utRho23
230,cpxP,8211570,8211640,8211570,70,148,utRho23
231,cpxR,8211372,8211372,8211340,32,10,utRho23
232,cra,175894,176056,175894,162,0,utRho23
233,crcB,1316016,1316016,1315876,140,46,utRho23
234,creA,9270486,9271042,9270486,556,840,utRho23
235,creD,9276320,9276356,9276320,36,542,utRho23
236,crl,515620,515658,515620,38,2792,utRho23
237,crp,6971906,6972240,6971906,334,2378,utRho23
238,crr,5070960,5071668,5070960,708,2242,utRho23
239,csdA,5886414,5886674,5886414,260,120,utRho23
240,csgB,2207718,2207902,2207718,184,0,utRho23
241,csgD,2206688,2206688,2206392,296,890,utRho23
242,csgG,2203510,2203510,2203368,142,458,utRho23
243,csiD,5577854,5577970,5577854,116,438,utRho23
244,csiE,5330802,5330870,5330802,68,470,utRho23
245,csiR,5590942,5591348,5590942,406,912,utRho23
246,cspA,7439778,7440098,7439778,320,2566,utRho23
247,cspB,3283430,3283430,3283108,322,136,utRho23
248,cspC,3815018,3815018,3814870,148,38,utRho23
249,cspD,1845352,1845352,1845180,172,2890,utRho23
250,cspE,1314294,1314584,1314294,290,216,utRho23
251,cspF,3283380,3283710,3283380,330,528,utRho23
252,cspG,2102610,2102922,2102610,312,922,utRho23
253,cspH,2102746,2102746,2102350,396,230,utRho23
254,cspI,3277624,3277624,3277334,290,100,utRho23
255,csrA,5638746,5638746,5638292,454,364,utRho23
256,csrB,5849048,5849048,5849048,0,0,utRho23
257,csrC,8102072,8102072,8102072,0,0,utRho23
258,csrD,6806850,6806850,6806664,186,152,utRho23
259,cstA,1259710,1259788,1259710,78,92,utRho23
260,cueO,274090,274166,274090,76,4,utRho23
261,cueR,1027948,1027986,1027948,38,64,utRho23
262,curA,3037784,3038054,3037784,270,1782,utRho23
263,cusC,1191146,1191200,1191146,54,158,utRho23
264,cusR,1190924,1190924,1190886,38,282,utRho23
265,cutA,8730784,8730784,8730712,72,928,utRho23
266,cutC,3918534,3918534,3917920,614,2098,utRho23
267,cvpA,4861600,4861600,4861526,74,52,utRho23
268,cvrA,2484328,2484328,2484142,186,104,utRho23
269,cyaA,7981548,7982306,7981548,758,1462,utRho23
270,cyaR,4334228,4334224,4334228,4,0,utRho23
271,cyaY,7988166,7988166,7988118,48,342,utRho23
272,cybB,2981522,2981804,2981522,282,696,utRho23
273,cycA,8859560,8859728,8859560,168,452,utRho23
274,cydA,1542340,1542916,1542340,576,456,utRho23
275,cydC,1858800,1858800,1858390,410,174,utRho23
276,cydD,1862062,1862062,1861924,138,12,utRho23
277,cydX,1548300,1548392,1548300,92,112,utRho23
278,cynR,717418,717418,717380,38,396,utRho23
279,cynT,1435092,1435196,1435092,104,72,utRho23
280,cyoA,903306,903306,903220,86,2638,utRho23
281,cyoE,895540,895540,895410,130,116,utRho23
282,cysB,2667576,2667710,2667576,134,314,utRho23
283,cysC,5748056,5748056,5747984,72,148,utRho23
284,cysD,5752736,5752736,5752658,78,382,utRho23
285,cysE,7565362,7565362,7565124,238,1022,utRho23
286,cysG,6995508,6995656,6995508,148,3802,utRho23
287,cysJ,5783928,5783928,5783796,132,5788,utRho23
288,cysK,5064688,5064818,5064688,130,0,utRho23
289,cysP,5087114,5087114,5087056,58,606,utRho23
290,cysS,1109154,1109222,1109154,68,18,utRho23
291,cysT,3984100,3984100,3983974,126,2,utRho23
292,cysZ,5062766,5062926,5062766,160,750,utRho23
293,cytR,8249018,8249018,8248912,106,530,utRho23
294,dacA,1328002,1328002,1327926,76,282,utRho23
295,dacB,6657714,6657926,6657714,212,120,utRho23
296,dacC,1761306,1761454,1761306,148,766,utRho23
297,dadA,2475018,2475142,2475018,124,42,utRho23
298,dam,7032504,7032504,7031826,678,1358,utRho23
299,damX,7035200,7035200,7034612,588,484,utRho23
300,dapA,5199568,5199568,5199520,48,2,utRho23
301,dapB,56576,56748,56576,172,1078,utRho23
302,dapD,371954,371954,371894,60,184,utRho23
303,dapE,5183120,5183214,5183120,94,1054,utRho23
304,dcp,3254844,3254844,3254760,84,184,utRho23
305,dcrB,7219534,7219910,7219534,376,1406,utRho23
306,dctA,7366996,7366996,7366894,102,594,utRho23
307,dcuA,8733686,8733686,8733546,140,102,utRho23
308,dcuB,8698182,8698182,8697488,694,6212,utRho23
309,dcuC,1312166,1312166,1311936,230,1932,utRho23
310,dcuD,6749166,6749738,6749166,572,1376,utRho23
311,dcuR,8701130,8701130,8700068,1062,1762,utRho23
312,dcuS,8703370,8703370,8703324,46,1616,utRho23
313,dcyD,3999016,3999016,3998960,56,78,utRho23
314,ddpX,3126498,3126498,3126152,346,288,utRho23
315,deaD,6615818,6615818,6615720,98,514,utRho23
316,dedA,4869880,4869880,4869482,398,4298,utRho23
317,dedD,4863750,4863750,4863368,382,0,utRho23
318,def,6867300,6867380,6867300,80,398,utRho23
319,degP,361690,361768,361690,78,58,utRho23
320,degQ,6761308,6761486,6761308,178,5910,utRho23
321,deoB,9239134,9239206,9239134,72,6,utRho23
322,deoC,9233358,9234646,9233358,1288,1584,utRho23
323,dfp,7625406,7625462,7625406,56,32,utRho23
324,dgcZ,3247758,3247758,3247700,58,0,utRho23
325,dgkA,8512914,8513274,8512914,360,474,utRho23
326,dgt,358392,358474,358392,82,1094,utRho23
327,dhaK,2501888,2501888,2501676,212,692,utRho23
328,dhaR,2502006,2502132,2502006,126,584,utRho23
329,dicB,3299194,3299218,3299194,24,60,utRho23
330,dicC,3295752,3295752,3295700,52,34,utRho23
331,dinB,501760,501796,501760,36,132,utRho23
332,dinD,7635398,7635520,7635398,122,170,utRho23
333,dinG,1666146,1666140,1666146,6,8,utRho23
334,dinI,2243018,2243018,2242974,44,308,utRho23
335,dinJ,493230,493230,493004,226,300,utRho23
336,dinQ,7295964,7295964,7295576,388,746,utRho23
337,djlA,114536,114728,114536,192,882,utRho23
338,dkgA,6313142,6313246,6313142,104,382,utRho23
339,dkgB,458196,458334,458196,138,0,utRho23
340,dksA,321502,321502,321208,294,410,utRho23
341,dld,4444164,4444370,4444164,206,130,utRho23
342,dmlA,3763424,3763824,3763424,400,2178,utRho23
343,dmlR,3763710,3763710,3763618,92,464,utRho23
344,dmsA,1881646,1881918,1881646,272,58,utRho23
345,dnaA,7767922,7767922,7767458,464,650,utRho23
346,dnaB,8528566,8528628,8528566,62,120,utRho23
347,dnaK,24096,24326,24096,230,8054,utRho23
348,dnaN,7765466,7765466,7764642,824,328,utRho23
349,dnaQ,471868,472134,471868,266,4248,utRho23
350,dnaT,18406460,18406460,18406068,392,3852,utRho23
351,dnaX,984112,984184,984112,72,292,utRho23
352,dosP,3131486,3131486,3131466,20,62,utRho23
353,dpiB,1303968,1304470,1303968,502,1154,utRho23
354,dppA,7415740,7415740,7415410,330,2130,utRho23
355,dps,1697900,1697900,1697822,78,66,utRho23
356,dsbA,8086754,8086836,8086754,82,654,utRho23
357,dsbB,2466294,2466294,2466060,234,346,utRho23
358,dsbC,6079266,6079266,6077644,1622,1632,utRho23
359,dsbG,1277600,1277600,1277146,454,724,utRho23
360,dsdA,4958242,4958404,4958242,162,674,utRho23
361,dsdC,4955492,4955492,4955258,234,802,utRho23
362,dsdX,4955642,4955694,4955642,52,524,utRho23
363,dsrA,4050626,4050626,4050626,0,0,utRho23
364,dsrB,4049686,4049686,4049646,40,1006,utRho23
365,dtpD,1485340,1485340,1485112,228,1228,utRho23
366,dusA,8523200,8523338,8523200,138,2254,utRho23
367,dusB,6820492,6820560,6820492,68,16,utRho23
368,dusC,4460790,4460790,4460770,20,0,utRho23
369,dut,7627704,7627864,7627704,160,606,utRho23
370,dxr,386670,387042,386670,372,380,utRho23
371,ebgA,6445102,6445266,6445102,164,174,utRho23
372,ebgR,6442874,6442932,6442874,58,72,utRho23
373,ecnB,8753018,8753106,8753018,88,188,utRho23
374,eco,4607594,4607810,4607594,216,0,utRho23
375,ecpA,621594,621594,621342,252,564,utRho23
376,ecpB,620238,620238,620052,186,764,utRho23
377,ecpR,622964,622964,622672,292,504,utRho23
378,eda,3866218,3866218,3865512,706,484,utRho23
379,edd,3869426,3869426,3869208,218,84,utRho23
380,efeO,2164308,2164486,2164308,178,62,utRho23
381,efeU_1,2162614,2162712,2162614,98,158,utRho23
382,efp,8751134,8751398,8751134,264,2490,utRho23
383,elaA,4763372,4763372,4763086,286,228,utRho23
384,elaD,4765308,4765426,4765308,118,176,utRho23
385,elfA,1995530,1995736,1995530,206,122,utRho23
386,elfD,1996642,1996980,1996642,338,262,utRho23
387,emrD,7707690,7707844,7707690,154,56,utRho23
388,emrK,4966896,4966896,4966678,218,258,utRho23
389,emrY,4964668,4964668,4964352,316,368,utRho23
390,emtA,2486250,2486360,2486250,110,62,utRho23
391,endA,12361100,12361388,12361100,288,128,utRho23
392,eno,5817692,5817692,5815882,1810,1704,utRho23
393,entC,1249662,1249770,1249662,108,96,utRho23
394,entD,1220508,1220508,1220158,350,212,utRho23
395,entH,1258584,1258600,1258584,16,0,utRho23
396,entS,1244506,1244600,1244506,94,66,utRho23
397,envR,6827266,6827266,6826930,336,194,utRho23
398,epd,12295292,12295292,12294764,528,668,utRho23
399,epmA,8765236,8765286,8765236,50,188,utRho23
400,epmB,8751406,8751406,8751314,92,1034,utRho23
401,eptB,7421162,7421162,7420950,212,108,utRho23
402,eptC,8300622,8300622,8300530,92,1124,utRho23
403,erfK,4126708,4126708,4126646,62,178,utRho23
404,erpA,353122,353220,353122,98,38,utRho23
405,esrE,8039956,8039956,8039956,0,0,utRho23
406,essD,1153746,1154796,1153746,1050,4252,utRho23
407,etk,2088606,2088606,2088420,186,1506,utRho23
408,evgA,4967262,4967510,4967262,248,146,utRho23
409,exbB,6304028,6304028,6303968,60,160,utRho23
410,exbD,6302780,6302780,6302486,294,242,utRho23
411,exuR,6493016,6493304,6493016,288,74,utRho23
412,exuT,6490004,6490208,6490004,204,102,utRho23
413,fabA,2032996,2032996,2032940,56,84,utRho23
414,fabB,4883282,4883282,4883210,72,28,utRho23
415,fabH,2297032,2297518,2297032,486,758,utRho23
416,fabI,2702236,2702236,2702078,158,140,utRho23
417,fadB,8062026,8062026,8061942,84,274,utRho23
418,fadD,3779614,3779614,3779492,122,52,utRho23
419,fadE,486812,486812,486606,206,214,utRho23
420,fadH,6463248,6463330,6463248,82,542,utRho23
421,fadI,4921022,4921022,4920938,84,654,utRho23
422,fadL,4922410,4922600,4922410,190,478,utRho23
423,fadM,928720,928804,928720,84,22,utRho23
424,fadR,2469810,2469876,2469810,66,12,utRho23
425,fbaB,4357334,4357334,4357128,206,142,utRho23
426,fdhE,8162722,8162722,8162456,266,994,utRho23
427,fdhF,8598814,8598814,8598732,82,384,utRho23
428,fdnG,3094744,3094802,3094744,58,94,utRho23
429,fdrA,1093012,1093360,1093012,348,380,utRho23
430,feaB,2894994,2895038,2894994,44,0,utRho23
431,feaR,2894734,2894734,2894566,168,16,utRho23
432,fecA,9033454,9033454,9033354,100,158,utRho23
433,fecE,9023288,9023288,9022914,374,1796,utRho23
434,fecI,9036564,9036564,9036470,94,1732,utRho23
435,feoA,7080114,7080326,7080114,212,1040,utRho23
436,fepA,1225334,1225334,1224988,346,970,utRho23
437,fepB,1249454,1249454,1249020,434,50,utRho23
438,fepD,1244468,1244468,1244378,90,44,utRho23
439,fes,1225374,1225630,1225374,256,1430,utRho23
440,ffh,5495706,5495706,5495590,116,452,utRho23
441,ffs,952576,952848,952576,272,8594,utRho23
442,fhuA,334884,334968,334884,84,528,utRho23
443,fhuE,2323294,2323294,2323102,192,718,utRho23
444,fhuF,9211504,9211504,9211326,178,65350,utRho23
445,fic,6983296,6983296,6982926,370,2940,utRho23
446,fieF,8212864,8212938,8212864,74,740,utRho23
447,fimA,9085388,9086230,9085388,842,1648,utRho23
448,fimB,9081334,9081914,9081334,580,6150,utRho23
449,fimE,9083742,9084074,9083742,332,2294,utRho23
450,fimZ,1129214,1129214,1128960,254,116,utRho23
451,fiu,1683296,1683296,1683062,234,454,utRho23
452,fixA,84650,84806,84650,156,396,utRho23
453,fkpA,6955050,6955050,6954838,212,1746,utRho23
454,fldA,2846084,2846084,2845860,224,1892,utRho23
455,fldB,6079644,6079710,6079644,66,252,utRho23
456,flgA,2261770,2261770,2261726,44,2568,utRho23
457,flgB,2261986,2262036,2261986,50,168,utRho23
458,flgK,2276702,2276756,2276702,54,430,utRho23
459,flgM,2260330,2260330,2260256,74,164,utRho23
460,flgN,2259828,2259828,2259660,168,206,utRho23
461,flhB,3932432,3932432,3932382,50,664,utRho23
462,flhC,3955864,3955864,3955688,176,54,utRho23
463,flhD,3957154,3957154,3956394,760,4920,utRho23
464,fliA,4003638,4003638,4003578,60,82,utRho23
465,fliC,4007352,4007352,4007212,140,76,utRho23
466,fliD,4007634,4007744,4007634,110,1800,utRho23
467,fliE,4026186,4026186,4026028,158,2310,utRho23
468,fliF,4026292,4026458,4026292,166,1658,utRho23
469,fliL,4039168,4039236,4039168,68,14,utRho23
470,flk,4875824,4875900,4875824,76,192,utRho23
471,flu,4142634,4143078,4142634,444,382,utRho23
472,flxA,3292776,3292810,3292776,34,374,utRho23
473,fnr,2799104,2799104,2799052,52,186,utRho23
474,fnrS,2818258,2818258,2818258,0,0,utRho23
475,focA,1909628,1909628,1908932,696,738,utRho23
476,folA,99598,99646,99598,48,290,utRho23
477,folB,6409296,6409296,6409178,118,182,utRho23
478,folD,1115562,1115562,1115482,80,296,utRho23
479,folE,4487696,4487696,4487304,392,1726,utRho23
480,fpr,8228998,8228998,8228944,54,146,utRho23
481,frc,4986878,4986878,4986508,370,348,utRho23
482,frdA,8764824,8764824,8764636,188,1866,utRho23
483,frdD,8758948,8758948,8758732,216,6412,utRho23
484,fre,8052886,8053054,8052886,168,1504,utRho23
485,frlA,6999518,6999820,6999518,302,566,utRho23
486,frr,385624,385744,385624,120,368,utRho23
487,frsA,513004,513054,513004,50,36,utRho23
488,fruB,4527194,4527194,4526990,204,0,utRho23
489,frvR,8179804,8179804,8179710,94,84,utRho23
490,fryA,5008986,5008986,5008970,16,566,utRho23
491,fsaA,1727060,1727284,1727060,224,1746,utRho23
492,fsr,1009710,1009710,1009392,318,592,utRho23
493,ftnA,3977364,3977432,3977364,68,18,utRho23
494,ftnB,3973550,3973850,3973550,300,496,utRho23
495,ftsA,207122,207964,207122,842,596,utRho23
496,ftsB,5745802,5745802,5745640,162,174,utRho23
497,ftsH,6654204,6654204,6653870,334,798,utRho23
498,ftsK,1865858,1866448,1865858,590,650,utRho23
499,ftsL,181376,182064,181376,688,2148,utRho23
500,ftsP,6325732,6325732,6325338,394,378,utRho23
501,ftsQ,205484,206310,205484,826,410,utRho23
502,ftsX,7204512,7204512,7204172,340,758,utRho23
503,ftsZ,209272,210610,209272,1338,90,utRho23
504,fucA,5867708,5867708,5867376,332,5172,utRho23
505,fucP,5868238,5868470,5868238,232,656,utRho23
506,fumA,6753760,6753760,6753508,252,2220,utRho23
507,fumB,8694696,8694696,8694652,44,298,utRho23
508,fumC,3373418,3373418,3373176,242,118,utRho23
509,fur,2842892,2842892,2842584,308,1996,utRho23
510,fusA,6947370,6947370,6947028,342,5010,utRho23
511,fxsA,8737206,8737328,8737206,122,38,utRho23
512,gabD,5581824,5582546,5581824,722,7348,utRho23
513,gadA,7335214,7335214,7335160,54,0,utRho23
514,gadB,3144144,3144144,3144090,54,830,utRho23
515,gadC,3141168,3141168,3140978,190,698,utRho23
516,gadE,7315600,7316732,7315600,1132,4614,utRho23
517,gadW,7329562,7329562,7329236,326,162,utRho23
518,gadX,14663356,14663356,14663240,116,1196,utRho23
519,gadY,7329728,7329728,7329728,0,0,utRho23
520,galE,1584354,1584354,1584110,244,146,utRho23
521,galF,4228702,4228702,4228654,48,254,utRho23
522,galM,1577796,1577796,1577674,122,806,utRho23
523,galP,6176510,6176568,6176510,58,136,utRho23
524,galR,5953138,5953198,5953138,60,312,utRho23
525,galS,4483420,4483420,4483336,84,48,utRho23
526,galU,2582810,2582914,2582810,104,260,utRho23
527,gapA,3724480,3725542,3724480,1062,1192,utRho23
528,garP,6549868,6549868,6549814,54,1638,utRho23
529,gatY,4354468,4354468,4354408,60,26,utRho23
530,gatZ,4352864,4352864,4352642,222,5658,utRho23
531,gcd,282558,282558,282450,108,140,utRho23
532,gcl,1067814,1067832,1067814,18,6,utRho23
533,gcvA,5885278,5885278,5885134,144,76,utRho23
534,gcvB,5885392,5885392,5885392,0,0,utRho23
535,gcvR,5199758,5199812,5199758,54,104,utRho23
536,gcvT,6101544,6101544,6101334,210,776,utRho23
537,gdhA,3684616,3684742,3684616,126,118,utRho23
538,gfcA,2099668,2099668,2099488,180,1786,utRho23
539,gfcD,2096236,2096236,2095890,346,4400,utRho23
540,ghrA,2195648,2195772,2195648,124,142,utRho23
541,ghrB,7434378,7434620,7434378,242,2970,utRho23
542,glcA,6242728,6242728,6242558,170,1582,utRho23
543,glcC,6256412,6256544,6256412,132,138,utRho23
544,glcD,6256152,6256152,6256042,110,678,utRho23
545,gldA,8278092,8278092,8278070,22,482,utRho23
546,glgA,7136784,7136784,7136066,718,1402,utRho23
547,glgB,7147314,7147314,7147004,310,314,utRho23
548,glgC,7139142,7139142,7138656,486,458,utRho23
549,glgP,7133546,7133546,7133162,384,680,utRho23
550,glgS,6384024,6384024,6383878,146,140,utRho23
551,glgX,7142838,7142838,7142638,200,164,utRho23
552,glk,5018922,5018922,5018852,70,230,utRho23
553,glmS,7827622,7827622,7827336,286,1222,utRho23
554,glmU,7830652,7830652,7830400,252,148,utRho23
555,glmY,10765360,10765360,10765360,0,0,utRho23
556,glmZ,7972864,7972864,7972864,0,0,utRho23
557,glnA,16232888,16232888,16232136,752,312,utRho23
558,glnB,5375052,5375052,5374816,236,362,utRho23
559,glnD,377310,377310,377300,10,110,utRho23
560,glnE,6399602,6399602,6399282,320,130,utRho23
561,glnH,1696396,1696396,1696008,388,1700,utRho23
562,glnK,945112,945196,945112,84,1010,utRho23
563,glnL,8112742,8112742,8112678,64,12,utRho23
564,glnQ,1693262,1693262,1692926,336,454,utRho23
565,glnS,1411998,1412186,1411998,188,1878,utRho23
566,gloA,3455602,3455674,3455602,72,110,utRho23
567,gloB,469852,469852,469564,288,1526,utRho23
568,glpA,4705166,4705294,4705166,128,120,utRho23
569,glpD,7123942,7124026,7123942,84,784,utRho23
570,glpE,7123698,7123698,7123646,52,32,utRho23
571,glpF,8236322,8236322,8236180,142,1586,utRho23
572,glpG,7122960,7122960,7122904,56,158,utRho23
573,glpR,7121782,7121782,7121210,572,7312,utRho23
574,glpT,4704902,4704902,4704748,154,1164,utRho23
575,glpX,8231212,8231212,8231158,54,428,utRho23
576,glrK,5382246,5382246,5382196,50,466,utRho23
577,gltA,1509534,1509534,1508936,598,13786,utRho23
578,gltB,6709018,6709264,6709018,246,1152,utRho23
579,gltI,1375792,1375792,1375494,298,3502,utRho23
580,gltP,8588536,8588962,8588536,426,1898,utRho23
581,gltS,7657382,7657382,7657330,52,1644,utRho23
582,gltX,5041568,5041568,5041344,224,406,utRho23
583,gluQ,320286,320286,320224,62,70,utRho23
584,glyA,5371148,5371148,5371014,134,250,utRho23
585,glyQ,7450708,7450708,7450636,72,608,utRho23
586,glyS,7448990,7448990,7448794,196,770,utRho23
587,glyU,5998128,5998128,5998114,14,0,utRho23
588,glyV,8784626,8784720,8784626,94,224,utRho23
589,glyW,3984360,3984360,3984234,126,2,utRho23
590,gmhB,445612,445666,445612,54,136,utRho23
591,gmk,7642776,7642856,7642776,80,80,utRho23
592,gmr,2693686,2693686,2693484,202,516,utRho23
593,gnd,4202648,4202648,4202536,112,326,utRho23
594,gnsB,3275692,3275692,3275564,128,48,utRho23
595,gntK,14310580,14310580,14310368,212,1876,utRho23
596,gntP,9102668,9102668,9102592,76,462,utRho23
597,gntR,7157760,7157760,7157452,308,336,utRho23
598,gntT,7092810,7093118,7092810,308,3104,utRho23
599,gntU,7154170,7154170,7154122,48,56,utRho23
600,gntX,7089334,7089764,7089334,430,116,utRho23
601,gor,7292224,7292598,7292224,374,472,utRho23
602,gpmA,1575340,1575340,1575190,150,8,utRho23
603,gpmM,7570374,7570520,7570374,146,208,utRho23
604,gpsA,7567620,7567620,7567322,298,1272,utRho23
605,gpt,511828,511954,511828,126,292,utRho23
606,grcA,5433046,5433046,5432898,148,1242,utRho23
607,greA,6657728,6657728,6657430,298,506,utRho23
608,greB,7073488,7073624,7073488,136,84,utRho23
609,groL,8741566,8742050,8741566,484,10932,utRho23
610,groS,8741232,8741376,8741232,144,7910,utRho23
611,grpE,5501494,5501494,5501416,78,354,utRho23
612,grxA,1781552,1781552,1781506,46,180,utRho23
613,grxB,2248206,2248206,2248108,98,1260,utRho23
614,grxC,7569152,7569152,7568884,268,1350,utRho23
615,grxD,3468324,3468324,3468202,122,626,utRho23
616,gspA,6911268,6911268,6910796,472,1556,utRho23
617,gspC,6910964,6911156,6910964,192,432,utRho23
618,gss,6277220,6277220,6277044,176,494,utRho23
619,gstA,3428654,3428754,3428654,100,0,utRho23
620,gstB,1761038,1761038,1760960,78,960,utRho23
621,guaB,5268214,5268214,5268140,74,72,utRho23
622,gudD,5839026,5839026,5838770,256,190,utRho23
623,gyrA,4678914,4678914,4678840,74,306,utRho23
624,gyrB,7760300,7760300,7760238,62,102,utRho23
625,hcaE,5337964,5338064,5337964,100,12298,utRho23
626,hcaR,5337928,5337928,5337792,136,15842,utRho23
627,hcaT,5336106,5336106,5335692,414,1476,utRho23
628,hchA,4071260,4071670,4071260,410,380,utRho23
629,hcp,1828258,1828258,1827628,630,2652,utRho23
630,hcr,1824400,1824400,1824300,100,276,utRho23
631,hdeA,7313582,7313582,7313480,102,16,utRho23
632,hdeD,7313920,7313990,7313920,70,4924,utRho23
633,hdfR,7896320,7896320,7895934,386,156,utRho23
634,hdhA,3396244,3396244,3396080,164,70,utRho23
635,helD,2048876,2048942,2048876,66,0,utRho23
636,hemA,2527166,2527428,2527166,262,214,utRho23
637,hemB,779722,779722,779454,268,5336,utRho23
638,hemF,5106410,5106450,5106410,40,124,utRho23
639,hemH,996062,996110,996062,48,1212,utRho23
640,hemL,349882,349882,349764,118,48,utRho23
641,hemN,8103886,8104090,8103886,204,306,utRho23
642,hepA,127176,127176,126528,648,4502,utRho23
643,hflD,2385372,2385372,2385262,110,162,utRho23
644,hfq,8799602,8800576,8799602,974,3774,utRho23
645,hha,961006,961006,960616,390,290,utRho23
646,hicA,3018442,3018572,3018442,130,260,utRho23
647,higA,6468682,6468682,6468288,394,3372,utRho23
648,higB,6468960,6468960,6468910,50,108,utRho23
649,hinT,2323642,2323770,2323642,128,12,utRho23
650,hipB,3184964,3184964,3184884,80,66,utRho23
651,hisB,4186720,4186936,4186720,216,308,utRho23
652,hisJ,4853674,4853674,4853576,98,134,utRho23
653,hisL,8359856,8359984,8359856,128,1276,utRho23
654,hisS,5281284,5281284,5281150,134,114,utRho23
655,hlpA,400910,400964,400910,54,8,utRho23
656,hlyE,2460932,2460932,2460788,144,1482,utRho23
657,hmp,5371594,5371670,5371594,76,40,utRho23
658,hns,2585916,2585916,2585844,72,728,utRho23
659,hofM,7045856,7045856,7045502,354,338,utRho23
660,hokA,7441620,7441620,7441200,420,1164,utRho23
661,hokC,33902,33902,33806,96,156,utRho23
662,hokE,1215462,1215672,1215462,210,58,utRho23
663,holC,8968546,8968546,8968560,14,592,utRho23
664,holD,9215562,9215606,9215562,44,8,utRho23
665,holE,3850040,3850216,3850040,176,2894,utRho23
666,hpt,282720,282862,282720,142,1872,utRho23
667,hrpB,324150,324210,324150,60,100,utRho23
668,hscB,5319048,5319048,5318934,114,462,utRho23
669,hscC,1367188,1367188,1366786,402,414,utRho23
670,hsdS,9163004,9163004,9162924,80,600,utRho23
671,hslJ,2883560,2883560,2883486,74,790,utRho23
672,hslO,7059344,7059548,7059344,204,12208,utRho23
673,hslR,7058220,7058696,7058220,476,1582,utRho23
674,hslV,8244708,8244708,8244574,134,302,utRho23
675,hsrA,7881412,7881412,7881224,188,364,utRho23
676,htgA,21286,21660,21286,374,23642,utRho23
677,htpG,989634,990240,989634,606,27084,utRho23
678,htpX,3825236,3825236,3825152,84,108,utRho23
679,htrE,311036,311036,310852,184,1610,utRho23
680,htrL,7587668,7587668,7587366,302,258,utRho23
681,hupA,8400352,8400562,8400352,210,4,utRho23
682,hupB,1845220,1845804,1845220,584,1036,utRho23
683,hyaA,2063968,2064278,2063968,310,40,utRho23
684,hybO,6292726,6292726,6292522,204,13244,utRho23
685,hycA,5700922,5700922,5700870,52,220,utRho23
686,hycI,5686204,5686204,5686086,118,2884,utRho23
687,hydN,5676264,5676264,5676210,54,60,utRho23
688,hyfA,5202342,5202402,5202342,60,182,utRho23
689,hypA,11402508,11402588,11402508,80,612,utRho23
690,hypB,11403356,11404004,11403356,648,148,utRho23
691,hypF,5676210,5676210,5674850,1360,8240,utRho23
692,hypT,9116634,9116634,9116578,56,28,utRho23
693,hyuA,6019660,6020056,6019660,396,1010,utRho23
694,iaaA,1733074,1733136,1733074,62,30,utRho23
695,iadA,9119074,9119074,9119052,22,814,utRho23
696,iap,5753072,5753162,5753072,90,114,utRho23
697,ibaG,6673966,6673966,6673606,360,76,utRho23
698,ibpA,7735036,7735036,7734844,192,2278,utRho23
699,ibpB,7733962,7733962,7733794,168,14798,utRho23
700,icd,2389922,2390246,2389922,324,178,utRho23
701,iclR,8447304,8447304,8447256,48,270,utRho23
702,idi,6065876,6066130,6065876,254,164,utRho23
703,idnD,8988870,8988870,8988812,58,64,utRho23
704,idnK,8989194,8989246,8989194,52,956,utRho23
705,ihfA,3591442,3591442,3591104,338,152,utRho23
706,ihfB,1927498,1927656,1927498,158,314,utRho23
707,ileS,43666,44782,43666,1116,2456,utRho23
708,ileX,6431194,6431196,6431194,2,10,utRho23
709,ilvA,15820940,15821324,15820940,384,1940,utRho23
710,ilvC,7915824,7915940,7915824,116,298,utRho23
711,ilvE,15809552,15809936,15809552,384,812,utRho23
712,ilvI,170840,171260,170840,420,570,utRho23
713,ilvL,23701308,23701932,23701308,624,462,utRho23
714,ilvY,7915734,7915734,7915640,94,154,utRho23
715,inaA,4698998,4698998,4698944,54,1370,utRho23
716,infA,1853370,1853370,1852886,484,722,utRho23
717,infC,3602692,3602692,3601276,1416,1176,utRho23
718,insA-5,3958452,3958452,3958430,22,162,utRho23
719,insA-7,9036758,9037054,9036758,296,2688,utRho23
720,insC-5,6372080,6372284,6372080,204,7028,utRho23
721,insEF-2,785238,785238,785820,582,3704,utRho23
722,insEF-4,2190310,2190310,2190892,582,3424,utRho23
723,insG,9007098,9007098,9006862,236,6,utRho23
724,insH-1,550596,550596,550234,362,37904,utRho23
725,insH-11,7306538,7306538,7306396,142,326,utRho23
726,insH-2,1151548,1151548,1151506,42,578,utRho23
727,insH-3,1378444,1378444,1378026,418,828,utRho23
728,insH-4,2791942,2792152,2791942,210,314,utRho23
729,insH-5,2857852,2857852,2857452,400,790,utRho23
730,insH-6,4135022,4135022,4134642,380,1712,utRho23
731,insH-7,4206186,4206186,4205822,364,2436,utRho23
732,insH-9,6260050,6260356,6260050,306,1950,utRho23
733,insI-3,9017372,9017372,9017234,138,1034,utRho23
734,insJ,7441188,7441360,7441188,172,358,utRho23
735,insK,7442130,7442308,7442130,178,2,utRho23
736,insL-1,30760,30890,30760,130,2216,utRho23
737,insL-2,1216112,1216130,1216112,18,172,utRho23
738,insL-3,5028644,5028662,5028644,18,180,utRho23
739,insN-1,540452,540484,540452,32,218,utRho23
740,intD,1132202,1132202,1131956,246,20490,utRho23
741,intR,2826520,2826520,2826470,50,86,utRho23
742,intS,4933026,4933090,4933026,64,3282,utRho23
743,intZ,5117386,5117542,5117386,156,10818,utRho23
744,iraD,9113152,9113986,9113152,834,1016,utRho23
745,iraM,2424246,2424246,2424006,240,344,utRho23
746,iraP,802638,802772,802638,134,0,utRho23
747,iscA,5319924,5319924,5319772,152,416,utRho23
748,iscR,5324398,5324398,5324262,136,5510,utRho23
749,iscX,5313834,5313834,5313472,362,1168,utRho23
750,ispF,5743968,5743968,5743560,408,2168,utRho23
751,ispG,5283908,5283908,5283608,300,228,utRho23
752,ispU,389568,389806,389568,238,18,utRho23
753,isrA,2811502,2811502,2811618,116,148,utRho23
754,istr-1,7706384,7706384,7706384,0,0,utRho23
755,istr-2,7706514,7706514,7706514,0,0,utRho23
756,ivbL,15412092,15412092,15411952,140,180,utRho23
757,ivy,480638,480686,480638,48,562,utRho23
758,katE,3627628,3627734,3627628,106,1174,utRho23
759,katG,8267624,8267670,8267624,46,60,utRho23
760,kbaZ,6557732,6557828,6557732,96,112,utRho23
761,kbl,7585154,7585154,7585102,52,664,utRho23
762,kch,2621046,2621046,2620538,508,434,utRho23
763,kdgR,3820506,3820506,3820198,308,142,utRho23
764,kdpE,1443788,1443788,1443466,322,136,utRho23
765,kdpF,1457698,1457698,1457642,56,206,utRho23
766,kdsA,2535708,2536330,2535708,622,928,utRho23
767,kdsC,6683438,6684546,6683438,1108,4350,utRho23
768,kduI,5968388,5968388,5968248,140,24338,utRho23
769,kefF,94160,94492,94160,332,3494,utRho23
770,kgtP,5451624,5451624,5451492,132,240,utRho23
771,kup,7862206,7862632,7862206,426,518,utRho23
772,lacI,735076,735076,735020,56,172,utRho23
773,lacZ,1465508,1465508,1465220,288,1932,utRho23
774,ldcA,2486394,2486394,2486160,234,310,utRho23
775,ldhA,2885830,2885830,2885686,144,138,utRho23
776,ldrA,2538954,2538954,2538550,404,2366,utRho23
777,ldrB,2540024,2540024,2539620,404,560,utRho23
778,ldrC,2541092,2541092,2540690,402,352,utRho23
779,ldrD,7400544,7400544,7400174,370,860,utRho23
780,lepA,5414392,5414392,5414248,144,26,utRho23
781,lepB,5410928,5410928,5410618,310,426,utRho23
782,leuD,159188,159188,158906,282,246,utRho23
783,leuE,3761600,3761600,3761518,82,190,utRho23
784,leuL,168048,168048,167416,632,252,utRho23
785,leuO,168308,168736,168308,428,154,utRho23
786,leuQ,9212864,9212864,9212802,62,58,utRho23
787,leuU,6644556,6644556,6644316,240,400,utRho23
788,leuV,9212546,9212546,9212330,216,612,utRho23
789,leuX,8992772,8992810,8992772,38,62,utRho23
790,lexA,8514174,8514230,8514174,56,940,utRho23
791,lhr,3456706,3458174,3456706,1468,6586,utRho23
792,ligA,5060402,5060402,5060352,50,0,utRho23
793,ligB,7642576,7642576,7642340,236,926,utRho23
794,lipA,1320602,1320602,1320432,170,702,utRho23
795,lipB,1324802,1324802,1324556,246,9822,utRho23
796,lit,2397032,2397390,2397032,358,3014,utRho23
797,livJ,7199524,7199524,7199316,208,2116,utRho23
798,livK,7195510,7195510,7195120,390,1030,utRho23
799,lldP,7554578,7554798,7554578,220,3370,utRho23
800,lnt,1381968,1381968,1381762,206,214,utRho23
801,loiP,6163784,6163826,6163784,42,36,utRho23
802,lolA,1874656,1874738,1874656,82,200,utRho23
803,lolB,2527112,2527112,2527000,112,156,utRho23
804,lolC,2350748,2350854,2350748,106,62,utRho23
805,lon,917630,917776,917630,146,292,utRho23
806,lpcA,486936,487086,486936,150,124,utRho23
807,lpd,255434,255824,255434,390,782,utRho23
808,lplA,9248476,9248476,9248234,242,1140,utRho23
809,lplT,5947878,5947878,5947724,154,48,utRho23
810,lpoA,6586422,6586800,6586422,378,1390,utRho23
811,lpp,3514592,3514842,3514592,250,274,utRho23
812,lptA,6686598,6686760,6686598,162,696,utRho23
813,lptB,6686792,6687888,6686792,1096,1682,utRho23
814,lptD,114672,114672,114218,454,2452,utRho23
815,lptF,8972244,8972436,8972244,192,54,utRho23
816,lpxC,213016,213114,213016,98,1526,utRho23
817,lpxD,401920,401942,401920,22,0,utRho23
818,lpxL,2233418,2233418,2233164,254,56,utRho23
819,lpxM,3880456,3880456,3880386,70,58,utRho23
820,lpxP,4991156,4991290,4991156,134,502,utRho23
821,lrhA,4813312,4813312,4813282,30,70,utRho23
822,lrp,1864656,1865190,1864656,534,772,utRho23
823,lspA,50028,50414,50028,386,742,utRho23
824,lsrA,3202920,3202980,3202920,60,58,utRho23
825,lsrR,3202514,3202514,3202482,32,2,utRho23
826,ltaE,1818640,1818640,1818588,52,14,utRho23
827,luxS,5630130,5630130,5629466,664,4564,utRho23
828,lysA,5957902,5957902,5957798,104,164,utRho23
829,lysC,8467232,8467232,8466466,766,2116,utRho23
830,lysP,4497120,4497120,4497064,56,82,utRho23
831,lysR,5957900,5958042,5957900,142,76,utRho23
832,lysT,1561028,1561108,1561028,80,0,utRho23
833,lysU,8709610,8709610,8709434,176,262,utRho23
834,macB,1840188,1840694,1840188,506,1636,utRho23
835,maeA,3111484,3111484,3111338,146,2332,utRho23
836,mak,820236,820288,820236,52,96,utRho23
837,malE,8492928,8492928,8492838,90,44,utRho23
838,malI,3398456,3398456,3398360,96,32,utRho23
839,malK,8493472,8493568,8493472,96,336,utRho23
840,malP,7105020,7105020,7104946,74,1134,utRho23
841,malQ,7100798,7100798,7100140,658,946,utRho23
842,malS,14949880,14949988,14949880,108,36,utRho23
843,malT,7106048,7106170,7106048,122,222,utRho23
844,malX,3398626,3398710,3398626,84,0,utRho23
845,malZ,1689980,1690072,1689980,92,904,utRho23
846,manA,3377102,3377152,3377102,50,8,utRho23
847,manX,3803866,3804096,3803866,230,476,utRho23
848,marC,3237882,3237882,3237816,66,670,utRho23
849,marR,3238186,3238240,3238186,54,546,utRho23
850,matP,2036918,2036970,2036918,52,54,utRho23
851,mazE,5822736,5822736,5822678,58,80,utRho23
852,mazG,5821720,5821720,5821370,350,4350,utRho23
853,mcbA,1684306,1684306,1684112,194,122,utRho23
854,mcbR,3040192,3040524,3040192,332,112,utRho23
855,mcrA,2420278,2420692,2420278,414,668,utRho23
856,mcrC,9156124,9156124,9155916,208,1296,utRho23
857,mdaB,6344814,6345060,6344814,246,534,utRho23
858,mdfA,1767138,1767346,1767138,208,0,utRho23
859,mdh,6768940,6768940,6768536,404,202,utRho23
860,mdoB,9198988,9198988,9198882,106,7568,utRho23
861,mdoD,2993290,2993712,2993290,422,56,utRho23
862,mdoG,2218514,2218670,2218514,156,42,utRho23
863,mdtA,4307958,4308032,4307958,74,178,utRho23
864,mdtE,7318168,7318464,7318168,296,4482,utRho23
865,mdtK,3486538,3486914,3486538,376,4250,utRho23
866,mdtP,8602472,8602472,8602060,412,4370,utRho23
867,melA,8683774,8683822,8683774,48,0,utRho23
868,melR,8683300,8683300,8683256,44,1752,utRho23
869,menA,8240812,8240812,8240698,114,120,utRho23
870,menB,4753774,4753774,4753638,136,746,utRho23
871,mepH,3468714,3468870,3468714,156,14,utRho23
872,mepM,3883666,3883666,3883270,396,184,utRho23
873,mepS,4539840,4539958,4539840,118,74,utRho23
874,metA,8428318,8428560,8428318,242,278,utRho23
875,metB,8257272,8257344,8257272,72,706,utRho23
876,metC,6304150,6304472,6304150,322,246,utRho23
877,metE,8025768,8026106,8025768,338,2646,utRho23
878,metF,8265092,8265232,8265092,140,190,utRho23
879,metG,4388538,4388600,4388538,62,92,utRho23
880,metH,8447010,8447656,8447010,646,4800,utRho23
881,metJ,8257116,8257116,8256790,326,472,utRho23
882,metK,6173154,6173412,6173154,258,50,utRho23
883,metN,445428,445428,445290,138,84,utRho23
884,metR,8025710,8025710,8025632,78,22,utRho23
885,metT,1394326,1394326,1394266,60,132,utRho23
886,metY,19910250,19910250,19909734,516,282,utRho23
887,metZ,11789528,11789548,11789528,20,52,utRho23
888,mfd,2348056,2348056,2347928,128,336,utRho23
889,mglA,4478782,4478782,4478578,204,292,utRho23
890,mglB,4481132,4481132,4480696,436,10200,utRho23
891,mglC,4475918,4475918,4475506,412,920,utRho23
892,mgrB,3817584,3817584,3817532,52,122,utRho23
893,mgrR,3245828,3245828,3245828,0,0,utRho23
894,mgsA,2054082,2054082,2054030,52,206,utRho23
895,mgtL,8934560,8934862,8934560,302,80,utRho23
896,mhpA,737038,737222,737038,184,792,utRho23
897,mhpR,737072,737072,736840,232,506,utRho23
898,mhpT,750772,750918,750772,146,102,utRho23
899,miaA,8797964,8798504,8797964,540,2026,utRho23
900,micA,5629604,5629604,5629604,0,0,utRho23
901,micC,2874242,2874238,2874242,4,0,utRho23
902,micF,4626168,4626168,4626168,0,0,utRho23
903,micM,1014408,1014408,1014408,0,0,utRho23
904,minE,2449422,2449422,2449090,332,1194,utRho23
905,mioC,7852950,7852950,7852910,40,42,utRho23
906,mipA,3733012,3733012,3732944,68,1138,utRho23
907,mlaA,4930270,4930270,4930014,256,0,utRho23
908,mlc,3337206,3337206,3337128,78,54,utRho23
909,mlrA,4429498,4429732,4429498,234,744,utRho23
910,mltA,5894546,5894546,5894356,190,274,utRho23
911,mltD,468050,468050,467910,140,108,utRho23
912,mltF,5391534,5391602,5391534,68,0,utRho23
913,mmuP,550238,550650,550238,412,45606,utRho23
914,mngA,1531622,1531968,1531622,346,688,utRho23
915,mngR,1531852,1531852,1531750,102,426,utRho23
916,mnmG,7851348,7851348,7851266,82,2830,utRho23
917,mntH,5025470,5025470,5025412,58,60,utRho23
918,mntP,3810918,3811376,3810918,458,2492,utRho23
919,mntR,1706160,1706366,1706160,206,20,utRho23
920,mntS,1706128,1706128,1705994,134,32,utRho23
921,moaA,1633654,1634088,1633654,434,2960,utRho23
922,moaB,1635954,1636110,1635954,156,1438,utRho23
923,mobA,8084242,8084242,8083998,244,280,utRho23
924,mocA,6030112,6030320,6030112,208,306,utRho23
925,modA,1589990,1590178,1589990,188,388,utRho23
926,moeA,1732788,1732788,1732728,60,116,utRho23
927,mokB,2984610,2984610,2984258,352,844,utRho23
928,molR_1,4392888,4392948,4392888,60,362,utRho23
929,motA,3954604,3954604,3954278,326,240,utRho23
930,mpaA,2781278,2781278,2781196,82,1006,utRho23
931,mpl,8911456,8911570,8911456,114,388,utRho23
932,mppA,2786108,2786454,2786108,346,68,utRho23
933,mprA,5621494,5621540,5621494,46,632,utRho23
934,mqo,4613848,4613848,4613508,340,750,utRho23
935,mqsA,6336742,6336742,6336492,250,640,utRho23
936,mqsR,6337306,6337306,6337088,218,1560,utRho23
937,mraZ,179192,179268,179192,76,22,utRho23
938,mrcA,7045652,7045742,7045652,90,54,utRho23
939,mrcB,329442,329460,329442,18,14,utRho23
940,mreB,13605424,13605424,13604348,1076,496,utRho23
941,mreD,6798166,6798166,6797750,416,296,utRho23
942,mrp,4388360,4388360,4388336,24,90,utRho23
943,mscK,972984,973072,972984,88,290,utRho23
944,mscL,6876002,6876048,6876002,46,676,utRho23
945,mscS,6139742,6139742,6139614,128,290,utRho23
946,msrA,8884522,8884522,8884352,170,1694,utRho23
947,msrB,3725168,3725168,3724858,310,0,utRho23
948,msyB,2228426,2228426,2228362,64,426,utRho23
949,mtfA,4087236,4087302,4087236,66,920,utRho23
950,mtgA,6699662,6699662,6699618,44,1572,utRho23
951,mtlA,30177504,30178248,30177504,744,10704,utRho23
952,mtn,358366,358366,358306,60,2454,utRho23
953,mtr,6611864,6611864,6611634,230,112,utRho23
954,mug,6430992,6430992,6430946,46,62,utRho23
955,murQ,5091466,5091546,5091466,80,232,utRho23
956,murR,5091586,5091586,5091218,368,1190,utRho23
957,mutH,5939164,5939324,5939164,160,600,utRho23
958,mutL,8794092,8794824,8794092,732,5160,utRho23
959,mutM,7622554,7622554,7622304,250,338,utRho23
960,mutS,5714038,5714186,5714038,148,2404,utRho23
961,mutY,18617466,18618078,18617466,612,1116,utRho23
962,nac,4123956,4123956,4123866,90,1120,utRho23
963,nadA,1564122,1564170,1564122,48,28,utRho23
964,nadB,5420714,5420840,5420714,126,228,utRho23
965,nadC,237326,237326,237290,36,430,utRho23
966,nadE,3644604,3644916,3644604,312,558,utRho23
967,nadK,5501526,5501662,5501526,136,272,utRho23
968,nagA,1406350,1406350,1405502,848,4344,utRho23
969,nagB,1407416,1407416,1407222,194,116,utRho23
970,nagC,1404016,1404016,1403188,828,168,utRho23
971,nagE,1407680,1407888,1407680,208,700,utRho23
972,nagK,2357080,2357186,2357080,106,118,utRho23
973,nanA,6747240,6747240,6747152,88,982,utRho23
974,nanC,9079856,9079856,9079002,854,836,utRho23
975,nanR,6749406,6749406,6748978,428,2340,utRho23
976,nanS,9075406,9075406,9075188,218,216,utRho23
977,napF,4607390,4607390,4606994,396,260,utRho23
978,narG,2559614,2559728,2559614,114,1110,utRho23
979,narK,2555642,2555914,2555642,272,798,utRho23
980,narP,4580844,4581000,4580844,156,320,utRho23
981,narQ,5171154,5171462,5171154,308,470,utRho23
982,narU,3088326,3088326,3088120,206,1018,utRho23
983,narW,3077374,3077374,3074618,2756,3894,utRho23
984,narX,2555554,2555554,2555236,318,788,utRho23
985,narZ,3085380,3085380,3085180,200,12,utRho23
986,ndh,2331984,2332170,2331984,186,1094,utRho23
987,ndk,5289920,5289920,5289728,192,310,utRho23
988,nemR,6904084,6904092,6904084,8,2600,utRho23
989,nepI,7683542,7683542,7683478,64,252,utRho23
990,nfo,4501612,4501680,4501612,68,306,utRho23
991,nfsB,1210906,1210906,1210848,58,226,utRho23
992,nfuA,7090916,7091248,7090916,332,510,utRho23
993,nhaA,34634,34978,34634,344,1028,utRho23
994,nhaB,2469534,2469534,2469434,100,74,utRho23
995,nhoA,3067926,3068048,3067926,122,188,utRho23
996,nikA,7226878,7227334,7226878,456,5884,utRho23
997,nikR,7237074,7237176,7237074,102,384,utRho23
998,nirB,6987974,6988022,6987974,48,108,utRho23
999,nlpA,7680034,7680034,7679986,48,34,utRho23
1000,nlpC,3585654,3585654,3585462,192,70,utRho23
1001,nlpD,5737658,5737658,5737506,152,82,utRho23
1002,nlpI,6618080,6618080,6617848,232,16,utRho23
1003,nmpC,1153740,1153740,1153650,90,82,utRho23
1004,nohA,3273206,3273206,3272734,472,1880,utRho23
1005,norR,5664614,5664614,5664578,36,130,utRho23
1006,norV,5664878,5664952,5664878,74,70,utRho23
1007,nrdA,4689510,4689730,4689510,220,8642,utRho23
1008,nrdD,8925676,8925676,8925320,356,3756,utRho23
1009,nrdH,5601312,5601446,5601312,134,576,utRho23
1010,nrdR,865954,866004,865954,50,148,utRho23
1011,nrfA,8575342,8575528,8575342,186,32,utRho23
1012,nsrR,8812088,8812380,8812088,292,6328,utRho23
1013,nudB,3897348,3897348,3897264,84,0,utRho23
1014,nudC,8393428,8393806,8393428,378,610,utRho23
1015,nudE,7052658,7052658,7052298,360,2382,utRho23
1016,nudG,3682876,3682980,3682876,104,98,utRho23
1017,nudI,4729050,4729108,4729050,58,168,utRho23
1018,nudJ,2388874,2388874,2388576,298,660,utRho23
1019,nuoA,4810670,4810670,4810144,526,896,utRho23
1020,nuoN,4783434,4783434,4783010,424,778,utRho23
1021,nupC,5026018,5026084,5026018,66,0,utRho23
1022,nupG,6211302,6211428,6211302,126,242,utRho23
1023,ogrK,4335096,4335096,4335040,56,0,utRho23
1024,ogt,2800568,2800568,2800472,96,250,utRho23
1025,ohsC,5401036,5401040,5401036,4,18,utRho23
1026,ompA,2040382,2040382,2040106,276,10288,utRho23
1027,ompC,4625774,4625774,4625498,276,36,utRho23
1028,ompF,1974184,1974184,1973964,220,42,utRho23
1029,ompL,8128958,8128958,8128590,368,644,utRho23
1030,ompN,2874158,2874158,2873786,372,48,utRho23
1031,ompR,7073510,7073510,7073168,342,166,utRho23
1032,ompT,1171330,1171330,1171266,64,178,utRho23
1033,ompW,2627982,2628040,2627982,58,142,utRho23
1034,ompX,1700418,1700900,1700418,482,846,utRho23
1035,omrA,5952378,5952378,5952378,0,0,utRho23
1036,omrB,5952770,5952770,5952770,0,0,utRho23
1037,oppA,2602170,2602364,2602170,194,3618,utRho23
1038,orn,8783168,8783208,8783168,40,434,utRho23
1039,osmB,2686952,2686952,2686656,296,2034,utRho23
1040,osmC,3113192,3113250,3113192,58,524,utRho23
1041,osmE,3644566,3644566,3644512,54,224,utRho23
1042,osmF,4439046,4439046,4438962,84,3062,utRho23
1043,osmY,9222306,9222792,9222306,486,532,utRho23
1044,otsA,3963302,3963302,3963224,78,832,utRho23
1045,otsB,3964930,3964930,3964774,156,492,utRho23
1046,oxc,4984288,4984288,4983900,388,2490,utRho23
1047,oxyR,8316914,8316980,8316914,66,3220,utRho23
1048,oxyS,8316788,8316788,8316788,0,0,utRho23
1049,paaA,2907730,2907854,2907730,124,54,utRho23
1050,paaX,2927018,2927078,2927018,60,0,utRho23
1051,paaZ,2907340,2907340,2907284,56,8,utRho23
1052,pabA,6981702,6981702,6981658,44,178,utRho23
1053,pabB,3789256,3789610,3789256,354,1634,utRho23
1054,pabC,2306186,2306600,2306186,414,538,utRho23
1055,pagP,1313052,1313114,1313052,62,142,utRho23
1056,panB,299260,299260,299202,58,8150,utRho23
1057,panC,297840,297840,297590,250,322,utRho23
1058,panD,293490,293490,293388,102,74,utRho23
1059,panZ,7195656,7195968,7195656,312,452,utRho23
1060,parC,6332060,6332060,6331946,114,506,utRho23
1061,patA,6438916,6438988,6438916,72,214,utRho23
1062,patD,3030830,3031156,3030830,326,442,utRho23
1063,pbpC,5294986,5294986,5294650,336,182,utRho23
1064,pbpG,4450132,4450132,4449740,392,50,utRho23
1065,pck,7065358,7065636,7065358,278,4292,utRho23
1066,pcnB,318782,318782,318252,530,626,utRho23
1067,pdhR,244068,244184,244068,116,248,utRho23
1068,pdxB,4875768,4875768,4875702,66,132,utRho23
1069,pdxH,3436068,3436068,3436014,54,118,utRho23
1070,pdxJ,5403626,5403626,5403458,168,126,utRho23
1071,pdxK,5074638,5074638,5074474,164,46,utRho23
1072,pepA,8972278,8972278,8971902,376,220,utRho23
1073,pepD,511618,511618,511432,186,1368,utRho23
1074,pepN,1981182,1981244,1981182,62,630,utRho23
1075,pepQ,8062294,8062322,8062294,28,178,utRho23
1076,pepT,2371646,2371688,2371646,42,272,utRho23
1077,pfkA,8214948,8215104,8214948,156,694,utRho23
1078,pfkB,3612646,3612740,3612646,94,282,utRho23
1079,pflA,1902456,1902456,1902160,296,0,utRho23
1080,pflB,1907850,1907850,1907108,742,1762,utRho23
1081,pflD,8287716,8287990,8287716,274,36,utRho23
1082,pgaA,2185046,2185046,2184578,468,810,utRho23
1083,pgi,8467444,8467516,8467444,72,62,utRho23
1084,pgk,12291428,12291428,12290488,940,4316,utRho23
1085,pgl,1597078,1597172,1597078,94,64,utRho23
1086,pgpB,2678324,2678660,2678324,336,686,utRho23
1087,pgpC,5397276,5397276,5397100,176,452,utRho23
1088,pgrR,2783744,2783982,2783744,238,988,utRho23
1089,pheL,5475158,5475198,5475158,40,0,utRho23
1090,pheM,7197204,7197204,7197080,124,0,utRho23
1091,pheP,1203858,1203918,1203858,60,280,utRho23
1092,pheU,8725254,8725254,8725252,2,64,utRho23
1093,pheV,6220730,6220732,6220730,2,0,utRho23
1094,phnC,8650412,8650412,8650330,82,490,utRho23
1095,phoA,803414,803494,803414,80,178,utRho23
1096,phoB,834202,834284,834202,82,44,utRho23
1097,phoE,520316,520316,520200,116,2076,utRho23
1098,phoH,2169730,2169984,2169730,254,828,utRho23
1099,phoP,2381016,2381016,2380894,122,2536,utRho23
1100,phoQ,2379880,2379880,2379552,328,1156,utRho23
1101,phoU,7815330,7815330,7815156,174,254,utRho23
1102,phr,1478842,1479014,1478842,172,480,utRho23
1103,pinE,2419054,2419370,2419054,316,2202,utRho23
1104,pinQ,3267168,3267244,3267168,76,490,utRho23
1105,pinR,2867424,2867424,2867348,76,330,utRho23
1106,pitA,7275224,7275284,7275224,60,72,utRho23
1107,pitB,6272806,6272806,6272742,64,680,utRho23
1108,pka,5439862,5439906,5439862,44,568,utRho23
1109,plaP,4174476,4174476,4174124,352,44,utRho23
1110,pldA,8009628,8009724,8009628,96,6076,utRho23
1111,pldB,8018028,8018340,8018028,312,4092,utRho23
1112,plsB,8513196,8513196,8512932,264,376,utRho23
1113,pmbA,8915890,8915918,8915890,28,60,utRho23
1114,pmrD,4747148,4747148,4747076,72,92,utRho23
1115,pncB,1980828,1980828,1980712,116,16,utRho23
1116,pncC,5648788,5648788,5648692,96,6,utRho23
1117,pnp,6622652,6622652,6622336,316,46,utRho23
1118,pntA,3355950,3355950,3355806,144,212,utRho23
1119,pntB,3353096,3353096,3352720,376,422,utRho23
1120,polA,8093880,8093932,8093880,52,520,utRho23
1121,polB,131606,131606,131560,46,50,utRho23
1122,potD,2365700,2365700,2365658,42,258,utRho23
1123,potE,1436688,1436688,1436530,158,54,utRho23
1124,potF,1787268,1787568,1787268,300,768,utRho23
1125,poxB,1822152,1822152,1822098,54,722,utRho23
1126,ppa,8899372,8899372,8899304,68,208,utRho23
1127,ppc,8306380,8306380,8306196,184,2370,utRho23
1128,ppdA,5928440,5928440,5928354,86,2978,utRho23
1129,ppdD,235410,235410,235098,312,490,utRho23
1130,pphA,3846770,3846770,3845938,832,3756,utRho23
1131,pphB,5719474,5719520,5719474,46,162,utRho23
1132,ppiA,6984898,6984898,6984594,304,118,utRho23
1133,ppiC,7919682,7919682,7919626,56,72,utRho23
1134,ppiD,923638,923830,923638,192,132,utRho23
1135,ppk,5245748,5246088,5245748,340,778,utRho23
1136,pppA,6228958,6228958,6228704,254,502,utRho23
1137,ppsA,3574322,3574322,3574224,98,42,utRho23
1138,ppsR,3574678,3574890,3574678,212,204,utRho23
1139,pptA,3065716,3066104,3065716,388,1952,utRho23
1140,pqiA,2023318,2024002,2023318,684,38,utRho23
1141,prc,3830054,3830054,3829632,422,4014,utRho23
1142,preT,4467978,4468066,4467978,88,2008,utRho23
1143,prfC,9218688,9218828,9218688,140,858,utRho23
1144,prkB,6968622,6968980,6968622,358,2324,utRho23
1145,prlC,7290476,7290476,7290364,112,790,utRho23
1146,prlF,6553944,6554004,6553944,60,1294,utRho23
1147,proB,520432,520776,520432,344,1964,utRho23
1148,proC,811372,811372,811288,84,54,utRho23
1149,proK,7417388,7417388,7417384,4,6,utRho23
1150,proL,4572414,4572422,4572414,8,12,utRho23
1151,proP,8660640,8661004,8660640,364,920,utRho23
1152,proS,437674,437674,437550,124,440,utRho23
1153,proV,5609126,5609630,5609126,504,1952,utRho23
1154,prpB,697292,697364,697292,72,140,utRho23
1155,prpR,696942,696942,696886,56,76,utRho23
1156,prs,2524354,2524354,2523750,604,15590,utRho23
1157,psd,8781276,8781276,8780720,556,2482,utRho23
1158,psiE,8480600,8480650,8480600,50,60,utRho23
1159,pspA,2736076,2736158,2736076,82,0,utRho23
1160,pspF,2736080,2736080,2735824,256,4,utRho23
1161,pspG,8525632,8525680,8525632,48,6,utRho23
1162,pssA,5445156,5445454,5445156,298,4548,utRho23
1163,pstB,7817112,7817112,7816732,380,88,utRho23
1164,pstC,7821084,7821084,7820796,288,132,utRho23
1165,pstS,23469408,23469408,23469150,258,384,utRho23
1166,psuG,4517114,4517114,4516734,380,6526,utRho23
1167,psuT,4514992,4514992,4514670,322,150,utRho23
1168,pth,2517084,2517084,2517026,58,0,utRho23
1169,ptrA,5918022,5918022,5917768,254,80,utRho23
1170,ptrB,3857730,3857730,3857678,52,3804,utRho23
1171,ptsG,2315252,2315738,2315252,486,1166,utRho23
1172,ptsH,5066996,5067528,5066996,532,1260,utRho23
1173,purA,8809328,8809374,8809328,46,40,utRho23
1174,purC,5195562,5195562,5195236,326,250,utRho23
1175,purD,8411972,8411972,8411862,110,142,utRho23
1176,purE,1106284,1106284,1106200,84,752,utRho23
1177,purH,8415254,8415254,8415064,190,0,utRho23
1178,purL,5391178,5391178,5391086,92,134,utRho23
1179,purM,5242306,5242394,5242306,88,168,utRho23
1180,purR,3475378,3475688,3475378,310,412,utRho23
1181,purT,3861438,3861762,3861438,324,718,utRho23
1182,purU,2577512,2577512,2577248,264,390,utRho23
1183,putA,2157850,2157850,2157764,86,124,utRho23
1184,putP,2158336,2158610,2158336,274,526,utRho23
1185,puuA,2721936,2721936,2721816,120,38,utRho23
1186,puuC,2725456,2725486,2725456,30,0,utRho23
1187,puuD,2722104,2722240,2722104,136,38,utRho23
1188,puuP,2718746,2718746,2718374,372,1484,utRho23
1189,pykA,3874988,3875298,3874988,310,234,utRho23
1190,pykF,3510934,3511396,3510934,462,2834,utRho23
1191,pyrC,2245286,2245286,2245214,72,50,utRho23
1192,pyrD,2009464,2009536,2009464,72,478,utRho23
1193,pyrE,7631970,7631970,7631536,434,710,utRho23
1194,pyrF,2683740,2683842,2683740,102,106,utRho23
1195,pyrG,5819594,5819594,5819332,262,1130,utRho23
1196,pyrH,383624,383710,383624,86,306,utRho23
1197,pyrL,8945490,8945490,8945066,424,876,utRho23
1198,qmcA,1031646,1031646,1031546,100,1018,utRho23
1199,qor,8528608,8528608,8528462,146,220,utRho23
1200,qseB,6339502,6339656,6339502,154,1320,utRho23
1201,queA,849970,850022,849970,52,244,utRho23
1202,queE,5811212,5811212,5810836,376,138,utRho23
1203,queF,5850642,5850696,5850642,54,66,utRho23
1204,queG,8788184,8788184,8788134,50,47056,utRho23
1205,racC,2835630,2835630,2835526,104,58,utRho23
1206,racR,2840898,2840898,2840482,416,586,utRho23
1207,raiA,5474208,5474308,5474208,100,42,utRho23
1208,rarD,8008594,8008594,8008356,238,1190,utRho23
1209,ravA,7862256,7862256,7862186,70,106,utRho23
1210,rayT,495088,495274,495088,186,742,utRho23
1211,rbn,4763162,4763216,4763162,54,40,utRho23
1212,rbsD,7866644,7866702,7866644,58,20,utRho23
1213,rcnA,4371654,4371834,4371654,180,552,utRho23
1214,rcnB,4373768,4373920,4373768,152,92,utRho23
1215,rcnR,4371806,4371806,4371592,214,738,utRho23
1216,rcsA,4047672,4047936,4047672,264,6838,utRho23
1217,rcsB,4631390,4632354,4631390,964,1346,utRho23
1218,rcsC,4640162,4640162,4639656,506,134,utRho23
1219,rcsD,4626904,4626976,4626904,72,410,utRho23
1220,rdgB,6193240,6193362,6193240,122,658,utRho23
1221,rdlA,2538646,2538646,2538646,0,0,utRho23
1222,rdlB,2539712,2539716,2539712,4,0,utRho23
1223,rdlC,2540782,2540786,2540782,4,4,utRho23
1224,rdlD,7400272,7400272,7400272,0,0,utRho23
1225,rdoA,8084782,8084830,8084782,48,62,utRho23
1226,recA,11295276,11295276,11295076,200,296,utRho23
1227,recC,5925014,5925014,5924856,158,58,utRho23
1228,recF,7763722,7763722,7762442,1280,3000,utRho23
1229,recN,5503518,5503590,5503518,72,0,utRho23
1230,recQ,8011666,8011728,8011666,62,154,utRho23
1231,relA,5828554,5828554,5827302,1252,892,utRho23
1232,relB,3291806,3291806,3291744,62,32,utRho23
1233,rem,3289950,3289950,3289804,146,280,utRho23
1234,rep,7921294,7921354,7921294,60,394,utRho23
1235,rfaD,7587730,7587974,7587730,244,1030,utRho23
1236,rfaE,6393852,6393852,6393506,346,152,utRho23
1237,rfaH,8049930,8049930,8049642,288,1822,utRho23
1238,rfbX,4219436,4219436,4219168,268,594,utRho23
1239,rfe,7935600,7935832,7935600,232,62,utRho23
1240,rhaB,8194944,8194944,8194896,48,28,utRho23
1241,rhaD,8188770,8188770,8188544,226,80,utRho23
1242,rhaS,8195422,8195472,8195422,50,276,utRho23
1243,rhaT,8201132,8201132,8201050,82,232,utRho23
1244,rhlE,1661566,1661744,1661566,178,586,utRho23
1245,rhoL,47593944,47594772,47593944,828,79704,utRho23
1246,rhsB,7238006,7238384,7238006,378,1662,utRho23
1247,rhsC,1458758,1459166,1458758,408,2,utRho23
1248,rhsD,1046132,1046522,1046132,390,54,utRho23
1249,rhtA,1700608,1700608,1700194,414,848,utRho23
1250,rhtC,8015478,8015514,8015478,36,1542,utRho23
1251,ribA,2678468,2678468,2678320,148,416,utRho23
1252,ribC,3486916,3486916,3486484,432,7752,utRho23
1253,ribE,869008,869294,869008,286,2242,utRho23
1254,ribF,42766,42814,42766,48,158,utRho23
1255,ridA,8941892,8941892,8941826,66,150,utRho23
1256,rihA,1369204,1369204,1368824,380,6664,utRho23
1257,rihB,4510504,4510504,4510372,132,420,utRho23
1258,rimJ,2251044,2251124,2251044,80,354,utRho23
1259,rimK,1783752,1783934,1783752,182,444,utRho23
1260,rimL,2997486,2997876,2997486,390,138,utRho23
1261,rimO,1756140,1756140,1756070,70,274,utRho23
1262,rimP,6636350,6636350,6636012,338,266,utRho23
1263,rlmA,3814172,3814172,3814120,52,414,utRho23
1264,rlmD,5830086,5830086,5830000,86,126,utRho23
1265,rlmE,6655520,6655520,6655328,192,618,utRho23
1266,rlmF,1684384,1684664,1684384,280,376,utRho23
1267,rlmG,6471784,6471784,6471750,34,94,utRho23
1268,rlmI,2060002,2060002,2059938,64,162,utRho23
1269,rlmJ,7290700,7290770,7290700,70,32,utRho23
1270,rlmL,2015344,2015688,2015344,344,2230,utRho23
1271,rlpA,1330444,1330444,1330380,64,422,utRho23
1272,rluA,120900,120900,120692,208,418,utRho23
1273,rluF,8460324,8460708,8460324,384,162,utRho23
1274,rmf,2031006,2031430,2031006,424,270,utRho23
1275,rna,1290068,1290068,1290006,62,4,utRho23
1276,rnb,2698258,2698258,2697824,434,4716,utRho23
1277,rnc,10816892,10816892,10816252,640,7948,utRho23
1278,rnd,3776122,3776122,3775982,140,46,utRho23
1279,rne,2289746,2289746,2288734,1012,5230,utRho23
1280,rnhA,472082,472082,472004,78,1336,utRho23
1281,rnk,1288360,1288360,1287934,426,0,utRho23
1282,rnlA,5531788,5531836,5531788,48,2292,utRho23
1283,rnlB,5533414,5533968,5533414,554,1868,utRho23
1284,rnpB,19623552,19623552,19623552,0,0,utRho23
1285,rob,9270706,9270706,9270620,86,134,utRho23
1286,rodZ,5285868,5285868,5285688,180,140,utRho23
1287,rpe,7030306,7030306,7030118,188,40,utRho23
1288,rph,15266320,15266320,15266196,124,448,utRho23
1289,rpiA,6118706,6118706,6118650,56,1966,utRho23
1290,rpiB,8626514,8626700,8626514,186,572,utRho23
1291,rpiR,8626274,8626274,8625982,292,102,utRho23
1292,rplJ,8359246,8359992,8359246,746,2220,utRho23
1293,rplK,8356708,8356894,8356708,186,22,utRho23
1294,rplM,6757344,6757344,6757302,42,558,utRho23
1295,rplN,6896444,6896444,6896298,146,282,utRho23
1296,rplS,5489284,5489284,5489060,224,2198,utRho23
1297,rplT,7199052,7199052,7198996,56,76,utRho23
1298,rplU,6667036,6667036,6666902,134,194,utRho23
1299,rplY,4564866,4565034,4564866,168,144,utRho23
1300,rpmA,6666450,6666450,6666238,212,78,utRho23
1301,rpmB,15247980,15247980,15246696,1284,18196,utRho23
1302,rpmE,8253816,8254026,8253816,210,286,utRho23
1303,rpmF,2294676,2294734,2294676,58,3248,utRho23
1304,rpmH,7768130,7768672,7768130,542,1158,utRho23
1305,rpmI,3600854,3600854,3599998,856,1856,utRho23
1306,rpoB,8362126,8362490,8362126,364,326,utRho23
1307,rpoD,6424946,6426094,6424946,1148,18722,utRho23
1308,rpoE,5420372,5420372,5420024,348,52,utRho23
1309,rpoH,7202006,7202006,7201566,440,6484,utRho23
1310,rpoN,6689324,6689434,6689324,110,128,utRho23
1311,rpoS,5736236,5736236,5735102,1134,2784,utRho23
1312,rpoZ,7644154,7644212,7644154,58,466,utRho23
1313,rppH,5937986,5937986,5937954,32,234,utRho23
1314,rprA,3540744,3540744,3540744,0,0,utRho23
1315,rpsA,1923434,1923990,1923434,556,15274,utRho23
1316,rpsF,8850050,8850236,8850050,186,2356,utRho23
1317,rpsI,6756580,6756580,6756414,166,828,utRho23
1318,rpsJ,6906884,6906884,6906540,344,1176,utRho23
1319,rpsL,6949242,6949242,6949104,138,796,utRho23
1320,rpsM,6885130,6885130,6884942,188,222,utRho23
1321,rpsO,13247144,13247144,13246736,408,672,utRho23
1322,rpsP,5492508,5492508,5492370,138,46,utRho23
1323,rpsT,42420,42420,42156,264,80,utRho23
1324,rpsU,12842584,12843124,12842584,540,1384,utRho23
1325,rraA,8238716,8238716,8238660,56,222,utRho23
1326,rraB,8956768,8956946,8956768,178,762,utRho23
1327,rrsA,8070478,8071062,8070478,584,2772,utRho23
1328,rrsB,16665468,16666636,16665468,1168,5856,utRho23
1329,rrsC,7883032,7883616,7883032,584,2098,utRho23
1330,rrsD,6858094,6858094,6857524,570,418,utRho23
1331,rrsE,8415726,8416294,8415726,568,160,utRho23
1332,rrsG,5462896,5462896,5462314,582,2966,utRho23
1333,rrsH,446970,447542,446970,572,150,utRho23
1334,rsd,8393908,8393908,8393616,292,1140,utRho23
1335,rseA,5419264,5419264,5418808,456,342,utRho23
1336,rseP,392940,393092,392940,152,26,utRho23
1337,rseX,4067298,4067298,4067298,0,0,utRho23
1338,rsfS,1338144,1338144,1338072,72,304,utRho23
1339,rsgA,8783132,8783132,8783018,114,138,utRho23
1340,rsmA,105176,105176,104860,316,1694,utRho23
1341,rsmB,6869982,6870414,6869982,432,126,utRho23
1342,rsmC,9215736,9215736,9215400,336,284,utRho23
1343,rsmD,7208594,7208786,7208594,192,148,utRho23
1344,rsmE,6182036,6182268,6182036,232,1212,utRho23
1345,rsmG,7847512,7847512,7847360,152,2360,utRho23
1346,rsmH,180020,180188,180020,168,64,utRho23
1347,rsmI,6587106,6587106,6586670,436,2722,utRho23
1348,rssA,2578212,2578412,2578212,200,1158,utRho23
1349,rssB,2580440,2580484,2580440,44,420,utRho23
1350,rstA,3364276,3364300,3364276,24,14,utRho23
1351,rsuA,4561096,4561096,4560966,130,56,utRho23
1352,rsxA,3411510,3411534,3411510,24,34,utRho23
1353,rtcA,7114004,7114004,7113698,306,3368,utRho23
1354,rtcB,7116214,7116214,7116158,56,142,utRho23
1355,rtn,4541356,4541452,4541356,96,90,utRho23
1356,rutA,2148052,2148052,2148022,30,324,utRho23
1357,rutG,2140090,2140090,2139678,412,688,utRho23
1358,rutR,2148226,2148484,2148226,258,1474,utRho23
1359,ruvA,7784096,7784096,7783904,192,68,utRho23
1360,ruvB,7782176,7782176,7781424,752,844,utRho23
1361,ruvC,3894878,3894878,3894752,126,102,utRho23
1362,rybB,1776114,1776114,1776114,0,0,utRho23
1363,rydB,3529860,3529860,3529322,538,668,utRho23
1364,rydC,2983012,2983012,2983012,0,0,utRho23
1365,ryfA,5307398,5307710,5307398,312,46,utRho23
1366,ryfD,5468590,5468590,5468590,0,0,utRho23
1367,ryhB,7162032,7162032,7162032,0,0,utRho23
1368,ryjA,8556132,8556132,8556132,0,0,utRho23
1369,ryjB,9055954,9055954,9055954,0,0,utRho23
1370,sad,3229598,3229598,3229406,192,388,utRho23
1371,safA,3168056,3168056,3167918,138,1532,utRho23
1372,sanA,4465368,4465756,4465368,388,314,utRho23
1373,sapF,2705314,2705314,2705268,46,202,utRho23
1374,sbcB,4165456,4165512,4165456,56,54,utRho23
1375,sbcC,831694,831694,831506,188,356,utRho23
1376,sbcD,833954,833954,833904,50,62,utRho23
1377,sbmA,793106,793278,793106,172,4462,utRho23
1378,sbmC,4162650,4162650,4162524,126,80,utRho23
1379,sdaA,3793618,3793864,3793618,246,468,utRho23
1380,sdaC,5856070,5856458,5856070,388,456,utRho23
1381,sdhC,1509916,1510354,1509916,438,23510,utRho23
1382,sdhD,1510808,1511120,1510808,312,9980,utRho23
1383,sdiA,3993834,3993834,3993664,170,124,utRho23
1384,secE,8354354,8354716,8354354,362,118,utRho23
1385,secG,6645180,6645180,6645010,170,292,utRho23
1386,selA,7522594,7522594,7522498,96,866,utRho23
1387,selB,7519850,7519850,7519722,128,490,utRho23
1388,selC,7672396,7672444,7672396,48,32,utRho23
1389,selD,3696058,3696058,3696016,42,3498,utRho23
1390,seqA,1425884,1425974,1425884,90,60,utRho23
1391,serA,6117098,6117098,6116820,278,492,utRho23
1392,serB,9249712,9249790,9249712,78,442,utRho23
1393,serC,3830380,3830612,3830380,232,0,utRho23
1394,serS,1878730,1878856,1878730,126,828,utRho23
1395,serT,2063438,2063438,2063424,14,42,utRho23
1396,serU,4087124,4087124,4087114,10,60,utRho23
1397,serV,5637394,5637394,5637290,104,190,utRho23
1398,serW,1852014,1852014,1851942,72,124,utRho23
1399,serX,2195352,2195352,2195304,48,56,utRho23
1400,setB,4527426,4527726,4527426,300,0,utRho23
1401,setC,7673488,7673906,7673488,418,2954,utRho23
1402,sfmA,1116124,1116424,1116124,300,392,utRho23
1403,sfmC,1117606,1117948,1117606,342,350,utRho23
1404,sfsA,323030,323030,322972,58,480,utRho23
1405,sfsB,6669592,6669818,6669592,226,688,utRho23
1406,sgrR,154676,154676,154598,78,278,utRho23
1407,sgrS,154734,154734,154734,0,0,utRho23
1408,shiA,4107068,4107286,4107068,218,522,utRho23
1409,sibA,4306622,4306622,4306622,0,0,utRho23
1410,sibB,4307292,4307292,4307292,0,0,utRho23
1411,sibC,6113702,6113702,6113702,0,0,utRho23
1412,sibD,6389730,6389730,6389730,0,0,utRho23
1413,sibE,6390480,6390480,6390480,0,0,utRho23
1414,sixA,4913998,4913998,4913624,374,54,utRho23
1415,slp,7307872,7307922,7307872,50,34,utRho23
1416,slt,9261400,9261466,9261400,66,136,utRho23
1417,slyA,3442028,3442028,3441648,380,246,utRho23
1418,slyB,3439496,3439752,3439496,256,54,utRho23
1419,slyD,6957398,6957398,6956994,404,872,utRho23
1420,slyX,6954862,6955280,6954862,418,1840,utRho23
1421,smf,6867372,6867372,6867120,252,672,utRho23
1422,smpB,5509534,5509792,5509534,258,1004,utRho23
1423,smrA,2811872,2811958,2811872,86,842,utRho23
1424,smrB,4896872,4897212,4896872,340,2188,utRho23
1425,smtA,1946808,1947074,1946808,266,244,utRho23
1426,sodA,8201518,8201620,8201518,102,1574,utRho23
1427,sodB,3470646,3470756,3470646,110,378,utRho23
1428,sodC,3449358,3449358,3449310,48,198,utRho23
1429,sohB,2658568,2658664,2658568,96,1170,utRho23
1430,sokB,2984232,2984238,2984232,6,108,utRho23
1431,solA,2241218,2241218,2241172,46,16,utRho23
1432,soxR,8554894,8554938,8554894,44,42,utRho23
1433,soxS,8554846,8554846,8554766,80,66,utRho23
1434,speA,6172096,6172096,6171822,274,180,utRho23
1435,speB,6167892,6167892,6167594,298,30,utRho23
1436,speC,6218350,6218350,6218310,40,6,utRho23
1437,spf,8099798,8099798,8099798,0,0,utRho23
1438,sppA,3697422,3697674,3697422,252,3512,utRho23
1439,spy,3651376,3651376,3651250,126,112,utRho23
1440,sra,3112092,3112092,3111926,166,52,utRho23
1441,sraB,2293178,2293178,2293178,0,0,utRho23
1442,sraC,3846132,3846132,3846132,0,0,utRho23
1443,srlA,5651582,5651664,5651582,82,66,utRho23
1444,srlR,5657720,5658094,5657720,374,12520,utRho23
1445,srmB,5425752,5425792,5425752,40,424,utRho23
1446,sroA,151216,151216,151216,0,0,utRho23
1447,sroG,6369436,6369436,6369436,0,0,utRho23
1448,sroH,8380974,8380974,8380974,0,0,utRho23
1449,ssb,8548022,8548250,8548022,228,290,utRho23
1450,sseA,5304782,5304988,5304782,206,3868,utRho23
1451,sspA,6755138,6755138,6754840,298,16,utRho23
1452,ssrA,5511014,5511186,5511014,172,154,utRho23
1453,ssrS,12223036,12223932,12223036,896,1196,utRho23
1454,sstT,6479726,6479888,6479726,162,230,utRho23
1455,ssuB,1988282,1988282,1988088,194,538,utRho23
1456,ssuE,1995126,1995126,1995024,102,62,utRho23
1457,sthA,8321604,8321604,8321580,24,2818,utRho23
1458,stpA,5597156,5597156,5596990,166,78,utRho23
1459,sucA,3034344,3034824,3034344,480,2200,utRho23
1460,sufA,3528836,3528836,3528772,64,12,utRho23
1461,sufE,3518962,3518962,3518580,382,240,utRho23
1462,sugE,8753588,8753750,8753588,162,1392,utRho23
1463,sulA,2041894,2041894,2041838,56,2950,utRho23
1464,syd,5850738,5850738,5850560,178,142,utRho23
1465,symE,9159834,9159834,9159680,154,988,utRho23
1466,symR,9159670,9159670,9159670,0,0,utRho23
1467,tabA,8949566,8949724,8949566,158,50,utRho23
1468,talA,5157140,5157332,5157140,192,278,utRho23
1469,talB,16382,16476,16382,94,7176,utRho23
1470,tam,3214442,3214692,3214442,250,760,utRho23
1471,tamA,8884540,8884764,8884540,224,1752,utRho23
1472,tar,3945432,3945432,3945382,50,4,utRho23
1473,tas,5943138,5943194,5943138,56,3864,utRho23
1474,tatA,16087636,16087780,16087636,144,308,utRho23
1475,tatE,1317742,1317894,1317742,152,184,utRho23
1476,tauA,770410,770464,770410,54,276,utRho23
1477,tdcA,6534186,6534186,6534130,56,10,utRho23
1478,tdcG,6519652,6519652,6519298,354,1798,utRho23
1479,tdcR,6534380,6534760,6534380,380,208,utRho23
1480,tdk,2586986,2587054,2586986,68,154,utRho23
1481,tehA,3001072,3001146,3001072,74,2,utRho23
1482,tesA,1039898,1039898,1039530,368,1164,utRho23
1483,tesB,950402,950402,950322,80,154,utRho23
1484,tfaE,2418532,2418532,2418238,294,1952,utRho23
1485,tfaQ,3269912,3269912,3269770,142,650,utRho23
1486,tff,379424,379256,379424,168,62,utRho23
1487,tgt,852110,852274,852110,164,158,utRho23
1488,thiD,4369346,4369346,4369032,314,244,utRho23
1489,thiI,882936,883098,882936,162,136,utRho23
1490,thiM,4370902,4370902,4370602,300,1006,utRho23
1491,thiQ,146170,146170,145854,316,9104,utRho23
1492,thrL,592,760,592,168,396,utRho23
1493,thrS,7210932,7210932,7210280,652,260,utRho23
1494,thrU,8350762,8350776,8350762,14,0,utRho23
1495,thrV,6847414,6847414,6847310,104,132392,utRho23
1496,thrW,525682,525742,525682,60,7574,utRho23
1497,thyA,5930696,5930696,5930310,386,2684,utRho23
1498,tig,909986,910266,909986,280,200,utRho23
1499,tisB,7706674,7707106,7706674,432,454,utRho23
1500,tktA,6163414,6163414,6163270,144,146,utRho23
1501,tktB,5158616,5159272,5158616,656,7138,utRho23
1502,tldD,6784368,6784368,6784056,312,0,utRho23
1503,tmcA,5191876,5191876,5191718,158,1660,utRho23
1504,tnaC,15553644,15553740,15553644,96,5160,utRho23
1505,tolB,1555074,1555480,1555074,406,600,utRho23
1506,tolC,6356008,6356230,6356008,222,212,utRho23
1507,tomB,961588,961588,961416,172,1350,utRho23
1508,tonB,2622108,2622178,2622108,70,60,utRho23
1509,topA,2661578,2662096,2661578,518,118,utRho23
1510,torC,2116112,2116168,2116112,56,726,utRho23
1511,torR,2115968,2115968,2115908,60,738,utRho23
1512,torS,2112364,2112364,2112356,8,88,utRho23
1513,torT,2112414,2112522,2112414,108,40,utRho23
1514,tpiA,8223138,8223138,8223014,124,106,utRho23
1515,tppB,3425342,3425538,3425342,196,2260,utRho23
1516,tpr,2574376,2574376,2574376,0,0,utRho23
1517,tpx,2777688,2777688,2777622,66,720,utRho23
1518,tqsA,3347780,3347826,3347780,46,98,utRho23
1519,treA,2494850,2494850,2494752,98,636,utRho23
1520,treB,8932420,8932420,8932360,60,134,utRho23
1521,treF,7339102,7339184,7339102,82,334,utRho23
1522,treR,8934694,8934694,8934492,202,48,utRho23
1523,trg,2984878,2984940,2984878,62,172,utRho23
1524,trkG,2847342,2847564,2847342,222,1348,utRho23
1525,trmA,8326590,8326590,8326540,50,230,utRho23
1526,trpA,2634678,2634678,2634444,234,338,utRho23
1527,trpC,2639888,2639888,2639570,318,28,utRho23
1528,trpL,5292432,5292432,5292328,104,12,utRho23
1529,trpR,9265408,9265520,9265408,112,432,utRho23
1530,trpS,7027394,7027394,7027276,118,1924,utRho23
1531,trpT,7893560,7893914,7893560,354,59294,utRho23
1532,trxA,7931294,7931522,7931294,228,506,utRho23
1533,trxB,1864156,1864156,1864100,56,136,utRho23
1534,trxC,5437350,5437470,5437350,120,764,utRho23
1535,tsaD,6421256,6421256,6421086,170,530,utRho23
1536,tsgA,6985038,6985136,6985038,98,466,utRho23
1537,tsr,9182824,9183314,9182824,490,5402,utRho23
1538,tsx,864490,864490,864026,464,1456,utRho23
1539,ttcA,2823970,2823970,2823896,74,3138,utRho23
1540,ttdA,6412848,6412926,6412848,78,246,utRho23
1541,ttdR,6412760,6412760,6412512,248,114,utRho23
1542,tufA,6943448,6943448,6942658,790,32780,utRho23
1543,tus,3368346,3368518,3368346,172,128,utRho23
1544,tusA,7218040,7218040,7217992,48,322,utRho23
1545,tusB,6950218,6950218,6949930,288,878,utRho23
1546,tynA,2902996,2902996,2902698,298,18,utRho23
1547,typA,8116460,8116814,8116460,354,2972,utRho23
1548,tyrB,8534164,8534228,8534164,64,1522,utRho23
1549,tyrP,3979004,3979362,3979004,358,640,utRho23
1550,tyrR,2773384,2773440,2773384,56,64,utRho23
1551,tyrS,3434566,3434566,3434444,122,60,utRho23
1552,tyrT,2575330,2575330,2575244,86,42,utRho23
1553,uacT,6062378,6062734,6062378,356,3824,utRho23
1554,ubiC,8504886,8505012,8504886,126,158,utRho23
1555,ubiD,8049618,8049976,8049618,358,1900,utRho23
1556,ubiE,8037494,8037710,8037494,216,434,utRho23
1557,ubiG,4679078,4679134,4679078,56,72,utRho23
1558,ucpA,5089342,5089342,5089246,96,30,utRho23
1559,udp,8032782,8032862,8032782,80,384,utRho23
1560,ugd,4199470,4199470,4199226,244,42,utRho23
1561,ugpB,7184852,7184852,7184650,202,4266,utRho23
1562,ugpQ,7176600,7176600,7176226,374,340,utRho23
1563,uhpT,7694396,7694396,7694334,62,94,utRho23
1564,uidA,3392304,3392304,3392142,162,148,utRho23
1565,uidC,3386012,3386012,3385702,310,84,utRho23
1566,uidR,3394150,3394150,3394104,46,164,utRho23
1567,ulaA,8839854,8839960,8839854,106,434,utRho23
1568,ulaG,8839350,8839350,8839250,100,310,utRho23
1569,ulaR,8837124,8837124,8836906,218,150,utRho23
1570,umpG,5741372,5741372,5740548,824,64,utRho23
1571,umpH,1400704,1400704,1400652,52,118,utRho23
1572,umuD,2461476,2461534,2461476,58,52,utRho23
1573,ung,5433476,5433508,5433476,32,412,utRho23
1574,uof,2843316,2843316,2842900,416,2144,utRho23
1575,upp,5241818,5241818,5241744,74,48,utRho23
1576,usg,4873780,4873780,4873298,482,372,utRho23
1577,ushA,1009772,1009828,1009772,56,272,utRho23
1578,uspA,7279966,7280222,7279966,256,802,utRho23
1579,uspB,7279696,7279696,7279440,256,568,utRho23
1580,uspC,3959172,3959506,3959172,334,158,utRho23
1581,uspE,2797318,2797318,2797244,74,152,utRho23
1582,uspF,2871282,2871282,2871238,44,230,utRho23
1583,uspG,1283806,1283806,1283734,72,3024,utRho23
1584,uvrA,8547872,8547872,8547742,130,570,utRho23
1585,uvrB,1626304,1627052,1626304,748,1148,utRho23
1586,uvrC,3989758,3989758,3989412,346,218,utRho23
1587,uvrD,7995814,7995966,7995814,152,882,utRho23
1588,uvrY,3990812,3990812,3990718,94,362,utRho23
1589,uxaB,3221474,3221474,3221360,114,12,utRho23
1590,uxaC,6489714,6489714,6489482,232,222,utRho23
1591,uxuA,9103036,9103272,9103036,236,3892,utRho23
1592,uxuR,9108916,9109152,9108916,236,412,utRho23
1593,valS,8967854,8967854,8967674,180,310,utRho23
1594,valU,5041848,5041862,5041848,14,76,utRho23
1595,valV,3492830,3492870,3492830,40,502,utRho23
1596,ves,3649968,3649968,3649874,94,250,utRho23
1597,waaA,7616512,7617080,7616512,568,1852,utRho23
1598,waaH,7580298,7580298,7580162,136,252,utRho23
1599,waaQ,7616476,7616476,7616196,280,1146,utRho23
1600,waaU,7598996,7598996,7598624,372,130,utRho23
1601,waaY,7602272,7602272,7601930,342,10076,utRho23
1602,wbbH,4214888,4214888,4214452,436,2500,utRho23
1603,wbbK,4209212,4209212,4209018,194,136,utRho23
1604,wcaM,4231868,4231868,4231792,76,50,utRho23
1605,wrbA,2135516,2135516,2135416,100,136,utRho23
1606,wza,4275166,4275166,4274486,680,478,utRho23
1607,wzxC,4240674,4240674,4240316,358,38,utRho23
1608,wzzB,4196950,4196950,4196602,348,186,utRho23
1609,xanP,7657642,7657890,7657642,248,340,utRho23
1610,xanQ,6048520,6048702,6048520,182,176,utRho23
1611,xapA,5049820,5049820,5049756,64,10,utRho23
1612,xapR,10090252,10090252,10089908,344,180,utRho23
1613,xdhA,6000514,6000690,6000514,176,4078,utRho23
1614,xerD,6079702,6079702,6079486,216,608,utRho23
1615,xseA,5268394,5268464,5268394,70,718,utRho23
1616,xseB,882746,882746,882686,60,142,utRho23
1617,xthA,3664798,3664856,3664798,58,0,utRho23
1618,xylA,7461614,7461614,7461530,84,16308,utRho23
1619,xylE,8484540,8484540,8484508,32,0,utRho23
1620,xylF,7462138,7462262,7462138,124,1504,utRho23
1621,xylR,7469812,7469958,7469812,146,156,utRho23
1622,yaaA,13230,13230,12918,312,108,utRho23
1623,yaaI,23876,23876,23572,304,2504,utRho23
1624,yaaJ,16034,16034,15918,116,336,utRho23
1625,yaaU,91184,91614,91184,430,1702,utRho23
1626,yaaW,23084,23084,22712,372,872,utRho23
1627,yaaX,10060,10468,10060,408,324,utRho23
1628,yabI,142542,142702,142542,160,420,utRho23
1629,yacC,273880,273880,273834,46,1588,utRho23
1630,yacH,262932,262932,262520,412,272,utRho23
1631,yacL,268678,268776,268678,98,698,utRho23
1632,yadD,293796,293936,293796,140,298,utRho23
1633,yadE,289930,290162,289930,232,318,utRho23
1634,yadN,314110,314110,313766,344,296,utRho23
1635,yadS,355572,355572,355248,324,9508,utRho23
1636,yadV,312470,312470,312402,68,388,utRho23
1637,yaeF,434270,434270,434006,264,136,utRho23
1638,yaeP,428374,428374,428250,124,1064,utRho23
1639,yaeQ,428176,428582,428176,406,1720,utRho23
1640,yaeR,423716,423754,423716,38,40,utRho23
1641,yafC,462166,462166,461762,404,234,utRho23
1642,yafD,462128,462244,462128,116,136,utRho23
1643,yafK,491986,491986,491610,376,2400,utRho23
1644,yafL,493282,493424,493282,142,246,utRho23
1645,yafN,503938,504010,503938,72,104,utRho23
1646,yafS,469568,469632,469568,64,638,utRho23
1647,yafT,474470,474670,474470,200,260,utRho23
1648,yafV,480432,480432,480378,54,46,utRho23
1649,yafZ,536052,536052,536010,42,340,utRho23
1650,yagE,564446,564556,564446,110,2964,utRho23
1651,yagG,570414,570790,570414,376,4036,utRho23
1652,yagI,578384,578384,578324,60,570,utRho23
1653,yagK,586236,586236,585896,340,22126,utRho23
1654,yagL,588062,588062,587836,226,4100,utRho23
1655,yagN,591342,591342,591158,184,1720,utRho23
1656,yahA,663746,664742,663746,996,8490,utRho23
1657,yahC,670136,670136,670044,92,5812,utRho23
1658,yahE,671478,671850,671478,372,506,utRho23
1659,yahM,690504,690808,690504,304,248,utRho23
1660,yahN,692872,692872,692674,198,3430,utRho23
1661,yahO,692864,692968,692864,104,436,utRho23
1662,yaiE,816296,816354,816296,58,260,utRho23
1663,yaiI,811396,811528,811396,132,58,utRho23
1664,yaiO,761946,761946,761684,262,706,utRho23
1665,yaiP,767970,767970,767870,100,206,utRho23
1666,yaiS,769660,769660,769232,428,1078,utRho23
1667,yaiV,788922,788922,788922,0,0,utRho23
1668,yaiY,799094,799094,798666,428,746,utRho23
1669,yaiZ,798888,799186,798888,298,680,utRho23
1670,yajC,854410,854574,854410,164,534,utRho23
1671,yajD,860938,861210,860938,272,598,utRho23
1672,yajI,866068,866068,865702,366,446,utRho23
1673,yajL,887496,887496,887282,214,450,utRho23
1674,yajQ,889316,889366,889316,50,202,utRho23
1675,yajR,893374,893374,893332,42,88,utRho23
1676,ybaB,987418,988152,987418,734,1142,utRho23
1677,ybaL,1006590,1006590,1006476,114,574,utRho23
1678,ybaM,980648,980648,980542,106,3748,utRho23
1679,ybaN,981436,981764,981436,328,1374,utRho23
1680,ybaO,936704,936766,936704,62,50,utRho23
1681,ybaP,1016568,1016568,1016160,408,1548,utRho23
1682,ybaQ,1016348,1016436,1016348,88,310,utRho23
1683,ybaS,1023146,1023282,1023146,136,1438,utRho23
1684,ybaV,927504,927874,927504,370,148,utRho23
1685,ybaY,950490,950758,950490,268,1248,utRho23
1686,ybbB,1062724,1062724,1062452,272,204,utRho23
1687,ybbJ,1030154,1030154,1029718,436,3220,utRho23
1688,ybbL,1031784,1031838,1031784,54,224,utRho23
1689,ybbN,1037136,1037136,1036558,578,2010,utRho23
1690,ybbO,1038658,1038658,1038298,360,716,utRho23
1691,ybbY,1080718,1081130,1080718,412,2868,utRho23
1692,ybcH,1176140,1176140,1175962,178,942,utRho23
1693,ybcI,1113264,1113264,1113106,158,2236,utRho23
1694,ybcJ,1114050,1114050,1113746,304,266,utRho23
1695,ybcK,1137502,1137804,1137502,302,342,utRho23
1696,ybcL,1141690,1141786,1141690,96,8,utRho23
1697,ybcN,1144628,1144932,1144628,304,212,utRho23
1698,ybcQ,1147548,1147912,1147548,364,5864,utRho23
1699,ybcW,1159610,1159760,1159610,150,280,utRho23
1700,ybdD,1263982,1264364,1263982,382,2182,utRho23
1701,ybdF,1212106,1212106,1211772,334,348,utRho23
1702,ybdH,1267048,1267048,1266954,94,106,utRho23
1703,ybdJ,1212822,1212822,1212398,424,434,utRho23
1704,ybdK,1215122,1215122,1214766,356,4174,utRho23
1705,ybdL,1267114,1267172,1267114,58,298,utRho23
1706,ybdM,1271110,1271110,1270752,358,5186,utRho23
1707,ybdN,1273372,1273372,1273138,234,192,utRho23
1708,ybdR,1283844,1284176,1283844,332,3620,utRho23
1709,ybeD,1325412,1325412,1325284,128,146,utRho23
1710,ybeF,1323090,1323090,1322756,334,1980,utRho23
1711,ybeL,1349986,1350036,1349986,50,1606,utRho23
1712,ybeQ,1353412,1353412,1353094,318,258,utRho23
1713,ybeR,1353120,1353422,1353120,302,258,utRho23
1714,ybeT,1358832,1358832,1358812,20,48,utRho23
1715,ybeU,1358924,1359016,1358924,92,42,utRho23
1716,ybeZ,1386938,1386938,1386834,104,2114,utRho23
1717,ybfA,1458074,1458268,1458074,194,644,utRho23
1718,ybfE,1423878,1423878,1423796,82,312,utRho23
1719,ybfF,1425692,1425692,1425604,88,154,utRho23
1720,ybfH,1433282,1433282,1433194,88,82,utRho23
1721,ybgA,1477840,1478002,1477840,162,698,utRho23
1722,ybgC,1549288,1549504,1549288,216,112,utRho23
1723,ybgD,1505916,1505916,1505590,326,16824,utRho23
1724,ybgI,1485238,1485654,1485238,416,112,utRho23
1725,ybgO,1498370,1498370,1497964,406,486,utRho23
1726,ybgS,1570992,1570992,1570634,358,146,utRho23
1727,ybhA,1597184,1597184,1596862,322,130,utRho23
1728,ybhB,1616070,1616070,1615818,252,628,utRho23
1729,ybhC,1614642,1614642,1614562,80,838,utRho23
1730,ybhD,1601418,1601418,1601276,142,138,utRho23
1731,ybhH,1601104,1601518,1601104,414,214,utRho23
1732,ybhK,1633384,1633384,1633294,90,472,utRho23
1733,ybhM,1641556,1641586,1641556,30,74,utRho23
1734,ybhN,1645296,1645296,1644996,300,638,utRho23
1735,ybhQ,1649202,1649260,1649202,58,2296,utRho23
1736,ybiA,1665920,1665920,1665900,20,26,utRho23
1737,ybiI,1676968,1676968,1676912,56,942,utRho23
1738,ybiO,1691328,1691328,1690960,368,1050,utRho23
1739,ybiP,1705252,1705252,1705194,58,298,utRho23
1740,ybiS,1711572,1711572,1711488,84,2,utRho23
1741,ybiT,1711894,1711926,1711894,32,0,utRho23
1742,ybiU,1718212,1718212,1718122,90,238,utRho23
1743,ybiV,1720176,1720176,1720056,120,0,utRho23
1744,ybiW,1725566,1725566,1725212,354,10288,utRho23
1745,ybiX,1678548,1678548,1678414,134,176,utRho23
1746,ybjC,1781784,1781826,1781784,42,0,utRho23
1747,ybjE,1830154,1830154,1829714,440,806,utRho23
1748,ybjG,1767016,1767016,1766776,240,1042,utRho23
1749,ybjL,1779882,1779882,1779638,244,146,utRho23
1750,ybjM,1779770,1780178,1779770,408,770,utRho23
1751,ybjO,1795704,1795978,1795704,274,42,utRho23
1752,ybjP,1809046,1809046,1808934,112,96,utRho23
1753,ybjQ,1809034,1809186,1809034,152,154,utRho23
1754,ybjS,1813796,1813796,1813506,290,398,utRho23
1755,ybjX,1838206,1838206,1838168,38,58,utRho23
1756,ycaD,1891438,1891742,1891438,304,136,utRho23
1757,ycaI,1928210,1928640,1928210,430,100,utRho23
1758,ycaK,1899094,1899336,1899094,242,470,utRho23
1759,ycaL,1920264,1920528,1920264,264,0,utRho23
1760,ycaM,1894240,1894458,1894240,218,254,utRho23
1761,ycaR,1941284,1941346,1941284,62,2236,utRho23
1762,ycbB,1961862,1962094,1961862,232,916,utRho23
1763,ycbJ,1943344,1943504,1943344,160,150,utRho23
1764,ycbK,1966046,1966150,1966046,104,116,utRho23
1765,ycbZ,2036920,2036920,2036598,322,110,utRho23
1766,yccA,2062886,2062886,2062836,50,50,utRho23
1767,yccF,2048730,2048730,2048696,34,74,utRho23
1768,yccS,2047988,2047988,2047766,222,622,utRho23
1769,yccT,2055674,2055674,2055546,128,174,utRho23
1770,yccX,2059960,2060128,2059960,168,766,utRho23
1771,ycdT,2185682,2185752,2185682,70,64,utRho23
1772,ycdU,2191266,2191686,2191266,420,846,utRho23
1773,ycdZ,2200504,2200592,2200504,88,290,utRho23
1774,yceA,2233544,2233614,2233544,70,20,utRho23
1775,yceD,2293298,2293588,2293298,290,390,utRho23
1776,yceF,2293522,2293522,2293190,332,244,utRho23
1777,yceH,2252154,2252314,2252154,160,832,utRho23
1778,yceI,2237282,2237282,2236952,330,804,utRho23
1779,yceJ,2238142,2238142,2238092,50,534,utRho23
1780,yceM,2253208,2253612,2253208,404,474,utRho23
1781,yceO,2239264,2239264,2238894,370,514,utRho23
1782,yceQ,2288760,2289004,2288760,244,4240,utRho23
1783,ycfD,2376540,2376540,2376480,60,268,utRho23
1784,ycfJ,2334814,2335198,2334814,384,302,utRho23
1785,ycfS,2340834,2340834,2340748,86,84,utRho23
1786,ycfT,2350658,2350658,2350330,328,226,utRho23
1787,ycfZ,2362760,2362760,2362534,226,2018,utRho23
1788,ycgB,2474570,2474570,2474482,88,40,utRho23
1789,ycgG,2434614,2434656,2434614,42,1908,utRho23
1790,ycgJ,2452956,2453200,2452956,244,298,utRho23
1791,ycgL,2455218,2455362,2455218,144,72,utRho23
1792,ycgN,2457366,2457660,2457366,294,186,utRho23
1793,ycgR,2489112,2489112,2489054,58,66,utRho23
1794,ycgV,2512222,2512222,2511904,318,1420,utRho23
1795,ycgX,2426568,2426568,2426214,354,13752,utRho23
1796,ycgY,2490166,2490320,2490166,154,956,utRho23
1797,ycgZ,2431504,2431578,2431504,74,272,utRho23
1798,ychE,2596904,2597196,2596904,292,0,utRho23
1799,ychF,2515764,2515764,2515624,140,2,utRho23
1800,ychH,2517476,2517582,2517476,106,638,utRho23
1801,ychJ,2578354,2578354,2578264,90,434,utRho23
1802,ychN,2547310,2547310,2547198,112,174,utRho23
1803,ychO,2547520,2547850,2547520,330,952,utRho23
1804,ychQ,2533798,2533848,2533798,50,2,utRho23
1805,yciA,2624828,2624828,2624492,336,318,utRho23
1806,yciB,2626110,2626110,2625780,330,716,utRho23
1807,yciC,2627396,2627396,2627326,70,28,utRho23
1808,yciE,2630794,2630794,2630448,346,848,utRho23
1809,yciG,5264368,5264368,5264140,228,296,utRho23
1810,yciI,2621784,2621784,2621730,54,64,utRho23
1811,yciN,2661606,2661606,2661336,270,30,utRho23
1812,yciS,2680270,2680486,2680270,216,86,utRho23
1813,yciT,2689088,2689088,2688692,396,1850,utRho23
1814,yciU,2614718,2614718,2614300,418,1322,utRho23
1815,yciV,2646376,2646440,2646376,64,6,utRho23
1816,yciW,2700472,2700472,2700214,258,4428,utRho23
1817,yciZ,2689276,2689276,2689218,58,1944,utRho23
1818,ycjD,2703792,2703792,2703520,272,62,utRho23
1819,ycjG,2777748,2777860,2777748,112,260,utRho23
1820,ycjM,2740006,2740432,2740006,426,298,utRho23
1821,ycjW,2767982,2767982,2767922,60,0,utRho23
1822,ycjX,2768138,2768234,2768138,96,114,utRho23
1823,ycjY,5568288,5568288,5567460,828,2096,utRho23
1824,ydaE,2836438,2836438,2836016,422,346,utRho23
1825,ydaN,2816048,2816100,2816048,52,484,utRho23
1826,ydaS,2840340,2840730,2840340,390,480,utRho23
1827,ydbC,2948376,2948442,2948376,66,28,utRho23
1828,ydbD,2950132,2950288,2950132,156,126,utRho23
1829,ydbH,2885800,2886102,2885800,302,368,utRho23
1830,ydbJ,2881712,2882116,2881712,404,2028,utRho23
1831,ydbK,2881692,2881692,2881568,124,536,utRho23
1832,ydcA,2983294,2983354,2983294,60,140,utRho23
1833,ydcF,2974404,2974470,2974404,66,48,utRho23
1834,ydcI,2990268,2990268,2990142,126,12,utRho23
1835,ydcJ,2990266,2990576,2990266,310,34,utRho23
1836,ydcK,3001280,3001280,3000898,382,384,utRho23
1837,ydcL,3004646,3004914,3004646,268,100,utRho23
1838,ydcN,3012308,3012344,3012308,36,2758,utRho23
1839,ydcP,3013508,3013562,3013508,54,222,utRho23
1840,ydcR,3019956,3020006,3019956,50,42,utRho23
1841,ydcS,3022906,3023308,3022906,402,726,utRho23
1842,ydcX,3034442,3034778,3034442,336,1530,utRho23
1843,ydcY,3035220,3035296,3035220,76,156,utRho23
1844,ydcZ,3036750,3036750,3036662,88,6820,utRho23
1845,yddB,3155332,3155332,3155238,94,230,utRho23
1846,yddE,3071738,3071738,3071716,22,2,utRho23
1847,yddG,3094410,3094410,3094338,72,116,utRho23
1848,yddJ,3089732,3089732,3089438,294,2510,utRho23
1849,yddW,3137704,3137704,3137646,58,0,utRho23
1850,ydeA,3233910,3234056,3233910,146,2800,utRho23
1851,ydeE,3242528,3242664,3242528,136,818,utRho23
1852,ydeI,3249118,3249118,3248994,124,60,utRho23
1853,ydeJ,3249376,3249546,3249376,170,88,utRho23
1854,ydeN,3165458,3165458,3165048,410,170,utRho23
1855,ydeP,3173328,3173328,3172972,356,452,utRho23
1856,ydeR,3176596,3176596,3176592,4,436,utRho23
1857,ydfA,3296872,3297016,3296872,144,26,utRho23
1858,ydfG,3254982,3255034,3254982,52,100,utRho23
1859,ydfH,3256652,3256704,3256652,52,52,utRho23
1860,ydfK,3265446,3266144,3265446,698,9462,utRho23
1861,ydgA,3379588,3379704,3379588,116,0,utRho23
1862,ydgC,3364124,3364124,3364060,64,14,utRho23
1863,ydgD,3343906,3343920,3343906,14,370,utRho23
1864,ydgH,3356754,3356854,3356754,100,0,utRho23
1865,ydgJ,3408798,3408798,3408616,182,824,utRho23
1866,ydgK,3410414,3410500,3410414,86,1170,utRho23
1867,ydhB,3479618,3479618,3479596,22,0,utRho23
1868,ydhC,3479698,3479822,3479698,124,88,utRho23
1869,ydhF,3451310,3451310,3451264,46,66,utRho23
1870,ydhI,3441996,3442050,3441996,54,0,utRho23
1871,ydhL,3451864,3451864,3451840,24,786,utRho23
1872,ydhQ,3492404,3492404,3492254,150,668,utRho23
1873,ydhS,3494136,3494262,3494136,126,1294,utRho23
1874,ydhT,3499138,3499138,3499118,20,370,utRho23
1875,ydhY,3509284,3509284,3508954,330,1282,utRho23
1876,ydhZ,3510418,3510418,3510282,136,2074,utRho23
1877,ydiE,3579206,3579226,3579206,20,0,utRho23
1878,ydiH,3530582,3530582,3530406,176,172,utRho23
1879,ydiM,3541852,3542142,3541852,290,114,utRho23
1880,ydiN,3544818,3545024,3544818,206,34,utRho23
1881,ydiP,3558656,3558656,3558602,54,594,utRho23
1882,ydiU,3582508,3582508,3582488,20,1262,utRho23
1883,ydiV,3584174,3584174,3584040,134,266,utRho23
1884,ydiY,3612500,3612500,3612166,334,238,utRho23
1885,ydjA,3697400,3697400,3697352,48,946,utRho23
1886,ydjE,3708082,3708082,3707958,124,22,utRho23
1887,ydjF,3709848,3709848,3709708,140,218,utRho23
1888,ydjM,3620340,3620422,3620340,82,0,utRho23
1889,ydjO,3626696,3626696,3626288,408,216,utRho23
1890,ydjX,3666434,3666802,3666434,368,2440,utRho23
1891,yeaE,3731448,3731448,3731272,176,268,utRho23
1892,yeaG,3733530,3733816,3733530,286,122,utRho23
1893,yeaI,3740486,3740770,3740486,284,318,utRho23
1894,yeaJ,3743874,3744082,3743874,208,326,utRho23
1895,yeaL,3748646,3748704,3748646,58,1152,utRho23
1896,yeaM,3751296,3751296,3751152,144,34,utRho23
1897,yeaN,3750926,3751346,3750926,420,312,utRho23
1898,yeaO,3753554,3753818,3753554,264,340,utRho23
1899,yeaP,3755314,3755430,3755314,116,620,utRho23
1900,yeaQ,3758780,3758780,3758510,270,520,utRho23
1901,yeaR,3759988,3759988,3759896,92,182,utRho23
1902,yeaY,3781122,3781122,3781064,58,0,utRho23
1903,yebB,3892220,3892502,3892220,282,484,utRho23
1904,yebC,3896370,3896370,3896302,68,120,utRho23
1905,yebE,3859464,3859464,3859414,50,2186,utRho23
1906,yebG,3861530,3861530,3861494,36,198,utRho23
1907,yebK,3873180,3873304,3873180,124,0,utRho23
1908,yebQ,3820314,3820552,3820314,238,144,utRho23
1909,yebS,3832238,3832516,3832238,278,42,utRho23
1910,yebV,3843430,3843560,3843430,130,0,utRho23
1911,yebW,3843914,3844242,3843914,328,2080,utRho23
1912,yecC,3995646,3995646,3995628,18,10,utRho23
1913,yecD,3901272,3901664,3901272,392,64,utRho23
1914,yecF,3991434,3991636,3991434,202,586,utRho23
1915,yecH,3979304,3979304,3978980,324,1102,utRho23
1916,yecJ,3975604,3975604,3975516,88,0,utRho23
1917,yecM,3919968,3919968,3919692,276,2308,utRho23
1918,yecR,3976400,3976444,3976400,44,170,utRho23
1919,yecT,3923862,3923944,3923862,82,40,utRho23
1920,yedD,4016522,4016522,4016180,342,842,utRho23
1921,yedE,4016310,4016554,4016310,244,798,utRho23
1922,yedI,4058922,4058922,4058732,190,730,utRho23
1923,yedJ,4066446,4066446,4066158,288,566,utRho23
1924,yedV,4076404,4076404,4076304,100,554,utRho23
1925,yedX,4077680,4077912,4077680,232,126,utRho23
1926,yedY,4078572,4078956,4078572,384,874,utRho23
1927,yeeA,4161322,4161322,4161182,140,46,utRho23
1928,yeeE,4171104,4171104,4171050,54,288,utRho23
1929,yeeJ,4089526,4089822,4089526,296,530,utRho23
1930,yeeN,4113508,4113716,4113508,208,78,utRho23
1931,yeeO,4119444,4119444,4119692,248,82,utRho23
1932,yeeX,4158834,4158834,4158722,112,138,utRho23
1933,yeeZ,4178422,4178422,4178256,166,204,utRho23
1934,yefM,4179466,4179466,4179426,40,124,utRho23
1935,yegD,4295288,4295348,4295288,60,44,utRho23
1936,yegH,4275726,4275804,4275726,78,588,utRho23
1937,yegI,4302154,4302154,4301970,184,16,utRho23
1938,yegJ,4302032,4302370,4302032,338,138,utRho23
1939,yegQ,4331182,4331336,4331182,154,1332,utRho23
1940,yegR,4336698,4336698,4336612,86,1056,utRho23
1941,yegS,4337086,4337424,4337086,338,564,utRho23
1942,yegT,4357562,4357642,4357562,80,1432,utRho23
1943,yegX,4367640,4367640,4367302,338,470,utRho23
1944,yehA,4376944,4376944,4376828,116,916,utRho23
1945,yehE,4385818,4385818,4385592,226,20,utRho23
1946,yehK,4407568,4407944,4407568,376,804,utRho23
1947,yehL,4408804,4409192,4408804,388,218,utRho23
1948,yeiB,4486146,4486146,4485934,212,114,utRho23
1949,yeiE,4499422,4499422,4499236,186,104,utRho23
1950,yeiG,4487776,4487820,4487776,44,244,utRho23
1951,yeiH,4499332,4499434,4499332,102,448,utRho23
1952,yeiI,4503306,4503400,4503306,94,258,utRho23
1953,yeiL,4510580,4510710,4510580,130,98,utRho23
1954,yeiP,4530834,4530900,4530834,66,636,utRho23
1955,yeiQ,4532328,4532490,4532328,162,464,utRho23
1956,yeiR,4535484,4535658,4535484,174,454,utRho23
1957,yeiW,4530840,4530840,4530590,250,824,utRho23
1958,yejA,4544624,4544728,4544624,104,130,utRho23
1959,yejG,4556892,4556892,4556474,418,6758,utRho23
1960,yejH,4561244,4561264,4561244,20,142,utRho23
1961,yejK,4568218,4568218,4567894,324,56,utRho23
1962,yejO,4578352,4578352,4577800,552,3318,utRho23
1963,yfaD,4713380,4713808,4713380,428,2150,utRho23
1964,yfaE,4696676,4697028,4696676,352,1108,utRho23
1965,yfaL,4688568,4688568,4688338,230,362,utRho23
1966,yfaP,4656398,4656398,4656286,112,206,utRho23
1967,yfaU,4717892,4717892,4717690,202,0,utRho23
1968,yfaY,4727310,4727310,4727266,44,2190,utRho23
1969,yfaZ,4728744,4728744,4728550,194,1120,utRho23
1970,yfbK,4771810,4771810,4771444,366,1698,utRho23
1971,yfbL,4771500,4771720,4771500,220,1328,utRho23
1972,yfbN,4777174,4777174,4776852,322,1490,utRho23
1973,yfbO,4776916,4777162,4776916,246,1478,utRho23
1974,yfbP,4777990,4778232,4777990,242,19098,utRho23
1975,yfbR,4817662,4817724,4817662,62,112,utRho23
1976,yfcI,4847424,4847424,4847078,346,1524,utRho23
1977,yfcJ,4880482,4880482,4880240,242,636,utRho23
1978,yfcL,4888502,4888502,4888338,164,338,utRho23
1979,yfcV,4911642,4911642,4911292,350,646,utRho23
1980,yfcZ,4921958,4921958,4921868,90,50,utRho23
1981,yfdF,4925604,4926024,4925604,420,11876,utRho23
1982,yfdG,4935474,4935710,4935474,236,142,utRho23
1983,yfdP,4946844,4947040,4946844,196,130,utRho23
1984,yfdX,4988866,4988866,4988804,62,86,utRho23
1985,yfdY,4990672,4990672,4990584,88,640,utRho23
1986,yfeA,5035784,5035784,5035664,120,9644,utRho23
1987,yfeC,5036668,5036934,5036668,266,108,utRho23
1988,yfeH,5053818,5053892,5053818,74,174,utRho23
1989,yfeK,5074630,5074684,5074630,54,40,utRho23
1990,yfeO,5018906,5019260,5018906,354,774,utRho23
1991,yfeR,5054078,5054078,5053712,366,368,utRho23
1992,yfeX,5101356,5101356,5101090,266,54,utRho23
1993,yfeY,5102486,5102486,5102432,54,72,utRho23
1994,yfeZ,5103842,5103842,5103452,390,432,utRho23
1995,yffO,5123804,5124222,5123804,418,848,utRho23
1996,yffQ,5126778,5127154,5126778,376,3382,utRho23
1997,yffS,5128800,5128986,5128800,186,24,utRho23
1998,yfgC,5232052,5232188,5232052,136,518,utRho23
1999,yfgF,5258062,5258062,5257876,186,3252,utRho23
2000,yfgG,5258170,5258580,5258170,410,5516,utRho23
2001,yfgH,5259344,5259584,5259344,240,200,utRho23
2002,yfgM,5278866,5278866,5278566,300,548,utRho23
2003,yfhH,5397414,5397518,5397414,104,286,utRho23
2004,yfhM,5304648,5304648,5304574,74,166,utRho23
2005,yfhR,5328408,5328726,5328408,318,9160,utRho23
2006,yfiC,5425610,5425610,5425528,82,60,utRho23
2007,yfiE,5430688,5430688,5430640,48,1478,utRho23
2008,yfiL,5482630,5482720,5482630,90,40,utRho23
2009,yfiM,5448066,5448358,5448066,292,9990,utRho23
2010,yfiR,5483354,5483750,5483354,396,440,utRho23
2011,yfjH,5517326,5517326,5517200,126,154,utRho23
2012,yfjI,5517710,5517970,5517710,260,1142,utRho23
2013,yfjJ,5521014,5521094,5521014,80,112,utRho23
2014,yfjM,5531970,5531970,5531552,418,14252,utRho23
2015,yfjP,5535080,5535420,5535080,340,1892,utRho23
2016,yfjW,5546570,5546636,5546570,66,42,utRho23
2017,yfjX,5551776,5551838,5551776,62,0,utRho23
2018,ygaC,5601180,5601180,5599988,1192,3082,utRho23
2019,ygaM,5600242,5600292,5600242,50,636,utRho23
2020,ygaU,5593628,5593628,5593572,56,236,utRho23
2021,ygaZ,5619190,5619234,5619190,44,210,utRho23
2022,ygbA,5713656,5713656,5713612,44,322,utRho23
2023,ygbE,5746784,5746784,5746674,110,602,utRho23
2024,ygbI,5722882,5722882,5722528,354,1180,utRho23
2025,ygbK,5724394,5724670,5724394,276,1034,utRho23
2026,ygbL,5727074,5727186,5727074,112,134,utRho23
2027,ygbN,5729814,5730202,5729814,388,1940,utRho23
2028,ygcG,5811210,5811422,5811210,212,210,utRho23
2029,ygcN,5785144,5785314,5785144,170,780,utRho23
2030,ygcU,5799214,5799214,5798836,378,486,utRho23
2031,ygcW,5800942,5800942,5800546,396,128,utRho23
2032,ygdD,5883442,5883442,5883262,180,554,utRho23
2033,ygdG,5861746,5861930,5861746,184,250,utRho23
2034,ygdI,5886526,5886526,5886290,236,170,utRho23
2035,ygdQ,5940784,5940840,5940784,56,84,utRho23
2036,ygdR,5942494,5942542,5942494,48,76,utRho23
2037,ygeA,5961606,5961606,5961270,336,504,utRho23
2038,ygeH,5983758,5984188,5983758,430,2526,utRho23
2039,ygeI,5987162,5987276,5987162,114,14178,utRho23
2040,ygeR,6000078,6000078,5999782,296,768,utRho23
2041,ygeV,6011694,6011694,6011572,122,242,utRho23
2042,ygeW,6012234,6012524,6012234,290,1246,utRho23
2043,ygfB,6110946,6110946,6110888,58,42,utRho23
2044,ygfK,6031984,6032120,6031984,136,230,utRho23
2045,ygfS,6058328,6058328,6058024,304,334,utRho23
2046,ygfZ,6082564,6082626,6082564,62,932,utRho23
2047,yggC,6149512,6149512,6149378,134,144,utRho23
2048,yggE,6136370,6136370,6136160,210,1382,utRho23
2049,yggI,6179176,6179510,6179176,334,662,utRho23
2050,yggL,6204508,6204508,6204266,242,614,utRho23
2051,yggM,6199514,6199514,6199130,384,200,utRho23
2052,yggN,6203596,6203596,6203246,350,1028,utRho23
2053,yggX,18623958,18624558,18623958,600,516,utRho23
2054,yghA,6298966,6299324,6298966,358,342,utRho23
2055,yghB,6307058,6307126,6307058,68,1394,utRho23
2056,yghD,6222614,6222614,6222252,362,452,utRho23
2057,yghF,6225798,6225798,6225840,42,34,utRho23
2058,yghJ,6238640,6238640,6238224,416,140,utRho23
2059,yghQ,6265186,6265186,6264816,370,1104,utRho23
2060,yghT,6267830,6268262,6267830,432,1072,utRho23
2061,yghU,6277400,6277454,6277400,54,394,utRho23
2062,yghW,6293506,6293506,6293474,32,96,utRho23
2063,yghZ,6295562,6295794,6295562,232,338,utRho23
2064,ygiD,6365122,6365122,6364868,254,3362,utRho23
2065,ygiH,6409066,6409388,6409066,322,638,utRho23
2066,ygiL,6370622,6370828,6370622,206,286,utRho23
2067,ygiM,6402084,6402414,6402084,330,262,utRho23
2068,ygiN,6346156,6346284,6346156,128,518,utRho23
2069,ygiQ,6322620,6322620,6322292,328,1614,utRho23
2070,ygiS,6335462,6335462,6335436,26,74,utRho23
2071,ygiV,6338582,6338582,6338462,120,174,utRho23
2072,ygiW,6339774,6339774,6339352,422,3466,utRho23
2073,ygiZ,6344506,6344506,6344422,84,44,utRho23
2074,ygjH,6442528,6442528,6442494,34,142,utRho23
2075,ygjI,6452140,6452468,6452140,328,88,utRho23
2076,ygjQ,6472730,6473080,6472730,350,2072,utRho23
2077,ygjR,6474564,6474586,6474564,22,80,utRho23
2078,ygjV,6483638,6483638,6483488,150,12,utRho23
2079,yhaB,6535632,6535708,6535632,76,0,utRho23
2080,yhaH,6504498,6504608,6504498,110,932,utRho23
2081,yhaI,6505400,6505822,6505400,422,520,utRho23
2082,yhaJ,6508560,6508560,6508428,132,378,utRho23
2083,yhaK,6508538,6508638,6508538,100,402,utRho23
2084,yhbQ,6599878,6599932,6599878,54,710,utRho23
2085,yhbT,6602736,6602736,6602552,184,3084,utRho23
2086,yhbU,6602558,6602970,6602558,412,3882,utRho23
2087,yhbX,6643302,6643302,6643226,76,44,utRho23
2088,yhbY,6655518,6655580,6655518,62,496,utRho23
2089,yhcA,6723956,6724224,6723956,268,2596,utRho23
2090,yhcB,6760364,6760382,6760364,18,36,utRho23
2091,yhcC,6708470,6708470,6708100,370,1434,utRho23
2092,yhcF,6733440,6733852,6733440,412,2708,utRho23
2093,yhcH,6739124,6739124,6738956,168,5332,utRho23
2094,yhcM,6760312,6760312,6759994,318,230,utRho23
2095,yhcN,6770812,6771076,6770812,264,524,utRho23
2096,yhcO,6772606,6772606,6772258,348,48,utRho23
2097,yhdH,6806560,6806968,6806560,408,444,utRho23
2098,yhdJ,6823234,6823306,6823234,72,12,utRho23
2099,yhdN,6879092,6879092,6879018,74,300,utRho23
2100,yhdT,6814702,6814750,6814702,48,60,utRho23
2101,yhdU,6824994,6825242,6824994,248,346,utRho23
2102,yhdV,6836392,6836780,6836392,388,2416,utRho23
2103,yhdW,6837944,6838298,6837944,354,444,utRho23
2104,yheO,6953082,6953082,6952880,202,264,utRho23
2105,yheV,6957970,6957970,6957584,386,264,utRho23
2106,yhfA,6971902,6971902,6971636,266,2552,utRho23
2107,yhfG,6983294,6983294,6983240,54,1506,utRho23
2108,yhfL,6998622,6998896,6998622,274,238,utRho23
2109,yhfY,7023244,7023244,7022844,400,0,utRho23
2110,yhgA,7086294,7086334,7086294,40,0,utRho23
2111,yhgE,7065176,7065176,7064878,298,2254,utRho23
2112,yhgF,7074352,7074770,7074352,418,8684,utRho23
2113,yhhA,7173458,7173886,7173458,428,1308,utRho23
2114,yhhI,7248346,7248756,7248346,410,72,utRho23
2115,yhhJ,7253696,7253696,7253606,90,292,utRho23
2116,yhhM,7211588,7211588,7211220,368,3034,utRho23
2117,yhhN,7211150,7211502,7211150,352,1890,utRho23
2118,yhhQ,7218238,7218434,7218238,196,1160,utRho23
2119,yhhT,7223682,7223730,7223682,48,26,utRho23
2120,yhhX,7162032,7162032,7161610,422,92,utRho23
2121,yhhY,7162222,7162276,7162222,54,36,utRho23
2122,yhhZ,7163516,7163726,7163516,210,992,utRho23
2123,yhiD,7312220,7312220,7311804,416,22108,utRho23
2124,yhiJ,7265190,7265190,7265180,10,118,utRho23
2125,yhiM,7269270,7269682,7269270,412,4938,utRho23
2126,yhiN,7275000,7275000,7274820,180,752,utRho23
2127,yhjA,7338522,7338522,7338376,146,496,utRho23
2128,yhjB,7344090,7344090,7343788,302,1292,utRho23
2129,yhjC,7344272,7344684,7344272,412,388,utRho23
2130,yhjD,7346660,7346724,7346660,64,210,utRho23
2131,yhjE,7349274,7349572,7349274,298,4366,utRho23
2132,yhjG,7356824,7356824,7356730,94,80,utRho23
2133,yhjH,7358458,7358458,7358374,84,312,utRho23
2134,yhjJ,7364032,7364032,7363880,152,436,utRho23
2135,yhjK,7371296,7371296,7371158,138,268,utRho23
2136,yhjR,7392750,7392750,7392370,380,144,utRho23
2137,yhjV,7400796,7401126,7400796,330,1842,utRho23
2138,yhjX,7424194,7424194,7424014,180,184,utRho23
2139,yhjY,7425966,7425966,7425868,98,248,utRho23
2140,yiaB,7455654,7455654,7455496,158,184,utRho23
2141,yiaD,7432712,7433094,7432712,382,944,utRho23
2142,yiaF,7438194,7438194,7438088,106,806,utRho23
2143,yiaG,7438862,7438956,7438862,94,530,utRho23
2144,yiaJ,7485236,7485236,7485064,172,2314,utRho23
2145,yiaK,7485348,7485466,7485348,118,276,utRho23
2146,yiaT,7503924,7503924,7503736,188,14,utRho23
2147,yiaU,7503792,7503984,7503792,192,0,utRho23
2148,yiaY,7515856,7515856,7515654,202,1104,utRho23
2149,yibF,7523950,7523950,7523910,40,28,utRho23
2150,yibG,7536128,7536354,7536128,226,616,utRho23
2151,yibL,7553194,7553330,7553194,136,412,utRho23
2152,yibN,7570112,7570112,7570030,82,122,utRho23
2153,yibT,7552848,7552848,7552760,88,1266,utRho23
2154,yicC,7633290,7633352,7633290,62,200,utRho23
2155,yicH,7660862,7660914,7660862,52,16,utRho23
2156,yicJ,7673328,7673328,7671858,1470,7400,utRho23
2157,yicN,7685018,7685018,7684804,214,2348,utRho23
2158,yicO,7687914,7687914,7687578,336,282,utRho23
2159,yicR,15250308,15250308,15250236,72,0,utRho23
2160,yidB,7755230,7755230,7754930,300,354,utRho23
2161,yidE,7732780,7732780,7732546,234,140,utRho23
2162,yidF,7711580,7711580,7711222,358,408,utRho23
2163,yidQ,7735088,7735456,7735088,368,630,utRho23
2164,yidR,7738824,7738824,7738618,206,0,utRho23
2165,yieE,7787658,7787738,7787658,80,1916,utRho23
2166,yieH,7793314,7793548,7793314,234,606,utRho23
2167,yieK,7798928,7798928,7798786,142,74,utRho23
2168,yifB,7900350,7900350,7899998,352,440,utRho23
2169,yifL,7988984,7989044,7988984,60,12068,utRho23
2170,yigF,8005750,8005750,8005598,152,41218,utRho23
2171,yigI,8009448,8009448,8009394,54,1946,utRho23
2172,yigM,8022100,8022152,8022100,52,230,utRho23
2173,yihA,8101970,8101970,8101458,512,838,utRho23
2174,yihD,8084098,8084138,8084098,40,134,utRho23
2175,yihF,8088110,8088398,8088110,288,278,utRho23
2176,yihG,8093304,8093304,8093204,100,212,utRho23
2177,yihI,8102616,8102694,8102616,78,6,utRho23
2178,yihL,8120506,8120894,8120506,388,1172,utRho23
2179,yihN,8124332,8124494,8124332,162,1990,utRho23
2180,yihO,8131942,8131942,8131532,410,426,utRho23
2181,yihQ,8138892,8138892,8138552,340,38,utRho23
2182,yihV,8147064,8147478,8147064,414,682,utRho23
2183,yihX,8151096,8151106,8151096,10,322,utRho23
2184,yiiE,8158192,8158582,8158192,390,2928,utRho23
2185,yiiF,8159124,8159502,8159124,378,928,utRho23
2186,yiiG,8173762,8174004,8173762,242,2,utRho23
2187,yiiM,8205506,8205644,8205506,138,6836,utRho23
2188,yiiQ,8224624,8224624,8224428,196,92,utRho23
2189,yiiS,8225738,8225934,8225738,196,180,utRho23
2190,yijE,8272178,8272216,8272178,38,60,utRho23
2191,yijF,8275728,8275728,8275314,414,3818,utRho23
2192,yijO,8296858,8296858,8296634,224,234,utRho23
2193,yjaA,8426240,8426468,8426240,228,56494,utRho23
2194,yjaB,8428312,8428312,8428246,66,350,utRho23
2195,yjaG,8398746,8399008,8398746,262,902,utRho23
2196,yjaH,8401022,8401132,8401022,110,208,utRho23
2197,yjaZ,8379506,8379572,8379506,66,46,utRho23
2198,yjbB,8455204,8455462,8455204,258,292,utRho23
2199,yjbE,16943432,16943624,16943432,192,660,utRho23
2200,yjbL,8520318,8520642,8520318,324,312,utRho23
2201,yjbQ,8540428,8540476,8540428,48,100,utRho23
2202,yjcB,8550328,8550328,8550082,246,646,utRho23
2203,yjcC,8550836,8550942,8550836,106,376,utRho23
2204,yjcD,8556628,8556958,8556628,330,1244,utRho23
2205,yjcE,8559658,8559960,8559658,302,1604,utRho23
2206,yjcF,8566212,8566212,8566150,62,82,utRho23
2207,yjcO,8594660,8594660,8594250,410,110,utRho23
2208,yjdA,8654128,8654270,8654128,142,6,utRho23
2209,yjdC,8726660,8726660,8726616,44,38,utRho23
2210,yjdK,8704780,8705168,8704780,388,6458,utRho23
2211,yjdL,8713034,8713034,8712822,212,76,utRho23
2212,yjdM,8653672,8653672,8653468,204,1296,utRho23
2213,yjeF,8787354,8788132,8787354,778,76728,utRho23
2214,yjeI,8745522,8745618,8745522,96,18,utRho23
2215,yjeJ,8748806,8748806,8748468,338,1024,utRho23
2216,yjeV,8785472,8785784,8785472,312,1984,utRho23
2217,yjfP,8833512,8833904,8833512,392,522,utRho23
2218,yjfY,8849656,8849656,8849582,74,204,utRho23
2219,yjfZ,8855052,8855052,8854844,208,810,utRho23
2220,yjgA,8916162,8916162,8915730,432,828,utRho23
2221,yjgL,8950802,8950874,8950802,72,250,utRho23
2222,yjgM,8959342,8959342,8959074,268,34,utRho23
2223,yjgN,8959132,8959460,8959132,328,60,utRho23
2224,yjgR,8980170,8980170,8980126,44,1136,utRho23
2225,yjgZ,9002116,9002520,9002116,404,5198,utRho23
2226,yjhB,9007764,9008116,9007764,352,456,utRho23
2227,yjhG,9048452,9048452,9048188,264,49034,utRho23
2228,yjhU,9041080,9041080,9040648,432,1278,utRho23
2229,yjiA,9178096,9178096,9177730,366,1126,utRho23
2230,yjiJ,9125364,9125364,9125350,14,12,utRho23
2231,yjiK,9127270,9127270,9127422,152,544,utRho23
2232,yjiL,9129604,9129604,9129378,226,68,utRho23
2233,yjiS,9143410,9143502,9143410,92,694,utRho23
2234,yjiY,9182734,9182734,9182558,176,1832,utRho23
2235,yjjA,9200674,9200674,9200378,296,1624,utRho23
2236,yjjB,18408708,18408708,18407800,908,904,utRho23
2237,yjjJ,9243314,9243538,9243314,224,0,utRho23
2238,yjjK,9261132,9261132,9261044,88,2280,utRho23
2239,yjjL,9189764,9189764,9189444,320,4914,utRho23
2240,yjjM,9191894,9191894,9191702,192,242,utRho23
2241,yjjP,9206068,9206068,9205716,352,15414,utRho23
2242,yjjQ,9206638,9206954,9206638,316,15962,utRho23
2243,yjjX,9267798,9267798,9267490,308,2624,utRho23
2244,yjjY,9280716,9280804,9280716,88,184,utRho23
2245,yjjZ,9211554,9211608,9211554,54,49458,utRho23
2246,yjtD,9281676,9281884,9281676,208,610,utRho23
2247,ykfB,532454,532454,532174,280,19284,utRho23
2248,ykfI,527636,527636,527338,298,1222,utRho23
2249,ykgB,637050,637050,636638,412,370,utRho23
2250,ykgC,640430,640430,640002,428,706,utRho23
2251,ykgD,640232,640454,640232,222,674,utRho23
2252,ykgE,642962,643216,642962,254,3110,utRho23
2253,ykgJ,608524,608524,608364,160,884,utRho23
2254,ykgL,623878,624224,623878,346,6156,utRho23
2255,ykgM,625610,625610,625554,56,1068,utRho23
2256,ykgR,626570,626570,626484,86,146,utRho23
2257,ylaC,958576,958576,958502,74,3780,utRho23
2258,yliE,1745938,1745958,1745938,20,0,utRho23
2259,ymcE,2103660,2103694,2103660,34,30,utRho23
2260,ymdA,2210450,2210828,2210450,378,246,utRho23
2261,ymdB,2211428,2211640,2211428,212,188,utRho23
2262,ymfD,2395322,2395322,2395064,258,788,utRho23
2263,ymfI,2402880,2402994,2402880,114,0,utRho23
2264,ymfJ,2404518,2404518,2404168,350,966,utRho23
2265,ymfK,2406176,2406176,2405866,310,174,utRho23
2266,ymfT,2405766,2406048,2405766,282,234,utRho23
2267,ymgE,2489110,2489456,2489110,346,1886,utRho23
2268,ymgF,2437628,2437966,2437628,338,472,utRho23
2269,ymiA,2670112,2670320,2670112,208,890,utRho23
2270,ymjA,2715620,2715620,2715336,284,844,utRho23
2271,ynaI,2791946,2791946,2791844,102,96,utRho23
2272,ynaK,2850438,2850754,2850438,316,424,utRho23
2273,ynbA,2954924,2955242,2954924,318,30,utRho23
2274,yncD,3046552,3046552,3046130,422,396,utRho23
2275,yncE,3046454,3046614,3046454,160,330,utRho23
2276,yncG,3052456,3052494,3052456,38,1890,utRho23
2277,yncL,3034492,3034492,3034388,104,1156,utRho23
2278,yneE,3218364,3218364,3218044,320,38,utRho23
2279,yneF,3223748,3223748,3223708,40,14,utRho23
2280,yneJ,3229560,3229608,3229560,48,136,utRho23
2281,yneK,3231100,3231526,3231100,426,812,utRho23
2282,yneM,3245176,3245292,3245176,116,208,utRho23
2283,ynfA,3311398,3311398,3311346,52,72,utRho23
2284,ynfB,3311418,3311616,3311418,198,594,utRho23
2285,ynfC,3315094,3315094,3314914,180,0,utRho23
2286,ynfD,3314828,3315130,3314828,302,8,utRho23
2287,ynfE,3316006,3316138,3316006,132,350,utRho23
2288,ynfK,3334670,3334670,3334438,232,752,utRho23
2289,ynfL,3339304,3339304,3339184,120,94,utRho23
2290,ynfM,3339260,3339398,3339260,138,118,utRho23
2291,ynfN,3276598,3276598,3276218,380,174,utRho23
2292,ynfO,3273454,3273512,3273454,58,722,utRho23
2293,ynhG,3517890,3517890,3517450,440,226,utRho23
2294,yniA,3615158,3615592,3615158,434,1224,utRho23
2295,yniB,3618526,3618526,3618466,60,38,utRho23
2296,yniC,3618652,3618760,3618652,108,310,utRho23
2297,yniD,3610202,3610330,3610202,128,118,utRho23
2298,ynjE,3678880,3678934,3678880,54,110,utRho23
2299,ynjF,3683222,3683222,3682806,416,678,utRho23
2300,ynjH,3684376,3684376,3684270,106,200,utRho23
2301,ynjI,3690022,3690022,3689742,280,556,utRho23
2302,yoaB,3786642,3786734,3786642,92,556,utRho23
2303,yoaC,3787932,3788146,3787932,214,654,utRho23
2304,yoaE,3803544,3803544,3803170,374,688,utRho23
2305,yoaF,3755444,3755444,3755064,380,1038,utRho23
2306,yoaH,3789866,3789866,3789462,404,2602,utRho23
2307,yobB,3850418,3850880,3850418,462,1338,utRho23
2308,yobF,3815586,3815586,3815182,404,380,utRho23
2309,yobH,3817800,3817850,3817800,50,1058,utRho23
2310,yodB,4084352,4084736,4084352,384,2352,utRho23
2311,yodC,4057008,4057008,4056740,268,108,utRho23
2312,yohC,4451358,4451358,4451262,96,272,utRho23
2313,yohD,4451526,4451602,4451526,76,256,utRho23
2314,yohJ,4460986,4461248,4460986,262,1138,utRho23
2315,yohO,4431172,4431314,4431172,142,404,utRho23
2316,yojI,4617282,4617282,4617230,52,50,utRho23
2317,ypdI,4988988,4989396,4988988,408,840,utRho23
2318,ypfG,5165786,5165786,5165554,232,204,utRho23
2319,ypfM,5182140,5182140,5181732,408,402,utRho23
2320,yphB,5349590,5349590,5349376,214,444,utRho23
2321,ypjA,5565644,5565644,5565452,192,3278,utRho23
2322,ypjB,5569636,5569636,5568858,778,304,utRho23
2323,ypjD,5495860,5495774,5495860,86,6,utRho23
2324,yqaE,5594170,5594170,5594056,114,270,utRho23
2325,yqcA,5846100,5846100,5845968,132,558,utRho23
2326,yqcE,5800944,5801184,5800944,240,4,utRho23
2327,yqeC,6030468,6030468,6030114,354,644,utRho23
2328,yqeF,5971618,5971618,5971184,434,6858,utRho23
2329,yqeG,5971438,5971694,5971438,256,10934,utRho23
2330,yqeH,5975016,5975072,5975016,56,23800,utRho23
2331,yqeI,5976688,5977004,5976688,316,284,utRho23
2332,yqeK,5981140,5981140,5980720,420,5724,utRho23
2333,yqfA,6086728,6086728,6086296,432,1260,utRho23
2334,yqgA,6219042,6219106,6219042,64,250,utRho23
2335,yqgB,6172500,6172500,6172102,398,594,utRho23
2336,yqgE,6185768,6185874,6185768,106,318,utRho23
2337,yqhA,6299150,6299150,6298942,208,196,utRho23
2338,yqhC,6310768,6310768,6310436,332,460,utRho23
2339,yqhD,6310604,6310710,6310604,106,146,utRho23
2340,yqhH,6316842,6317254,6316842,412,1492,utRho23
2341,yqiC,6369662,6369680,6369662,18,810,utRho23
2342,yqiJ,6384108,6384416,6384108,308,198,utRho23
2343,yqjA,6495096,6495546,6495096,450,14326,utRho23
2344,yqjF,6500932,6501124,6500932,192,1608,utRho23
2345,yqjG,6501948,6502048,6501948,100,4,utRho23
2346,yqjH,6433078,6433078,6432982,96,116,utRho23
2347,yqjI,6433506,6433558,6433506,52,52,utRho23
2348,yraH,6574552,6574852,6574552,300,396,utRho23
2349,yraP,6592144,6592818,6592144,674,718,utRho23
2350,yraQ,6596414,6596414,6596276,138,0,utRho23
2351,yraR,6598024,6598024,6597692,332,842,utRho23
2352,yrbG,13360844,13361100,13360844,256,0,utRho23
2353,yrbL,6696842,6696904,6696842,62,3162,utRho23
2354,yrbN,6616172,6616172,6615866,306,1696,utRho23
2355,yrdB,6860176,6860176,6860046,130,184,utRho23
2356,yrfF,7052548,7052938,7052548,390,1486,utRho23
2357,yrhB,7169440,7169518,7169440,78,68,utRho23
2358,ysaB,7451804,7451804,7451424,380,52,utRho23
2359,ysgA,8032686,8032686,8032338,348,1248,utRho23
2360,ytfB,8857638,8857638,8857434,204,340,utRho23
2361,ytfE,8864018,8864018,8863966,52,270,utRho23
2362,ytfF,8866296,8866296,8866130,166,684,utRho23
2363,ytfH,8868164,8868226,8868164,62,932,utRho23
2364,ytfI,8875234,8875414,8875234,180,324,utRho23
2365,ytfJ,8878572,8878572,8878524,48,372,utRho23
2366,ytfK,8879022,8879174,8879022,152,186,utRho23
2367,ytfL,8882642,8882642,8882430,212,90,utRho23
2368,ytfQ,8899634,8899924,8899634,290,504,utRho23
2369,ytjB,9249598,9249598,9249578,20,236,utRho23
2370,yzfA,8896588,8896588,8896490,98,36,utRho23
2371,zapA,6111102,6111224,6111102,122,552,utRho23
2372,zapB,8236772,8237030,8236772,258,280,utRho23
2373,zapC,2011700,2011904,2011700,204,50,utRho23
2374,zinT,4082692,4082750,4082692,58,822,utRho23
2375,zipA,5062814,5062814,5062466,348,584,utRho23
2376,zitB,1569716,1569716,1569646,70,96,utRho23
2377,zntA,7212844,7212902,7212844,58,172,utRho23
2378,zntR,6878336,6878336,6878260,76,128,utRho23
2379,znuA,3885322,3885322,3885166,156,252,utRho23
2380,znuC,3885268,3885324,3885268,56,244,utRho23
2381,zraP,8403424,8403424,8403376,48,106,utRho23
2382,zraS,8403810,8403852,8403810,42,10,utRho23
2383,zupT,6364866,6365100,6364866,234,3348,utRho23
2384,zur,8520282,8520282,8520006,276,516,utRho23
2385,zwf,3872752,3872752,3872628,124,96,utRho23
0,C0343,2818676,2818728,2818676,52,0,utRho24
1,aaeB,6776526,6776526,6776376,150,138,utRho24
2,aaeR,6778762,6779040,6778762,278,1124,utRho24
3,aaeX,6778860,6778860,6778674,186,1256,utRho24
4,aat,1854920,1854920,1854864,56,0,utRho24
5,accA,416822,417242,416822,420,592,utRho24
6,accB,6810280,6810872,6810280,592,1464,utRho24
7,accD,4868030,4868030,4867852,178,272,utRho24
8,aceB,8430804,8430956,8430804,152,1234,utRho24
9,aceE,245938,246034,245938,96,220,utRho24
10,ackA,4826918,4826940,4826918,22,100,utRho24
11,acnA,2670848,2671662,2670848,814,844,utRho24
12,acnB,263038,263230,263038,192,458,utRho24
13,acpP,2303148,2303230,2303148,82,78,utRho24
14,acpS,5402324,5402324,5401996,328,368,utRho24
15,acrA,971396,971396,971238,158,30,utRho24
16,acrB,969370,969370,968806,564,1108,utRho24
17,acrD,5174950,5175190,5174950,240,326,utRho24
18,acrE,6827404,6827728,6827404,324,398,utRho24
19,acrR,971398,971522,971398,124,12,utRho24
20,acrZ,1589502,1589546,1589502,44,322,utRho24
21,acs,8575190,8575190,8574742,448,4004,utRho24
22,actP,8569870,8569870,8569804,66,86,utRho24
23,ada,4620854,4620854,4620810,44,0,utRho24
24,add,3404404,3404466,3404404,62,166,utRho24
25,ade,7687802,7687928,7687802,126,144,utRho24
26,adhE,2596826,2596826,2596242,584,18,utRho24
27,adhP,3107988,3107988,3107676,312,590,utRho24
28,adiA,8681112,8681112,8681042,70,180,utRho24
29,adiC,8674404,8674404,8674062,342,362,utRho24
30,adiY,8676084,8676084,8675858,226,34,utRho24
31,adk,994278,994350,994278,72,1152,utRho24
32,adrA,807374,807406,807374,32,286,utRho24
33,aer,6438240,6438240,6438152,88,190,utRho24
34,aes,1000102,1000102,999946,156,4486,utRho24
35,agaR,6557406,6557406,6557330,76,24,utRho24
36,agaS,6563778,6563952,6563778,174,34,utRho24
37,agp,2131118,2131170,2131118,52,46,utRho24
38,agrA,7296126,7296126,7296126,0,0,utRho24
39,agrB,7296588,7296588,7296588,0,0,utRho24
40,ahpC,1277386,1277890,1277386,504,512,utRho24
41,ahpF,1278004,1279506,1278004,1502,70378,utRho24
42,ahr,8992698,8992698,8992418,280,2076,utRho24
43,aidB,8828494,8828550,8828494,56,34,utRho24
44,ais,4731512,4731512,4731240,272,404,utRho24
45,alaA,4814816,4815122,4814816,306,218,utRho24
46,alaC,4996798,4996798,4996590,208,48,utRho24
47,alaE,5598140,5598328,5598140,188,344,utRho24
48,alaS,5644180,5644180,5644022,158,778,utRho24
49,alaW,5036612,5036612,5036462,150,0,utRho24
50,aldA,2976380,2976464,2976380,84,416,utRho24
51,aldB,7513070,7513070,7513022,48,740,utRho24
52,alkA,4295118,4295118,4295080,38,226,utRho24
53,alkB,4618890,4618890,4618682,208,142,utRho24
54,allA,1064780,1064902,1064780,122,256,utRho24
55,allD,1092822,1092822,1092726,96,128,utRho24
56,allE,1088112,1088112,1088092,20,222,utRho24
57,allS,1064600,1064600,1064442,158,790,utRho24
58,alr,8531178,8531564,8531178,386,1154,utRho24
59,alsE,8617334,8617334,8616956,378,812,utRho24
60,alsK,8615990,8615990,8615598,392,1582,utRho24
61,alx,6476740,6477160,6476740,420,92,utRho24
62,amiA,5104482,5104704,5104482,222,80,utRho24
63,amiC,5898378,5898378,5898020,358,334,utRho24
64,amn,4110062,4110122,4110062,60,22,utRho24
65,ampC,8758006,8758006,8757888,118,72,utRho24
66,ampD,237362,237466,237362,104,428,utRho24
67,ampG,907372,907372,907090,282,168,utRho24
68,ampH,792726,792726,792574,152,104,utRho24
69,amyA,4012230,4012312,4012230,82,16,utRho24
70,anmK,3439346,3439346,3439204,142,92,utRho24
71,ansB,6201580,6201580,6201456,124,1248,utRho24
72,ansP,3052040,3052040,3051960,80,282,utRho24
73,apaG,104068,104068,103212,856,2864,utRho24
74,apaH,102586,102586,102444,142,5704,utRho24
75,apbE,4623188,4623188,4623068,120,18,utRho24
76,appA,2081198,2081234,2081198,36,18,utRho24
77,appC,2075420,2075480,2075420,60,8,utRho24
78,appY,1167134,1167362,1167134,228,68,utRho24
79,apt,982620,982824,982620,204,24,utRho24
80,aqpZ,1832424,1832424,1832094,330,160,utRho24
81,araB,140150,140150,140096,54,40,utRho24
82,araC,140482,140774,140482,292,764,utRho24
83,araE,5964416,5964416,5964364,52,16,utRho24
84,araF,3972476,3972476,3972256,220,260,utRho24
85,araH,3967120,3967120,3967086,34,940,utRho24
86,araJ,825058,825058,824962,96,6044,utRho24
87,arcA,9281602,9281602,9280612,990,1410,utRho24
88,arcB,6706098,6706098,6706050,48,380,utRho24
89,arcZ,6701154,6701154,6701154,0,0,utRho24
90,arfA,6877346,6877346,6877298,48,808,utRho24
91,argA,5898312,5898484,5898312,172,256,utRho24
92,argC,8309770,8310002,8309770,232,266,utRho24
93,argD,6980442,6980442,6980360,82,216,utRho24
94,argE,8310156,8310156,8309694,462,478,utRho24
95,argF,580680,580680,580610,70,38,utRho24
96,argG,6637124,6637274,6637124,150,462,utRho24
97,argI,8956688,8956688,8956622,66,346,utRho24
98,argO,6137672,6137672,6137616,56,468,utRho24
99,argP,6119460,6119506,6119460,46,548,utRho24
100,argR,6769204,6769406,6769204,202,256,utRho24
101,argS,3920002,3920124,3920002,122,156,utRho24
102,argT,4855698,4855698,4855582,116,146,utRho24
103,argU,1129406,1129446,1129406,40,0,utRho24
104,argW,4932616,4932618,4932616,2,34,utRho24
105,argX,7964728,7964750,7964728,22,54,utRho24
106,aroF,5482402,5482402,5482300,102,78,utRho24
107,aroG,1571182,1571266,1571182,84,212,utRho24
108,aroH,3576636,3576870,3576636,234,324,utRho24
109,aroK,7038760,7038760,7038128,632,1806,utRho24
110,aroL,812560,812810,812560,250,2458,utRho24
111,aroP,243342,243342,243102,240,106,utRho24
112,arpA,8445382,8445382,8444974,408,616,utRho24
113,arrS,7316108,7316108,7316108,0,0,utRho24
114,arsR,7297024,7297056,7297024,32,214,utRho24
115,artJ,1801252,1801252,1801150,102,26,utRho24
116,artP,1807686,1807686,1807468,218,7516,utRho24
117,ascF,5678858,5679048,5678858,190,118,utRho24
118,ascG,5678574,5678574,5678528,46,266,utRho24
119,aslB,7965562,7965916,7965562,354,606,utRho24
120,asnA,7854258,7854310,7854258,52,1522,utRho24
121,asnB,1398444,1398444,1398354,90,2210,utRho24
122,asnC,23562186,23562186,23562018,168,1584,utRho24
123,asnS,1978088,1978088,1977970,118,1620,utRho24
124,asnT,4089082,4089098,4089082,16,274,utRho24
125,asnU,4119690,4119702,4119690,12,0,utRho24
126,asnV,4124504,4124520,4124504,16,164,utRho24
127,aspA,17473728,17473728,17473308,420,120,utRho24
128,aspC,1971486,1971486,1971418,68,62,utRho24
129,aspS,3901402,3901402,3901044,358,528,utRho24
130,aspT,7893560,7893744,7893560,184,67726,utRho24
131,aspV,473826,473862,473826,36,48,utRho24
132,asr,3342654,3342752,3342654,98,126,utRho24
133,astC,3664088,3664088,3663964,124,142,utRho24
134,astE,3654138,3654138,3653846,292,314,utRho24
135,atoD,4646824,4646894,4646824,70,1428,utRho24
136,atpB,7844540,7844540,7844102,438,98,utRho24
137,atpC,7832118,7832118,7831944,174,308,utRho24
138,atpI,7845050,7845050,7844880,170,64,utRho24
139,avtA,7479348,7479410,7479348,62,1364,utRho24
140,azoR,2965982,2965982,2965720,262,528,utRho24
141,azuC,3976002,3976002,3975918,84,0,utRho24
142,bacA,6408350,6408350,6408262,88,956,utRho24
143,bamA,394052,395856,394052,1804,886,utRho24
144,bamB,5277950,5277950,5277304,646,660,utRho24
145,bamC,5198028,5198028,5197730,298,506,utRho24
146,bamD,5471922,5472292,5471922,370,1940,utRho24
147,bamE,5506972,5507210,5506972,238,64,utRho24
148,basS,8666954,8666954,8666544,410,1798,utRho24
149,bax,7474468,7474468,7474354,114,204,utRho24
150,bcp,5200874,5200956,5200874,82,1096,utRho24
151,bcsB,7385346,7385346,7385214,132,42,utRho24
152,bcsE,7392644,7392916,7392644,272,216,utRho24
153,bdcA,8948128,8948128,8948106,22,1372,utRho24
154,bdcR,8948192,8948248,8948192,56,698,utRho24
155,bdm,3112680,3112680,3112560,120,240,utRho24
156,betA,654522,654522,654494,28,192,utRho24
157,betI,658722,658722,658668,54,200,utRho24
158,betT,658842,658926,658842,84,382,utRho24
159,bfr,6933498,6933498,6933450,48,128,utRho24
160,bglG,23440182,23440182,23439402,780,2184,utRho24
161,bglX,4444240,4444240,4443978,262,58,utRho24
162,bhsA,2337962,2338146,2337962,184,342,utRho24
163,bioA,1618584,1618584,1618514,70,16,utRho24
164,bioB,1618604,1618688,1618604,84,0,utRho24
165,bioH,7089716,7089716,7089688,28,60,utRho24
166,bisC,7433026,7433026,7432788,238,320,utRho24
167,blc,8755490,8755490,8755444,46,52,utRho24
168,blr,3409024,3409102,3409024,78,374,utRho24
169,bluF,2431226,2431226,2430950,276,532,utRho24
170,bluR,2428226,2428226,2428118,108,0,utRho24
171,bolA,908698,908944,908698,246,78,utRho24
172,borD,1157842,1157842,1157786,56,840,utRho24
173,brnQ,838976,839182,838976,206,762,utRho24
174,bssR,1756492,1756496,1756492,4,0,utRho24
175,bssS,2242116,2242116,2241910,206,158,utRho24
176,btuB,8326798,8327278,8326798,480,2538,utRho24
177,cadB,8720212,8720212,8720062,150,472,utRho24
178,cadC,8723926,8723926,8723868,58,94,utRho24
179,caiE,70998,70998,70742,256,734,utRho24
180,caiF,68436,68600,68436,164,2544,utRho24
181,caiT,84074,84074,83862,212,406,utRho24
182,can,285406,285406,285340,66,308,utRho24
183,carA,59102,59302,59102,200,1296,utRho24
184,carB,61550,61634,61550,84,462,utRho24
185,cas2,5757830,5757830,5757706,124,440,utRho24
186,casA,5768638,5768638,5768276,362,130,utRho24
187,cbl,4121882,4121882,4121828,54,1944,utRho24
188,cbpA,2128074,2128074,2127550,524,648,utRho24
189,cbrA,7738628,7738754,7738628,126,110,utRho24
190,cbrB,7794958,7795012,7794958,54,934,utRho24
191,ccmH,4585242,4585242,4584820,422,490,utRho24
192,cdaR,364894,364926,364894,32,80,utRho24
193,cdd,4463638,4463688,4463638,50,38,utRho24
194,cdh,8219814,8219860,8219814,46,1360,utRho24
195,cdsA,391110,391354,391110,244,470,utRho24
196,cedA,3627484,3627484,3627326,158,690,utRho24
197,cfa,3482402,3482826,3482402,424,346,utRho24
198,chaC,2544844,2544972,2544844,128,1412,utRho24
199,chbB,3643452,3643452,3643238,214,420,utRho24
200,chbG,3634624,3634624,3634270,354,48,utRho24
201,cheW,3946924,3946924,3946678,246,178,utRho24
202,chiA,6939792,6939792,6939706,86,400,utRho24
203,chiP,1416472,1416668,1416472,196,32,utRho24
204,cho,3646984,3647030,3646984,46,418,utRho24
205,chpS,8896804,8896894,8896804,90,8,utRho24
206,cirA,4493884,4493884,4493538,346,488,utRho24
207,citC,1304078,1304078,1303712,366,1302,utRho24
208,citT,1293264,1293264,1293160,104,90,utRho24
209,clcA,350104,350214,350104,110,46,utRho24
210,clpA,1846160,1846528,1846160,368,112,utRho24
211,clpB,5468410,5468410,5468346,64,72,utRho24
212,clpP,913154,913354,913154,200,178,utRho24
213,clpS,1845500,1845826,1845500,326,164,utRho24
214,clpX,914404,914852,914404,448,308,utRho24
215,clsA,2617346,2617346,2617290,56,372,utRho24
216,clsC,2212584,2212710,2212584,126,192,utRho24
217,cmk,1922330,1922402,1922330,72,0,utRho24
218,cnu,3409522,3409898,3409522,376,1858,utRho24
219,coaA,8350214,8350214,8350052,162,780,utRho24
220,cobC,1340092,1340092,1339814,278,580,utRho24
221,cobT,4129202,4129202,4128934,268,90,utRho24
222,cobU,4131944,4131944,4131528,416,474,utRho24
223,codB,709768,709844,709768,76,888,utRho24
224,comR,2337726,2337726,2337664,62,0,utRho24
225,copA,1022822,1022822,1022758,64,186,utRho24
226,corA,8002388,8002852,8002388,464,28730,utRho24
227,cpdB,8873258,8873258,8873130,128,1014,utRho24
228,cptB,6082198,6082198,6082140,58,20,utRho24
229,cpxA,8210202,8210202,8209950,252,712,utRho24
230,cpxP,8211570,8211640,8211570,70,262,utRho24
231,cpxR,8211372,8211372,8211340,32,48,utRho24
232,cra,175894,176056,175894,162,68,utRho24
233,crcB,1316016,1316016,1315876,140,100,utRho24
234,creA,9270486,9271042,9270486,556,512,utRho24
235,creD,9276320,9276356,9276320,36,318,utRho24
236,crl,515620,515658,515620,38,1918,utRho24
237,crp,6971906,6972240,6971906,334,1706,utRho24
238,crr,5070960,5071668,5070960,708,1356,utRho24
239,csdA,5886414,5886674,5886414,260,92,utRho24
240,csgB,2207718,2207902,2207718,184,108,utRho24
241,csgD,2206688,2206688,2206392,296,736,utRho24
242,csgG,2203510,2203510,2203368,142,600,utRho24
243,csiD,5577854,5577970,5577854,116,308,utRho24
244,csiE,5330802,5330870,5330802,68,358,utRho24
245,csiR,5590942,5591348,5590942,406,364,utRho24
246,cspA,7439778,7440098,7439778,320,1674,utRho24
247,cspB,3283430,3283430,3283108,322,68,utRho24
248,cspC,3815018,3815018,3814870,148,86,utRho24
249,cspD,1845352,1845352,1845180,172,1982,utRho24
250,cspE,1314294,1314584,1314294,290,62,utRho24
251,cspF,3283380,3283710,3283380,330,330,utRho24
252,cspG,2102610,2102922,2102610,312,304,utRho24
253,cspH,2102746,2102746,2102350,396,128,utRho24
254,cspI,3277624,3277624,3277334,290,8,utRho24
255,csrA,5638746,5638746,5638292,454,450,utRho24
256,csrB,5849048,5849048,5849048,0,0,utRho24
257,csrC,8102072,8102072,8102072,0,0,utRho24
258,csrD,6806850,6806850,6806664,186,174,utRho24
259,cstA,1259710,1259788,1259710,78,78,utRho24
260,cueO,274090,274166,274090,76,46,utRho24
261,cueR,1027948,1027986,1027948,38,14,utRho24
262,curA,3037784,3038054,3037784,270,1870,utRho24
263,cusC,1191146,1191200,1191146,54,254,utRho24
264,cusR,1190924,1190924,1190886,38,276,utRho24
265,cutA,8730784,8730784,8730712,72,706,utRho24
266,cutC,3918534,3918534,3917920,614,2272,utRho24
267,cvpA,4861600,4861600,4861526,74,0,utRho24
268,cvrA,2484328,2484328,2484142,186,198,utRho24
269,cyaA,7981548,7982306,7981548,758,624,utRho24
270,cyaR,4334228,4334224,4334228,4,0,utRho24
271,cyaY,7988166,7988166,7988118,48,170,utRho24
272,cybB,2981522,2981804,2981522,282,396,utRho24
273,cycA,8859560,8859728,8859560,168,496,utRho24
274,cydA,1542340,1542916,1542340,576,676,utRho24
275,cydC,1858800,1858800,1858390,410,476,utRho24
276,cydD,1862062,1862062,1861924,138,4,utRho24
277,cydX,1548300,1548392,1548300,92,112,utRho24
278,cynR,717418,717418,717380,38,556,utRho24
279,cynT,1435092,1435196,1435092,104,112,utRho24
280,cyoA,903306,903306,903220,86,992,utRho24
281,cyoE,895540,895540,895410,130,60,utRho24
282,cysB,2667576,2667710,2667576,134,240,utRho24
283,cysC,5748056,5748056,5747984,72,234,utRho24
284,cysD,5752736,5752736,5752658,78,98,utRho24
285,cysE,7565362,7565362,7565124,238,666,utRho24
286,cysG,6995508,6995656,6995508,148,4472,utRho24
287,cysJ,5783928,5783928,5783796,132,5800,utRho24
288,cysK,5064688,5064818,5064688,130,20,utRho24
289,cysP,5087114,5087114,5087056,58,616,utRho24
290,cysS,1109154,1109222,1109154,68,178,utRho24
291,cysT,3984100,3984100,3983974,126,26,utRho24
292,cysZ,5062766,5062926,5062766,160,576,utRho24
293,cytR,8249018,8249018,8248912,106,68,utRho24
294,dacA,1328002,1328002,1327926,76,28,utRho24
295,dacB,6657714,6657926,6657714,212,42,utRho24
296,dacC,1761306,1761454,1761306,148,832,utRho24
297,dadA,2475018,2475142,2475018,124,92,utRho24
298,dam,7032504,7032504,7031826,678,1132,utRho24
299,damX,7035200,7035200,7034612,588,778,utRho24
300,dapA,5199568,5199568,5199520,48,20,utRho24
301,dapB,56576,56748,56576,172,948,utRho24
302,dapD,371954,371954,371894,60,162,utRho24
303,dapE,5183120,5183214,5183120,94,1010,utRho24
304,dcp,3254844,3254844,3254760,84,152,utRho24
305,dcrB,7219534,7219910,7219534,376,1704,utRho24
306,dctA,7366996,7366996,7366894,102,428,utRho24
307,dcuA,8733686,8733686,8733546,140,36,utRho24
308,dcuB,8698182,8698182,8697488,694,4606,utRho24
309,dcuC,1312166,1312166,1311936,230,2048,utRho24
310,dcuD,6749166,6749738,6749166,572,870,utRho24
311,dcuR,8701130,8701130,8700068,1062,1708,utRho24
312,dcuS,8703370,8703370,8703324,46,1158,utRho24
313,dcyD,3999016,3999016,3998960,56,0,utRho24
314,ddpX,3126498,3126498,3126152,346,370,utRho24
315,deaD,6615818,6615818,6615720,98,636,utRho24
316,dedA,4869880,4869880,4869482,398,5236,utRho24
317,dedD,4863750,4863750,4863368,382,172,utRho24
318,def,6867300,6867380,6867300,80,390,utRho24
319,degP,361690,361768,361690,78,4,utRho24
320,degQ,6761308,6761486,6761308,178,4838,utRho24
321,deoB,9239134,9239206,9239134,72,104,utRho24
322,deoC,9233358,9234646,9233358,1288,1340,utRho24
323,dfp,7625406,7625462,7625406,56,0,utRho24
324,dgcZ,3247758,3247758,3247700,58,8,utRho24
325,dgkA,8512914,8513274,8512914,360,462,utRho24
326,dgt,358392,358474,358392,82,1548,utRho24
327,dhaK,2501888,2501888,2501676,212,394,utRho24
328,dhaR,2502006,2502132,2502006,126,382,utRho24
329,dicB,3299194,3299218,3299194,24,60,utRho24
330,dicC,3295752,3295752,3295700,52,4,utRho24
331,dinB,501760,501796,501760,36,152,utRho24
332,dinD,7635398,7635520,7635398,122,464,utRho24
333,dinG,1666146,1666140,1666146,6,32,utRho24
334,dinI,2243018,2243018,2242974,44,246,utRho24
335,dinJ,493230,493230,493004,226,190,utRho24
336,dinQ,7295964,7295964,7295576,388,932,utRho24
337,djlA,114536,114728,114536,192,504,utRho24
338,dkgA,6313142,6313246,6313142,104,424,utRho24
339,dkgB,458196,458334,458196,138,0,utRho24
340,dksA,321502,321502,321208,294,322,utRho24
341,dld,4444164,4444370,4444164,206,32,utRho24
342,dmlA,3763424,3763824,3763424,400,1486,utRho24
343,dmlR,3763710,3763710,3763618,92,272,utRho24
344,dmsA,1881646,1881918,1881646,272,0,utRho24
345,dnaA,7767922,7767922,7767458,464,352,utRho24
346,dnaB,8528566,8528628,8528566,62,88,utRho24
347,dnaK,24096,24326,24096,230,7514,utRho24
348,dnaN,7765466,7765466,7764642,824,628,utRho24
349,dnaQ,471868,472134,471868,266,4082,utRho24
350,dnaT,18406460,18406460,18406068,392,3012,utRho24
351,dnaX,984112,984184,984112,72,374,utRho24
352,dosP,3131486,3131486,3131466,20,42,utRho24
353,dpiB,1303968,1304470,1303968,502,1220,utRho24
354,dppA,7415740,7415740,7415410,330,2164,utRho24
355,dps,1697900,1697900,1697822,78,64,utRho24
356,dsbA,8086754,8086836,8086754,82,640,utRho24
357,dsbB,2466294,2466294,2466060,234,168,utRho24
358,dsbC,6079266,6079266,6077644,1622,1182,utRho24
359,dsbG,1277600,1277600,1277146,454,266,utRho24
360,dsdA,4958242,4958404,4958242,162,402,utRho24
361,dsdC,4955492,4955492,4955258,234,372,utRho24
362,dsdX,4955642,4955694,4955642,52,762,utRho24
363,dsrA,4050626,4050626,4050626,0,0,utRho24
364,dsrB,4049686,4049686,4049646,40,442,utRho24
365,dtpD,1485340,1485340,1485112,228,630,utRho24
366,dusA,8523200,8523338,8523200,138,2496,utRho24
367,dusB,6820492,6820560,6820492,68,0,utRho24
368,dusC,4460790,4460790,4460770,20,0,utRho24
369,dut,7627704,7627864,7627704,160,708,utRho24
370,dxr,386670,387042,386670,372,170,utRho24
371,ebgA,6445102,6445266,6445102,164,148,utRho24
372,ebgR,6442874,6442932,6442874,58,48,utRho24
373,ecnB,8753018,8753106,8753018,88,98,utRho24
374,eco,4607594,4607810,4607594,216,20,utRho24
375,ecpA,621594,621594,621342,252,768,utRho24
376,ecpB,620238,620238,620052,186,762,utRho24
377,ecpR,622964,622964,622672,292,260,utRho24
378,eda,3866218,3866218,3865512,706,18,utRho24
379,edd,3869426,3869426,3869208,218,0,utRho24
380,efeO,2164308,2164486,2164308,178,288,utRho24
381,efeU_1,2162614,2162712,2162614,98,160,utRho24
382,efp,8751134,8751398,8751134,264,1842,utRho24
383,elaA,4763372,4763372,4763086,286,108,utRho24
384,elaD,4765308,4765426,4765308,118,212,utRho24
385,elfA,1995530,1995736,1995530,206,130,utRho24
386,elfD,1996642,1996980,1996642,338,126,utRho24
387,emrD,7707690,7707844,7707690,154,224,utRho24
388,emrK,4966896,4966896,4966678,218,334,utRho24
389,emrY,4964668,4964668,4964352,316,638,utRho24
390,emtA,2486250,2486360,2486250,110,82,utRho24
391,endA,12361100,12361388,12361100,288,220,utRho24
392,eno,5817692,5817692,5815882,1810,2306,utRho24
393,entC,1249662,1249770,1249662,108,84,utRho24
394,entD,1220508,1220508,1220158,350,112,utRho24
395,entH,1258584,1258600,1258584,16,30,utRho24
396,entS,1244506,1244600,1244506,94,190,utRho24
397,envR,6827266,6827266,6826930,336,22,utRho24
398,epd,12295292,12295292,12294764,528,572,utRho24
399,epmA,8765236,8765286,8765236,50,410,utRho24
400,epmB,8751406,8751406,8751314,92,872,utRho24
401,eptB,7421162,7421162,7420950,212,4,utRho24
402,eptC,8300622,8300622,8300530,92,1676,utRho24
403,erfK,4126708,4126708,4126646,62,76,utRho24
404,erpA,353122,353220,353122,98,34,utRho24
405,esrE,8039956,8039956,8039956,0,0,utRho24
406,essD,1153746,1154796,1153746,1050,3072,utRho24
407,etk,2088606,2088606,2088420,186,2250,utRho24
408,evgA,4967262,4967510,4967262,248,48,utRho24
409,exbB,6304028,6304028,6303968,60,192,utRho24
410,exbD,6302780,6302780,6302486,294,124,utRho24
411,exuR,6493016,6493304,6493016,288,122,utRho24
412,exuT,6490004,6490208,6490004,204,18,utRho24
413,fabA,2032996,2032996,2032940,56,128,utRho24
414,fabB,4883282,4883282,4883210,72,10,utRho24
415,fabH,2297032,2297518,2297032,486,570,utRho24
416,fabI,2702236,2702236,2702078,158,218,utRho24
417,fadB,8062026,8062026,8061942,84,8,utRho24
418,fadD,3779614,3779614,3779492,122,2,utRho24
419,fadE,486812,486812,486606,206,160,utRho24
420,fadH,6463248,6463330,6463248,82,454,utRho24
421,fadI,4921022,4921022,4920938,84,186,utRho24
422,fadL,4922410,4922600,4922410,190,382,utRho24
423,fadM,928720,928804,928720,84,0,utRho24
424,fadR,2469810,2469876,2469810,66,0,utRho24
425,fbaB,4357334,4357334,4357128,206,228,utRho24
426,fdhE,8162722,8162722,8162456,266,830,utRho24
427,fdhF,8598814,8598814,8598732,82,260,utRho24
428,fdnG,3094744,3094802,3094744,58,56,utRho24
429,fdrA,1093012,1093360,1093012,348,402,utRho24
430,feaB,2894994,2895038,2894994,44,0,utRho24
431,feaR,2894734,2894734,2894566,168,30,utRho24
432,fecA,9033454,9033454,9033354,100,230,utRho24
433,fecE,9023288,9023288,9022914,374,1500,utRho24
434,fecI,9036564,9036564,9036470,94,838,utRho24
435,feoA,7080114,7080326,7080114,212,474,utRho24
436,fepA,1225334,1225334,1224988,346,1484,utRho24
437,fepB,1249454,1249454,1249020,434,548,utRho24
438,fepD,1244468,1244468,1244378,90,60,utRho24
439,fes,1225374,1225630,1225374,256,1648,utRho24
440,ffh,5495706,5495706,5495590,116,424,utRho24
441,ffs,952576,952848,952576,272,7634,utRho24
442,fhuA,334884,334968,334884,84,770,utRho24
443,fhuE,2323294,2323294,2323102,192,430,utRho24
444,fhuF,9211504,9211504,9211326,178,48866,utRho24
445,fic,6983296,6983296,6982926,370,2996,utRho24
446,fieF,8212864,8212938,8212864,74,454,utRho24
447,fimA,9085388,9086230,9085388,842,1730,utRho24
448,fimB,9081334,9081914,9081334,580,5120,utRho24
449,fimE,9083742,9084074,9083742,332,3222,utRho24
450,fimZ,1129214,1129214,1128960,254,0,utRho24
451,fiu,1683296,1683296,1683062,234,70,utRho24
452,fixA,84650,84806,84650,156,390,utRho24
453,fkpA,6955050,6955050,6954838,212,1470,utRho24
454,fldA,2846084,2846084,2845860,224,1196,utRho24
455,fldB,6079644,6079710,6079644,66,214,utRho24
456,flgA,2261770,2261770,2261726,44,1926,utRho24
457,flgB,2261986,2262036,2261986,50,392,utRho24
458,flgK,2276702,2276756,2276702,54,804,utRho24
459,flgM,2260330,2260330,2260256,74,74,utRho24
460,flgN,2259828,2259828,2259660,168,184,utRho24
461,flhB,3932432,3932432,3932382,50,764,utRho24
462,flhC,3955864,3955864,3955688,176,306,utRho24
463,flhD,3957154,3957154,3956394,760,3836,utRho24
464,fliA,4003638,4003638,4003578,60,60,utRho24
465,fliC,4007352,4007352,4007212,140,308,utRho24
466,fliD,4007634,4007744,4007634,110,1858,utRho24
467,fliE,4026186,4026186,4026028,158,1818,utRho24
468,fliF,4026292,4026458,4026292,166,1080,utRho24
469,fliL,4039168,4039236,4039168,68,110,utRho24
470,flk,4875824,4875900,4875824,76,164,utRho24
471,flu,4142634,4143078,4142634,444,296,utRho24
472,flxA,3292776,3292810,3292776,34,398,utRho24
473,fnr,2799104,2799104,2799052,52,4,utRho24
474,fnrS,2818258,2818258,2818258,0,0,utRho24
475,focA,1909628,1909628,1908932,696,516,utRho24
476,folA,99598,99646,99598,48,170,utRho24
477,folB,6409296,6409296,6409178,118,208,utRho24
478,folD,1115562,1115562,1115482,80,138,utRho24
479,folE,4487696,4487696,4487304,392,1546,utRho24
480,fpr,8228998,8228998,8228944,54,0,utRho24
481,frc,4986878,4986878,4986508,370,528,utRho24
482,frdA,8764824,8764824,8764636,188,1170,utRho24
483,frdD,8758948,8758948,8758732,216,6848,utRho24
484,fre,8052886,8053054,8052886,168,568,utRho24
485,frlA,6999518,6999820,6999518,302,462,utRho24
486,frr,385624,385744,385624,120,312,utRho24
487,frsA,513004,513054,513004,50,46,utRho24
488,fruB,4527194,4527194,4526990,204,0,utRho24
489,frvR,8179804,8179804,8179710,94,86,utRho24
490,fryA,5008986,5008986,5008970,16,542,utRho24
491,fsaA,1727060,1727284,1727060,224,1052,utRho24
492,fsr,1009710,1009710,1009392,318,292,utRho24
493,ftnA,3977364,3977432,3977364,68,16,utRho24
494,ftnB,3973550,3973850,3973550,300,594,utRho24
495,ftsA,207122,207964,207122,842,828,utRho24
496,ftsB,5745802,5745802,5745640,162,370,utRho24
497,ftsH,6654204,6654204,6653870,334,382,utRho24
498,ftsK,1865858,1866448,1865858,590,650,utRho24
499,ftsL,181376,182064,181376,688,1844,utRho24
500,ftsP,6325732,6325732,6325338,394,412,utRho24
501,ftsQ,205484,206310,205484,826,378,utRho24
502,ftsX,7204512,7204512,7204172,340,204,utRho24
503,ftsZ,209272,210610,209272,1338,82,utRho24
504,fucA,5867708,5867708,5867376,332,4254,utRho24
505,fucP,5868238,5868470,5868238,232,268,utRho24
506,fumA,6753760,6753760,6753508,252,1580,utRho24
507,fumB,8694696,8694696,8694652,44,150,utRho24
508,fumC,3373418,3373418,3373176,242,90,utRho24
509,fur,2842892,2842892,2842584,308,1852,utRho24
510,fusA,6947370,6947370,6947028,342,4758,utRho24
511,fxsA,8737206,8737328,8737206,122,142,utRho24
512,gabD,5581824,5582546,5581824,722,7796,utRho24
513,gadA,7335214,7335214,7335160,54,50,utRho24
514,gadB,3144144,3144144,3144090,54,548,utRho24
515,gadC,3141168,3141168,3140978,190,388,utRho24
516,gadE,7315600,7316732,7315600,1132,3658,utRho24
517,gadW,7329562,7329562,7329236,326,104,utRho24
518,gadX,14663356,14663356,14663240,116,1752,utRho24
519,gadY,7329728,7329728,7329728,0,0,utRho24
520,galE,1584354,1584354,1584110,244,104,utRho24
521,galF,4228702,4228702,4228654,48,0,utRho24
522,galM,1577796,1577796,1577674,122,1016,utRho24
523,galP,6176510,6176568,6176510,58,0,utRho24
524,galR,5953138,5953198,5953138,60,70,utRho24
525,galS,4483420,4483420,4483336,84,48,utRho24
526,galU,2582810,2582914,2582810,104,206,utRho24
527,gapA,3724480,3725542,3724480,1062,1260,utRho24
528,garP,6549868,6549868,6549814,54,998,utRho24
529,gatY,4354468,4354468,4354408,60,0,utRho24
530,gatZ,4352864,4352864,4352642,222,7410,utRho24
531,gcd,282558,282558,282450,108,52,utRho24
532,gcl,1067814,1067832,1067814,18,10,utRho24
533,gcvA,5885278,5885278,5885134,144,18,utRho24
534,gcvB,5885392,5885392,5885392,0,0,utRho24
535,gcvR,5199758,5199812,5199758,54,68,utRho24
536,gcvT,6101544,6101544,6101334,210,834,utRho24
537,gdhA,3684616,3684742,3684616,126,0,utRho24
538,gfcA,2099668,2099668,2099488,180,1656,utRho24
539,gfcD,2096236,2096236,2095890,346,3454,utRho24
540,ghrA,2195648,2195772,2195648,124,84,utRho24
541,ghrB,7434378,7434620,7434378,242,1938,utRho24
542,glcA,6242728,6242728,6242558,170,1722,utRho24
543,glcC,6256412,6256544,6256412,132,268,utRho24
544,glcD,6256152,6256152,6256042,110,600,utRho24
545,gldA,8278092,8278092,8278070,22,408,utRho24
546,glgA,7136784,7136784,7136066,718,1968,utRho24
547,glgB,7147314,7147314,7147004,310,336,utRho24
548,glgC,7139142,7139142,7138656,486,600,utRho24
549,glgP,7133546,7133546,7133162,384,222,utRho24
550,glgS,6384024,6384024,6383878,146,98,utRho24
551,glgX,7142838,7142838,7142638,200,44,utRho24
552,glk,5018922,5018922,5018852,70,158,utRho24
553,glmS,7827622,7827622,7827336,286,1164,utRho24
554,glmU,7830652,7830652,7830400,252,56,utRho24
555,glmY,10765360,10765360,10765360,0,0,utRho24
556,glmZ,7972864,7972864,7972864,0,0,utRho24
557,glnA,16232888,16232888,16232136,752,56,utRho24
558,glnB,5375052,5375052,5374816,236,378,utRho24
559,glnD,377310,377310,377300,10,78,utRho24
560,glnE,6399602,6399602,6399282,320,82,utRho24
561,glnH,1696396,1696396,1696008,388,1242,utRho24
562,glnK,945112,945196,945112,84,1178,utRho24
563,glnL,8112742,8112742,8112678,64,0,utRho24
564,glnQ,1693262,1693262,1692926,336,170,utRho24
565,glnS,1411998,1412186,1411998,188,1310,utRho24
566,gloA,3455602,3455674,3455602,72,28,utRho24
567,gloB,469852,469852,469564,288,1152,utRho24
568,glpA,4705166,4705294,4705166,128,130,utRho24
569,glpD,7123942,7124026,7123942,84,298,utRho24
570,glpE,7123698,7123698,7123646,52,176,utRho24
571,glpF,8236322,8236322,8236180,142,1492,utRho24
572,glpG,7122960,7122960,7122904,56,266,utRho24
573,glpR,7121782,7121782,7121210,572,7080,utRho24
574,glpT,4704902,4704902,4704748,154,1564,utRho24
575,glpX,8231212,8231212,8231158,54,370,utRho24
576,glrK,5382246,5382246,5382196,50,478,utRho24
577,gltA,1509534,1509534,1508936,598,11706,utRho24
578,gltB,6709018,6709264,6709018,246,1038,utRho24
579,gltI,1375792,1375792,1375494,298,2208,utRho24
580,gltP,8588536,8588962,8588536,426,1180,utRho24
581,gltS,7657382,7657382,7657330,52,1420,utRho24
582,gltX,5041568,5041568,5041344,224,322,utRho24
583,gluQ,320286,320286,320224,62,0,utRho24
584,glyA,5371148,5371148,5371014,134,328,utRho24
585,glyQ,7450708,7450708,7450636,72,976,utRho24
586,glyS,7448990,7448990,7448794,196,724,utRho24
587,glyU,5998128,5998128,5998114,14,0,utRho24
588,glyV,8784626,8784720,8784626,94,32,utRho24
589,glyW,3984360,3984360,3984234,126,0,utRho24
590,gmhB,445612,445666,445612,54,126,utRho24
591,gmk,7642776,7642856,7642776,80,34,utRho24
592,gmr,2693686,2693686,2693484,202,862,utRho24
593,gnd,4202648,4202648,4202536,112,374,utRho24
594,gnsB,3275692,3275692,3275564,128,70,utRho24
595,gntK,14310580,14310580,14310368,212,1460,utRho24
596,gntP,9102668,9102668,9102592,76,436,utRho24
597,gntR,7157760,7157760,7157452,308,336,utRho24
598,gntT,7092810,7093118,7092810,308,2268,utRho24
599,gntU,7154170,7154170,7154122,48,450,utRho24
600,gntX,7089334,7089764,7089334,430,164,utRho24
601,gor,7292224,7292598,7292224,374,286,utRho24
602,gpmA,1575340,1575340,1575190,150,44,utRho24
603,gpmM,7570374,7570520,7570374,146,30,utRho24
604,gpsA,7567620,7567620,7567322,298,1374,utRho24
605,gpt,511828,511954,511828,126,460,utRho24
606,grcA,5433046,5433046,5432898,148,2368,utRho24
607,greA,6657728,6657728,6657430,298,340,utRho24
608,greB,7073488,7073624,7073488,136,196,utRho24
609,groL,8741566,8742050,8741566,484,8588,utRho24
610,groS,8741232,8741376,8741232,144,8068,utRho24
611,grpE,5501494,5501494,5501416,78,420,utRho24
612,grxA,1781552,1781552,1781506,46,10,utRho24
613,grxB,2248206,2248206,2248108,98,1032,utRho24
614,grxC,7569152,7569152,7568884,268,1194,utRho24
615,grxD,3468324,3468324,3468202,122,612,utRho24
616,gspA,6911268,6911268,6910796,472,716,utRho24
617,gspC,6910964,6911156,6910964,192,270,utRho24
618,gss,6277220,6277220,6277044,176,500,utRho24
619,gstA,3428654,3428754,3428654,100,0,utRho24
620,gstB,1761038,1761038,1760960,78,1240,utRho24
621,guaB,5268214,5268214,5268140,74,100,utRho24
622,gudD,5839026,5839026,5838770,256,46,utRho24
623,gyrA,4678914,4678914,4678840,74,496,utRho24
624,gyrB,7760300,7760300,7760238,62,90,utRho24
625,hcaE,5337964,5338064,5337964,100,8690,utRho24
626,hcaR,5337928,5337928,5337792,136,11052,utRho24
627,hcaT,5336106,5336106,5335692,414,1056,utRho24
628,hchA,4071260,4071670,4071260,410,60,utRho24
629,hcp,1828258,1828258,1827628,630,1676,utRho24
630,hcr,1824400,1824400,1824300,100,78,utRho24
631,hdeA,7313582,7313582,7313480,102,158,utRho24
632,hdeD,7313920,7313990,7313920,70,3066,utRho24
633,hdfR,7896320,7896320,7895934,386,144,utRho24
634,hdhA,3396244,3396244,3396080,164,140,utRho24
635,helD,2048876,2048942,2048876,66,48,utRho24
636,hemA,2527166,2527428,2527166,262,338,utRho24
637,hemB,779722,779722,779454,268,4950,utRho24
638,hemF,5106410,5106450,5106410,40,0,utRho24
639,hemH,996062,996110,996062,48,1064,utRho24
640,hemL,349882,349882,349764,118,122,utRho24
641,hemN,8103886,8104090,8103886,204,394,utRho24
642,hepA,127176,127176,126528,648,2962,utRho24
643,hflD,2385372,2385372,2385262,110,200,utRho24
644,hfq,8799602,8800576,8799602,974,3472,utRho24
645,hha,961006,961006,960616,390,90,utRho24
646,hicA,3018442,3018572,3018442,130,38,utRho24
647,higA,6468682,6468682,6468288,394,2750,utRho24
648,higB,6468960,6468960,6468910,50,158,utRho24
649,hinT,2323642,2323770,2323642,128,2,utRho24
650,hipB,3184964,3184964,3184884,80,184,utRho24
651,hisB,4186720,4186936,4186720,216,280,utRho24
652,hisJ,4853674,4853674,4853576,98,132,utRho24
653,hisL,8359856,8359984,8359856,128,896,utRho24
654,hisS,5281284,5281284,5281150,134,26,utRho24
655,hlpA,400910,400964,400910,54,2,utRho24
656,hlyE,2460932,2460932,2460788,144,1180,utRho24
657,hmp,5371594,5371670,5371594,76,0,utRho24
658,hns,2585916,2585916,2585844,72,204,utRho24
659,hofM,7045856,7045856,7045502,354,128,utRho24
660,hokA,7441620,7441620,7441200,420,792,utRho24
661,hokC,33902,33902,33806,96,164,utRho24
662,hokE,1215462,1215672,1215462,210,88,utRho24
663,holC,8968546,8968546,8968560,14,272,utRho24
664,holD,9215562,9215606,9215562,44,38,utRho24
665,holE,3850040,3850216,3850040,176,2256,utRho24
666,hpt,282720,282862,282720,142,1614,utRho24
667,hrpB,324150,324210,324150,60,90,utRho24
668,hscB,5319048,5319048,5318934,114,730,utRho24
669,hscC,1367188,1367188,1366786,402,534,utRho24
670,hsdS,9163004,9163004,9162924,80,350,utRho24
671,hslJ,2883560,2883560,2883486,74,814,utRho24
672,hslO,7059344,7059548,7059344,204,12450,utRho24
673,hslR,7058220,7058696,7058220,476,2690,utRho24
674,hslV,8244708,8244708,8244574,134,204,utRho24
675,hsrA,7881412,7881412,7881224,188,282,utRho24
676,htgA,21286,21660,21286,374,25524,utRho24
677,htpG,989634,990240,989634,606,23138,utRho24
678,htpX,3825236,3825236,3825152,84,6,utRho24
679,htrE,311036,311036,310852,184,1382,utRho24
680,htrL,7587668,7587668,7587366,302,254,utRho24
681,hupA,8400352,8400562,8400352,210,22,utRho24
682,hupB,1845220,1845804,1845220,584,732,utRho24
683,hyaA,2063968,2064278,2063968,310,146,utRho24
684,hybO,6292726,6292726,6292522,204,10224,utRho24
685,hycA,5700922,5700922,5700870,52,248,utRho24
686,hycI,5686204,5686204,5686086,118,3230,utRho24
687,hydN,5676264,5676264,5676210,54,92,utRho24
688,hyfA,5202342,5202402,5202342,60,152,utRho24
689,hypA,11402508,11402588,11402508,80,624,utRho24
690,hypB,11403356,11404004,11403356,648,540,utRho24
691,hypF,5676210,5676210,5674850,1360,8836,utRho24
692,hypT,9116634,9116634,9116578,56,2,utRho24
693,hyuA,6019660,6020056,6019660,396,522,utRho24
694,iaaA,1733074,1733136,1733074,62,158,utRho24
695,iadA,9119074,9119074,9119052,22,684,utRho24
696,iap,5753072,5753162,5753072,90,68,utRho24
697,ibaG,6673966,6673966,6673606,360,164,utRho24
698,ibpA,7735036,7735036,7734844,192,2314,utRho24
699,ibpB,7733962,7733962,7733794,168,12620,utRho24
700,icd,2389922,2390246,2389922,324,182,utRho24
701,iclR,8447304,8447304,8447256,48,266,utRho24
702,idi,6065876,6066130,6065876,254,22,utRho24
703,idnD,8988870,8988870,8988812,58,116,utRho24
704,idnK,8989194,8989246,8989194,52,908,utRho24
705,ihfA,3591442,3591442,3591104,338,176,utRho24
706,ihfB,1927498,1927656,1927498,158,446,utRho24
707,ileS,43666,44782,43666,1116,2826,utRho24
708,ileX,6431194,6431196,6431194,2,0,utRho24
709,ilvA,15820940,15821324,15820940,384,1512,utRho24
710,ilvC,7915824,7915940,7915824,116,114,utRho24
711,ilvE,15809552,15809936,15809552,384,976,utRho24
712,ilvI,170840,171260,170840,420,468,utRho24
713,ilvL,23701308,23701932,23701308,624,258,utRho24
714,ilvY,7915734,7915734,7915640,94,132,utRho24
715,inaA,4698998,4698998,4698944,54,1312,utRho24
716,infA,1853370,1853370,1852886,484,44,utRho24
717,infC,3602692,3602692,3601276,1416,1756,utRho24
718,insA-5,3958452,3958452,3958430,22,122,utRho24
719,insA-7,9036758,9037054,9036758,296,2698,utRho24
720,insC-5,6372080,6372284,6372080,204,6470,utRho24
721,insEF-2,785238,785238,785820,582,3656,utRho24
722,insEF-4,2190310,2190310,2190892,582,3432,utRho24
723,insG,9007098,9007098,9006862,236,42,utRho24
724,insH-1,550596,550596,550234,362,38170,utRho24
725,insH-11,7306538,7306538,7306396,142,332,utRho24
726,insH-2,1151548,1151548,1151506,42,268,utRho24
727,insH-3,1378444,1378444,1378026,418,790,utRho24
728,insH-4,2791942,2792152,2791942,210,354,utRho24
729,insH-5,2857852,2857852,2857452,400,790,utRho24
730,insH-6,4135022,4135022,4134642,380,1668,utRho24
731,insH-7,4206186,4206186,4205822,364,2516,utRho24
732,insH-9,6260050,6260356,6260050,306,1944,utRho24
733,insI-3,9017372,9017372,9017234,138,642,utRho24
734,insJ,7441188,7441360,7441188,172,322,utRho24
735,insK,7442130,7442308,7442130,178,40,utRho24
736,insL-1,30760,30890,30760,130,2054,utRho24
737,insL-2,1216112,1216130,1216112,18,160,utRho24
738,insL-3,5028644,5028662,5028644,18,120,utRho24
739,insN-1,540452,540484,540452,32,208,utRho24
740,intD,1132202,1132202,1131956,246,19780,utRho24
741,intR,2826520,2826520,2826470,50,136,utRho24
742,intS,4933026,4933090,4933026,64,2996,utRho24
743,intZ,5117386,5117542,5117386,156,7792,utRho24
744,iraD,9113152,9113986,9113152,834,708,utRho24
745,iraM,2424246,2424246,2424006,240,56,utRho24
746,iraP,802638,802772,802638,134,4,utRho24
747,iscA,5319924,5319924,5319772,152,494,utRho24
748,iscR,5324398,5324398,5324262,136,4314,utRho24
749,iscX,5313834,5313834,5313472,362,1088,utRho24
750,ispF,5743968,5743968,5743560,408,2058,utRho24
751,ispG,5283908,5283908,5283608,300,180,utRho24
752,ispU,389568,389806,389568,238,28,utRho24
753,isrA,2811502,2811502,2811618,116,20,utRho24
754,istr-1,7706384,7706384,7706384,0,0,utRho24
755,istr-2,7706514,7706514,7706514,0,0,utRho24
756,ivbL,15412092,15412092,15411952,140,292,utRho24
757,ivy,480638,480686,480638,48,288,utRho24
758,katE,3627628,3627734,3627628,106,610,utRho24
759,katG,8267624,8267670,8267624,46,104,utRho24
760,kbaZ,6557732,6557828,6557732,96,0,utRho24
761,kbl,7585154,7585154,7585102,52,532,utRho24
762,kch,2621046,2621046,2620538,508,552,utRho24
763,kdgR,3820506,3820506,3820198,308,52,utRho24
764,kdpE,1443788,1443788,1443466,322,254,utRho24
765,kdpF,1457698,1457698,1457642,56,186,utRho24
766,kdsA,2535708,2536330,2535708,622,966,utRho24
767,kdsC,6683438,6684546,6683438,1108,3862,utRho24
768,kduI,5968388,5968388,5968248,140,23528,utRho24
769,kefF,94160,94492,94160,332,3618,utRho24
770,kgtP,5451624,5451624,5451492,132,214,utRho24
771,kup,7862206,7862632,7862206,426,408,utRho24
772,lacI,735076,735076,735020,56,280,utRho24
773,lacZ,1465508,1465508,1465220,288,2168,utRho24
774,ldcA,2486394,2486394,2486160,234,552,utRho24
775,ldhA,2885830,2885830,2885686,144,38,utRho24
776,ldrA,2538954,2538954,2538550,404,1612,utRho24
777,ldrB,2540024,2540024,2539620,404,410,utRho24
778,ldrC,2541092,2541092,2540690,402,564,utRho24
779,ldrD,7400544,7400544,7400174,370,592,utRho24
780,lepA,5414392,5414392,5414248,144,154,utRho24
781,lepB,5410928,5410928,5410618,310,156,utRho24
782,leuD,159188,159188,158906,282,142,utRho24
783,leuE,3761600,3761600,3761518,82,236,utRho24
784,leuL,168048,168048,167416,632,192,utRho24
785,leuO,168308,168736,168308,428,12,utRho24
786,leuQ,9212864,9212864,9212802,62,0,utRho24
787,leuU,6644556,6644556,6644316,240,326,utRho24
788,leuV,9212546,9212546,9212330,216,518,utRho24
789,leuX,8992772,8992810,8992772,38,22,utRho24
790,lexA,8514174,8514230,8514174,56,356,utRho24
791,lhr,3456706,3458174,3456706,1468,5094,utRho24
792,ligA,5060402,5060402,5060352,50,0,utRho24
793,ligB,7642576,7642576,7642340,236,794,utRho24
794,lipA,1320602,1320602,1320432,170,362,utRho24
795,lipB,1324802,1324802,1324556,246,7644,utRho24
796,lit,2397032,2397390,2397032,358,3918,utRho24
797,livJ,7199524,7199524,7199316,208,2100,utRho24
798,livK,7195510,7195510,7195120,390,990,utRho24
799,lldP,7554578,7554798,7554578,220,2934,utRho24
800,lnt,1381968,1381968,1381762,206,484,utRho24
801,loiP,6163784,6163826,6163784,42,28,utRho24
802,lolA,1874656,1874738,1874656,82,150,utRho24
803,lolB,2527112,2527112,2527000,112,212,utRho24
804,lolC,2350748,2350854,2350748,106,76,utRho24
805,lon,917630,917776,917630,146,56,utRho24
806,lpcA,486936,487086,486936,150,148,utRho24
807,lpd,255434,255824,255434,390,936,utRho24
808,lplA,9248476,9248476,9248234,242,1030,utRho24
809,lplT,5947878,5947878,5947724,154,104,utRho24
810,lpoA,6586422,6586800,6586422,378,976,utRho24
811,lpp,3514592,3514842,3514592,250,250,utRho24
812,lptA,6686598,6686760,6686598,162,792,utRho24
813,lptB,6686792,6687888,6686792,1096,1680,utRho24
814,lptD,114672,114672,114218,454,2198,utRho24
815,lptF,8972244,8972436,8972244,192,102,utRho24
816,lpxC,213016,213114,213016,98,1280,utRho24
817,lpxD,401920,401942,401920,22,0,utRho24
818,lpxL,2233418,2233418,2233164,254,30,utRho24
819,lpxM,3880456,3880456,3880386,70,34,utRho24
820,lpxP,4991156,4991290,4991156,134,630,utRho24
821,lrhA,4813312,4813312,4813282,30,6,utRho24
822,lrp,1864656,1865190,1864656,534,634,utRho24
823,lspA,50028,50414,50028,386,428,utRho24
824,lsrA,3202920,3202980,3202920,60,112,utRho24
825,lsrR,3202514,3202514,3202482,32,0,utRho24
826,ltaE,1818640,1818640,1818588,52,68,utRho24
827,luxS,5630130,5630130,5629466,664,5286,utRho24
828,lysA,5957902,5957902,5957798,104,136,utRho24
829,lysC,8467232,8467232,8466466,766,2084,utRho24
830,lysP,4497120,4497120,4497064,56,226,utRho24
831,lysR,5957900,5958042,5957900,142,78,utRho24
832,lysT,1561028,1561108,1561028,80,62,utRho24
833,lysU,8709610,8709610,8709434,176,198,utRho24
834,macB,1840188,1840694,1840188,506,884,utRho24
835,maeA,3111484,3111484,3111338,146,1814,utRho24
836,mak,820236,820288,820236,52,54,utRho24
837,malE,8492928,8492928,8492838,90,2,utRho24
838,malI,3398456,3398456,3398360,96,38,utRho24
839,malK,8493472,8493568,8493472,96,210,utRho24
840,malP,7105020,7105020,7104946,74,1192,utRho24
841,malQ,7100798,7100798,7100140,658,372,utRho24
842,malS,14949880,14949988,14949880,108,4,utRho24
843,malT,7106048,7106170,7106048,122,288,utRho24
844,malX,3398626,3398710,3398626,84,0,utRho24
845,malZ,1689980,1690072,1689980,92,1288,utRho24
846,manA,3377102,3377152,3377102,50,44,utRho24
847,manX,3803866,3804096,3803866,230,326,utRho24
848,marC,3237882,3237882,3237816,66,350,utRho24
849,marR,3238186,3238240,3238186,54,342,utRho24
850,matP,2036918,2036970,2036918,52,92,utRho24
851,mazE,5822736,5822736,5822678,58,60,utRho24
852,mazG,5821720,5821720,5821370,350,4472,utRho24
853,mcbA,1684306,1684306,1684112,194,210,utRho24
854,mcbR,3040192,3040524,3040192,332,92,utRho24
855,mcrA,2420278,2420692,2420278,414,430,utRho24
856,mcrC,9156124,9156124,9155916,208,1292,utRho24
857,mdaB,6344814,6345060,6344814,246,202,utRho24
858,mdfA,1767138,1767346,1767138,208,0,utRho24
859,mdh,6768940,6768940,6768536,404,324,utRho24
860,mdoB,9198988,9198988,9198882,106,4660,utRho24
861,mdoD,2993290,2993712,2993290,422,212,utRho24
862,mdoG,2218514,2218670,2218514,156,256,utRho24
863,mdtA,4307958,4308032,4307958,74,20,utRho24
864,mdtE,7318168,7318464,7318168,296,2784,utRho24
865,mdtK,3486538,3486914,3486538,376,4366,utRho24
866,mdtP,8602472,8602472,8602060,412,2892,utRho24
867,melA,8683774,8683822,8683774,48,16,utRho24
868,melR,8683300,8683300,8683256,44,1414,utRho24
869,menA,8240812,8240812,8240698,114,58,utRho24
870,menB,4753774,4753774,4753638,136,532,utRho24
871,mepH,3468714,3468870,3468714,156,0,utRho24
872,mepM,3883666,3883666,3883270,396,140,utRho24
873,mepS,4539840,4539958,4539840,118,190,utRho24
874,metA,8428318,8428560,8428318,242,160,utRho24
875,metB,8257272,8257344,8257272,72,826,utRho24
876,metC,6304150,6304472,6304150,322,480,utRho24
877,metE,8025768,8026106,8025768,338,3030,utRho24
878,metF,8265092,8265232,8265092,140,172,utRho24
879,metG,4388538,4388600,4388538,62,100,utRho24
880,metH,8447010,8447656,8447010,646,4450,utRho24
881,metJ,8257116,8257116,8256790,326,350,utRho24
882,metK,6173154,6173412,6173154,258,98,utRho24
883,metN,445428,445428,445290,138,30,utRho24
884,metR,8025710,8025710,8025632,78,36,utRho24
885,metT,1394326,1394326,1394266,60,224,utRho24
886,metY,19910250,19910250,19909734,516,474,utRho24
887,metZ,11789528,11789548,11789528,20,196,utRho24
888,mfd,2348056,2348056,2347928,128,136,utRho24
889,mglA,4478782,4478782,4478578,204,300,utRho24
890,mglB,4481132,4481132,4480696,436,9380,utRho24
891,mglC,4475918,4475918,4475506,412,310,utRho24
892,mgrB,3817584,3817584,3817532,52,82,utRho24
893,mgrR,3245828,3245828,3245828,0,0,utRho24
894,mgsA,2054082,2054082,2054030,52,30,utRho24
895,mgtL,8934560,8934862,8934560,302,122,utRho24
896,mhpA,737038,737222,737038,184,674,utRho24
897,mhpR,737072,737072,736840,232,350,utRho24
898,mhpT,750772,750918,750772,146,168,utRho24
899,miaA,8797964,8798504,8797964,540,1694,utRho24
900,micA,5629604,5629604,5629604,0,0,utRho24
901,micC,2874242,2874238,2874242,4,0,utRho24
902,micF,4626168,4626168,4626168,0,0,utRho24
903,micM,1014408,1014408,1014408,0,0,utRho24
904,minE,2449422,2449422,2449090,332,314,utRho24
905,mioC,7852950,7852950,7852910,40,0,utRho24
906,mipA,3733012,3733012,3732944,68,848,utRho24
907,mlaA,4930270,4930270,4930014,256,56,utRho24
908,mlc,3337206,3337206,3337128,78,292,utRho24
909,mlrA,4429498,4429732,4429498,234,490,utRho24
910,mltA,5894546,5894546,5894356,190,320,utRho24
911,mltD,468050,468050,467910,140,78,utRho24
912,mltF,5391534,5391602,5391534,68,0,utRho24
913,mmuP,550238,550650,550238,412,46098,utRho24
914,mngA,1531622,1531968,1531622,346,684,utRho24
915,mngR,1531852,1531852,1531750,102,448,utRho24
916,mnmG,7851348,7851348,7851266,82,2408,utRho24
917,mntH,5025470,5025470,5025412,58,16,utRho24
918,mntP,3810918,3811376,3810918,458,1938,utRho24
919,mntR,1706160,1706366,1706160,206,36,utRho24
920,mntS,1706128,1706128,1705994,134,36,utRho24
921,moaA,1633654,1634088,1633654,434,2318,utRho24
922,moaB,1635954,1636110,1635954,156,1796,utRho24
923,mobA,8084242,8084242,8083998,244,320,utRho24
924,mocA,6030112,6030320,6030112,208,122,utRho24
925,modA,1589990,1590178,1589990,188,174,utRho24
926,moeA,1732788,1732788,1732728,60,184,utRho24
927,mokB,2984610,2984610,2984258,352,688,utRho24
928,molR_1,4392888,4392948,4392888,60,218,utRho24
929,motA,3954604,3954604,3954278,326,124,utRho24
930,mpaA,2781278,2781278,2781196,82,750,utRho24
931,mpl,8911456,8911570,8911456,114,304,utRho24
932,mppA,2786108,2786454,2786108,346,128,utRho24
933,mprA,5621494,5621540,5621494,46,686,utRho24
934,mqo,4613848,4613848,4613508,340,988,utRho24
935,mqsA,6336742,6336742,6336492,250,438,utRho24
936,mqsR,6337306,6337306,6337088,218,1254,utRho24
937,mraZ,179192,179268,179192,76,100,utRho24
938,mrcA,7045652,7045742,7045652,90,86,utRho24
939,mrcB,329442,329460,329442,18,0,utRho24
940,mreB,13605424,13605424,13604348,1076,620,utRho24
941,mreD,6798166,6798166,6797750,416,168,utRho24
942,mrp,4388360,4388360,4388336,24,50,utRho24
943,mscK,972984,973072,972984,88,188,utRho24
944,mscL,6876002,6876048,6876002,46,772,utRho24
945,mscS,6139742,6139742,6139614,128,426,utRho24
946,msrA,8884522,8884522,8884352,170,1272,utRho24
947,msrB,3725168,3725168,3724858,310,0,utRho24
948,msyB,2228426,2228426,2228362,64,308,utRho24
949,mtfA,4087236,4087302,4087236,66,402,utRho24
950,mtgA,6699662,6699662,6699618,44,1844,utRho24
951,mtlA,30177504,30178248,30177504,744,8664,utRho24
952,mtn,358366,358366,358306,60,3036,utRho24
953,mtr,6611864,6611864,6611634,230,146,utRho24
954,mug,6430992,6430992,6430946,46,76,utRho24
955,murQ,5091466,5091546,5091466,80,64,utRho24
956,murR,5091586,5091586,5091218,368,236,utRho24
957,mutH,5939164,5939324,5939164,160,396,utRho24
958,mutL,8794092,8794824,8794092,732,4666,utRho24
959,mutM,7622554,7622554,7622304,250,88,utRho24
960,mutS,5714038,5714186,5714038,148,1864,utRho24
961,mutY,18617466,18618078,18617466,612,1068,utRho24
962,nac,4123956,4123956,4123866,90,1014,utRho24
963,nadA,1564122,1564170,1564122,48,26,utRho24
964,nadB,5420714,5420840,5420714,126,342,utRho24
965,nadC,237326,237326,237290,36,312,utRho24
966,nadE,3644604,3644916,3644604,312,826,utRho24
967,nadK,5501526,5501662,5501526,136,296,utRho24
968,nagA,1406350,1406350,1405502,848,2796,utRho24
969,nagB,1407416,1407416,1407222,194,250,utRho24
970,nagC,1404016,1404016,1403188,828,256,utRho24
971,nagE,1407680,1407888,1407680,208,344,utRho24
972,nagK,2357080,2357186,2357080,106,88,utRho24
973,nanA,6747240,6747240,6747152,88,1690,utRho24
974,nanC,9079856,9079856,9079002,854,890,utRho24
975,nanR,6749406,6749406,6748978,428,1524,utRho24
976,nanS,9075406,9075406,9075188,218,130,utRho24
977,napF,4607390,4607390,4606994,396,248,utRho24
978,narG,2559614,2559728,2559614,114,1130,utRho24
979,narK,2555642,2555914,2555642,272,584,utRho24
980,narP,4580844,4581000,4580844,156,352,utRho24
981,narQ,5171154,5171462,5171154,308,624,utRho24
982,narU,3088326,3088326,3088120,206,640,utRho24
983,narW,3077374,3077374,3074618,2756,4506,utRho24
984,narX,2555554,2555554,2555236,318,348,utRho24
985,narZ,3085380,3085380,3085180,200,68,utRho24
986,ndh,2331984,2332170,2331984,186,776,utRho24
987,ndk,5289920,5289920,5289728,192,694,utRho24
988,nemR,6904084,6904092,6904084,8,2176,utRho24
989,nepI,7683542,7683542,7683478,64,352,utRho24
990,nfo,4501612,4501680,4501612,68,114,utRho24
991,nfsB,1210906,1210906,1210848,58,178,utRho24
992,nfuA,7090916,7091248,7090916,332,526,utRho24
993,nhaA,34634,34978,34634,344,830,utRho24
994,nhaB,2469534,2469534,2469434,100,224,utRho24
995,nhoA,3067926,3068048,3067926,122,28,utRho24
996,nikA,7226878,7227334,7226878,456,5032,utRho24
997,nikR,7237074,7237176,7237074,102,118,utRho24
998,nirB,6987974,6988022,6987974,48,156,utRho24
999,nlpA,7680034,7680034,7679986,48,56,utRho24
1000,nlpC,3585654,3585654,3585462,192,70,utRho24
1001,nlpD,5737658,5737658,5737506,152,130,utRho24
1002,nlpI,6618080,6618080,6617848,232,0,utRho24
1003,nmpC,1153740,1153740,1153650,90,22,utRho24
1004,nohA,3273206,3273206,3272734,472,1846,utRho24
1005,norR,5664614,5664614,5664578,36,108,utRho24
1006,norV,5664878,5664952,5664878,74,144,utRho24
1007,nrdA,4689510,4689730,4689510,220,6126,utRho24
1008,nrdD,8925676,8925676,8925320,356,3126,utRho24
1009,nrdH,5601312,5601446,5601312,134,522,utRho24
1010,nrdR,865954,866004,865954,50,142,utRho24
1011,nrfA,8575342,8575528,8575342,186,0,utRho24
1012,nsrR,8812088,8812380,8812088,292,5112,utRho24
1013,nudB,3897348,3897348,3897264,84,0,utRho24
1014,nudC,8393428,8393806,8393428,378,580,utRho24
1015,nudE,7052658,7052658,7052298,360,1686,utRho24
1016,nudG,3682876,3682980,3682876,104,68,utRho24
1017,nudI,4729050,4729108,4729050,58,92,utRho24
1018,nudJ,2388874,2388874,2388576,298,434,utRho24
1019,nuoA,4810670,4810670,4810144,526,1078,utRho24
1020,nuoN,4783434,4783434,4783010,424,734,utRho24
1021,nupC,5026018,5026084,5026018,66,0,utRho24
1022,nupG,6211302,6211428,6211302,126,292,utRho24
1023,ogrK,4335096,4335096,4335040,56,0,utRho24
1024,ogt,2800568,2800568,2800472,96,346,utRho24
1025,ohsC,5401036,5401040,5401036,4,0,utRho24
1026,ompA,2040382,2040382,2040106,276,9638,utRho24
1027,ompC,4625774,4625774,4625498,276,214,utRho24
1028,ompF,1974184,1974184,1973964,220,0,utRho24
1029,ompL,8128958,8128958,8128590,368,604,utRho24
1030,ompN,2874158,2874158,2873786,372,36,utRho24
1031,ompR,7073510,7073510,7073168,342,352,utRho24
1032,ompT,1171330,1171330,1171266,64,70,utRho24
1033,ompW,2627982,2628040,2627982,58,34,utRho24
1034,ompX,1700418,1700900,1700418,482,556,utRho24
1035,omrA,5952378,5952378,5952378,0,0,utRho24
1036,omrB,5952770,5952770,5952770,0,0,utRho24
1037,oppA,2602170,2602364,2602170,194,4374,utRho24
1038,orn,8783168,8783208,8783168,40,156,utRho24
1039,osmB,2686952,2686952,2686656,296,1882,utRho24
1040,osmC,3113192,3113250,3113192,58,196,utRho24
1041,osmE,3644566,3644566,3644512,54,202,utRho24
1042,osmF,4439046,4439046,4438962,84,2308,utRho24
1043,osmY,9222306,9222792,9222306,486,328,utRho24
1044,otsA,3963302,3963302,3963224,78,568,utRho24
1045,otsB,3964930,3964930,3964774,156,900,utRho24
1046,oxc,4984288,4984288,4983900,388,2700,utRho24
1047,oxyR,8316914,8316980,8316914,66,2228,utRho24
1048,oxyS,8316788,8316788,8316788,0,0,utRho24
1049,paaA,2907730,2907854,2907730,124,0,utRho24
1050,paaX,2927018,2927078,2927018,60,0,utRho24
1051,paaZ,2907340,2907340,2907284,56,14,utRho24
1052,pabA,6981702,6981702,6981658,44,122,utRho24
1053,pabB,3789256,3789610,3789256,354,906,utRho24
1054,pabC,2306186,2306600,2306186,414,300,utRho24
1055,pagP,1313052,1313114,1313052,62,2,utRho24
1056,panB,299260,299260,299202,58,7374,utRho24
1057,panC,297840,297840,297590,250,434,utRho24
1058,panD,293490,293490,293388,102,70,utRho24
1059,panZ,7195656,7195968,7195656,312,250,utRho24
1060,parC,6332060,6332060,6331946,114,368,utRho24
1061,patA,6438916,6438988,6438916,72,166,utRho24
1062,patD,3030830,3031156,3030830,326,412,utRho24
1063,pbpC,5294986,5294986,5294650,336,106,utRho24
1064,pbpG,4450132,4450132,4449740,392,4,utRho24
1065,pck,7065358,7065636,7065358,278,3534,utRho24
1066,pcnB,318782,318782,318252,530,450,utRho24
1067,pdhR,244068,244184,244068,116,24,utRho24
1068,pdxB,4875768,4875768,4875702,66,124,utRho24
1069,pdxH,3436068,3436068,3436014,54,88,utRho24
1070,pdxJ,5403626,5403626,5403458,168,134,utRho24
1071,pdxK,5074638,5074638,5074474,164,22,utRho24
1072,pepA,8972278,8972278,8971902,376,106,utRho24
1073,pepD,511618,511618,511432,186,886,utRho24
1074,pepN,1981182,1981244,1981182,62,356,utRho24
1075,pepQ,8062294,8062322,8062294,28,2,utRho24
1076,pepT,2371646,2371688,2371646,42,218,utRho24
1077,pfkA,8214948,8215104,8214948,156,806,utRho24
1078,pfkB,3612646,3612740,3612646,94,106,utRho24
1079,pflA,1902456,1902456,1902160,296,26,utRho24
1080,pflB,1907850,1907850,1907108,742,1160,utRho24
1081,pflD,8287716,8287990,8287716,274,72,utRho24
1082,pgaA,2185046,2185046,2184578,468,598,utRho24
1083,pgi,8467444,8467516,8467444,72,32,utRho24
1084,pgk,12291428,12291428,12290488,940,3884,utRho24
1085,pgl,1597078,1597172,1597078,94,106,utRho24
1086,pgpB,2678324,2678660,2678324,336,646,utRho24
1087,pgpC,5397276,5397276,5397100,176,212,utRho24
1088,pgrR,2783744,2783982,2783744,238,722,utRho24
1089,pheL,5475158,5475198,5475158,40,24,utRho24
1090,pheM,7197204,7197204,7197080,124,56,utRho24
1091,pheP,1203858,1203918,1203858,60,586,utRho24
1092,pheU,8725254,8725254,8725252,2,0,utRho24
1093,pheV,6220730,6220732,6220730,2,0,utRho24
1094,phnC,8650412,8650412,8650330,82,440,utRho24
1095,phoA,803414,803494,803414,80,396,utRho24
1096,phoB,834202,834284,834202,82,56,utRho24
1097,phoE,520316,520316,520200,116,1932,utRho24
1098,phoH,2169730,2169984,2169730,254,712,utRho24
1099,phoP,2381016,2381016,2380894,122,2564,utRho24
1100,phoQ,2379880,2379880,2379552,328,562,utRho24
1101,phoU,7815330,7815330,7815156,174,244,utRho24
1102,phr,1478842,1479014,1478842,172,432,utRho24
1103,pinE,2419054,2419370,2419054,316,1586,utRho24
1104,pinQ,3267168,3267244,3267168,76,572,utRho24
1105,pinR,2867424,2867424,2867348,76,614,utRho24
1106,pitA,7275224,7275284,7275224,60,56,utRho24
1107,pitB,6272806,6272806,6272742,64,1110,utRho24
1108,pka,5439862,5439906,5439862,44,566,utRho24
1109,plaP,4174476,4174476,4174124,352,270,utRho24
1110,pldA,8009628,8009724,8009628,96,2760,utRho24
1111,pldB,8018028,8018340,8018028,312,4478,utRho24
1112,plsB,8513196,8513196,8512932,264,394,utRho24
1113,pmbA,8915890,8915918,8915890,28,52,utRho24
1114,pmrD,4747148,4747148,4747076,72,86,utRho24
1115,pncB,1980828,1980828,1980712,116,100,utRho24
1116,pncC,5648788,5648788,5648692,96,0,utRho24
1117,pnp,6622652,6622652,6622336,316,2,utRho24
1118,pntA,3355950,3355950,3355806,144,82,utRho24
1119,pntB,3353096,3353096,3352720,376,480,utRho24
1120,polA,8093880,8093932,8093880,52,350,utRho24
1121,polB,131606,131606,131560,46,0,utRho24
1122,potD,2365700,2365700,2365658,42,78,utRho24
1123,potE,1436688,1436688,1436530,158,118,utRho24
1124,potF,1787268,1787568,1787268,300,816,utRho24
1125,poxB,1822152,1822152,1822098,54,616,utRho24
1126,ppa,8899372,8899372,8899304,68,0,utRho24
1127,ppc,8306380,8306380,8306196,184,1678,utRho24
1128,ppdA,5928440,5928440,5928354,86,2862,utRho24
1129,ppdD,235410,235410,235098,312,196,utRho24
1130,pphA,3846770,3846770,3845938,832,3326,utRho24
1131,pphB,5719474,5719520,5719474,46,168,utRho24
1132,ppiA,6984898,6984898,6984594,304,48,utRho24
1133,ppiC,7919682,7919682,7919626,56,72,utRho24
1134,ppiD,923638,923830,923638,192,156,utRho24
1135,ppk,5245748,5246088,5245748,340,636,utRho24
1136,pppA,6228958,6228958,6228704,254,354,utRho24
1137,ppsA,3574322,3574322,3574224,98,0,utRho24
1138,ppsR,3574678,3574890,3574678,212,294,utRho24
1139,pptA,3065716,3066104,3065716,388,1604,utRho24
1140,pqiA,2023318,2024002,2023318,684,70,utRho24
1141,prc,3830054,3830054,3829632,422,4268,utRho24
1142,preT,4467978,4468066,4467978,88,1728,utRho24
1143,prfC,9218688,9218828,9218688,140,364,utRho24
1144,prkB,6968622,6968980,6968622,358,2348,utRho24
1145,prlC,7290476,7290476,7290364,112,720,utRho24
1146,prlF,6553944,6554004,6553944,60,1080,utRho24
1147,proB,520432,520776,520432,344,1482,utRho24
1148,proC,811372,811372,811288,84,0,utRho24
1149,proK,7417388,7417388,7417384,4,0,utRho24
1150,proL,4572414,4572422,4572414,8,8,utRho24
1151,proP,8660640,8661004,8660640,364,734,utRho24
1152,proS,437674,437674,437550,124,596,utRho24
1153,proV,5609126,5609630,5609126,504,1510,utRho24
1154,prpB,697292,697364,697292,72,188,utRho24
1155,prpR,696942,696942,696886,56,56,utRho24
1156,prs,2524354,2524354,2523750,604,11914,utRho24
1157,psd,8781276,8781276,8780720,556,1582,utRho24
1158,psiE,8480600,8480650,8480600,50,80,utRho24
1159,pspA,2736076,2736158,2736076,82,12,utRho24
1160,pspF,2736080,2736080,2735824,256,76,utRho24
1161,pspG,8525632,8525680,8525632,48,64,utRho24
1162,pssA,5445156,5445454,5445156,298,3516,utRho24
1163,pstB,7817112,7817112,7816732,380,60,utRho24
1164,pstC,7821084,7821084,7820796,288,188,utRho24
1165,pstS,23469408,23469408,23469150,258,120,utRho24
1166,psuG,4517114,4517114,4516734,380,5642,utRho24
1167,psuT,4514992,4514992,4514670,322,150,utRho24
1168,pth,2517084,2517084,2517026,58,20,utRho24
1169,ptrA,5918022,5918022,5917768,254,0,utRho24
1170,ptrB,3857730,3857730,3857678,52,2980,utRho24
1171,ptsG,2315252,2315738,2315252,486,1118,utRho24
1172,ptsH,5066996,5067528,5066996,532,1540,utRho24
1173,purA,8809328,8809374,8809328,46,8,utRho24
1174,purC,5195562,5195562,5195236,326,286,utRho24
1175,purD,8411972,8411972,8411862,110,310,utRho24
1176,purE,1106284,1106284,1106200,84,512,utRho24
1177,purH,8415254,8415254,8415064,190,146,utRho24
1178,purL,5391178,5391178,5391086,92,416,utRho24
1179,purM,5242306,5242394,5242306,88,168,utRho24
1180,purR,3475378,3475688,3475378,310,34,utRho24
1181,purT,3861438,3861762,3861438,324,432,utRho24
1182,purU,2577512,2577512,2577248,264,154,utRho24
1183,putA,2157850,2157850,2157764,86,88,utRho24
1184,putP,2158336,2158610,2158336,274,116,utRho24
1185,puuA,2721936,2721936,2721816,120,0,utRho24
1186,puuC,2725456,2725486,2725456,30,26,utRho24
1187,puuD,2722104,2722240,2722104,136,34,utRho24
1188,puuP,2718746,2718746,2718374,372,1138,utRho24
1189,pykA,3874988,3875298,3874988,310,398,utRho24
1190,pykF,3510934,3511396,3510934,462,1654,utRho24
1191,pyrC,2245286,2245286,2245214,72,8,utRho24
1192,pyrD,2009464,2009536,2009464,72,472,utRho24
1193,pyrE,7631970,7631970,7631536,434,344,utRho24
1194,pyrF,2683740,2683842,2683740,102,210,utRho24
1195,pyrG,5819594,5819594,5819332,262,1338,utRho24
1196,pyrH,383624,383710,383624,86,266,utRho24
1197,pyrL,8945490,8945490,8945066,424,440,utRho24
1198,qmcA,1031646,1031646,1031546,100,502,utRho24
1199,qor,8528608,8528608,8528462,146,194,utRho24
1200,qseB,6339502,6339656,6339502,154,1680,utRho24
1201,queA,849970,850022,849970,52,380,utRho24
1202,queE,5811212,5811212,5810836,376,182,utRho24
1203,queF,5850642,5850696,5850642,54,0,utRho24
1204,queG,8788184,8788184,8788134,50,48862,utRho24
1205,racC,2835630,2835630,2835526,104,34,utRho24
1206,racR,2840898,2840898,2840482,416,1168,utRho24
1207,raiA,5474208,5474308,5474208,100,84,utRho24
1208,rarD,8008594,8008594,8008356,238,764,utRho24
1209,ravA,7862256,7862256,7862186,70,86,utRho24
1210,rayT,495088,495274,495088,186,350,utRho24
1211,rbn,4763162,4763216,4763162,54,20,utRho24
1212,rbsD,7866644,7866702,7866644,58,0,utRho24
1213,rcnA,4371654,4371834,4371654,180,346,utRho24
1214,rcnB,4373768,4373920,4373768,152,106,utRho24
1215,rcnR,4371806,4371806,4371592,214,634,utRho24
1216,rcsA,4047672,4047936,4047672,264,5606,utRho24
1217,rcsB,4631390,4632354,4631390,964,752,utRho24
1218,rcsC,4640162,4640162,4639656,506,244,utRho24
1219,rcsD,4626904,4626976,4626904,72,266,utRho24
1220,rdgB,6193240,6193362,6193240,122,586,utRho24
1221,rdlA,2538646,2538646,2538646,0,0,utRho24
1222,rdlB,2539712,2539716,2539712,4,34,utRho24
1223,rdlC,2540782,2540786,2540782,4,24,utRho24
1224,rdlD,7400272,7400272,7400272,0,0,utRho24
1225,rdoA,8084782,8084830,8084782,48,92,utRho24
1226,recA,11295276,11295276,11295076,200,84,utRho24
1227,recC,5925014,5925014,5924856,158,56,utRho24
1228,recF,7763722,7763722,7762442,1280,3990,utRho24
1229,recN,5503518,5503590,5503518,72,28,utRho24
1230,recQ,8011666,8011728,8011666,62,84,utRho24
1231,relA,5828554,5828554,5827302,1252,588,utRho24
1232,relB,3291806,3291806,3291744,62,134,utRho24
1233,rem,3289950,3289950,3289804,146,142,utRho24
1234,rep,7921294,7921354,7921294,60,210,utRho24
1235,rfaD,7587730,7587974,7587730,244,1122,utRho24
1236,rfaE,6393852,6393852,6393506,346,392,utRho24
1237,rfaH,8049930,8049930,8049642,288,1762,utRho24
1238,rfbX,4219436,4219436,4219168,268,890,utRho24
1239,rfe,7935600,7935832,7935600,232,66,utRho24
1240,rhaB,8194944,8194944,8194896,48,64,utRho24
1241,rhaD,8188770,8188770,8188544,226,58,utRho24
1242,rhaS,8195422,8195472,8195422,50,48,utRho24
1243,rhaT,8201132,8201132,8201050,82,246,utRho24
1244,rhlE,1661566,1661744,1661566,178,402,utRho24
1245,rhoL,47593944,47594772,47593944,828,52116,utRho24
1246,rhsB,7238006,7238384,7238006,378,1170,utRho24
1247,rhsC,1458758,1459166,1458758,408,4,utRho24
1248,rhsD,1046132,1046522,1046132,390,252,utRho24
1249,rhtA,1700608,1700608,1700194,414,810,utRho24
1250,rhtC,8015478,8015514,8015478,36,1354,utRho24
1251,ribA,2678468,2678468,2678320,148,424,utRho24
1252,ribC,3486916,3486916,3486484,432,7530,utRho24
1253,ribE,869008,869294,869008,286,1880,utRho24
1254,ribF,42766,42814,42766,48,154,utRho24
1255,ridA,8941892,8941892,8941826,66,76,utRho24
1256,rihA,1369204,1369204,1368824,380,5524,utRho24
1257,rihB,4510504,4510504,4510372,132,170,utRho24
1258,rimJ,2251044,2251124,2251044,80,160,utRho24
1259,rimK,1783752,1783934,1783752,182,638,utRho24
1260,rimL,2997486,2997876,2997486,390,86,utRho24
1261,rimO,1756140,1756140,1756070,70,96,utRho24
1262,rimP,6636350,6636350,6636012,338,298,utRho24
1263,rlmA,3814172,3814172,3814120,52,254,utRho24
1264,rlmD,5830086,5830086,5830000,86,42,utRho24
1265,rlmE,6655520,6655520,6655328,192,534,utRho24
1266,rlmF,1684384,1684664,1684384,280,896,utRho24
1267,rlmG,6471784,6471784,6471750,34,124,utRho24
1268,rlmI,2060002,2060002,2059938,64,100,utRho24
1269,rlmJ,7290700,7290770,7290700,70,0,utRho24
1270,rlmL,2015344,2015688,2015344,344,1968,utRho24
1271,rlpA,1330444,1330444,1330380,64,210,utRho24
1272,rluA,120900,120900,120692,208,820,utRho24
1273,rluF,8460324,8460708,8460324,384,276,utRho24
1274,rmf,2031006,2031430,2031006,424,638,utRho24
1275,rna,1290068,1290068,1290006,62,0,utRho24
1276,rnb,2698258,2698258,2697824,434,3942,utRho24
1277,rnc,10816892,10816892,10816252,640,7100,utRho24
1278,rnd,3776122,3776122,3775982,140,2,utRho24
1279,rne,2289746,2289746,2288734,1012,3416,utRho24
1280,rnhA,472082,472082,472004,78,1538,utRho24
1281,rnk,1288360,1288360,1287934,426,60,utRho24
1282,rnlA,5531788,5531836,5531788,48,1324,utRho24
1283,rnlB,5533414,5533968,5533414,554,1440,utRho24
1284,rnpB,19623552,19623552,19623552,0,0,utRho24
1285,rob,9270706,9270706,9270620,86,130,utRho24
1286,rodZ,5285868,5285868,5285688,180,144,utRho24
1287,rpe,7030306,7030306,7030118,188,172,utRho24
1288,rph,15266320,15266320,15266196,124,344,utRho24
1289,rpiA,6118706,6118706,6118650,56,1524,utRho24
1290,rpiB,8626514,8626700,8626514,186,742,utRho24
1291,rpiR,8626274,8626274,8625982,292,278,utRho24
1292,rplJ,8359246,8359992,8359246,746,1262,utRho24
1293,rplK,8356708,8356894,8356708,186,58,utRho24
1294,rplM,6757344,6757344,6757302,42,732,utRho24
1295,rplN,6896444,6896444,6896298,146,342,utRho24
1296,rplS,5489284,5489284,5489060,224,1466,utRho24
1297,rplT,7199052,7199052,7198996,56,72,utRho24
1298,rplU,6667036,6667036,6666902,134,126,utRho24
1299,rplY,4564866,4565034,4564866,168,184,utRho24
1300,rpmA,6666450,6666450,6666238,212,48,utRho24
1301,rpmB,15247980,15247980,15246696,1284,16536,utRho24
1302,rpmE,8253816,8254026,8253816,210,534,utRho24
1303,rpmF,2294676,2294734,2294676,58,2584,utRho24
1304,rpmH,7768130,7768672,7768130,542,736,utRho24
1305,rpmI,3600854,3600854,3599998,856,1300,utRho24
1306,rpoB,8362126,8362490,8362126,364,352,utRho24
1307,rpoD,6424946,6426094,6424946,1148,18782,utRho24
1308,rpoE,5420372,5420372,5420024,348,172,utRho24
1309,rpoH,7202006,7202006,7201566,440,6482,utRho24
1310,rpoN,6689324,6689434,6689324,110,80,utRho24
1311,rpoS,5736236,5736236,5735102,1134,2614,utRho24
1312,rpoZ,7644154,7644212,7644154,58,356,utRho24
1313,rppH,5937986,5937986,5937954,32,26,utRho24
1314,rprA,3540744,3540744,3540744,0,0,utRho24
1315,rpsA,1923434,1923990,1923434,556,16128,utRho24
1316,rpsF,8850050,8850236,8850050,186,1828,utRho24
1317,rpsI,6756580,6756580,6756414,166,810,utRho24
1318,rpsJ,6906884,6906884,6906540,344,522,utRho24
1319,rpsL,6949242,6949242,6949104,138,326,utRho24
1320,rpsM,6885130,6885130,6884942,188,282,utRho24
1321,rpsO,13247144,13247144,13246736,408,264,utRho24
1322,rpsP,5492508,5492508,5492370,138,22,utRho24
1323,rpsT,42420,42420,42156,264,256,utRho24
1324,rpsU,12842584,12843124,12842584,540,1092,utRho24
1325,rraA,8238716,8238716,8238660,56,110,utRho24
1326,rraB,8956768,8956946,8956768,178,552,utRho24
1327,rrsA,8070478,8071062,8070478,584,2974,utRho24
1328,rrsB,16665468,16666636,16665468,1168,5584,utRho24
1329,rrsC,7883032,7883616,7883032,584,2696,utRho24
1330,rrsD,6858094,6858094,6857524,570,336,utRho24
1331,rrsE,8415726,8416294,8415726,568,364,utRho24
1332,rrsG,5462896,5462896,5462314,582,3004,utRho24
1333,rrsH,446970,447542,446970,572,392,utRho24
1334,rsd,8393908,8393908,8393616,292,1132,utRho24
1335,rseA,5419264,5419264,5418808,456,60,utRho24
1336,rseP,392940,393092,392940,152,16,utRho24
1337,rseX,4067298,4067298,4067298,0,0,utRho24
1338,rsfS,1338144,1338144,1338072,72,174,utRho24
1339,rsgA,8783132,8783132,8783018,114,288,utRho24
1340,rsmA,105176,105176,104860,316,1618,utRho24
1341,rsmB,6869982,6870414,6869982,432,470,utRho24
1342,rsmC,9215736,9215736,9215400,336,274,utRho24
1343,rsmD,7208594,7208786,7208594,192,32,utRho24
1344,rsmE,6182036,6182268,6182036,232,1010,utRho24
1345,rsmG,7847512,7847512,7847360,152,752,utRho24
1346,rsmH,180020,180188,180020,168,116,utRho24
1347,rsmI,6587106,6587106,6586670,436,1736,utRho24
1348,rssA,2578212,2578412,2578212,200,778,utRho24
1349,rssB,2580440,2580484,2580440,44,236,utRho24
1350,rstA,3364276,3364300,3364276,24,0,utRho24
1351,rsuA,4561096,4561096,4560966,130,216,utRho24
1352,rsxA,3411510,3411534,3411510,24,0,utRho24
1353,rtcA,7114004,7114004,7113698,306,2700,utRho24
1354,rtcB,7116214,7116214,7116158,56,70,utRho24
1355,rtn,4541356,4541452,4541356,96,22,utRho24
1356,rutA,2148052,2148052,2148022,30,138,utRho24
1357,rutG,2140090,2140090,2139678,412,644,utRho24
1358,rutR,2148226,2148484,2148226,258,898,utRho24
1359,ruvA,7784096,7784096,7783904,192,168,utRho24
1360,ruvB,7782176,7782176,7781424,752,768,utRho24
1361,ruvC,3894878,3894878,3894752,126,32,utRho24
1362,rybB,1776114,1776114,1776114,0,0,utRho24
1363,rydB,3529860,3529860,3529322,538,350,utRho24
1364,rydC,2983012,2983012,2983012,0,0,utRho24
1365,ryfA,5307398,5307710,5307398,312,106,utRho24
1366,ryfD,5468590,5468590,5468590,0,0,utRho24
1367,ryhB,7162032,7162032,7162032,0,0,utRho24
1368,ryjA,8556132,8556132,8556132,0,0,utRho24
1369,ryjB,9055954,9055954,9055954,0,0,utRho24
1370,sad,3229598,3229598,3229406,192,218,utRho24
1371,safA,3168056,3168056,3167918,138,1324,utRho24
1372,sanA,4465368,4465756,4465368,388,242,utRho24
1373,sapF,2705314,2705314,2705268,46,80,utRho24
1374,sbcB,4165456,4165512,4165456,56,0,utRho24
1375,sbcC,831694,831694,831506,188,310,utRho24
1376,sbcD,833954,833954,833904,50,48,utRho24
1377,sbmA,793106,793278,793106,172,3338,utRho24
1378,sbmC,4162650,4162650,4162524,126,36,utRho24
1379,sdaA,3793618,3793864,3793618,246,194,utRho24
1380,sdaC,5856070,5856458,5856070,388,256,utRho24
1381,sdhC,1509916,1510354,1509916,438,16850,utRho24
1382,sdhD,1510808,1511120,1510808,312,6456,utRho24
1383,sdiA,3993834,3993834,3993664,170,76,utRho24
1384,secE,8354354,8354716,8354354,362,220,utRho24
1385,secG,6645180,6645180,6645010,170,98,utRho24
1386,selA,7522594,7522594,7522498,96,1298,utRho24
1387,selB,7519850,7519850,7519722,128,280,utRho24
1388,selC,7672396,7672444,7672396,48,62,utRho24
1389,selD,3696058,3696058,3696016,42,3378,utRho24
1390,seqA,1425884,1425974,1425884,90,146,utRho24
1391,serA,6117098,6117098,6116820,278,236,utRho24
1392,serB,9249712,9249790,9249712,78,240,utRho24
1393,serC,3830380,3830612,3830380,232,28,utRho24
1394,serS,1878730,1878856,1878730,126,668,utRho24
1395,serT,2063438,2063438,2063424,14,0,utRho24
1396,serU,4087124,4087124,4087114,10,66,utRho24
1397,serV,5637394,5637394,5637290,104,154,utRho24
1398,serW,1852014,1852014,1851942,72,122,utRho24
1399,serX,2195352,2195352,2195304,48,26,utRho24
1400,setB,4527426,4527726,4527426,300,20,utRho24
1401,setC,7673488,7673906,7673488,418,3330,utRho24
1402,sfmA,1116124,1116424,1116124,300,216,utRho24
1403,sfmC,1117606,1117948,1117606,342,44,utRho24
1404,sfsA,323030,323030,322972,58,430,utRho24
1405,sfsB,6669592,6669818,6669592,226,616,utRho24
1406,sgrR,154676,154676,154598,78,238,utRho24
1407,sgrS,154734,154734,154734,0,0,utRho24
1408,shiA,4107068,4107286,4107068,218,368,utRho24
1409,sibA,4306622,4306622,4306622,0,0,utRho24
1410,sibB,4307292,4307292,4307292,0,0,utRho24
1411,sibC,6113702,6113702,6113702,0,0,utRho24
1412,sibD,6389730,6389730,6389730,0,0,utRho24
1413,sibE,6390480,6390480,6390480,0,0,utRho24
1414,sixA,4913998,4913998,4913624,374,10,utRho24
1415,slp,7307872,7307922,7307872,50,0,utRho24
1416,slt,9261400,9261466,9261400,66,358,utRho24
1417,slyA,3442028,3442028,3441648,380,142,utRho24
1418,slyB,3439496,3439752,3439496,256,134,utRho24
1419,slyD,6957398,6957398,6956994,404,368,utRho24
1420,slyX,6954862,6955280,6954862,418,1772,utRho24
1421,smf,6867372,6867372,6867120,252,734,utRho24
1422,smpB,5509534,5509792,5509534,258,836,utRho24
1423,smrA,2811872,2811958,2811872,86,600,utRho24
1424,smrB,4896872,4897212,4896872,340,2398,utRho24
1425,smtA,1946808,1947074,1946808,266,142,utRho24
1426,sodA,8201518,8201620,8201518,102,1968,utRho24
1427,sodB,3470646,3470756,3470646,110,530,utRho24
1428,sodC,3449358,3449358,3449310,48,172,utRho24
1429,sohB,2658568,2658664,2658568,96,1008,utRho24
1430,sokB,2984232,2984238,2984232,6,130,utRho24
1431,solA,2241218,2241218,2241172,46,0,utRho24
1432,soxR,8554894,8554938,8554894,44,134,utRho24
1433,soxS,8554846,8554846,8554766,80,64,utRho24
1434,speA,6172096,6172096,6171822,274,116,utRho24
1435,speB,6167892,6167892,6167594,298,54,utRho24
1436,speC,6218350,6218350,6218310,40,32,utRho24
1437,spf,8099798,8099798,8099798,0,0,utRho24
1438,sppA,3697422,3697674,3697422,252,3078,utRho24
1439,spy,3651376,3651376,3651250,126,34,utRho24
1440,sra,3112092,3112092,3111926,166,0,utRho24
1441,sraB,2293178,2293178,2293178,0,0,utRho24
1442,sraC,3846132,3846132,3846132,0,0,utRho24
1443,srlA,5651582,5651664,5651582,82,106,utRho24
1444,srlR,5657720,5658094,5657720,374,11908,utRho24
1445,srmB,5425752,5425792,5425752,40,206,utRho24
1446,sroA,151216,151216,151216,0,0,utRho24
1447,sroG,6369436,6369436,6369436,0,0,utRho24
1448,sroH,8380974,8380974,8380974,0,0,utRho24
1449,ssb,8548022,8548250,8548022,228,302,utRho24
1450,sseA,5304782,5304988,5304782,206,3018,utRho24
1451,sspA,6755138,6755138,6754840,298,246,utRho24
1452,ssrA,5511014,5511186,5511014,172,256,utRho24
1453,ssrS,12223036,12223932,12223036,896,880,utRho24
1454,sstT,6479726,6479888,6479726,162,24,utRho24
1455,ssuB,1988282,1988282,1988088,194,626,utRho24
1456,ssuE,1995126,1995126,1995024,102,0,utRho24
1457,sthA,8321604,8321604,8321580,24,1774,utRho24
1458,stpA,5597156,5597156,5596990,166,40,utRho24
1459,sucA,3034344,3034824,3034344,480,2348,utRho24
1460,sufA,3528836,3528836,3528772,64,84,utRho24
1461,sufE,3518962,3518962,3518580,382,224,utRho24
1462,sugE,8753588,8753750,8753588,162,814,utRho24
1463,sulA,2041894,2041894,2041838,56,3564,utRho24
1464,syd,5850738,5850738,5850560,178,4,utRho24
1465,symE,9159834,9159834,9159680,154,556,utRho24
1466,symR,9159670,9159670,9159670,0,0,utRho24
1467,tabA,8949566,8949724,8949566,158,0,utRho24
1468,talA,5157140,5157332,5157140,192,190,utRho24
1469,talB,16382,16476,16382,94,6060,utRho24
1470,tam,3214442,3214692,3214442,250,606,utRho24
1471,tamA,8884540,8884764,8884540,224,1700,utRho24
1472,tar,3945432,3945432,3945382,50,0,utRho24
1473,tas,5943138,5943194,5943138,56,2724,utRho24
1474,tatA,16087636,16087780,16087636,144,132,utRho24
1475,tatE,1317742,1317894,1317742,152,116,utRho24
1476,tauA,770410,770464,770410,54,68,utRho24
1477,tdcA,6534186,6534186,6534130,56,54,utRho24
1478,tdcG,6519652,6519652,6519298,354,1726,utRho24
1479,tdcR,6534380,6534760,6534380,380,140,utRho24
1480,tdk,2586986,2587054,2586986,68,48,utRho24
1481,tehA,3001072,3001146,3001072,74,64,utRho24
1482,tesA,1039898,1039898,1039530,368,842,utRho24
1483,tesB,950402,950402,950322,80,48,utRho24
1484,tfaE,2418532,2418532,2418238,294,1614,utRho24
1485,tfaQ,3269912,3269912,3269770,142,472,utRho24
1486,tff,379424,379256,379424,168,178,utRho24
1487,tgt,852110,852274,852110,164,44,utRho24
1488,thiD,4369346,4369346,4369032,314,308,utRho24
1489,thiI,882936,883098,882936,162,138,utRho24
1490,thiM,4370902,4370902,4370602,300,840,utRho24
1491,thiQ,146170,146170,145854,316,8098,utRho24
1492,thrL,592,760,592,168,332,utRho24
1493,thrS,7210932,7210932,7210280,652,412,utRho24
1494,thrU,8350762,8350776,8350762,14,0,utRho24
1495,thrV,6847414,6847414,6847310,104,152428,utRho24
1496,thrW,525682,525742,525682,60,5350,utRho24
1497,thyA,5930696,5930696,5930310,386,1384,utRho24
1498,tig,909986,910266,909986,280,48,utRho24
1499,tisB,7706674,7707106,7706674,432,792,utRho24
1500,tktA,6163414,6163414,6163270,144,208,utRho24
1501,tktB,5158616,5159272,5158616,656,4694,utRho24
1502,tldD,6784368,6784368,6784056,312,32,utRho24
1503,tmcA,5191876,5191876,5191718,158,1520,utRho24
1504,tnaC,15553644,15553740,15553644,96,6224,utRho24
1505,tolB,1555074,1555480,1555074,406,334,utRho24
1506,tolC,6356008,6356230,6356008,222,208,utRho24
1507,tomB,961588,961588,961416,172,1318,utRho24
1508,tonB,2622108,2622178,2622108,70,4,utRho24
1509,topA,2661578,2662096,2661578,518,4,utRho24
1510,torC,2116112,2116168,2116112,56,486,utRho24
1511,torR,2115968,2115968,2115908,60,544,utRho24
1512,torS,2112364,2112364,2112356,8,58,utRho24
1513,torT,2112414,2112522,2112414,108,4,utRho24
1514,tpiA,8223138,8223138,8223014,124,108,utRho24
1515,tppB,3425342,3425538,3425342,196,1912,utRho24
1516,tpr,2574376,2574376,2574376,0,0,utRho24
1517,tpx,2777688,2777688,2777622,66,1138,utRho24
1518,tqsA,3347780,3347826,3347780,46,74,utRho24
1519,treA,2494850,2494850,2494752,98,552,utRho24
1520,treB,8932420,8932420,8932360,60,92,utRho24
1521,treF,7339102,7339184,7339102,82,580,utRho24
1522,treR,8934694,8934694,8934492,202,66,utRho24
1523,trg,2984878,2984940,2984878,62,120,utRho24
1524,trkG,2847342,2847564,2847342,222,1304,utRho24
1525,trmA,8326590,8326590,8326540,50,262,utRho24
1526,trpA,2634678,2634678,2634444,234,500,utRho24
1527,trpC,2639888,2639888,2639570,318,0,utRho24
1528,trpL,5292432,5292432,5292328,104,0,utRho24
1529,trpR,9265408,9265520,9265408,112,382,utRho24
1530,trpS,7027394,7027394,7027276,118,1616,utRho24
1531,trpT,7893560,7893914,7893560,354,67754,utRho24
1532,trxA,7931294,7931522,7931294,228,876,utRho24
1533,trxB,1864156,1864156,1864100,56,58,utRho24
1534,trxC,5437350,5437470,5437350,120,448,utRho24
1535,tsaD,6421256,6421256,6421086,170,538,utRho24
1536,tsgA,6985038,6985136,6985038,98,196,utRho24
1537,tsr,9182824,9183314,9182824,490,5366,utRho24
1538,tsx,864490,864490,864026,464,610,utRho24
1539,ttcA,2823970,2823970,2823896,74,2668,utRho24
1540,ttdA,6412848,6412926,6412848,78,124,utRho24
1541,ttdR,6412760,6412760,6412512,248,528,utRho24
1542,tufA,6943448,6943448,6942658,790,26410,utRho24
1543,tus,3368346,3368518,3368346,172,134,utRho24
1544,tusA,7218040,7218040,7217992,48,312,utRho24
1545,tusB,6950218,6950218,6949930,288,1082,utRho24
1546,tynA,2902996,2902996,2902698,298,90,utRho24
1547,typA,8116460,8116814,8116460,354,1760,utRho24
1548,tyrB,8534164,8534228,8534164,64,1028,utRho24
1549,tyrP,3979004,3979362,3979004,358,492,utRho24
1550,tyrR,2773384,2773440,2773384,56,46,utRho24
1551,tyrS,3434566,3434566,3434444,122,40,utRho24
1552,tyrT,2575330,2575330,2575244,86,62,utRho24
1553,uacT,6062378,6062734,6062378,356,3190,utRho24
1554,ubiC,8504886,8505012,8504886,126,386,utRho24
1555,ubiD,8049618,8049976,8049618,358,1882,utRho24
1556,ubiE,8037494,8037710,8037494,216,362,utRho24
1557,ubiG,4679078,4679134,4679078,56,160,utRho24
1558,ucpA,5089342,5089342,5089246,96,0,utRho24
1559,udp,8032782,8032862,8032782,80,324,utRho24
1560,ugd,4199470,4199470,4199226,244,58,utRho24
1561,ugpB,7184852,7184852,7184650,202,4602,utRho24
1562,ugpQ,7176600,7176600,7176226,374,438,utRho24
1563,uhpT,7694396,7694396,7694334,62,22,utRho24
1564,uidA,3392304,3392304,3392142,162,164,utRho24
1565,uidC,3386012,3386012,3385702,310,38,utRho24
1566,uidR,3394150,3394150,3394104,46,10,utRho24
1567,ulaA,8839854,8839960,8839854,106,178,utRho24
1568,ulaG,8839350,8839350,8839250,100,346,utRho24
1569,ulaR,8837124,8837124,8836906,218,120,utRho24
1570,umpG,5741372,5741372,5740548,824,120,utRho24
1571,umpH,1400704,1400704,1400652,52,22,utRho24
1572,umuD,2461476,2461534,2461476,58,42,utRho24
1573,ung,5433476,5433508,5433476,32,150,utRho24
1574,uof,2843316,2843316,2842900,416,2048,utRho24
1575,upp,5241818,5241818,5241744,74,156,utRho24
1576,usg,4873780,4873780,4873298,482,222,utRho24
1577,ushA,1009772,1009828,1009772,56,126,utRho24
1578,uspA,7279966,7280222,7279966,256,588,utRho24
1579,uspB,7279696,7279696,7279440,256,572,utRho24
1580,uspC,3959172,3959506,3959172,334,154,utRho24
1581,uspE,2797318,2797318,2797244,74,62,utRho24
1582,uspF,2871282,2871282,2871238,44,270,utRho24
1583,uspG,1283806,1283806,1283734,72,2240,utRho24
1584,uvrA,8547872,8547872,8547742,130,352,utRho24
1585,uvrB,1626304,1627052,1626304,748,1286,utRho24
1586,uvrC,3989758,3989758,3989412,346,112,utRho24
1587,uvrD,7995814,7995966,7995814,152,780,utRho24
1588,uvrY,3990812,3990812,3990718,94,218,utRho24
1589,uxaB,3221474,3221474,3221360,114,94,utRho24
1590,uxaC,6489714,6489714,6489482,232,160,utRho24
1591,uxuA,9103036,9103272,9103036,236,2962,utRho24
1592,uxuR,9108916,9109152,9108916,236,370,utRho24
1593,valS,8967854,8967854,8967674,180,312,utRho24
1594,valU,5041848,5041862,5041848,14,38,utRho24
1595,valV,3492830,3492870,3492830,40,224,utRho24
1596,ves,3649968,3649968,3649874,94,158,utRho24
1597,waaA,7616512,7617080,7616512,568,674,utRho24
1598,waaH,7580298,7580298,7580162,136,4,utRho24
1599,waaQ,7616476,7616476,7616196,280,516,utRho24
1600,waaU,7598996,7598996,7598624,372,200,utRho24
1601,waaY,7602272,7602272,7601930,342,8012,utRho24
1602,wbbH,4214888,4214888,4214452,436,1606,utRho24
1603,wbbK,4209212,4209212,4209018,194,136,utRho24
1604,wcaM,4231868,4231868,4231792,76,28,utRho24
1605,wrbA,2135516,2135516,2135416,100,52,utRho24
1606,wza,4275166,4275166,4274486,680,286,utRho24
1607,wzxC,4240674,4240674,4240316,358,106,utRho24
1608,wzzB,4196950,4196950,4196602,348,4,utRho24
1609,xanP,7657642,7657890,7657642,248,554,utRho24
1610,xanQ,6048520,6048702,6048520,182,80,utRho24
1611,xapA,5049820,5049820,5049756,64,14,utRho24
1612,xapR,10090252,10090252,10089908,344,56,utRho24
1613,xdhA,6000514,6000690,6000514,176,2858,utRho24
1614,xerD,6079702,6079702,6079486,216,350,utRho24
1615,xseA,5268394,5268464,5268394,70,394,utRho24
1616,xseB,882746,882746,882686,60,164,utRho24
1617,xthA,3664798,3664856,3664798,58,0,utRho24
1618,xylA,7461614,7461614,7461530,84,18484,utRho24
1619,xylE,8484540,8484540,8484508,32,6,utRho24
1620,xylF,7462138,7462262,7462138,124,1058,utRho24
1621,xylR,7469812,7469958,7469812,146,48,utRho24
1622,yaaA,13230,13230,12918,312,12,utRho24
1623,yaaI,23876,23876,23572,304,1902,utRho24
1624,yaaJ,16034,16034,15918,116,96,utRho24
1625,yaaU,91184,91614,91184,430,1520,utRho24
1626,yaaW,23084,23084,22712,372,500,utRho24
1627,yaaX,10060,10468,10060,408,314,utRho24
1628,yabI,142542,142702,142542,160,506,utRho24
1629,yacC,273880,273880,273834,46,836,utRho24
1630,yacH,262932,262932,262520,412,112,utRho24
1631,yacL,268678,268776,268678,98,694,utRho24
1632,yadD,293796,293936,293796,140,198,utRho24
1633,yadE,289930,290162,289930,232,456,utRho24
1634,yadN,314110,314110,313766,344,134,utRho24
1635,yadS,355572,355572,355248,324,7104,utRho24
1636,yadV,312470,312470,312402,68,264,utRho24
1637,yaeF,434270,434270,434006,264,128,utRho24
1638,yaeP,428374,428374,428250,124,738,utRho24
1639,yaeQ,428176,428582,428176,406,1454,utRho24
1640,yaeR,423716,423754,423716,38,194,utRho24
1641,yafC,462166,462166,461762,404,154,utRho24
1642,yafD,462128,462244,462128,116,114,utRho24
1643,yafK,491986,491986,491610,376,2136,utRho24
1644,yafL,493282,493424,493282,142,110,utRho24
1645,yafN,503938,504010,503938,72,166,utRho24
1646,yafS,469568,469632,469568,64,616,utRho24
1647,yafT,474470,474670,474470,200,154,utRho24
1648,yafV,480432,480432,480378,54,90,utRho24
1649,yafZ,536052,536052,536010,42,356,utRho24
1650,yagE,564446,564556,564446,110,2978,utRho24
1651,yagG,570414,570790,570414,376,3432,utRho24
1652,yagI,578384,578384,578324,60,380,utRho24
1653,yagK,586236,586236,585896,340,17492,utRho24
1654,yagL,588062,588062,587836,226,4242,utRho24
1655,yagN,591342,591342,591158,184,1142,utRho24
1656,yahA,663746,664742,663746,996,6650,utRho24
1657,yahC,670136,670136,670044,92,4488,utRho24
1658,yahE,671478,671850,671478,372,966,utRho24
1659,yahM,690504,690808,690504,304,272,utRho24
1660,yahN,692872,692872,692674,198,2162,utRho24
1661,yahO,692864,692968,692864,104,194,utRho24
1662,yaiE,816296,816354,816296,58,96,utRho24
1663,yaiI,811396,811528,811396,132,54,utRho24
1664,yaiO,761946,761946,761684,262,546,utRho24
1665,yaiP,767970,767970,767870,100,118,utRho24
1666,yaiS,769660,769660,769232,428,1036,utRho24
1667,yaiV,788922,788922,788922,0,0,utRho24
1668,yaiY,799094,799094,798666,428,546,utRho24
1669,yaiZ,798888,799186,798888,298,786,utRho24
1670,yajC,854410,854574,854410,164,368,utRho24
1671,yajD,860938,861210,860938,272,300,utRho24
1672,yajI,866068,866068,865702,366,450,utRho24
1673,yajL,887496,887496,887282,214,432,utRho24
1674,yajQ,889316,889366,889316,50,140,utRho24
1675,yajR,893374,893374,893332,42,46,utRho24
1676,ybaB,987418,988152,987418,734,966,utRho24
1677,ybaL,1006590,1006590,1006476,114,334,utRho24
1678,ybaM,980648,980648,980542,106,2294,utRho24
1679,ybaN,981436,981764,981436,328,996,utRho24
1680,ybaO,936704,936766,936704,62,66,utRho24
1681,ybaP,1016568,1016568,1016160,408,1748,utRho24
1682,ybaQ,1016348,1016436,1016348,88,418,utRho24
1683,ybaS,1023146,1023282,1023146,136,1888,utRho24
1684,ybaV,927504,927874,927504,370,4,utRho24
1685,ybaY,950490,950758,950490,268,1094,utRho24
1686,ybbB,1062724,1062724,1062452,272,86,utRho24
1687,ybbJ,1030154,1030154,1029718,436,2266,utRho24
1688,ybbL,1031784,1031838,1031784,54,120,utRho24
1689,ybbN,1037136,1037136,1036558,578,1898,utRho24
1690,ybbO,1038658,1038658,1038298,360,792,utRho24
1691,ybbY,1080718,1081130,1080718,412,2252,utRho24
1692,ybcH,1176140,1176140,1175962,178,610,utRho24
1693,ybcI,1113264,1113264,1113106,158,2734,utRho24
1694,ybcJ,1114050,1114050,1113746,304,114,utRho24
1695,ybcK,1137502,1137804,1137502,302,602,utRho24
1696,ybcL,1141690,1141786,1141690,96,0,utRho24
1697,ybcN,1144628,1144932,1144628,304,334,utRho24
1698,ybcQ,1147548,1147912,1147548,364,3910,utRho24
1699,ybcW,1159610,1159760,1159610,150,264,utRho24
1700,ybdD,1263982,1264364,1263982,382,2404,utRho24
1701,ybdF,1212106,1212106,1211772,334,170,utRho24
1702,ybdH,1267048,1267048,1266954,94,292,utRho24
1703,ybdJ,1212822,1212822,1212398,424,426,utRho24
1704,ybdK,1215122,1215122,1214766,356,2120,utRho24
1705,ybdL,1267114,1267172,1267114,58,470,utRho24
1706,ybdM,1271110,1271110,1270752,358,4258,utRho24
1707,ybdN,1273372,1273372,1273138,234,276,utRho24
1708,ybdR,1283844,1284176,1283844,332,2964,utRho24
1709,ybeD,1325412,1325412,1325284,128,30,utRho24
1710,ybeF,1323090,1323090,1322756,334,1722,utRho24
1711,ybeL,1349986,1350036,1349986,50,820,utRho24
1712,ybeQ,1353412,1353412,1353094,318,152,utRho24
1713,ybeR,1353120,1353422,1353120,302,152,utRho24
1714,ybeT,1358832,1358832,1358812,20,66,utRho24
1715,ybeU,1358924,1359016,1358924,92,148,utRho24
1716,ybeZ,1386938,1386938,1386834,104,2346,utRho24
1717,ybfA,1458074,1458268,1458074,194,698,utRho24
1718,ybfE,1423878,1423878,1423796,82,132,utRho24
1719,ybfF,1425692,1425692,1425604,88,120,utRho24
1720,ybfH,1433282,1433282,1433194,88,90,utRho24
1721,ybgA,1477840,1478002,1477840,162,170,utRho24
1722,ybgC,1549288,1549504,1549288,216,84,utRho24
1723,ybgD,1505916,1505916,1505590,326,11394,utRho24
1724,ybgI,1485238,1485654,1485238,416,40,utRho24
1725,ybgO,1498370,1498370,1497964,406,514,utRho24
1726,ybgS,1570992,1570992,1570634,358,228,utRho24
1727,ybhA,1597184,1597184,1596862,322,142,utRho24
1728,ybhB,1616070,1616070,1615818,252,320,utRho24
1729,ybhC,1614642,1614642,1614562,80,1104,utRho24
1730,ybhD,1601418,1601418,1601276,142,126,utRho24
1731,ybhH,1601104,1601518,1601104,414,240,utRho24
1732,ybhK,1633384,1633384,1633294,90,242,utRho24
1733,ybhM,1641556,1641586,1641556,30,94,utRho24
1734,ybhN,1645296,1645296,1644996,300,898,utRho24
1735,ybhQ,1649202,1649260,1649202,58,2262,utRho24
1736,ybiA,1665920,1665920,1665900,20,28,utRho24
1737,ybiI,1676968,1676968,1676912,56,1034,utRho24
1738,ybiO,1691328,1691328,1690960,368,870,utRho24
1739,ybiP,1705252,1705252,1705194,58,414,utRho24
1740,ybiS,1711572,1711572,1711488,84,402,utRho24
1741,ybiT,1711894,1711926,1711894,32,0,utRho24
1742,ybiU,1718212,1718212,1718122,90,136,utRho24
1743,ybiV,1720176,1720176,1720056,120,80,utRho24
1744,ybiW,1725566,1725566,1725212,354,9808,utRho24
1745,ybiX,1678548,1678548,1678414,134,258,utRho24
1746,ybjC,1781784,1781826,1781784,42,0,utRho24
1747,ybjE,1830154,1830154,1829714,440,728,utRho24
1748,ybjG,1767016,1767016,1766776,240,1152,utRho24
1749,ybjL,1779882,1779882,1779638,244,96,utRho24
1750,ybjM,1779770,1780178,1779770,408,634,utRho24
1751,ybjO,1795704,1795978,1795704,274,38,utRho24
1752,ybjP,1809046,1809046,1808934,112,96,utRho24
1753,ybjQ,1809034,1809186,1809034,152,108,utRho24
1754,ybjS,1813796,1813796,1813506,290,148,utRho24
1755,ybjX,1838206,1838206,1838168,38,0,utRho24
1756,ycaD,1891438,1891742,1891438,304,60,utRho24
1757,ycaI,1928210,1928640,1928210,430,320,utRho24
1758,ycaK,1899094,1899336,1899094,242,540,utRho24
1759,ycaL,1920264,1920528,1920264,264,144,utRho24
1760,ycaM,1894240,1894458,1894240,218,322,utRho24
1761,ycaR,1941284,1941346,1941284,62,1986,utRho24
1762,ycbB,1961862,1962094,1961862,232,1024,utRho24
1763,ycbJ,1943344,1943504,1943344,160,0,utRho24
1764,ycbK,1966046,1966150,1966046,104,76,utRho24
1765,ycbZ,2036920,2036920,2036598,322,36,utRho24
1766,yccA,2062886,2062886,2062836,50,48,utRho24
1767,yccF,2048730,2048730,2048696,34,28,utRho24
1768,yccS,2047988,2047988,2047766,222,582,utRho24
1769,yccT,2055674,2055674,2055546,128,182,utRho24
1770,yccX,2059960,2060128,2059960,168,462,utRho24
1771,ycdT,2185682,2185752,2185682,70,122,utRho24
1772,ycdU,2191266,2191686,2191266,420,692,utRho24
1773,ycdZ,2200504,2200592,2200504,88,144,utRho24
1774,yceA,2233544,2233614,2233544,70,26,utRho24
1775,yceD,2293298,2293588,2293298,290,380,utRho24
1776,yceF,2293522,2293522,2293190,332,232,utRho24
1777,yceH,2252154,2252314,2252154,160,1504,utRho24
1778,yceI,2237282,2237282,2236952,330,232,utRho24
1779,yceJ,2238142,2238142,2238092,50,262,utRho24
1780,yceM,2253208,2253612,2253208,404,124,utRho24
1781,yceO,2239264,2239264,2238894,370,606,utRho24
1782,yceQ,2288760,2289004,2288760,244,2910,utRho24
1783,ycfD,2376540,2376540,2376480,60,142,utRho24
1784,ycfJ,2334814,2335198,2334814,384,350,utRho24
1785,ycfS,2340834,2340834,2340748,86,118,utRho24
1786,ycfT,2350658,2350658,2350330,328,176,utRho24
1787,ycfZ,2362760,2362760,2362534,226,1204,utRho24
1788,ycgB,2474570,2474570,2474482,88,0,utRho24
1789,ycgG,2434614,2434656,2434614,42,1450,utRho24
1790,ycgJ,2452956,2453200,2452956,244,476,utRho24
1791,ycgL,2455218,2455362,2455218,144,56,utRho24
1792,ycgN,2457366,2457660,2457366,294,234,utRho24
1793,ycgR,2489112,2489112,2489054,58,76,utRho24
1794,ycgV,2512222,2512222,2511904,318,1052,utRho24
1795,ycgX,2426568,2426568,2426214,354,14466,utRho24
1796,ycgY,2490166,2490320,2490166,154,894,utRho24
1797,ycgZ,2431504,2431578,2431504,74,82,utRho24
1798,ychE,2596904,2597196,2596904,292,0,utRho24
1799,ychF,2515764,2515764,2515624,140,0,utRho24
1800,ychH,2517476,2517582,2517476,106,580,utRho24
1801,ychJ,2578354,2578354,2578264,90,224,utRho24
1802,ychN,2547310,2547310,2547198,112,40,utRho24
1803,ychO,2547520,2547850,2547520,330,304,utRho24
1804,ychQ,2533798,2533848,2533798,50,56,utRho24
1805,yciA,2624828,2624828,2624492,336,128,utRho24
1806,yciB,2626110,2626110,2625780,330,838,utRho24
1807,yciC,2627396,2627396,2627326,70,36,utRho24
1808,yciE,2630794,2630794,2630448,346,922,utRho24
1809,yciG,5264368,5264368,5264140,228,28,utRho24
1810,yciI,2621784,2621784,2621730,54,6,utRho24
1811,yciN,2661606,2661606,2661336,270,52,utRho24
1812,yciS,2680270,2680486,2680270,216,284,utRho24
1813,yciT,2689088,2689088,2688692,396,1862,utRho24
1814,yciU,2614718,2614718,2614300,418,946,utRho24
1815,yciV,2646376,2646440,2646376,64,0,utRho24
1816,yciW,2700472,2700472,2700214,258,3584,utRho24
1817,yciZ,2689276,2689276,2689218,58,1570,utRho24
1818,ycjD,2703792,2703792,2703520,272,146,utRho24
1819,ycjG,2777748,2777860,2777748,112,232,utRho24
1820,ycjM,2740006,2740432,2740006,426,168,utRho24
1821,ycjW,2767982,2767982,2767922,60,26,utRho24
1822,ycjX,2768138,2768234,2768138,96,136,utRho24
1823,ycjY,5568288,5568288,5567460,828,1668,utRho24
1824,ydaE,2836438,2836438,2836016,422,378,utRho24
1825,ydaN,2816048,2816100,2816048,52,208,utRho24
1826,ydaS,2840340,2840730,2840340,390,728,utRho24
1827,ydbC,2948376,2948442,2948376,66,0,utRho24
1828,ydbD,2950132,2950288,2950132,156,0,utRho24
1829,ydbH,2885800,2886102,2885800,302,276,utRho24
1830,ydbJ,2881712,2882116,2881712,404,1788,utRho24
1831,ydbK,2881692,2881692,2881568,124,378,utRho24
1832,ydcA,2983294,2983354,2983294,60,158,utRho24
1833,ydcF,2974404,2974470,2974404,66,36,utRho24
1834,ydcI,2990268,2990268,2990142,126,0,utRho24
1835,ydcJ,2990266,2990576,2990266,310,36,utRho24
1836,ydcK,3001280,3001280,3000898,382,340,utRho24
1837,ydcL,3004646,3004914,3004646,268,38,utRho24
1838,ydcN,3012308,3012344,3012308,36,1410,utRho24
1839,ydcP,3013508,3013562,3013508,54,226,utRho24
1840,ydcR,3019956,3020006,3019956,50,2,utRho24
1841,ydcS,3022906,3023308,3022906,402,486,utRho24
1842,ydcX,3034442,3034778,3034442,336,1460,utRho24
1843,ydcY,3035220,3035296,3035220,76,94,utRho24
1844,ydcZ,3036750,3036750,3036662,88,4634,utRho24
1845,yddB,3155332,3155332,3155238,94,518,utRho24
1846,yddE,3071738,3071738,3071716,22,0,utRho24
1847,yddG,3094410,3094410,3094338,72,118,utRho24
1848,yddJ,3089732,3089732,3089438,294,1752,utRho24
1849,yddW,3137704,3137704,3137646,58,0,utRho24
1850,ydeA,3233910,3234056,3233910,146,2332,utRho24
1851,ydeE,3242528,3242664,3242528,136,340,utRho24
1852,ydeI,3249118,3249118,3248994,124,172,utRho24
1853,ydeJ,3249376,3249546,3249376,170,24,utRho24
1854,ydeN,3165458,3165458,3165048,410,472,utRho24
1855,ydeP,3173328,3173328,3172972,356,498,utRho24
1856,ydeR,3176596,3176596,3176592,4,534,utRho24
1857,ydfA,3296872,3297016,3296872,144,42,utRho24
1858,ydfG,3254982,3255034,3254982,52,178,utRho24
1859,ydfH,3256652,3256704,3256652,52,16,utRho24
1860,ydfK,3265446,3266144,3265446,698,9780,utRho24
1861,ydgA,3379588,3379704,3379588,116,0,utRho24
1862,ydgC,3364124,3364124,3364060,64,26,utRho24
1863,ydgD,3343906,3343920,3343906,14,284,utRho24
1864,ydgH,3356754,3356854,3356754,100,38,utRho24
1865,ydgJ,3408798,3408798,3408616,182,694,utRho24
1866,ydgK,3410414,3410500,3410414,86,758,utRho24
1867,ydhB,3479618,3479618,3479596,22,0,utRho24
1868,ydhC,3479698,3479822,3479698,124,26,utRho24
1869,ydhF,3451310,3451310,3451264,46,30,utRho24
1870,ydhI,3441996,3442050,3441996,54,38,utRho24
1871,ydhL,3451864,3451864,3451840,24,916,utRho24
1872,ydhQ,3492404,3492404,3492254,150,234,utRho24
1873,ydhS,3494136,3494262,3494136,126,1052,utRho24
1874,ydhT,3499138,3499138,3499118,20,214,utRho24
1875,ydhY,3509284,3509284,3508954,330,1484,utRho24
1876,ydhZ,3510418,3510418,3510282,136,2564,utRho24
1877,ydiE,3579206,3579226,3579206,20,0,utRho24
1878,ydiH,3530582,3530582,3530406,176,4,utRho24
1879,ydiM,3541852,3542142,3541852,290,86,utRho24
1880,ydiN,3544818,3545024,3544818,206,288,utRho24
1881,ydiP,3558656,3558656,3558602,54,512,utRho24
1882,ydiU,3582508,3582508,3582488,20,566,utRho24
1883,ydiV,3584174,3584174,3584040,134,266,utRho24
1884,ydiY,3612500,3612500,3612166,334,262,utRho24
1885,ydjA,3697400,3697400,3697352,48,980,utRho24
1886,ydjE,3708082,3708082,3707958,124,30,utRho24
1887,ydjF,3709848,3709848,3709708,140,28,utRho24
1888,ydjM,3620340,3620422,3620340,82,0,utRho24
1889,ydjO,3626696,3626696,3626288,408,204,utRho24
1890,ydjX,3666434,3666802,3666434,368,2744,utRho24
1891,yeaE,3731448,3731448,3731272,176,280,utRho24
1892,yeaG,3733530,3733816,3733530,286,46,utRho24
1893,yeaI,3740486,3740770,3740486,284,64,utRho24
1894,yeaJ,3743874,3744082,3743874,208,586,utRho24
1895,yeaL,3748646,3748704,3748646,58,694,utRho24
1896,yeaM,3751296,3751296,3751152,144,2,utRho24
1897,yeaN,3750926,3751346,3750926,420,216,utRho24
1898,yeaO,3753554,3753818,3753554,264,278,utRho24
1899,yeaP,3755314,3755430,3755314,116,734,utRho24
1900,yeaQ,3758780,3758780,3758510,270,782,utRho24
1901,yeaR,3759988,3759988,3759896,92,234,utRho24
1902,yeaY,3781122,3781122,3781064,58,0,utRho24
1903,yebB,3892220,3892502,3892220,282,158,utRho24
1904,yebC,3896370,3896370,3896302,68,126,utRho24
1905,yebE,3859464,3859464,3859414,50,1398,utRho24
1906,yebG,3861530,3861530,3861494,36,146,utRho24
1907,yebK,3873180,3873304,3873180,124,60,utRho24
1908,yebQ,3820314,3820552,3820314,238,78,utRho24
1909,yebS,3832238,3832516,3832238,278,0,utRho24
1910,yebV,3843430,3843560,3843430,130,0,utRho24
1911,yebW,3843914,3844242,3843914,328,1846,utRho24
1912,yecC,3995646,3995646,3995628,18,0,utRho24
1913,yecD,3901272,3901664,3901272,392,238,utRho24
1914,yecF,3991434,3991636,3991434,202,460,utRho24
1915,yecH,3979304,3979304,3978980,324,958,utRho24
1916,yecJ,3975604,3975604,3975516,88,0,utRho24
1917,yecM,3919968,3919968,3919692,276,2668,utRho24
1918,yecR,3976400,3976444,3976400,44,120,utRho24
1919,yecT,3923862,3923944,3923862,82,0,utRho24
1920,yedD,4016522,4016522,4016180,342,836,utRho24
1921,yedE,4016310,4016554,4016310,244,568,utRho24
1922,yedI,4058922,4058922,4058732,190,542,utRho24
1923,yedJ,4066446,4066446,4066158,288,718,utRho24
1924,yedV,4076404,4076404,4076304,100,482,utRho24
1925,yedX,4077680,4077912,4077680,232,134,utRho24
1926,yedY,4078572,4078956,4078572,384,946,utRho24
1927,yeeA,4161322,4161322,4161182,140,24,utRho24
1928,yeeE,4171104,4171104,4171050,54,732,utRho24
1929,yeeJ,4089526,4089822,4089526,296,538,utRho24
1930,yeeN,4113508,4113716,4113508,208,306,utRho24
1931,yeeO,4119444,4119444,4119692,248,0,utRho24
1932,yeeX,4158834,4158834,4158722,112,306,utRho24
1933,yeeZ,4178422,4178422,4178256,166,128,utRho24
1934,yefM,4179466,4179466,4179426,40,46,utRho24
1935,yegD,4295288,4295348,4295288,60,168,utRho24
1936,yegH,4275726,4275804,4275726,78,664,utRho24
1937,yegI,4302154,4302154,4301970,184,42,utRho24
1938,yegJ,4302032,4302370,4302032,338,186,utRho24
1939,yegQ,4331182,4331336,4331182,154,1444,utRho24
1940,yegR,4336698,4336698,4336612,86,1074,utRho24
1941,yegS,4337086,4337424,4337086,338,372,utRho24
1942,yegT,4357562,4357642,4357562,80,2042,utRho24
1943,yegX,4367640,4367640,4367302,338,498,utRho24
1944,yehA,4376944,4376944,4376828,116,692,utRho24
1945,yehE,4385818,4385818,4385592,226,52,utRho24
1946,yehK,4407568,4407944,4407568,376,238,utRho24
1947,yehL,4408804,4409192,4408804,388,170,utRho24
1948,yeiB,4486146,4486146,4485934,212,114,utRho24
1949,yeiE,4499422,4499422,4499236,186,20,utRho24
1950,yeiG,4487776,4487820,4487776,44,416,utRho24
1951,yeiH,4499332,4499434,4499332,102,352,utRho24
1952,yeiI,4503306,4503400,4503306,94,124,utRho24
1953,yeiL,4510580,4510710,4510580,130,62,utRho24
1954,yeiP,4530834,4530900,4530834,66,332,utRho24
1955,yeiQ,4532328,4532490,4532328,162,250,utRho24
1956,yeiR,4535484,4535658,4535484,174,742,utRho24
1957,yeiW,4530840,4530840,4530590,250,378,utRho24
1958,yejA,4544624,4544728,4544624,104,18,utRho24
1959,yejG,4556892,4556892,4556474,418,4068,utRho24
1960,yejH,4561244,4561264,4561244,20,60,utRho24
1961,yejK,4568218,4568218,4567894,324,24,utRho24
1962,yejO,4578352,4578352,4577800,552,3984,utRho24
1963,yfaD,4713380,4713808,4713380,428,2030,utRho24
1964,yfaE,4696676,4697028,4696676,352,848,utRho24
1965,yfaL,4688568,4688568,4688338,230,162,utRho24
1966,yfaP,4656398,4656398,4656286,112,136,utRho24
1967,yfaU,4717892,4717892,4717690,202,62,utRho24
1968,yfaY,4727310,4727310,4727266,44,1982,utRho24
1969,yfaZ,4728744,4728744,4728550,194,1198,utRho24
1970,yfbK,4771810,4771810,4771444,366,1312,utRho24
1971,yfbL,4771500,4771720,4771500,220,950,utRho24
1972,yfbN,4777174,4777174,4776852,322,856,utRho24
1973,yfbO,4776916,4777162,4776916,246,820,utRho24
1974,yfbP,4777990,4778232,4777990,242,14864,utRho24
1975,yfbR,4817662,4817724,4817662,62,150,utRho24
1976,yfcI,4847424,4847424,4847078,346,976,utRho24
1977,yfcJ,4880482,4880482,4880240,242,558,utRho24
1978,yfcL,4888502,4888502,4888338,164,116,utRho24
1979,yfcV,4911642,4911642,4911292,350,560,utRho24
1980,yfcZ,4921958,4921958,4921868,90,36,utRho24
1981,yfdF,4925604,4926024,4925604,420,7890,utRho24
1982,yfdG,4935474,4935710,4935474,236,26,utRho24
1983,yfdP,4946844,4947040,4946844,196,132,utRho24
1984,yfdX,4988866,4988866,4988804,62,110,utRho24
1985,yfdY,4990672,4990672,4990584,88,618,utRho24
1986,yfeA,5035784,5035784,5035664,120,9604,utRho24
1987,yfeC,5036668,5036934,5036668,266,0,utRho24
1988,yfeH,5053818,5053892,5053818,74,262,utRho24
1989,yfeK,5074630,5074684,5074630,54,0,utRho24
1990,yfeO,5018906,5019260,5018906,354,630,utRho24
1991,yfeR,5054078,5054078,5053712,366,290,utRho24
1992,yfeX,5101356,5101356,5101090,266,0,utRho24
1993,yfeY,5102486,5102486,5102432,54,6,utRho24
1994,yfeZ,5103842,5103842,5103452,390,168,utRho24
1995,yffO,5123804,5124222,5123804,418,1010,utRho24
1996,yffQ,5126778,5127154,5126778,376,2916,utRho24
1997,yffS,5128800,5128986,5128800,186,64,utRho24
1998,yfgC,5232052,5232188,5232052,136,258,utRho24
1999,yfgF,5258062,5258062,5257876,186,3336,utRho24
2000,yfgG,5258170,5258580,5258170,410,4522,utRho24
2001,yfgH,5259344,5259584,5259344,240,466,utRho24
2002,yfgM,5278866,5278866,5278566,300,806,utRho24
2003,yfhH,5397414,5397518,5397414,104,118,utRho24
2004,yfhM,5304648,5304648,5304574,74,292,utRho24
2005,yfhR,5328408,5328726,5328408,318,6430,utRho24
2006,yfiC,5425610,5425610,5425528,82,202,utRho24
2007,yfiE,5430688,5430688,5430640,48,1286,utRho24
2008,yfiL,5482630,5482720,5482630,90,66,utRho24
2009,yfiM,5448066,5448358,5448066,292,8884,utRho24
2010,yfiR,5483354,5483750,5483354,396,490,utRho24
2011,yfjH,5517326,5517326,5517200,126,336,utRho24
2012,yfjI,5517710,5517970,5517710,260,442,utRho24
2013,yfjJ,5521014,5521094,5521014,80,276,utRho24
2014,yfjM,5531970,5531970,5531552,418,11804,utRho24
2015,yfjP,5535080,5535420,5535080,340,1524,utRho24
2016,yfjW,5546570,5546636,5546570,66,140,utRho24
2017,yfjX,5551776,5551838,5551776,62,0,utRho24
2018,ygaC,5601180,5601180,5599988,1192,3122,utRho24
2019,ygaM,5600242,5600292,5600242,50,832,utRho24
2020,ygaU,5593628,5593628,5593572,56,546,utRho24
2021,ygaZ,5619190,5619234,5619190,44,250,utRho24
2022,ygbA,5713656,5713656,5713612,44,306,utRho24
2023,ygbE,5746784,5746784,5746674,110,270,utRho24
2024,ygbI,5722882,5722882,5722528,354,1150,utRho24
2025,ygbK,5724394,5724670,5724394,276,1306,utRho24
2026,ygbL,5727074,5727186,5727074,112,172,utRho24
2027,ygbN,5729814,5730202,5729814,388,1296,utRho24
2028,ygcG,5811210,5811422,5811210,212,400,utRho24
2029,ygcN,5785144,5785314,5785144,170,658,utRho24
2030,ygcU,5799214,5799214,5798836,378,304,utRho24
2031,ygcW,5800942,5800942,5800546,396,86,utRho24
2032,ygdD,5883442,5883442,5883262,180,308,utRho24
2033,ygdG,5861746,5861930,5861746,184,130,utRho24
2034,ygdI,5886526,5886526,5886290,236,160,utRho24
2035,ygdQ,5940784,5940840,5940784,56,98,utRho24
2036,ygdR,5942494,5942542,5942494,48,2,utRho24
2037,ygeA,5961606,5961606,5961270,336,386,utRho24
2038,ygeH,5983758,5984188,5983758,430,2164,utRho24
2039,ygeI,5987162,5987276,5987162,114,10800,utRho24
2040,ygeR,6000078,6000078,5999782,296,706,utRho24
2041,ygeV,6011694,6011694,6011572,122,56,utRho24
2042,ygeW,6012234,6012524,6012234,290,598,utRho24
2043,ygfB,6110946,6110946,6110888,58,14,utRho24
2044,ygfK,6031984,6032120,6031984,136,176,utRho24
2045,ygfS,6058328,6058328,6058024,304,208,utRho24
2046,ygfZ,6082564,6082626,6082564,62,686,utRho24
2047,yggC,6149512,6149512,6149378,134,130,utRho24
2048,yggE,6136370,6136370,6136160,210,1254,utRho24
2049,yggI,6179176,6179510,6179176,334,524,utRho24
2050,yggL,6204508,6204508,6204266,242,464,utRho24
2051,yggM,6199514,6199514,6199130,384,178,utRho24
2052,yggN,6203596,6203596,6203246,350,1136,utRho24
2053,yggX,18623958,18624558,18623958,600,462,utRho24
2054,yghA,6298966,6299324,6298966,358,426,utRho24
2055,yghB,6307058,6307126,6307058,68,748,utRho24
2056,yghD,6222614,6222614,6222252,362,730,utRho24
2057,yghF,6225798,6225798,6225840,42,40,utRho24
2058,yghJ,6238640,6238640,6238224,416,232,utRho24
2059,yghQ,6265186,6265186,6264816,370,468,utRho24
2060,yghT,6267830,6268262,6267830,432,1216,utRho24
2061,yghU,6277400,6277454,6277400,54,220,utRho24
2062,yghW,6293506,6293506,6293474,32,64,utRho24
2063,yghZ,6295562,6295794,6295562,232,192,utRho24
2064,ygiD,6365122,6365122,6364868,254,3608,utRho24
2065,ygiH,6409066,6409388,6409066,322,514,utRho24
2066,ygiL,6370622,6370828,6370622,206,276,utRho24
2067,ygiM,6402084,6402414,6402084,330,186,utRho24
2068,ygiN,6346156,6346284,6346156,128,524,utRho24
2069,ygiQ,6322620,6322620,6322292,328,1272,utRho24
2070,ygiS,6335462,6335462,6335436,26,204,utRho24
2071,ygiV,6338582,6338582,6338462,120,462,utRho24
2072,ygiW,6339774,6339774,6339352,422,3606,utRho24
2073,ygiZ,6344506,6344506,6344422,84,92,utRho24
2074,ygjH,6442528,6442528,6442494,34,302,utRho24
2075,ygjI,6452140,6452468,6452140,328,40,utRho24
2076,ygjQ,6472730,6473080,6472730,350,2298,utRho24
2077,ygjR,6474564,6474586,6474564,22,0,utRho24
2078,ygjV,6483638,6483638,6483488,150,44,utRho24
2079,yhaB,6535632,6535708,6535632,76,44,utRho24
2080,yhaH,6504498,6504608,6504498,110,666,utRho24
2081,yhaI,6505400,6505822,6505400,422,540,utRho24
2082,yhaJ,6508560,6508560,6508428,132,576,utRho24
2083,yhaK,6508538,6508638,6508538,100,696,utRho24
2084,yhbQ,6599878,6599932,6599878,54,554,utRho24
2085,yhbT,6602736,6602736,6602552,184,2274,utRho24
2086,yhbU,6602558,6602970,6602558,412,3018,utRho24
2087,yhbX,6643302,6643302,6643226,76,84,utRho24
2088,yhbY,6655518,6655580,6655518,62,360,utRho24
2089,yhcA,6723956,6724224,6723956,268,1178,utRho24
2090,yhcB,6760364,6760382,6760364,18,26,utRho24
2091,yhcC,6708470,6708470,6708100,370,754,utRho24
2092,yhcF,6733440,6733852,6733440,412,2716,utRho24
2093,yhcH,6739124,6739124,6738956,168,5192,utRho24
2094,yhcM,6760312,6760312,6759994,318,152,utRho24
2095,yhcN,6770812,6771076,6770812,264,332,utRho24
2096,yhcO,6772606,6772606,6772258,348,16,utRho24
2097,yhdH,6806560,6806968,6806560,408,360,utRho24
2098,yhdJ,6823234,6823306,6823234,72,18,utRho24
2099,yhdN,6879092,6879092,6879018,74,164,utRho24
2100,yhdT,6814702,6814750,6814702,48,28,utRho24
2101,yhdU,6824994,6825242,6824994,248,420,utRho24
2102,yhdV,6836392,6836780,6836392,388,1956,utRho24
2103,yhdW,6837944,6838298,6837944,354,240,utRho24
2104,yheO,6953082,6953082,6952880,202,292,utRho24
2105,yheV,6957970,6957970,6957584,386,142,utRho24
2106,yhfA,6971902,6971902,6971636,266,1238,utRho24
2107,yhfG,6983294,6983294,6983240,54,1690,utRho24
2108,yhfL,6998622,6998896,6998622,274,414,utRho24
2109,yhfY,7023244,7023244,7022844,400,0,utRho24
2110,yhgA,7086294,7086334,7086294,40,0,utRho24
2111,yhgE,7065176,7065176,7064878,298,1482,utRho24
2112,yhgF,7074352,7074770,7074352,418,6820,utRho24
2113,yhhA,7173458,7173886,7173458,428,1316,utRho24
2114,yhhI,7248346,7248756,7248346,410,16,utRho24
2115,yhhJ,7253696,7253696,7253606,90,326,utRho24
2116,yhhM,7211588,7211588,7211220,368,2452,utRho24
2117,yhhN,7211150,7211502,7211150,352,1756,utRho24
2118,yhhQ,7218238,7218434,7218238,196,1536,utRho24
2119,yhhT,7223682,7223730,7223682,48,82,utRho24
2120,yhhX,7162032,7162032,7161610,422,212,utRho24
2121,yhhY,7162222,7162276,7162222,54,98,utRho24
2122,yhhZ,7163516,7163726,7163516,210,1258,utRho24
2123,yhiD,7312220,7312220,7311804,416,21288,utRho24
2124,yhiJ,7265190,7265190,7265180,10,112,utRho24
2125,yhiM,7269270,7269682,7269270,412,4372,utRho24
2126,yhiN,7275000,7275000,7274820,180,808,utRho24
2127,yhjA,7338522,7338522,7338376,146,482,utRho24
2128,yhjB,7344090,7344090,7343788,302,1746,utRho24
2129,yhjC,7344272,7344684,7344272,412,670,utRho24
2130,yhjD,7346660,7346724,7346660,64,80,utRho24
2131,yhjE,7349274,7349572,7349274,298,3196,utRho24
2132,yhjG,7356824,7356824,7356730,94,210,utRho24
2133,yhjH,7358458,7358458,7358374,84,258,utRho24
2134,yhjJ,7364032,7364032,7363880,152,564,utRho24
2135,yhjK,7371296,7371296,7371158,138,358,utRho24
2136,yhjR,7392750,7392750,7392370,380,40,utRho24
2137,yhjV,7400796,7401126,7400796,330,1592,utRho24
2138,yhjX,7424194,7424194,7424014,180,172,utRho24
2139,yhjY,7425966,7425966,7425868,98,180,utRho24
2140,yiaB,7455654,7455654,7455496,158,148,utRho24
2141,yiaD,7432712,7433094,7432712,382,908,utRho24
2142,yiaF,7438194,7438194,7438088,106,570,utRho24
2143,yiaG,7438862,7438956,7438862,94,510,utRho24
2144,yiaJ,7485236,7485236,7485064,172,1896,utRho24
2145,yiaK,7485348,7485466,7485348,118,148,utRho24
2146,yiaT,7503924,7503924,7503736,188,0,utRho24
2147,yiaU,7503792,7503984,7503792,192,0,utRho24
2148,yiaY,7515856,7515856,7515654,202,470,utRho24
2149,yibF,7523950,7523950,7523910,40,144,utRho24
2150,yibG,7536128,7536354,7536128,226,620,utRho24
2151,yibL,7553194,7553330,7553194,136,168,utRho24
2152,yibN,7570112,7570112,7570030,82,146,utRho24
2153,yibT,7552848,7552848,7552760,88,856,utRho24
2154,yicC,7633290,7633352,7633290,62,100,utRho24
2155,yicH,7660862,7660914,7660862,52,172,utRho24
2156,yicJ,7673328,7673328,7671858,1470,6166,utRho24
2157,yicN,7685018,7685018,7684804,214,1822,utRho24
2158,yicO,7687914,7687914,7687578,336,294,utRho24
2159,yicR,15250308,15250308,15250236,72,0,utRho24
2160,yidB,7755230,7755230,7754930,300,440,utRho24
2161,yidE,7732780,7732780,7732546,234,110,utRho24
2162,yidF,7711580,7711580,7711222,358,384,utRho24
2163,yidQ,7735088,7735456,7735088,368,846,utRho24
2164,yidR,7738824,7738824,7738618,206,198,utRho24
2165,yieE,7787658,7787738,7787658,80,1322,utRho24
2166,yieH,7793314,7793548,7793314,234,346,utRho24
2167,yieK,7798928,7798928,7798786,142,222,utRho24
2168,yifB,7900350,7900350,7899998,352,206,utRho24
2169,yifL,7988984,7989044,7988984,60,10118,utRho24
2170,yigF,8005750,8005750,8005598,152,44320,utRho24
2171,yigI,8009448,8009448,8009394,54,1152,utRho24
2172,yigM,8022100,8022152,8022100,52,88,utRho24
2173,yihA,8101970,8101970,8101458,512,238,utRho24
2174,yihD,8084098,8084138,8084098,40,190,utRho24
2175,yihF,8088110,8088398,8088110,288,324,utRho24
2176,yihG,8093304,8093304,8093204,100,202,utRho24
2177,yihI,8102616,8102694,8102616,78,26,utRho24
2178,yihL,8120506,8120894,8120506,388,956,utRho24
2179,yihN,8124332,8124494,8124332,162,1190,utRho24
2180,yihO,8131942,8131942,8131532,410,474,utRho24
2181,yihQ,8138892,8138892,8138552,340,72,utRho24
2182,yihV,8147064,8147478,8147064,414,782,utRho24
2183,yihX,8151096,8151106,8151096,10,132,utRho24
2184,yiiE,8158192,8158582,8158192,390,3372,utRho24
2185,yiiF,8159124,8159502,8159124,378,838,utRho24
2186,yiiG,8173762,8174004,8173762,242,30,utRho24
2187,yiiM,8205506,8205644,8205506,138,3726,utRho24
2188,yiiQ,8224624,8224624,8224428,196,160,utRho24
2189,yiiS,8225738,8225934,8225738,196,8,utRho24
2190,yijE,8272178,8272216,8272178,38,70,utRho24
2191,yijF,8275728,8275728,8275314,414,4806,utRho24
2192,yijO,8296858,8296858,8296634,224,164,utRho24
2193,yjaA,8426240,8426468,8426240,228,64870,utRho24
2194,yjaB,8428312,8428312,8428246,66,50,utRho24
2195,yjaG,8398746,8399008,8398746,262,792,utRho24
2196,yjaH,8401022,8401132,8401022,110,58,utRho24
2197,yjaZ,8379506,8379572,8379506,66,54,utRho24
2198,yjbB,8455204,8455462,8455204,258,270,utRho24
2199,yjbE,16943432,16943624,16943432,192,688,utRho24
2200,yjbL,8520318,8520642,8520318,324,120,utRho24
2201,yjbQ,8540428,8540476,8540428,48,0,utRho24
2202,yjcB,8550328,8550328,8550082,246,424,utRho24
2203,yjcC,8550836,8550942,8550836,106,242,utRho24
2204,yjcD,8556628,8556958,8556628,330,926,utRho24
2205,yjcE,8559658,8559960,8559658,302,1360,utRho24
2206,yjcF,8566212,8566212,8566150,62,40,utRho24
2207,yjcO,8594660,8594660,8594250,410,228,utRho24
2208,yjdA,8654128,8654270,8654128,142,0,utRho24
2209,yjdC,8726660,8726660,8726616,44,80,utRho24
2210,yjdK,8704780,8705168,8704780,388,3800,utRho24
2211,yjdL,8713034,8713034,8712822,212,0,utRho24
2212,yjdM,8653672,8653672,8653468,204,1894,utRho24
2213,yjeF,8787354,8788132,8787354,778,79274,utRho24
2214,yjeI,8745522,8745618,8745522,96,128,utRho24
2215,yjeJ,8748806,8748806,8748468,338,652,utRho24
2216,yjeV,8785472,8785784,8785472,312,2054,utRho24
2217,yjfP,8833512,8833904,8833512,392,624,utRho24
2218,yjfY,8849656,8849656,8849582,74,258,utRho24
2219,yjfZ,8855052,8855052,8854844,208,1128,utRho24
2220,yjgA,8916162,8916162,8915730,432,498,utRho24
2221,yjgL,8950802,8950874,8950802,72,156,utRho24
2222,yjgM,8959342,8959342,8959074,268,144,utRho24
2223,yjgN,8959132,8959460,8959132,328,102,utRho24
2224,yjgR,8980170,8980170,8980126,44,594,utRho24
2225,yjgZ,9002116,9002520,9002116,404,5182,utRho24
2226,yjhB,9007764,9008116,9007764,352,338,utRho24
2227,yjhG,9048452,9048452,9048188,264,39368,utRho24
2228,yjhU,9041080,9041080,9040648,432,1274,utRho24
2229,yjiA,9178096,9178096,9177730,366,1230,utRho24
2230,yjiJ,9125364,9125364,9125350,14,50,utRho24
2231,yjiK,9127270,9127270,9127422,152,554,utRho24
2232,yjiL,9129604,9129604,9129378,226,42,utRho24
2233,yjiS,9143410,9143502,9143410,92,370,utRho24
2234,yjiY,9182734,9182734,9182558,176,1396,utRho24
2235,yjjA,9200674,9200674,9200378,296,872,utRho24
2236,yjjB,18408708,18408708,18407800,908,1384,utRho24
2237,yjjJ,9243314,9243538,9243314,224,50,utRho24
2238,yjjK,9261132,9261132,9261044,88,1292,utRho24
2239,yjjL,9189764,9189764,9189444,320,4198,utRho24
2240,yjjM,9191894,9191894,9191702,192,242,utRho24
2241,yjjP,9206068,9206068,9205716,352,13706,utRho24
2242,yjjQ,9206638,9206954,9206638,316,12580,utRho24
2243,yjjX,9267798,9267798,9267490,308,2144,utRho24
2244,yjjY,9280716,9280804,9280716,88,194,utRho24
2245,yjjZ,9211554,9211608,9211554,54,37020,utRho24
2246,yjtD,9281676,9281884,9281676,208,284,utRho24
2247,ykfB,532454,532454,532174,280,15770,utRho24
2248,ykfI,527636,527636,527338,298,1398,utRho24
2249,ykgB,637050,637050,636638,412,534,utRho24
2250,ykgC,640430,640430,640002,428,624,utRho24
2251,ykgD,640232,640454,640232,222,680,utRho24
2252,ykgE,642962,643216,642962,254,2978,utRho24
2253,ykgJ,608524,608524,608364,160,664,utRho24
2254,ykgL,623878,624224,623878,346,4266,utRho24
2255,ykgM,625610,625610,625554,56,1226,utRho24
2256,ykgR,626570,626570,626484,86,122,utRho24
2257,ylaC,958576,958576,958502,74,3410,utRho24
2258,yliE,1745938,1745958,1745938,20,16,utRho24
2259,ymcE,2103660,2103694,2103660,34,18,utRho24
2260,ymdA,2210450,2210828,2210450,378,350,utRho24
2261,ymdB,2211428,2211640,2211428,212,212,utRho24
2262,ymfD,2395322,2395322,2395064,258,678,utRho24
2263,ymfI,2402880,2402994,2402880,114,0,utRho24
2264,ymfJ,2404518,2404518,2404168,350,786,utRho24
2265,ymfK,2406176,2406176,2405866,310,194,utRho24
2266,ymfT,2405766,2406048,2405766,282,178,utRho24
2267,ymgE,2489110,2489456,2489110,346,1718,utRho24
2268,ymgF,2437628,2437966,2437628,338,156,utRho24
2269,ymiA,2670112,2670320,2670112,208,546,utRho24
2270,ymjA,2715620,2715620,2715336,284,306,utRho24
2271,ynaI,2791946,2791946,2791844,102,166,utRho24
2272,ynaK,2850438,2850754,2850438,316,438,utRho24
2273,ynbA,2954924,2955242,2954924,318,178,utRho24
2274,yncD,3046552,3046552,3046130,422,282,utRho24
2275,yncE,3046454,3046614,3046454,160,60,utRho24
2276,yncG,3052456,3052494,3052456,38,1768,utRho24
2277,yncL,3034492,3034492,3034388,104,1432,utRho24
2278,yneE,3218364,3218364,3218044,320,10,utRho24
2279,yneF,3223748,3223748,3223708,40,0,utRho24
2280,yneJ,3229560,3229608,3229560,48,220,utRho24
2281,yneK,3231100,3231526,3231100,426,838,utRho24
2282,yneM,3245176,3245292,3245176,116,358,utRho24
2283,ynfA,3311398,3311398,3311346,52,70,utRho24
2284,ynfB,3311418,3311616,3311418,198,102,utRho24
2285,ynfC,3315094,3315094,3314914,180,64,utRho24
2286,ynfD,3314828,3315130,3314828,302,104,utRho24
2287,ynfE,3316006,3316138,3316006,132,194,utRho24
2288,ynfK,3334670,3334670,3334438,232,212,utRho24
2289,ynfL,3339304,3339304,3339184,120,100,utRho24
2290,ynfM,3339260,3339398,3339260,138,98,utRho24
2291,ynfN,3276598,3276598,3276218,380,40,utRho24
2292,ynfO,3273454,3273512,3273454,58,636,utRho24
2293,ynhG,3517890,3517890,3517450,440,226,utRho24
2294,yniA,3615158,3615592,3615158,434,1128,utRho24
2295,yniB,3618526,3618526,3618466,60,50,utRho24
2296,yniC,3618652,3618760,3618652,108,56,utRho24
2297,yniD,3610202,3610330,3610202,128,160,utRho24
2298,ynjE,3678880,3678934,3678880,54,110,utRho24
2299,ynjF,3683222,3683222,3682806,416,626,utRho24
2300,ynjH,3684376,3684376,3684270,106,176,utRho24
2301,ynjI,3690022,3690022,3689742,280,1048,utRho24
2302,yoaB,3786642,3786734,3786642,92,280,utRho24
2303,yoaC,3787932,3788146,3787932,214,322,utRho24
2304,yoaE,3803544,3803544,3803170,374,866,utRho24
2305,yoaF,3755444,3755444,3755064,380,1390,utRho24
2306,yoaH,3789866,3789866,3789462,404,1422,utRho24
2307,yobB,3850418,3850880,3850418,462,1242,utRho24
2308,yobF,3815586,3815586,3815182,404,318,utRho24
2309,yobH,3817800,3817850,3817800,50,832,utRho24
2310,yodB,4084352,4084736,4084352,384,1366,utRho24
2311,yodC,4057008,4057008,4056740,268,68,utRho24
2312,yohC,4451358,4451358,4451262,96,252,utRho24
2313,yohD,4451526,4451602,4451526,76,178,utRho24
2314,yohJ,4460986,4461248,4460986,262,768,utRho24
2315,yohO,4431172,4431314,4431172,142,450,utRho24
2316,yojI,4617282,4617282,4617230,52,24,utRho24
2317,ypdI,4988988,4989396,4988988,408,452,utRho24
2318,ypfG,5165786,5165786,5165554,232,254,utRho24
2319,ypfM,5182140,5182140,5181732,408,634,utRho24
2320,yphB,5349590,5349590,5349376,214,368,utRho24
2321,ypjA,5565644,5565644,5565452,192,2104,utRho24
2322,ypjB,5569636,5569636,5568858,778,248,utRho24
2323,ypjD,5495860,5495774,5495860,86,2,utRho24
2324,yqaE,5594170,5594170,5594056,114,274,utRho24
2325,yqcA,5846100,5846100,5845968,132,538,utRho24
2326,yqcE,5800944,5801184,5800944,240,32,utRho24
2327,yqeC,6030468,6030468,6030114,354,338,utRho24
2328,yqeF,5971618,5971618,5971184,434,5654,utRho24
2329,yqeG,5971438,5971694,5971438,256,11522,utRho24
2330,yqeH,5975016,5975072,5975016,56,17868,utRho24
2331,yqeI,5976688,5977004,5976688,316,340,utRho24
2332,yqeK,5981140,5981140,5980720,420,5966,utRho24
2333,yqfA,6086728,6086728,6086296,432,842,utRho24
2334,yqgA,6219042,6219106,6219042,64,84,utRho24
2335,yqgB,6172500,6172500,6172102,398,510,utRho24
2336,yqgE,6185768,6185874,6185768,106,354,utRho24
2337,yqhA,6299150,6299150,6298942,208,324,utRho24
2338,yqhC,6310768,6310768,6310436,332,922,utRho24
2339,yqhD,6310604,6310710,6310604,106,334,utRho24
2340,yqhH,6316842,6317254,6316842,412,1478,utRho24
2341,yqiC,6369662,6369680,6369662,18,728,utRho24
2342,yqiJ,6384108,6384416,6384108,308,416,utRho24
2343,yqjA,6495096,6495546,6495096,450,12068,utRho24
2344,yqjF,6500932,6501124,6500932,192,1170,utRho24
2345,yqjG,6501948,6502048,6501948,100,10,utRho24
2346,yqjH,6433078,6433078,6432982,96,0,utRho24
2347,yqjI,6433506,6433558,6433506,52,124,utRho24
2348,yraH,6574552,6574852,6574552,300,232,utRho24
2349,yraP,6592144,6592818,6592144,674,676,utRho24
2350,yraQ,6596414,6596414,6596276,138,54,utRho24
2351,yraR,6598024,6598024,6597692,332,982,utRho24
2352,yrbG,13360844,13361100,13360844,256,88,utRho24
2353,yrbL,6696842,6696904,6696842,62,1336,utRho24
2354,yrbN,6616172,6616172,6615866,306,1504,utRho24
2355,yrdB,6860176,6860176,6860046,130,0,utRho24
2356,yrfF,7052548,7052938,7052548,390,1232,utRho24
2357,yrhB,7169440,7169518,7169440,78,100,utRho24
2358,ysaB,7451804,7451804,7451424,380,78,utRho24
2359,ysgA,8032686,8032686,8032338,348,944,utRho24
2360,ytfB,8857638,8857638,8857434,204,824,utRho24
2361,ytfE,8864018,8864018,8863966,52,234,utRho24
2362,ytfF,8866296,8866296,8866130,166,636,utRho24
2363,ytfH,8868164,8868226,8868164,62,406,utRho24
2364,ytfI,8875234,8875414,8875234,180,426,utRho24
2365,ytfJ,8878572,8878572,8878524,48,198,utRho24
2366,ytfK,8879022,8879174,8879022,152,330,utRho24
2367,ytfL,8882642,8882642,8882430,212,156,utRho24
2368,ytfQ,8899634,8899924,8899634,290,346,utRho24
2369,ytjB,9249598,9249598,9249578,20,84,utRho24
2370,yzfA,8896588,8896588,8896490,98,2,utRho24
2371,zapA,6111102,6111224,6111102,122,704,utRho24
2372,zapB,8236772,8237030,8236772,258,298,utRho24
2373,zapC,2011700,2011904,2011700,204,162,utRho24
2374,zinT,4082692,4082750,4082692,58,382,utRho24
2375,zipA,5062814,5062814,5062466,348,302,utRho24
2376,zitB,1569716,1569716,1569646,70,124,utRho24
2377,zntA,7212844,7212902,7212844,58,170,utRho24
2378,zntR,6878336,6878336,6878260,76,242,utRho24
2379,znuA,3885322,3885322,3885166,156,212,utRho24
2380,znuC,3885268,3885324,3885268,56,190,utRho24
2381,zraP,8403424,8403424,8403376,48,42,utRho24
2382,zraS,8403810,8403852,8403810,42,4,utRho24
2383,zupT,6364866,6365100,6364866,234,3578,utRho24
2384,zur,8520282,8520282,8520006,276,366,utRho24
2385,zwf,3872752,3872752,3872628,124,124,utRho24
0,C0343,2818676,2818728,2818676,52,0,utRho25
1,aaeB,6776526,6776526,6776376,150,52,utRho25
2,aaeR,6778762,6779040,6778762,278,116,utRho25
3,aaeX,6778860,6778860,6778674,186,102,utRho25
4,aat,1854920,1854920,1854864,56,0,utRho25
5,accA,416822,417242,416822,420,272,utRho25
6,accB,6810280,6810872,6810280,592,832,utRho25
7,accD,4868030,4868030,4867852,178,68,utRho25
8,aceB,8430804,8430956,8430804,152,26,utRho25
9,aceE,245938,246034,245938,96,134,utRho25
10,ackA,4826918,4826940,4826918,22,274,utRho25
11,acnA,2670848,2671662,2670848,814,202,utRho25
12,acnB,263038,263230,263038,192,566,utRho25
13,acpP,2303148,2303230,2303148,82,90,utRho25
14,acpS,5402324,5402324,5401996,328,562,utRho25
15,acrA,971396,971396,971238,158,0,utRho25
16,acrB,969370,969370,968806,564,504,utRho25
17,acrD,5174950,5175190,5174950,240,52,utRho25
18,acrE,6827404,6827728,6827404,324,22,utRho25
19,acrR,971398,971522,971398,124,0,utRho25
20,acrZ,1589502,1589546,1589502,44,0,utRho25
21,acs,8575190,8575190,8574742,448,674,utRho25
22,actP,8569870,8569870,8569804,66,52,utRho25
23,ada,4620854,4620854,4620810,44,0,utRho25
24,add,3404404,3404466,3404404,62,170,utRho25
25,ade,7687802,7687928,7687802,126,20,utRho25
26,adhE,2596826,2596826,2596242,584,0,utRho25
27,adhP,3107988,3107988,3107676,312,308,utRho25
28,adiA,8681112,8681112,8681042,70,0,utRho25
29,adiC,8674404,8674404,8674062,342,20,utRho25
30,adiY,8676084,8676084,8675858,226,12,utRho25
31,adk,994278,994350,994278,72,400,utRho25
32,adrA,807374,807406,807374,32,0,utRho25
33,aer,6438240,6438240,6438152,88,0,utRho25
34,aes,1000102,1000102,999946,156,80,utRho25
35,agaR,6557406,6557406,6557330,76,68,utRho25
36,agaS,6563778,6563952,6563778,174,0,utRho25
37,agp,2131118,2131170,2131118,52,0,utRho25
38,agrA,7296126,7296126,7296126,0,0,utRho25
39,agrB,7296588,7296588,7296588,0,0,utRho25
40,ahpC,1277386,1277890,1277386,504,862,utRho25
41,ahpF,1278004,1279506,1278004,1502,38012,utRho25
42,ahr,8992698,8992698,8992418,280,60,utRho25
43,aidB,8828494,8828550,8828494,56,0,utRho25
44,ais,4731512,4731512,4731240,272,124,utRho25
45,alaA,4814816,4815122,4814816,306,2,utRho25
46,alaC,4996798,4996798,4996590,208,74,utRho25
47,alaE,5598140,5598328,5598140,188,330,utRho25
48,alaS,5644180,5644180,5644022,158,396,utRho25
49,alaW,5036612,5036612,5036462,150,128,utRho25
50,aldA,2976380,2976464,2976380,84,8,utRho25
51,aldB,7513070,7513070,7513022,48,44,utRho25
52,alkA,4295118,4295118,4295080,38,0,utRho25
53,alkB,4618890,4618890,4618682,208,112,utRho25
54,allA,1064780,1064902,1064780,122,34,utRho25
55,allD,1092822,1092822,1092726,96,0,utRho25
56,allE,1088112,1088112,1088092,20,0,utRho25
57,allS,1064600,1064600,1064442,158,98,utRho25
58,alr,8531178,8531564,8531178,386,242,utRho25
59,alsE,8617334,8617334,8616956,378,628,utRho25
60,alsK,8615990,8615990,8615598,392,60,utRho25
61,alx,6476740,6477160,6476740,420,96,utRho25
62,amiA,5104482,5104704,5104482,222,4,utRho25
63,amiC,5898378,5898378,5898020,358,0,utRho25
64,amn,4110062,4110122,4110062,60,0,utRho25
65,ampC,8758006,8758006,8757888,118,0,utRho25
66,ampD,237362,237466,237362,104,80,utRho25
67,ampG,907372,907372,907090,282,24,utRho25
68,ampH,792726,792726,792574,152,0,utRho25
69,amyA,4012230,4012312,4012230,82,0,utRho25
70,anmK,3439346,3439346,3439204,142,0,utRho25
71,ansB,6201580,6201580,6201456,124,56,utRho25
72,ansP,3052040,3052040,3051960,80,0,utRho25
73,apaG,104068,104068,103212,856,294,utRho25
74,apaH,102586,102586,102444,142,88,utRho25
75,apbE,4623188,4623188,4623068,120,0,utRho25
76,appA,2081198,2081234,2081198,36,0,utRho25
77,appC,2075420,2075480,2075420,60,68,utRho25
78,appY,1167134,1167362,1167134,228,0,utRho25
79,apt,982620,982824,982620,204,46,utRho25
80,aqpZ,1832424,1832424,1832094,330,58,utRho25
81,araB,140150,140150,140096,54,22,utRho25
82,araC,140482,140774,140482,292,96,utRho25
83,araE,5964416,5964416,5964364,52,0,utRho25
84,araF,3972476,3972476,3972256,220,0,utRho25
85,araH,3967120,3967120,3967086,34,26,utRho25
86,araJ,825058,825058,824962,96,428,utRho25
87,arcA,9281602,9281602,9280612,990,1882,utRho25
88,arcB,6706098,6706098,6706050,48,180,utRho25
89,arcZ,6701154,6701154,6701154,0,0,utRho25
90,arfA,6877346,6877346,6877298,48,16,utRho25
91,argA,5898312,5898484,5898312,172,0,utRho25
92,argC,8309770,8310002,8309770,232,80,utRho25
93,argD,6980442,6980442,6980360,82,14,utRho25
94,argE,8310156,8310156,8309694,462,110,utRho25
95,argF,580680,580680,580610,70,0,utRho25
96,argG,6637124,6637274,6637124,150,254,utRho25
97,argI,8956688,8956688,8956622,66,0,utRho25
98,argO,6137672,6137672,6137616,56,256,utRho25
99,argP,6119460,6119506,6119460,46,8,utRho25
100,argR,6769204,6769406,6769204,202,0,utRho25
101,argS,3920002,3920124,3920002,122,0,utRho25
102,argT,4855698,4855698,4855582,116,0,utRho25
103,argU,1129406,1129446,1129406,40,0,utRho25
104,argW,4932616,4932618,4932616,2,0,utRho25
105,argX,7964728,7964750,7964728,22,58,utRho25
106,aroF,5482402,5482402,5482300,102,0,utRho25
107,aroG,1571182,1571266,1571182,84,48,utRho25
108,aroH,3576636,3576870,3576636,234,316,utRho25
109,aroK,7038760,7038760,7038128,632,588,utRho25
110,aroL,812560,812810,812560,250,104,utRho25
111,aroP,243342,243342,243102,240,0,utRho25
112,arpA,8445382,8445382,8444974,408,6,utRho25
113,arrS,7316108,7316108,7316108,0,0,utRho25
114,arsR,7297024,7297056,7297024,32,0,utRho25
115,artJ,1801252,1801252,1801150,102,0,utRho25
116,artP,1807686,1807686,1807468,218,324,utRho25
117,ascF,5678858,5679048,5678858,190,0,utRho25
118,ascG,5678574,5678574,5678528,46,0,utRho25
119,aslB,7965562,7965916,7965562,354,250,utRho25
120,asnA,7854258,7854310,7854258,52,134,utRho25
121,asnB,1398444,1398444,1398354,90,178,utRho25
122,asnC,23562186,23562186,23562018,168,402,utRho25
123,asnS,1978088,1978088,1977970,118,1818,utRho25
124,asnT,4089082,4089098,4089082,16,0,utRho25
125,asnU,4119690,4119702,4119690,12,0,utRho25
126,asnV,4124504,4124520,4124504,16,2,utRho25
127,aspA,17473728,17473728,17473308,420,4,utRho25
128,aspC,1971486,1971486,1971418,68,40,utRho25
129,aspS,3901402,3901402,3901044,358,20,utRho25
130,aspT,7893560,7893744,7893560,184,104176,utRho25
131,aspV,473826,473862,473826,36,266,utRho25
132,asr,3342654,3342752,3342654,98,84,utRho25
133,astC,3664088,3664088,3663964,124,38,utRho25
134,astE,3654138,3654138,3653846,292,0,utRho25
135,atoD,4646824,4646894,4646824,70,120,utRho25
136,atpB,7844540,7844540,7844102,438,264,utRho25
137,atpC,7832118,7832118,7831944,174,524,utRho25
138,atpI,7845050,7845050,7844880,170,494,utRho25
139,avtA,7479348,7479410,7479348,62,246,utRho25
140,azoR,2965982,2965982,2965720,262,78,utRho25
141,azuC,3976002,3976002,3975918,84,24,utRho25
142,bacA,6408350,6408350,6408262,88,566,utRho25
143,bamA,394052,395856,394052,1804,1356,utRho25
144,bamB,5277950,5277950,5277304,646,600,utRho25
145,bamC,5198028,5198028,5197730,298,418,utRho25
146,bamD,5471922,5472292,5471922,370,770,utRho25
147,bamE,5506972,5507210,5506972,238,804,utRho25
148,basS,8666954,8666954,8666544,410,386,utRho25
149,bax,7474468,7474468,7474354,114,82,utRho25
150,bcp,5200874,5200956,5200874,82,300,utRho25
151,bcsB,7385346,7385346,7385214,132,108,utRho25
152,bcsE,7392644,7392916,7392644,272,150,utRho25
153,bdcA,8948128,8948128,8948106,22,34,utRho25
154,bdcR,8948192,8948248,8948192,56,32,utRho25
155,bdm,3112680,3112680,3112560,120,138,utRho25
156,betA,654522,654522,654494,28,0,utRho25
157,betI,658722,658722,658668,54,20,utRho25
158,betT,658842,658926,658842,84,56,utRho25
159,bfr,6933498,6933498,6933450,48,66,utRho25
160,bglG,23440182,23440182,23439402,780,144,utRho25
161,bglX,4444240,4444240,4443978,262,0,utRho25
162,bhsA,2337962,2338146,2337962,184,6,utRho25
163,bioA,1618584,1618584,1618514,70,0,utRho25
164,bioB,1618604,1618688,1618604,84,0,utRho25
165,bioH,7089716,7089716,7089688,28,0,utRho25
166,bisC,7433026,7433026,7432788,238,58,utRho25
167,blc,8755490,8755490,8755444,46,0,utRho25
168,blr,3409024,3409102,3409024,78,26,utRho25
169,bluF,2431226,2431226,2430950,276,72,utRho25
170,bluR,2428226,2428226,2428118,108,0,utRho25
171,bolA,908698,908944,908698,246,4,utRho25
172,borD,1157842,1157842,1157786,56,6,utRho25
173,brnQ,838976,839182,838976,206,1038,utRho25
174,bssR,1756492,1756496,1756492,4,0,utRho25
175,bssS,2242116,2242116,2241910,206,500,utRho25
176,btuB,8326798,8327278,8326798,480,742,utRho25
177,cadB,8720212,8720212,8720062,150,78,utRho25
178,cadC,8723926,8723926,8723868,58,0,utRho25
179,caiE,70998,70998,70742,256,30,utRho25
180,caiF,68436,68600,68436,164,22,utRho25
181,caiT,84074,84074,83862,212,186,utRho25
182,can,285406,285406,285340,66,108,utRho25
183,carA,59102,59302,59102,200,160,utRho25
184,carB,61550,61634,61550,84,0,utRho25
185,cas2,5757830,5757830,5757706,124,2,utRho25
186,casA,5768638,5768638,5768276,362,128,utRho25
187,cbl,4121882,4121882,4121828,54,0,utRho25
188,cbpA,2128074,2128074,2127550,524,0,utRho25
189,cbrA,7738628,7738754,7738628,126,72,utRho25
190,cbrB,7794958,7795012,7794958,54,32,utRho25
191,ccmH,4585242,4585242,4584820,422,120,utRho25
192,cdaR,364894,364926,364894,32,16,utRho25
193,cdd,4463638,4463688,4463638,50,0,utRho25
194,cdh,8219814,8219860,8219814,46,56,utRho25
195,cdsA,391110,391354,391110,244,242,utRho25
196,cedA,3627484,3627484,3627326,158,160,utRho25
197,cfa,3482402,3482826,3482402,424,52,utRho25
198,chaC,2544844,2544972,2544844,128,0,utRho25
199,chbB,3643452,3643452,3643238,214,0,utRho25
200,chbG,3634624,3634624,3634270,354,22,utRho25
201,cheW,3946924,3946924,3946678,246,314,utRho25
202,chiA,6939792,6939792,6939706,86,206,utRho25
203,chiP,1416472,1416668,1416472,196,20,utRho25
204,cho,3646984,3647030,3646984,46,0,utRho25
205,chpS,8896804,8896894,8896804,90,28,utRho25
206,cirA,4493884,4493884,4493538,346,44,utRho25
207,citC,1304078,1304078,1303712,366,420,utRho25
208,citT,1293264,1293264,1293160,104,0,utRho25
209,clcA,350104,350214,350104,110,0,utRho25
210,clpA,1846160,1846528,1846160,368,0,utRho25
211,clpB,5468410,5468410,5468346,64,390,utRho25
212,clpP,913154,913354,913154,200,712,utRho25
213,clpS,1845500,1845826,1845500,326,652,utRho25
214,clpX,914404,914852,914404,448,2382,utRho25
215,clsA,2617346,2617346,2617290,56,0,utRho25
216,clsC,2212584,2212710,2212584,126,8,utRho25
217,cmk,1922330,1922402,1922330,72,0,utRho25
218,cnu,3409522,3409898,3409522,376,878,utRho25
219,coaA,8350214,8350214,8350052,162,62,utRho25
220,cobC,1340092,1340092,1339814,278,40,utRho25
221,cobT,4129202,4129202,4128934,268,168,utRho25
222,cobU,4131944,4131944,4131528,416,152,utRho25
223,codB,709768,709844,709768,76,0,utRho25
224,comR,2337726,2337726,2337664,62,26,utRho25
225,copA,1022822,1022822,1022758,64,0,utRho25
226,corA,8002388,8002852,8002388,464,31440,utRho25
227,cpdB,8873258,8873258,8873130,128,86,utRho25
228,cptB,6082198,6082198,6082140,58,2,utRho25
229,cpxA,8210202,8210202,8209950,252,58,utRho25
230,cpxP,8211570,8211640,8211570,70,122,utRho25
231,cpxR,8211372,8211372,8211340,32,0,utRho25
232,cra,175894,176056,175894,162,158,utRho25
233,crcB,1316016,1316016,1315876,140,0,utRho25
234,creA,9270486,9271042,9270486,556,78,utRho25
235,creD,9276320,9276356,9276320,36,238,utRho25
236,crl,515620,515658,515620,38,480,utRho25
237,crp,6971906,6972240,6971906,334,214,utRho25
238,crr,5070960,5071668,5070960,708,1178,utRho25
239,csdA,5886414,5886674,5886414,260,0,utRho25
240,csgB,2207718,2207902,2207718,184,0,utRho25
241,csgD,2206688,2206688,2206392,296,172,utRho25
242,csgG,2203510,2203510,2203368,142,262,utRho25
243,csiD,5577854,5577970,5577854,116,2,utRho25
244,csiE,5330802,5330870,5330802,68,28,utRho25
245,csiR,5590942,5591348,5590942,406,124,utRho25
246,cspA,7439778,7440098,7439778,320,460,utRho25
247,cspB,3283430,3283430,3283108,322,0,utRho25
248,cspC,3815018,3815018,3814870,148,70,utRho25
249,cspD,1845352,1845352,1845180,172,4674,utRho25
250,cspE,1314294,1314584,1314294,290,78,utRho25
251,cspF,3283380,3283710,3283380,330,190,utRho25
252,cspG,2102610,2102922,2102610,312,212,utRho25
253,cspH,2102746,2102746,2102350,396,60,utRho25
254,cspI,3277624,3277624,3277334,290,0,utRho25
255,csrA,5638746,5638746,5638292,454,482,utRho25
256,csrB,5849048,5849048,5849048,0,0,utRho25
257,csrC,8102072,8102072,8102072,0,0,utRho25
258,csrD,6806850,6806850,6806664,186,242,utRho25
259,cstA,1259710,1259788,1259710,78,22,utRho25
260,cueO,274090,274166,274090,76,0,utRho25
261,cueR,1027948,1027986,1027948,38,2,utRho25
262,curA,3037784,3038054,3037784,270,76,utRho25
263,cusC,1191146,1191200,1191146,54,0,utRho25
264,cusR,1190924,1190924,1190886,38,0,utRho25
265,cutA,8730784,8730784,8730712,72,26,utRho25
266,cutC,3918534,3918534,3917920,614,230,utRho25
267,cvpA,4861600,4861600,4861526,74,100,utRho25
268,cvrA,2484328,2484328,2484142,186,0,utRho25
269,cyaA,7981548,7982306,7981548,758,354,utRho25
270,cyaR,4334228,4334224,4334228,4,26,utRho25
271,cyaY,7988166,7988166,7988118,48,270,utRho25
272,cybB,2981522,2981804,2981522,282,0,utRho25
273,cycA,8859560,8859728,8859560,168,54,utRho25
274,cydA,1542340,1542916,1542340,576,2094,utRho25
275,cydC,1858800,1858800,1858390,410,214,utRho25
276,cydD,1862062,1862062,1861924,138,0,utRho25
277,cydX,1548300,1548392,1548300,92,168,utRho25
278,cynR,717418,717418,717380,38,2,utRho25
279,cynT,1435092,1435196,1435092,104,0,utRho25
280,cyoA,903306,903306,903220,86,312,utRho25
281,cyoE,895540,895540,895410,130,120,utRho25
282,cysB,2667576,2667710,2667576,134,240,utRho25
283,cysC,5748056,5748056,5747984,72,176,utRho25
284,cysD,5752736,5752736,5752658,78,64,utRho25
285,cysE,7565362,7565362,7565124,238,504,utRho25
286,cysG,6995508,6995656,6995508,148,684,utRho25
287,cysJ,5783928,5783928,5783796,132,578,utRho25
288,cysK,5064688,5064818,5064688,130,0,utRho25
289,cysP,5087114,5087114,5087056,58,2,utRho25
290,cysS,1109154,1109222,1109154,68,0,utRho25
291,cysT,3984100,3984100,3983974,126,112,utRho25
292,cysZ,5062766,5062926,5062766,160,254,utRho25
293,cytR,8249018,8249018,8248912,106,112,utRho25
294,dacA,1328002,1328002,1327926,76,0,utRho25
295,dacB,6657714,6657926,6657714,212,0,utRho25
296,dacC,1761306,1761454,1761306,148,62,utRho25
297,dadA,2475018,2475142,2475018,124,8,utRho25
298,dam,7032504,7032504,7031826,678,422,utRho25
299,damX,7035200,7035200,7034612,588,1500,utRho25
300,dapA,5199568,5199568,5199520,48,0,utRho25
301,dapB,56576,56748,56576,172,206,utRho25
302,dapD,371954,371954,371894,60,130,utRho25
303,dapE,5183120,5183214,5183120,94,128,utRho25
304,dcp,3254844,3254844,3254760,84,14,utRho25
305,dcrB,7219534,7219910,7219534,376,132,utRho25
306,dctA,7366996,7366996,7366894,102,124,utRho25
307,dcuA,8733686,8733686,8733546,140,658,utRho25
308,dcuB,8698182,8698182,8697488,694,628,utRho25
309,dcuC,1312166,1312166,1311936,230,564,utRho25
310,dcuD,6749166,6749738,6749166,572,356,utRho25
311,dcuR,8701130,8701130,8700068,1062,492,utRho25
312,dcuS,8703370,8703370,8703324,46,96,utRho25
313,dcyD,3999016,3999016,3998960,56,0,utRho25
314,ddpX,3126498,3126498,3126152,346,0,utRho25
315,deaD,6615818,6615818,6615720,98,64,utRho25
316,dedA,4869880,4869880,4869482,398,316,utRho25
317,dedD,4863750,4863750,4863368,382,156,utRho25
318,def,6867300,6867380,6867300,80,0,utRho25
319,degP,361690,361768,361690,78,0,utRho25
320,degQ,6761308,6761486,6761308,178,10,utRho25
321,deoB,9239134,9239206,9239134,72,52,utRho25
322,deoC,9233358,9234646,9233358,1288,474,utRho25
323,dfp,7625406,7625462,7625406,56,0,utRho25
324,dgcZ,3247758,3247758,3247700,58,0,utRho25
325,dgkA,8512914,8513274,8512914,360,256,utRho25
326,dgt,358392,358474,358392,82,86,utRho25
327,dhaK,2501888,2501888,2501676,212,26,utRho25
328,dhaR,2502006,2502132,2502006,126,24,utRho25
329,dicB,3299194,3299218,3299194,24,0,utRho25
330,dicC,3295752,3295752,3295700,52,0,utRho25
331,dinB,501760,501796,501760,36,0,utRho25
332,dinD,7635398,7635520,7635398,122,128,utRho25
333,dinG,1666146,1666140,1666146,6,0,utRho25
334,dinI,2243018,2243018,2242974,44,30,utRho25
335,dinJ,493230,493230,493004,226,2,utRho25
336,dinQ,7295964,7295964,7295576,388,120,utRho25
337,djlA,114536,114728,114536,192,56,utRho25
338,dkgA,6313142,6313246,6313142,104,92,utRho25
339,dkgB,458196,458334,458196,138,0,utRho25
340,dksA,321502,321502,321208,294,650,utRho25
341,dld,4444164,4444370,4444164,206,36,utRho25
342,dmlA,3763424,3763824,3763424,400,114,utRho25
343,dmlR,3763710,3763710,3763618,92,26,utRho25
344,dmsA,1881646,1881918,1881646,272,0,utRho25
345,dnaA,7767922,7767922,7767458,464,370,utRho25
346,dnaB,8528566,8528628,8528566,62,264,utRho25
347,dnaK,24096,24326,24096,230,5134,utRho25
348,dnaN,7765466,7765466,7764642,824,226,utRho25
349,dnaQ,471868,472134,471868,266,2912,utRho25
350,dnaT,18406460,18406460,18406068,392,16,utRho25
351,dnaX,984112,984184,984112,72,0,utRho25
352,dosP,3131486,3131486,3131466,20,2,utRho25
353,dpiB,1303968,1304470,1303968,502,28,utRho25
354,dppA,7415740,7415740,7415410,330,496,utRho25
355,dps,1697900,1697900,1697822,78,30,utRho25
356,dsbA,8086754,8086836,8086754,82,930,utRho25
357,dsbB,2466294,2466294,2466060,234,20,utRho25
358,dsbC,6079266,6079266,6077644,1622,766,utRho25
359,dsbG,1277600,1277600,1277146,454,464,utRho25
360,dsdA,4958242,4958404,4958242,162,2,utRho25
361,dsdC,4955492,4955492,4955258,234,0,utRho25
362,dsdX,4955642,4955694,4955642,52,36,utRho25
363,dsrA,4050626,4050626,4050626,0,0,utRho25
364,dsrB,4049686,4049686,4049646,40,0,utRho25
365,dtpD,1485340,1485340,1485112,228,2,utRho25
366,dusA,8523200,8523338,8523200,138,700,utRho25
367,dusB,6820492,6820560,6820492,68,0,utRho25
368,dusC,4460790,4460790,4460770,20,0,utRho25
369,dut,7627704,7627864,7627704,160,874,utRho25
370,dxr,386670,387042,386670,372,374,utRho25
371,ebgA,6445102,6445266,6445102,164,0,utRho25
372,ebgR,6442874,6442932,6442874,58,0,utRho25
373,ecnB,8753018,8753106,8753018,88,32,utRho25
374,eco,4607594,4607810,4607594,216,42,utRho25
375,ecpA,621594,621594,621342,252,0,utRho25
376,ecpB,620238,620238,620052,186,0,utRho25
377,ecpR,622964,622964,622672,292,0,utRho25
378,eda,3866218,3866218,3865512,706,24,utRho25
379,edd,3869426,3869426,3869208,218,4,utRho25
380,efeO,2164308,2164486,2164308,178,2,utRho25
381,efeU_1,2162614,2162712,2162614,98,224,utRho25
382,efp,8751134,8751398,8751134,264,530,utRho25
383,elaA,4763372,4763372,4763086,286,6,utRho25
384,elaD,4765308,4765426,4765308,118,22,utRho25
385,elfA,1995530,1995736,1995530,206,0,utRho25
386,elfD,1996642,1996980,1996642,338,14,utRho25
387,emrD,7707690,7707844,7707690,154,0,utRho25
388,emrK,4966896,4966896,4966678,218,46,utRho25
389,emrY,4964668,4964668,4964352,316,316,utRho25
390,emtA,2486250,2486360,2486250,110,0,utRho25
391,endA,12361100,12361388,12361100,288,0,utRho25
392,eno,5817692,5817692,5815882,1810,816,utRho25
393,entC,1249662,1249770,1249662,108,0,utRho25
394,entD,1220508,1220508,1220158,350,144,utRho25
395,entH,1258584,1258600,1258584,16,86,utRho25
396,entS,1244506,1244600,1244506,94,32,utRho25
397,envR,6827266,6827266,6826930,336,0,utRho25
398,epd,12295292,12295292,12294764,528,12,utRho25
399,epmA,8765236,8765286,8765236,50,0,utRho25
400,epmB,8751406,8751406,8751314,92,326,utRho25
401,eptB,7421162,7421162,7420950,212,0,utRho25
402,eptC,8300622,8300622,8300530,92,112,utRho25
403,erfK,4126708,4126708,4126646,62,28,utRho25
404,erpA,353122,353220,353122,98,4,utRho25
405,esrE,8039956,8039956,8039956,0,0,utRho25
406,essD,1153746,1154796,1153746,1050,232,utRho25
407,etk,2088606,2088606,2088420,186,150,utRho25
408,evgA,4967262,4967510,4967262,248,48,utRho25
409,exbB,6304028,6304028,6303968,60,20,utRho25
410,exbD,6302780,6302780,6302486,294,56,utRho25
411,exuR,6493016,6493304,6493016,288,0,utRho25
412,exuT,6490004,6490208,6490004,204,0,utRho25
413,fabA,2032996,2032996,2032940,56,64,utRho25
414,fabB,4883282,4883282,4883210,72,8,utRho25
415,fabH,2297032,2297518,2297032,486,386,utRho25
416,fabI,2702236,2702236,2702078,158,46,utRho25
417,fadB,8062026,8062026,8061942,84,0,utRho25
418,fadD,3779614,3779614,3779492,122,282,utRho25
419,fadE,486812,486812,486606,206,286,utRho25
420,fadH,6463248,6463330,6463248,82,26,utRho25
421,fadI,4921022,4921022,4920938,84,4,utRho25
422,fadL,4922410,4922600,4922410,190,220,utRho25
423,fadM,928720,928804,928720,84,0,utRho25
424,fadR,2469810,2469876,2469810,66,0,utRho25
425,fbaB,4357334,4357334,4357128,206,0,utRho25
426,fdhE,8162722,8162722,8162456,266,448,utRho25
427,fdhF,8598814,8598814,8598732,82,0,utRho25
428,fdnG,3094744,3094802,3094744,58,32,utRho25
429,fdrA,1093012,1093360,1093012,348,72,utRho25
430,feaB,2894994,2895038,2894994,44,0,utRho25
431,feaR,2894734,2894734,2894566,168,0,utRho25
432,fecA,9033454,9033454,9033354,100,30,utRho25
433,fecE,9023288,9023288,9022914,374,1750,utRho25
434,fecI,9036564,9036564,9036470,94,110,utRho25
435,feoA,7080114,7080326,7080114,212,572,utRho25
436,fepA,1225334,1225334,1224988,346,42,utRho25
437,fepB,1249454,1249454,1249020,434,0,utRho25
438,fepD,1244468,1244468,1244378,90,0,utRho25
439,fes,1225374,1225630,1225374,256,0,utRho25
440,ffh,5495706,5495706,5495590,116,444,utRho25
441,ffs,952576,952848,952576,272,124,utRho25
442,fhuA,334884,334968,334884,84,94,utRho25
443,fhuE,2323294,2323294,2323102,192,16,utRho25
444,fhuF,9211504,9211504,9211326,178,198,utRho25
445,fic,6983296,6983296,6982926,370,0,utRho25
446,fieF,8212864,8212938,8212864,74,34,utRho25
447,fimA,9085388,9086230,9085388,842,774,utRho25
448,fimB,9081334,9081914,9081334,580,1538,utRho25
449,fimE,9083742,9084074,9083742,332,478,utRho25
450,fimZ,1129214,1129214,1128960,254,116,utRho25
451,fiu,1683296,1683296,1683062,234,38,utRho25
452,fixA,84650,84806,84650,156,0,utRho25
453,fkpA,6955050,6955050,6954838,212,6418,utRho25
454,fldA,2846084,2846084,2845860,224,600,utRho25
455,fldB,6079644,6079710,6079644,66,0,utRho25
456,flgA,2261770,2261770,2261726,44,184,utRho25
457,flgB,2261986,2262036,2261986,50,0,utRho25
458,flgK,2276702,2276756,2276702,54,0,utRho25
459,flgM,2260330,2260330,2260256,74,28,utRho25
460,flgN,2259828,2259828,2259660,168,0,utRho25
461,flhB,3932432,3932432,3932382,50,38,utRho25
462,flhC,3955864,3955864,3955688,176,194,utRho25
463,flhD,3957154,3957154,3956394,760,532,utRho25
464,fliA,4003638,4003638,4003578,60,20,utRho25
465,fliC,4007352,4007352,4007212,140,110,utRho25
466,fliD,4007634,4007744,4007634,110,0,utRho25
467,fliE,4026186,4026186,4026028,158,152,utRho25
468,fliF,4026292,4026458,4026292,166,26,utRho25
469,fliL,4039168,4039236,4039168,68,14,utRho25
470,flk,4875824,4875900,4875824,76,2,utRho25
471,flu,4142634,4143078,4142634,444,132,utRho25
472,flxA,3292776,3292810,3292776,34,36,utRho25
473,fnr,2799104,2799104,2799052,52,56,utRho25
474,fnrS,2818258,2818258,2818258,0,0,utRho25
475,focA,1909628,1909628,1908932,696,32,utRho25
476,folA,99598,99646,99598,48,0,utRho25
477,folB,6409296,6409296,6409178,118,2,utRho25
478,folD,1115562,1115562,1115482,80,62,utRho25
479,folE,4487696,4487696,4487304,392,110,utRho25
480,fpr,8228998,8228998,8228944,54,0,utRho25
481,frc,4986878,4986878,4986508,370,116,utRho25
482,frdA,8764824,8764824,8764636,188,32,utRho25
483,frdD,8758948,8758948,8758732,216,134,utRho25
484,fre,8052886,8053054,8052886,168,90,utRho25
485,frlA,6999518,6999820,6999518,302,16,utRho25
486,frr,385624,385744,385624,120,420,utRho25
487,frsA,513004,513054,513004,50,0,utRho25
488,fruB,4527194,4527194,4526990,204,0,utRho25
489,frvR,8179804,8179804,8179710,94,0,utRho25
490,fryA,5008986,5008986,5008970,16,118,utRho25
491,fsaA,1727060,1727284,1727060,224,8,utRho25
492,fsr,1009710,1009710,1009392,318,128,utRho25
493,ftnA,3977364,3977432,3977364,68,8,utRho25
494,ftnB,3973550,3973850,3973550,300,314,utRho25
495,ftsA,207122,207964,207122,842,414,utRho25
496,ftsB,5745802,5745802,5745640,162,0,utRho25
497,ftsH,6654204,6654204,6653870,334,984,utRho25
498,ftsK,1865858,1866448,1865858,590,1066,utRho25
499,ftsL,181376,182064,181376,688,240,utRho25
500,ftsP,6325732,6325732,6325338,394,48,utRho25
501,ftsQ,205484,206310,205484,826,506,utRho25
502,ftsX,7204512,7204512,7204172,340,238,utRho25
503,ftsZ,209272,210610,209272,1338,160,utRho25
504,fucA,5867708,5867708,5867376,332,138,utRho25
505,fucP,5868238,5868470,5868238,232,40,utRho25
506,fumA,6753760,6753760,6753508,252,1688,utRho25
507,fumB,8694696,8694696,8694652,44,0,utRho25
508,fumC,3373418,3373418,3373176,242,52,utRho25
509,fur,2842892,2842892,2842584,308,396,utRho25
510,fusA,6947370,6947370,6947028,342,6378,utRho25
511,fxsA,8737206,8737328,8737206,122,1146,utRho25
512,gabD,5581824,5582546,5581824,722,876,utRho25
513,gadA,7335214,7335214,7335160,54,0,utRho25
514,gadB,3144144,3144144,3144090,54,0,utRho25
515,gadC,3141168,3141168,3140978,190,544,utRho25
516,gadE,7315600,7316732,7315600,1132,312,utRho25
517,gadW,7329562,7329562,7329236,326,0,utRho25
518,gadX,14663356,14663356,14663240,116,4,utRho25
519,gadY,7329728,7329728,7329728,0,0,utRho25
520,galE,1584354,1584354,1584110,244,0,utRho25
521,galF,4228702,4228702,4228654,48,42,utRho25
522,galM,1577796,1577796,1577674,122,136,utRho25
523,galP,6176510,6176568,6176510,58,0,utRho25
524,galR,5953138,5953198,5953138,60,38,utRho25
525,galS,4483420,4483420,4483336,84,0,utRho25
526,galU,2582810,2582914,2582810,104,266,utRho25
527,gapA,3724480,3725542,3724480,1062,1056,utRho25
528,garP,6549868,6549868,6549814,54,132,utRho25
529,gatY,4354468,4354468,4354408,60,0,utRho25
530,gatZ,4352864,4352864,4352642,222,372,utRho25
531,gcd,282558,282558,282450,108,58,utRho25
532,gcl,1067814,1067832,1067814,18,0,utRho25
533,gcvA,5885278,5885278,5885134,144,0,utRho25
534,gcvB,5885392,5885392,5885392,0,0,utRho25
535,gcvR,5199758,5199812,5199758,54,40,utRho25
536,gcvT,6101544,6101544,6101334,210,186,utRho25
537,gdhA,3684616,3684742,3684616,126,98,utRho25
538,gfcA,2099668,2099668,2099488,180,64,utRho25
539,gfcD,2096236,2096236,2095890,346,268,utRho25
540,ghrA,2195648,2195772,2195648,124,204,utRho25
541,ghrB,7434378,7434620,7434378,242,432,utRho25
542,glcA,6242728,6242728,6242558,170,310,utRho25
543,glcC,6256412,6256544,6256412,132,0,utRho25
544,glcD,6256152,6256152,6256042,110,140,utRho25
545,gldA,8278092,8278092,8278070,22,18,utRho25
546,glgA,7136784,7136784,7136066,718,58,utRho25
547,glgB,7147314,7147314,7147004,310,102,utRho25
548,glgC,7139142,7139142,7138656,486,8,utRho25
549,glgP,7133546,7133546,7133162,384,136,utRho25
550,glgS,6384024,6384024,6383878,146,204,utRho25
551,glgX,7142838,7142838,7142638,200,0,utRho25
552,glk,5018922,5018922,5018852,70,2,utRho25
553,glmS,7827622,7827622,7827336,286,490,utRho25
554,glmU,7830652,7830652,7830400,252,0,utRho25
555,glmY,10765360,10765360,10765360,0,0,utRho25
556,glmZ,7972864,7972864,7972864,0,0,utRho25
557,glnA,16232888,16232888,16232136,752,328,utRho25
558,glnB,5375052,5375052,5374816,236,54,utRho25
559,glnD,377310,377310,377300,10,82,utRho25
560,glnE,6399602,6399602,6399282,320,0,utRho25
561,glnH,1696396,1696396,1696008,388,38,utRho25
562,glnK,945112,945196,945112,84,0,utRho25
563,glnL,8112742,8112742,8112678,64,0,utRho25
564,glnQ,1693262,1693262,1692926,336,158,utRho25
565,glnS,1411998,1412186,1411998,188,1956,utRho25
566,gloA,3455602,3455674,3455602,72,26,utRho25
567,gloB,469852,469852,469564,288,334,utRho25
568,glpA,4705166,4705294,4705166,128,0,utRho25
569,glpD,7123942,7124026,7123942,84,40,utRho25
570,glpE,7123698,7123698,7123646,52,0,utRho25
571,glpF,8236322,8236322,8236180,142,244,utRho25
572,glpG,7122960,7122960,7122904,56,60,utRho25
573,glpR,7121782,7121782,7121210,572,992,utRho25
574,glpT,4704902,4704902,4704748,154,310,utRho25
575,glpX,8231212,8231212,8231158,54,342,utRho25
576,glrK,5382246,5382246,5382196,50,0,utRho25
577,gltA,1509534,1509534,1508936,598,1750,utRho25
578,gltB,6709018,6709264,6709018,246,16,utRho25
579,gltI,1375792,1375792,1375494,298,656,utRho25
580,gltP,8588536,8588962,8588536,426,450,utRho25
581,gltS,7657382,7657382,7657330,52,242,utRho25
582,gltX,5041568,5041568,5041344,224,388,utRho25
583,gluQ,320286,320286,320224,62,28,utRho25
584,glyA,5371148,5371148,5371014,134,0,utRho25
585,glyQ,7450708,7450708,7450636,72,78,utRho25
586,glyS,7448990,7448990,7448794,196,696,utRho25
587,glyU,5998128,5998128,5998114,14,0,utRho25
588,glyV,8784626,8784720,8784626,94,114,utRho25
589,glyW,3984360,3984360,3984234,126,4,utRho25
590,gmhB,445612,445666,445612,54,0,utRho25
591,gmk,7642776,7642856,7642776,80,0,utRho25
592,gmr,2693686,2693686,2693484,202,6,utRho25
593,gnd,4202648,4202648,4202536,112,642,utRho25
594,gnsB,3275692,3275692,3275564,128,0,utRho25
595,gntK,14310580,14310580,14310368,212,8,utRho25
596,gntP,9102668,9102668,9102592,76,380,utRho25
597,gntR,7157760,7157760,7157452,308,350,utRho25
598,gntT,7092810,7093118,7092810,308,228,utRho25
599,gntU,7154170,7154170,7154122,48,56,utRho25
600,gntX,7089334,7089764,7089334,430,92,utRho25
601,gor,7292224,7292598,7292224,374,572,utRho25
602,gpmA,1575340,1575340,1575190,150,4,utRho25
603,gpmM,7570374,7570520,7570374,146,46,utRho25
604,gpsA,7567620,7567620,7567322,298,4668,utRho25
605,gpt,511828,511954,511828,126,280,utRho25
606,grcA,5433046,5433046,5432898,148,336,utRho25
607,greA,6657728,6657728,6657430,298,844,utRho25
608,greB,7073488,7073624,7073488,136,0,utRho25
609,groL,8741566,8742050,8741566,484,15068,utRho25
610,groS,8741232,8741376,8741232,144,14872,utRho25
611,grpE,5501494,5501494,5501416,78,712,utRho25
612,grxA,1781552,1781552,1781506,46,0,utRho25
613,grxB,2248206,2248206,2248108,98,258,utRho25
614,grxC,7569152,7569152,7568884,268,1298,utRho25
615,grxD,3468324,3468324,3468202,122,2958,utRho25
616,gspA,6911268,6911268,6910796,472,168,utRho25
617,gspC,6910964,6911156,6910964,192,94,utRho25
618,gss,6277220,6277220,6277044,176,48,utRho25
619,gstA,3428654,3428754,3428654,100,52,utRho25
620,gstB,1761038,1761038,1760960,78,218,utRho25
621,guaB,5268214,5268214,5268140,74,98,utRho25
622,gudD,5839026,5839026,5838770,256,8,utRho25
623,gyrA,4678914,4678914,4678840,74,76,utRho25
624,gyrB,7760300,7760300,7760238,62,64,utRho25
625,hcaE,5337964,5338064,5337964,100,120,utRho25
626,hcaR,5337928,5337928,5337792,136,134,utRho25
627,hcaT,5336106,5336106,5335692,414,114,utRho25
628,hchA,4071260,4071670,4071260,410,4,utRho25
629,hcp,1828258,1828258,1827628,630,176,utRho25
630,hcr,1824400,1824400,1824300,100,0,utRho25
631,hdeA,7313582,7313582,7313480,102,0,utRho25
632,hdeD,7313920,7313990,7313920,70,540,utRho25
633,hdfR,7896320,7896320,7895934,386,234,utRho25
634,hdhA,3396244,3396244,3396080,164,50,utRho25
635,helD,2048876,2048942,2048876,66,72,utRho25
636,hemA,2527166,2527428,2527166,262,232,utRho25
637,hemB,779722,779722,779454,268,350,utRho25
638,hemF,5106410,5106450,5106410,40,0,utRho25
639,hemH,996062,996110,996062,48,0,utRho25
640,hemL,349882,349882,349764,118,0,utRho25
641,hemN,8103886,8104090,8103886,204,0,utRho25
642,hepA,127176,127176,126528,648,13042,utRho25
643,hflD,2385372,2385372,2385262,110,116,utRho25
644,hfq,8799602,8800576,8799602,974,5166,utRho25
645,hha,961006,961006,960616,390,0,utRho25
646,hicA,3018442,3018572,3018442,130,20,utRho25
647,higA,6468682,6468682,6468288,394,250,utRho25
648,higB,6468960,6468960,6468910,50,326,utRho25
649,hinT,2323642,2323770,2323642,128,60,utRho25
650,hipB,3184964,3184964,3184884,80,10,utRho25
651,hisB,4186720,4186936,4186720,216,160,utRho25
652,hisJ,4853674,4853674,4853576,98,20,utRho25
653,hisL,8359856,8359984,8359856,128,232,utRho25
654,hisS,5281284,5281284,5281150,134,0,utRho25
655,hlpA,400910,400964,400910,54,36,utRho25
656,hlyE,2460932,2460932,2460788,144,126,utRho25
657,hmp,5371594,5371670,5371594,76,16,utRho25
658,hns,2585916,2585916,2585844,72,4132,utRho25
659,hofM,7045856,7045856,7045502,354,0,utRho25
660,hokA,7441620,7441620,7441200,420,194,utRho25
661,hokC,33902,33902,33806,96,268,utRho25
662,hokE,1215462,1215672,1215462,210,0,utRho25
663,holC,8968546,8968546,8968560,14,44,utRho25
664,holD,9215562,9215606,9215562,44,0,utRho25
665,holE,3850040,3850216,3850040,176,50,utRho25
666,hpt,282720,282862,282720,142,58,utRho25
667,hrpB,324150,324210,324150,60,12,utRho25
668,hscB,5319048,5319048,5318934,114,152,utRho25
669,hscC,1367188,1367188,1366786,402,130,utRho25
670,hsdS,9163004,9163004,9162924,80,508,utRho25
671,hslJ,2883560,2883560,2883486,74,680,utRho25
672,hslO,7059344,7059548,7059344,204,70208,utRho25
673,hslR,7058220,7058696,7058220,476,7142,utRho25
674,hslV,8244708,8244708,8244574,134,4,utRho25
675,hsrA,7881412,7881412,7881224,188,24,utRho25
676,htgA,21286,21660,21286,374,542,utRho25
677,htpG,989634,990240,989634,606,824,utRho25
678,htpX,3825236,3825236,3825152,84,84,utRho25
679,htrE,311036,311036,310852,184,2,utRho25
680,htrL,7587668,7587668,7587366,302,6,utRho25
681,hupA,8400352,8400562,8400352,210,164,utRho25
682,hupB,1845220,1845804,1845220,584,852,utRho25
683,hyaA,2063968,2064278,2063968,310,164,utRho25
684,hybO,6292726,6292726,6292522,204,158,utRho25
685,hycA,5700922,5700922,5700870,52,0,utRho25
686,hycI,5686204,5686204,5686086,118,210,utRho25
687,hydN,5676264,5676264,5676210,54,0,utRho25
688,hyfA,5202342,5202402,5202342,60,0,utRho25
689,hypA,11402508,11402588,11402508,80,252,utRho25
690,hypB,11403356,11404004,11403356,648,0,utRho25
691,hypF,5676210,5676210,5674850,1360,540,utRho25
692,hypT,9116634,9116634,9116578,56,0,utRho25
693,hyuA,6019660,6020056,6019660,396,4,utRho25
694,iaaA,1733074,1733136,1733074,62,36,utRho25
695,iadA,9119074,9119074,9119052,22,102,utRho25
696,iap,5753072,5753162,5753072,90,0,utRho25
697,ibaG,6673966,6673966,6673606,360,0,utRho25
698,ibpA,7735036,7735036,7734844,192,6496,utRho25
699,ibpB,7733962,7733962,7733794,168,61326,utRho25
700,icd,2389922,2390246,2389922,324,164,utRho25
701,iclR,8447304,8447304,8447256,48,14,utRho25
702,idi,6065876,6066130,6065876,254,30,utRho25
703,idnD,8988870,8988870,8988812,58,0,utRho25
704,idnK,8989194,8989246,8989194,52,240,utRho25
705,ihfA,3591442,3591442,3591104,338,518,utRho25
706,ihfB,1927498,1927656,1927498,158,406,utRho25
707,ileS,43666,44782,43666,1116,760,utRho25
708,ileX,6431194,6431196,6431194,2,4,utRho25
709,ilvA,15820940,15821324,15820940,384,96,utRho25
710,ilvC,7915824,7915940,7915824,116,0,utRho25
711,ilvE,15809552,15809936,15809552,384,264,utRho25
712,ilvI,170840,171260,170840,420,4,utRho25
713,ilvL,23701308,23701932,23701308,624,360,utRho25
714,ilvY,7915734,7915734,7915640,94,2,utRho25
715,inaA,4698998,4698998,4698944,54,0,utRho25
716,infA,1853370,1853370,1852886,484,208,utRho25
717,infC,3602692,3602692,3601276,1416,2252,utRho25
718,insA-5,3958452,3958452,3958430,22,26,utRho25
719,insA-7,9036758,9037054,9036758,296,232,utRho25
720,insC-5,6372080,6372284,6372080,204,274,utRho25
721,insEF-2,785238,785238,785820,582,334,utRho25
722,insEF-4,2190310,2190310,2190892,582,392,utRho25
723,insG,9007098,9007098,9006862,236,0,utRho25
724,insH-1,550596,550596,550234,362,222,utRho25
725,insH-11,7306538,7306538,7306396,142,48,utRho25
726,insH-2,1151548,1151548,1151506,42,58,utRho25
727,insH-3,1378444,1378444,1378026,418,558,utRho25
728,insH-4,2791942,2792152,2791942,210,182,utRho25
729,insH-5,2857852,2857852,2857452,400,28,utRho25
730,insH-6,4135022,4135022,4134642,380,138,utRho25
731,insH-7,4206186,4206186,4205822,364,4196,utRho25
732,insH-9,6260050,6260356,6260050,306,722,utRho25
733,insI-3,9017372,9017372,9017234,138,74,utRho25
734,insJ,7441188,7441360,7441188,172,44,utRho25
735,insK,7442130,7442308,7442130,178,0,utRho25
736,insL-1,30760,30890,30760,130,8772,utRho25
737,insL-2,1216112,1216130,1216112,18,152,utRho25
738,insL-3,5028644,5028662,5028644,18,126,utRho25
739,insN-1,540452,540484,540452,32,4,utRho25
740,intD,1132202,1132202,1131956,246,334,utRho25
741,intR,2826520,2826520,2826470,50,0,utRho25
742,intS,4933026,4933090,4933026,64,4,utRho25
743,intZ,5117386,5117542,5117386,156,8,utRho25
744,iraD,9113152,9113986,9113152,834,0,utRho25
745,iraM,2424246,2424246,2424006,240,44,utRho25
746,iraP,802638,802772,802638,134,0,utRho25
747,iscA,5319924,5319924,5319772,152,698,utRho25
748,iscR,5324398,5324398,5324262,136,1966,utRho25
749,iscX,5313834,5313834,5313472,362,428,utRho25
750,ispF,5743968,5743968,5743560,408,6,utRho25
751,ispG,5283908,5283908,5283608,300,0,utRho25
752,ispU,389568,389806,389568,238,4,utRho25
753,isrA,2811502,2811502,2811618,116,18,utRho25
754,istr-1,7706384,7706384,7706384,0,0,utRho25
755,istr-2,7706514,7706514,7706514,0,0,utRho25
756,ivbL,15412092,15412092,15411952,140,288,utRho25
757,ivy,480638,480686,480638,48,0,utRho25
758,katE,3627628,3627734,3627628,106,88,utRho25
759,katG,8267624,8267670,8267624,46,38,utRho25
760,kbaZ,6557732,6557828,6557732,96,0,utRho25
761,kbl,7585154,7585154,7585102,52,358,utRho25
762,kch,2621046,2621046,2620538,508,0,utRho25
763,kdgR,3820506,3820506,3820198,308,0,utRho25
764,kdpE,1443788,1443788,1443466,322,56,utRho25
765,kdpF,1457698,1457698,1457642,56,78,utRho25
766,kdsA,2535708,2536330,2535708,622,1126,utRho25
767,kdsC,6683438,6684546,6683438,1108,3394,utRho25
768,kduI,5968388,5968388,5968248,140,112,utRho25
769,kefF,94160,94492,94160,332,1008,utRho25
770,kgtP,5451624,5451624,5451492,132,524,utRho25
771,kup,7862206,7862632,7862206,426,1508,utRho25
772,lacI,735076,735076,735020,56,0,utRho25
773,lacZ,1465508,1465508,1465220,288,96,utRho25
774,ldcA,2486394,2486394,2486160,234,0,utRho25
775,ldhA,2885830,2885830,2885686,144,124,utRho25
776,ldrA,2538954,2538954,2538550,404,324,utRho25
777,ldrB,2540024,2540024,2539620,404,112,utRho25
778,ldrC,2541092,2541092,2540690,402,74,utRho25
779,ldrD,7400544,7400544,7400174,370,364,utRho25
780,lepA,5414392,5414392,5414248,144,122,utRho25
781,lepB,5410928,5410928,5410618,310,860,utRho25
782,leuD,159188,159188,158906,282,168,utRho25
783,leuE,3761600,3761600,3761518,82,256,utRho25
784,leuL,168048,168048,167416,632,36,utRho25
785,leuO,168308,168736,168308,428,8,utRho25
786,leuQ,9212864,9212864,9212802,62,12,utRho25
787,leuU,6644556,6644556,6644316,240,1056,utRho25
788,leuV,9212546,9212546,9212330,216,242,utRho25
789,leuX,8992772,8992810,8992772,38,4,utRho25
790,lexA,8514174,8514230,8514174,56,118,utRho25
791,lhr,3456706,3458174,3456706,1468,400,utRho25
792,ligA,5060402,5060402,5060352,50,0,utRho25
793,ligB,7642576,7642576,7642340,236,132,utRho25
794,lipA,1320602,1320602,1320432,170,114,utRho25
795,lipB,1324802,1324802,1324556,246,7046,utRho25
796,lit,2397032,2397390,2397032,358,174,utRho25
797,livJ,7199524,7199524,7199316,208,1092,utRho25
798,livK,7195510,7195510,7195120,390,810,utRho25
799,lldP,7554578,7554798,7554578,220,372,utRho25
800,lnt,1381968,1381968,1381762,206,676,utRho25
801,loiP,6163784,6163826,6163784,42,0,utRho25
802,lolA,1874656,1874738,1874656,82,116,utRho25
803,lolB,2527112,2527112,2527000,112,100,utRho25
804,lolC,2350748,2350854,2350748,106,8,utRho25
805,lon,917630,917776,917630,146,948,utRho25
806,lpcA,486936,487086,486936,150,80,utRho25
807,lpd,255434,255824,255434,390,752,utRho25
808,lplA,9248476,9248476,9248234,242,564,utRho25
809,lplT,5947878,5947878,5947724,154,24,utRho25
810,lpoA,6586422,6586800,6586422,378,52,utRho25
811,lpp,3514592,3514842,3514592,250,20,utRho25
812,lptA,6686598,6686760,6686598,162,72,utRho25
813,lptB,6686792,6687888,6686792,1096,1010,utRho25
814,lptD,114672,114672,114218,454,434,utRho25
815,lptF,8972244,8972436,8972244,192,92,utRho25
816,lpxC,213016,213114,213016,98,1382,utRho25
817,lpxD,401920,401942,401920,22,0,utRho25
818,lpxL,2233418,2233418,2233164,254,0,utRho25
819,lpxM,3880456,3880456,3880386,70,0,utRho25
820,lpxP,4991156,4991290,4991156,134,10,utRho25
821,lrhA,4813312,4813312,4813282,30,20,utRho25
822,lrp,1864656,1865190,1864656,534,266,utRho25
823,lspA,50028,50414,50028,386,384,utRho25
824,lsrA,3202920,3202980,3202920,60,42,utRho25
825,lsrR,3202514,3202514,3202482,32,0,utRho25
826,ltaE,1818640,1818640,1818588,52,0,utRho25
827,luxS,5630130,5630130,5629466,664,1662,utRho25
828,lysA,5957902,5957902,5957798,104,0,utRho25
829,lysC,8467232,8467232,8466466,766,584,utRho25
830,lysP,4497120,4497120,4497064,56,94,utRho25
831,lysR,5957900,5958042,5957900,142,0,utRho25
832,lysT,1561028,1561108,1561028,80,134,utRho25
833,lysU,8709610,8709610,8709434,176,0,utRho25
834,macB,1840188,1840694,1840188,506,118,utRho25
835,maeA,3111484,3111484,3111338,146,418,utRho25
836,mak,820236,820288,820236,52,34,utRho25
837,malE,8492928,8492928,8492838,90,56,utRho25
838,malI,3398456,3398456,3398360,96,0,utRho25
839,malK,8493472,8493568,8493472,96,70,utRho25
840,malP,7105020,7105020,7104946,74,64,utRho25
841,malQ,7100798,7100798,7100140,658,268,utRho25
842,malS,14949880,14949988,14949880,108,136,utRho25
843,malT,7106048,7106170,7106048,122,0,utRho25
844,malX,3398626,3398710,3398626,84,36,utRho25
845,malZ,1689980,1690072,1689980,92,8,utRho25
846,manA,3377102,3377152,3377102,50,0,utRho25
847,manX,3803866,3804096,3803866,230,0,utRho25
848,marC,3237882,3237882,3237816,66,50,utRho25
849,marR,3238186,3238240,3238186,54,58,utRho25
850,matP,2036918,2036970,2036918,52,0,utRho25
851,mazE,5822736,5822736,5822678,58,0,utRho25
852,mazG,5821720,5821720,5821370,350,554,utRho25
853,mcbA,1684306,1684306,1684112,194,0,utRho25
854,mcbR,3040192,3040524,3040192,332,0,utRho25
855,mcrA,2420278,2420692,2420278,414,226,utRho25
856,mcrC,9156124,9156124,9155916,208,454,utRho25
857,mdaB,6344814,6345060,6344814,246,0,utRho25
858,mdfA,1767138,1767346,1767138,208,0,utRho25
859,mdh,6768940,6768940,6768536,404,80,utRho25
860,mdoB,9198988,9198988,9198882,106,210,utRho25
861,mdoD,2993290,2993712,2993290,422,0,utRho25
862,mdoG,2218514,2218670,2218514,156,40,utRho25
863,mdtA,4307958,4308032,4307958,74,0,utRho25
864,mdtE,7318168,7318464,7318168,296,502,utRho25
865,mdtK,3486538,3486914,3486538,376,482,utRho25
866,mdtP,8602472,8602472,8602060,412,326,utRho25
867,melA,8683774,8683822,8683774,48,0,utRho25
868,melR,8683300,8683300,8683256,44,112,utRho25
869,menA,8240812,8240812,8240698,114,130,utRho25
870,menB,4753774,4753774,4753638,136,0,utRho25
871,mepH,3468714,3468870,3468714,156,0,utRho25
872,mepM,3883666,3883666,3883270,396,6,utRho25
873,mepS,4539840,4539958,4539840,118,0,utRho25
874,metA,8428318,8428560,8428318,242,12,utRho25
875,metB,8257272,8257344,8257272,72,290,utRho25
876,metC,6304150,6304472,6304150,322,94,utRho25
877,metE,8025768,8026106,8025768,338,0,utRho25
878,metF,8265092,8265232,8265092,140,0,utRho25
879,metG,4388538,4388600,4388538,62,8,utRho25
880,metH,8447010,8447656,8447010,646,854,utRho25
881,metJ,8257116,8257116,8256790,326,2,utRho25
882,metK,6173154,6173412,6173154,258,76,utRho25
883,metN,445428,445428,445290,138,0,utRho25
884,metR,8025710,8025710,8025632,78,0,utRho25
885,metT,1394326,1394326,1394266,60,24,utRho25
886,metY,19910250,19910250,19909734,516,1620,utRho25
887,metZ,11789528,11789548,11789528,20,172,utRho25
888,mfd,2348056,2348056,2347928,128,0,utRho25
889,mglA,4478782,4478782,4478578,204,138,utRho25
890,mglB,4481132,4481132,4480696,436,10340,utRho25
891,mglC,4475918,4475918,4475506,412,98,utRho25
892,mgrB,3817584,3817584,3817532,52,0,utRho25
893,mgrR,3245828,3245828,3245828,0,0,utRho25
894,mgsA,2054082,2054082,2054030,52,32,utRho25
895,mgtL,8934560,8934862,8934560,302,90,utRho25
896,mhpA,737038,737222,737038,184,0,utRho25
897,mhpR,737072,737072,736840,232,32,utRho25
898,mhpT,750772,750918,750772,146,0,utRho25
899,miaA,8797964,8798504,8797964,540,182,utRho25
900,micA,5629604,5629604,5629604,0,0,utRho25
901,micC,2874242,2874238,2874242,4,0,utRho25
902,micF,4626168,4626168,4626168,0,0,utRho25
903,micM,1014408,1014408,1014408,0,0,utRho25
904,minE,2449422,2449422,2449090,332,302,utRho25
905,mioC,7852950,7852950,7852910,40,0,utRho25
906,mipA,3733012,3733012,3732944,68,868,utRho25
907,mlaA,4930270,4930270,4930014,256,28,utRho25
908,mlc,3337206,3337206,3337128,78,52,utRho25
909,mlrA,4429498,4429732,4429498,234,20,utRho25
910,mltA,5894546,5894546,5894356,190,26,utRho25
911,mltD,468050,468050,467910,140,130,utRho25
912,mltF,5391534,5391602,5391534,68,0,utRho25
913,mmuP,550238,550650,550238,412,232,utRho25
914,mngA,1531622,1531968,1531622,346,4,utRho25
915,mngR,1531852,1531852,1531750,102,4,utRho25
916,mnmG,7851348,7851348,7851266,82,146,utRho25
917,mntH,5025470,5025470,5025412,58,0,utRho25
918,mntP,3810918,3811376,3810918,458,44,utRho25
919,mntR,1706160,1706366,1706160,206,98,utRho25
920,mntS,1706128,1706128,1705994,134,94,utRho25
921,moaA,1633654,1634088,1633654,434,22,utRho25
922,moaB,1635954,1636110,1635954,156,126,utRho25
923,mobA,8084242,8084242,8083998,244,0,utRho25
924,mocA,6030112,6030320,6030112,208,80,utRho25
925,modA,1589990,1590178,1589990,188,0,utRho25
926,moeA,1732788,1732788,1732728,60,30,utRho25
927,mokB,2984610,2984610,2984258,352,130,utRho25
928,molR_1,4392888,4392948,4392888,60,0,utRho25
929,motA,3954604,3954604,3954278,326,36,utRho25
930,mpaA,2781278,2781278,2781196,82,28,utRho25
931,mpl,8911456,8911570,8911456,114,68,utRho25
932,mppA,2786108,2786454,2786108,346,0,utRho25
933,mprA,5621494,5621540,5621494,46,84,utRho25
934,mqo,4613848,4613848,4613508,340,0,utRho25
935,mqsA,6336742,6336742,6336492,250,226,utRho25
936,mqsR,6337306,6337306,6337088,218,428,utRho25
937,mraZ,179192,179268,179192,76,68,utRho25
938,mrcA,7045652,7045742,7045652,90,0,utRho25
939,mrcB,329442,329460,329442,18,0,utRho25
940,mreB,13605424,13605424,13604348,1076,1436,utRho25
941,mreD,6798166,6798166,6797750,416,100,utRho25
942,mrp,4388360,4388360,4388336,24,90,utRho25
943,mscK,972984,973072,972984,88,0,utRho25
944,mscL,6876002,6876048,6876002,46,694,utRho25
945,mscS,6139742,6139742,6139614,128,4,utRho25
946,msrA,8884522,8884522,8884352,170,260,utRho25
947,msrB,3725168,3725168,3724858,310,158,utRho25
948,msyB,2228426,2228426,2228362,64,200,utRho25
949,mtfA,4087236,4087302,4087236,66,0,utRho25
950,mtgA,6699662,6699662,6699618,44,90,utRho25
951,mtlA,30177504,30178248,30177504,744,3208,utRho25
952,mtn,358366,358366,358306,60,190,utRho25
953,mtr,6611864,6611864,6611634,230,26,utRho25
954,mug,6430992,6430992,6430946,46,894,utRho25
955,murQ,5091466,5091546,5091466,80,0,utRho25
956,murR,5091586,5091586,5091218,368,46,utRho25
957,mutH,5939164,5939324,5939164,160,450,utRho25
958,mutL,8794092,8794824,8794092,732,132,utRho25
959,mutM,7622554,7622554,7622304,250,246,utRho25
960,mutS,5714038,5714186,5714038,148,180,utRho25
961,mutY,18617466,18618078,18617466,612,0,utRho25
962,nac,4123956,4123956,4123866,90,90,utRho25
963,nadA,1564122,1564170,1564122,48,0,utRho25
964,nadB,5420714,5420840,5420714,126,54,utRho25
965,nadC,237326,237326,237290,36,96,utRho25
966,nadE,3644604,3644916,3644604,312,282,utRho25
967,nadK,5501526,5501662,5501526,136,0,utRho25
968,nagA,1406350,1406350,1405502,848,1064,utRho25
969,nagB,1407416,1407416,1407222,194,0,utRho25
970,nagC,1404016,1404016,1403188,828,0,utRho25
971,nagE,1407680,1407888,1407680,208,72,utRho25
972,nagK,2357080,2357186,2357080,106,116,utRho25
973,nanA,6747240,6747240,6747152,88,0,utRho25
974,nanC,9079856,9079856,9079002,854,252,utRho25
975,nanR,6749406,6749406,6748978,428,632,utRho25
976,nanS,9075406,9075406,9075188,218,46,utRho25
977,napF,4607390,4607390,4606994,396,80,utRho25
978,narG,2559614,2559728,2559614,114,30,utRho25
979,narK,2555642,2555914,2555642,272,94,utRho25
980,narP,4580844,4581000,4580844,156,186,utRho25
981,narQ,5171154,5171462,5171154,308,80,utRho25
982,narU,3088326,3088326,3088120,206,132,utRho25
983,narW,3077374,3077374,3074618,2756,164,utRho25
984,narX,2555554,2555554,2555236,318,74,utRho25
985,narZ,3085380,3085380,3085180,200,0,utRho25
986,ndh,2331984,2332170,2331984,186,234,utRho25
987,ndk,5289920,5289920,5289728,192,124,utRho25
988,nemR,6904084,6904092,6904084,8,48,utRho25
989,nepI,7683542,7683542,7683478,64,86,utRho25
990,nfo,4501612,4501680,4501612,68,18,utRho25
991,nfsB,1210906,1210906,1210848,58,0,utRho25
992,nfuA,7090916,7091248,7090916,332,676,utRho25
993,nhaA,34634,34978,34634,344,398,utRho25
994,nhaB,2469534,2469534,2469434,100,0,utRho25
995,nhoA,3067926,3068048,3067926,122,0,utRho25
996,nikA,7226878,7227334,7226878,456,974,utRho25
997,nikR,7237074,7237176,7237074,102,110,utRho25
998,nirB,6987974,6988022,6987974,48,56,utRho25
999,nlpA,7680034,7680034,7679986,48,0,utRho25
1000,nlpC,3585654,3585654,3585462,192,64,utRho25
1001,nlpD,5737658,5737658,5737506,152,30,utRho25
1002,nlpI,6618080,6618080,6617848,232,68,utRho25
1003,nmpC,1153740,1153740,1153650,90,0,utRho25
1004,nohA,3273206,3273206,3272734,472,4,utRho25
1005,norR,5664614,5664614,5664578,36,0,utRho25
1006,norV,5664878,5664952,5664878,74,40,utRho25
1007,nrdA,4689510,4689730,4689510,220,7974,utRho25
1008,nrdD,8925676,8925676,8925320,356,426,utRho25
1009,nrdH,5601312,5601446,5601312,134,258,utRho25
1010,nrdR,865954,866004,865954,50,70,utRho25
1011,nrfA,8575342,8575528,8575342,186,0,utRho25
1012,nsrR,8812088,8812380,8812088,292,262,utRho25
1013,nudB,3897348,3897348,3897264,84,44,utRho25
1014,nudC,8393428,8393806,8393428,378,14,utRho25
1015,nudE,7052658,7052658,7052298,360,82,utRho25
1016,nudG,3682876,3682980,3682876,104,4,utRho25
1017,nudI,4729050,4729108,4729050,58,0,utRho25
1018,nudJ,2388874,2388874,2388576,298,8,utRho25
1019,nuoA,4810670,4810670,4810144,526,1240,utRho25
1020,nuoN,4783434,4783434,4783010,424,266,utRho25
1021,nupC,5026018,5026084,5026018,66,0,utRho25
1022,nupG,6211302,6211428,6211302,126,184,utRho25
1023,ogrK,4335096,4335096,4335040,56,0,utRho25
1024,ogt,2800568,2800568,2800472,96,312,utRho25
1025,ohsC,5401036,5401040,5401036,4,88,utRho25
1026,ompA,2040382,2040382,2040106,276,5504,utRho25
1027,ompC,4625774,4625774,4625498,276,152,utRho25
1028,ompF,1974184,1974184,1973964,220,0,utRho25
1029,ompL,8128958,8128958,8128590,368,602,utRho25
1030,ompN,2874158,2874158,2873786,372,4,utRho25
1031,ompR,7073510,7073510,7073168,342,0,utRho25
1032,ompT,1171330,1171330,1171266,64,64,utRho25
1033,ompW,2627982,2628040,2627982,58,40,utRho25
1034,ompX,1700418,1700900,1700418,482,820,utRho25
1035,omrA,5952378,5952378,5952378,0,0,utRho25
1036,omrB,5952770,5952770,5952770,0,0,utRho25
1037,oppA,2602170,2602364,2602170,194,264,utRho25
1038,orn,8783168,8783208,8783168,40,16,utRho25
1039,osmB,2686952,2686952,2686656,296,694,utRho25
1040,osmC,3113192,3113250,3113192,58,160,utRho25
1041,osmE,3644566,3644566,3644512,54,52,utRho25
1042,osmF,4439046,4439046,4438962,84,128,utRho25
1043,osmY,9222306,9222792,9222306,486,4,utRho25
1044,otsA,3963302,3963302,3963224,78,112,utRho25
1045,otsB,3964930,3964930,3964774,156,158,utRho25
1046,oxc,4984288,4984288,4983900,388,104,utRho25
1047,oxyR,8316914,8316980,8316914,66,6,utRho25
1048,oxyS,8316788,8316788,8316788,0,0,utRho25
1049,paaA,2907730,2907854,2907730,124,0,utRho25
1050,paaX,2927018,2927078,2927018,60,0,utRho25
1051,paaZ,2907340,2907340,2907284,56,0,utRho25
1052,pabA,6981702,6981702,6981658,44,0,utRho25
1053,pabB,3789256,3789610,3789256,354,84,utRho25
1054,pabC,2306186,2306600,2306186,414,196,utRho25
1055,pagP,1313052,1313114,1313052,62,34,utRho25
1056,panB,299260,299260,299202,58,646,utRho25
1057,panC,297840,297840,297590,250,0,utRho25
1058,panD,293490,293490,293388,102,34,utRho25
1059,panZ,7195656,7195968,7195656,312,114,utRho25
1060,parC,6332060,6332060,6331946,114,124,utRho25
1061,patA,6438916,6438988,6438916,72,16,utRho25
1062,patD,3030830,3031156,3030830,326,0,utRho25
1063,pbpC,5294986,5294986,5294650,336,0,utRho25
1064,pbpG,4450132,4450132,4449740,392,0,utRho25
1065,pck,7065358,7065636,7065358,278,904,utRho25
1066,pcnB,318782,318782,318252,530,158,utRho25
1067,pdhR,244068,244184,244068,116,0,utRho25
1068,pdxB,4875768,4875768,4875702,66,106,utRho25
1069,pdxH,3436068,3436068,3436014,54,4,utRho25
1070,pdxJ,5403626,5403626,5403458,168,324,utRho25
1071,pdxK,5074638,5074638,5074474,164,46,utRho25
1072,pepA,8972278,8972278,8971902,376,158,utRho25
1073,pepD,511618,511618,511432,186,228,utRho25
1074,pepN,1981182,1981244,1981182,62,358,utRho25
1075,pepQ,8062294,8062322,8062294,28,0,utRho25
1076,pepT,2371646,2371688,2371646,42,28,utRho25
1077,pfkA,8214948,8215104,8214948,156,124,utRho25
1078,pfkB,3612646,3612740,3612646,94,0,utRho25
1079,pflA,1902456,1902456,1902160,296,0,utRho25
1080,pflB,1907850,1907850,1907108,742,350,utRho25
1081,pflD,8287716,8287990,8287716,274,0,utRho25
1082,pgaA,2185046,2185046,2184578,468,476,utRho25
1083,pgi,8467444,8467516,8467444,72,0,utRho25
1084,pgk,12291428,12291428,12290488,940,592,utRho25
1085,pgl,1597078,1597172,1597078,94,110,utRho25
1086,pgpB,2678324,2678660,2678324,336,76,utRho25
1087,pgpC,5397276,5397276,5397100,176,0,utRho25
1088,pgrR,2783744,2783982,2783744,238,56,utRho25
1089,pheL,5475158,5475198,5475158,40,0,utRho25
1090,pheM,7197204,7197204,7197080,124,0,utRho25
1091,pheP,1203858,1203918,1203858,60,34,utRho25
1092,pheU,8725254,8725254,8725252,2,0,utRho25
1093,pheV,6220730,6220732,6220730,2,0,utRho25
1094,phnC,8650412,8650412,8650330,82,20,utRho25
1095,phoA,803414,803494,803414,80,144,utRho25
1096,phoB,834202,834284,834202,82,86,utRho25
1097,phoE,520316,520316,520200,116,4,utRho25
1098,phoH,2169730,2169984,2169730,254,138,utRho25
1099,phoP,2381016,2381016,2380894,122,272,utRho25
1100,phoQ,2379880,2379880,2379552,328,206,utRho25
1101,phoU,7815330,7815330,7815156,174,54,utRho25
1102,phr,1478842,1479014,1478842,172,80,utRho25
1103,pinE,2419054,2419370,2419054,316,78,utRho25
1104,pinQ,3267168,3267244,3267168,76,0,utRho25
1105,pinR,2867424,2867424,2867348,76,2,utRho25
1106,pitA,7275224,7275284,7275224,60,20,utRho25
1107,pitB,6272806,6272806,6272742,64,52,utRho25
1108,pka,5439862,5439906,5439862,44,0,utRho25
1109,plaP,4174476,4174476,4174124,352,296,utRho25
1110,pldA,8009628,8009724,8009628,96,228,utRho25
1111,pldB,8018028,8018340,8018028,312,360,utRho25
1112,plsB,8513196,8513196,8512932,264,224,utRho25
1113,pmbA,8915890,8915918,8915890,28,2,utRho25
1114,pmrD,4747148,4747148,4747076,72,0,utRho25
1115,pncB,1980828,1980828,1980712,116,0,utRho25
1116,pncC,5648788,5648788,5648692,96,30,utRho25
1117,pnp,6622652,6622652,6622336,316,90,utRho25
1118,pntA,3355950,3355950,3355806,144,54,utRho25
1119,pntB,3353096,3353096,3352720,376,148,utRho25
1120,polA,8093880,8093932,8093880,52,0,utRho25
1121,polB,131606,131606,131560,46,0,utRho25
1122,potD,2365700,2365700,2365658,42,62,utRho25
1123,potE,1436688,1436688,1436530,158,0,utRho25
1124,potF,1787268,1787568,1787268,300,4,utRho25
1125,poxB,1822152,1822152,1822098,54,14,utRho25
1126,ppa,8899372,8899372,8899304,68,198,utRho25
1127,ppc,8306380,8306380,8306196,184,940,utRho25
1128,ppdA,5928440,5928440,5928354,86,18,utRho25
1129,ppdD,235410,235410,235098,312,92,utRho25
1130,pphA,3846770,3846770,3845938,832,1410,utRho25
1131,pphB,5719474,5719520,5719474,46,0,utRho25
1132,ppiA,6984898,6984898,6984594,304,72,utRho25
1133,ppiC,7919682,7919682,7919626,56,6,utRho25
1134,ppiD,923638,923830,923638,192,90,utRho25
1135,ppk,5245748,5246088,5245748,340,104,utRho25
1136,pppA,6228958,6228958,6228704,254,300,utRho25
1137,ppsA,3574322,3574322,3574224,98,2,utRho25
1138,ppsR,3574678,3574890,3574678,212,72,utRho25
1139,pptA,3065716,3066104,3065716,388,262,utRho25
1140,pqiA,2023318,2024002,2023318,684,16,utRho25
1141,prc,3830054,3830054,3829632,422,1464,utRho25
1142,preT,4467978,4468066,4467978,88,46,utRho25
1143,prfC,9218688,9218828,9218688,140,110,utRho25
1144,prkB,6968622,6968980,6968622,358,62,utRho25
1145,prlC,7290476,7290476,7290364,112,668,utRho25
1146,prlF,6553944,6554004,6553944,60,452,utRho25
1147,proB,520432,520776,520432,344,66,utRho25
1148,proC,811372,811372,811288,84,8,utRho25
1149,proK,7417388,7417388,7417384,4,4,utRho25
1150,proL,4572414,4572422,4572414,8,12,utRho25
1151,proP,8660640,8661004,8660640,364,190,utRho25
1152,proS,437674,437674,437550,124,138,utRho25
1153,proV,5609126,5609630,5609126,504,92,utRho25
1154,prpB,697292,697364,697292,72,0,utRho25
1155,prpR,696942,696942,696886,56,0,utRho25
1156,prs,2524354,2524354,2523750,604,3370,utRho25
1157,psd,8781276,8781276,8780720,556,260,utRho25
1158,psiE,8480600,8480650,8480600,50,0,utRho25
1159,pspA,2736076,2736158,2736076,82,0,utRho25
1160,pspF,2736080,2736080,2735824,256,0,utRho25
1161,pspG,8525632,8525680,8525632,48,0,utRho25
1162,pssA,5445156,5445454,5445156,298,524,utRho25
1163,pstB,7817112,7817112,7816732,380,4,utRho25
1164,pstC,7821084,7821084,7820796,288,0,utRho25
1165,pstS,23469408,23469408,23469150,258,0,utRho25
1166,psuG,4517114,4517114,4516734,380,2330,utRho25
1167,psuT,4514992,4514992,4514670,322,0,utRho25
1168,pth,2517084,2517084,2517026,58,0,utRho25
1169,ptrA,5918022,5918022,5917768,254,76,utRho25
1170,ptrB,3857730,3857730,3857678,52,148,utRho25
1171,ptsG,2315252,2315738,2315252,486,480,utRho25
1172,ptsH,5066996,5067528,5066996,532,366,utRho25
1173,purA,8809328,8809374,8809328,46,166,utRho25
1174,purC,5195562,5195562,5195236,326,0,utRho25
1175,purD,8411972,8411972,8411862,110,4,utRho25
1176,purE,1106284,1106284,1106200,84,0,utRho25
1177,purH,8415254,8415254,8415064,190,0,utRho25
1178,purL,5391178,5391178,5391086,92,188,utRho25
1179,purM,5242306,5242394,5242306,88,10,utRho25
1180,purR,3475378,3475688,3475378,310,36,utRho25
1181,purT,3861438,3861762,3861438,324,30,utRho25
1182,purU,2577512,2577512,2577248,264,0,utRho25
1183,putA,2157850,2157850,2157764,86,0,utRho25
1184,putP,2158336,2158610,2158336,274,92,utRho25
1185,puuA,2721936,2721936,2721816,120,0,utRho25
1186,puuC,2725456,2725486,2725456,30,0,utRho25
1187,puuD,2722104,2722240,2722104,136,0,utRho25
1188,puuP,2718746,2718746,2718374,372,36,utRho25
1189,pykA,3874988,3875298,3874988,310,60,utRho25
1190,pykF,3510934,3511396,3510934,462,18,utRho25
1191,pyrC,2245286,2245286,2245214,72,18,utRho25
1192,pyrD,2009464,2009536,2009464,72,4,utRho25
1193,pyrE,7631970,7631970,7631536,434,0,utRho25
1194,pyrF,2683740,2683842,2683740,102,758,utRho25
1195,pyrG,5819594,5819594,5819332,262,580,utRho25
1196,pyrH,383624,383710,383624,86,334,utRho25
1197,pyrL,8945490,8945490,8945066,424,256,utRho25
1198,qmcA,1031646,1031646,1031546,100,454,utRho25
1199,qor,8528608,8528608,8528462,146,230,utRho25
1200,qseB,6339502,6339656,6339502,154,122,utRho25
1201,queA,849970,850022,849970,52,164,utRho25
1202,queE,5811212,5811212,5810836,376,72,utRho25
1203,queF,5850642,5850696,5850642,54,0,utRho25
1204,queG,8788184,8788184,8788134,50,326,utRho25
1205,racC,2835630,2835630,2835526,104,0,utRho25
1206,racR,2840898,2840898,2840482,416,304,utRho25
1207,raiA,5474208,5474308,5474208,100,54,utRho25
1208,rarD,8008594,8008594,8008356,238,278,utRho25
1209,ravA,7862256,7862256,7862186,70,218,utRho25
1210,rayT,495088,495274,495088,186,24,utRho25
1211,rbn,4763162,4763216,4763162,54,0,utRho25
1212,rbsD,7866644,7866702,7866644,58,0,utRho25
1213,rcnA,4371654,4371834,4371654,180,174,utRho25
1214,rcnB,4373768,4373920,4373768,152,62,utRho25
1215,rcnR,4371806,4371806,4371592,214,328,utRho25
1216,rcsA,4047672,4047936,4047672,264,520,utRho25
1217,rcsB,4631390,4632354,4631390,964,360,utRho25
1218,rcsC,4640162,4640162,4639656,506,0,utRho25
1219,rcsD,4626904,4626976,4626904,72,4,utRho25
1220,rdgB,6193240,6193362,6193240,122,142,utRho25
1221,rdlA,2538646,2538646,2538646,0,0,utRho25
1222,rdlB,2539712,2539716,2539712,4,0,utRho25
1223,rdlC,2540782,2540786,2540782,4,0,utRho25
1224,rdlD,7400272,7400272,7400272,0,0,utRho25
1225,rdoA,8084782,8084830,8084782,48,20,utRho25
1226,recA,11295276,11295276,11295076,200,316,utRho25
1227,recC,5925014,5925014,5924856,158,0,utRho25
1228,recF,7763722,7763722,7762442,1280,1122,utRho25
1229,recN,5503518,5503590,5503518,72,0,utRho25
1230,recQ,8011666,8011728,8011666,62,38,utRho25
1231,relA,5828554,5828554,5827302,1252,20,utRho25
1232,relB,3291806,3291806,3291744,62,126,utRho25
1233,rem,3289950,3289950,3289804,146,0,utRho25
1234,rep,7921294,7921354,7921294,60,66,utRho25
1235,rfaD,7587730,7587974,7587730,244,452,utRho25
1236,rfaE,6393852,6393852,6393506,346,28,utRho25
1237,rfaH,8049930,8049930,8049642,288,1050,utRho25
1238,rfbX,4219436,4219436,4219168,268,634,utRho25
1239,rfe,7935600,7935832,7935600,232,400,utRho25
1240,rhaB,8194944,8194944,8194896,48,0,utRho25
1241,rhaD,8188770,8188770,8188544,226,0,utRho25
1242,rhaS,8195422,8195472,8195422,50,0,utRho25
1243,rhaT,8201132,8201132,8201050,82,0,utRho25
1244,rhlE,1661566,1661744,1661566,178,0,utRho25
1245,rhoL,47593944,47594772,47593944,828,2856,utRho25
1246,rhsB,7238006,7238384,7238006,378,176,utRho25
1247,rhsC,1458758,1459166,1458758,408,44,utRho25
1248,rhsD,1046132,1046522,1046132,390,0,utRho25
1249,rhtA,1700608,1700608,1700194,414,894,utRho25
1250,rhtC,8015478,8015514,8015478,36,180,utRho25
1251,ribA,2678468,2678468,2678320,148,0,utRho25
1252,ribC,3486916,3486916,3486484,432,778,utRho25
1253,ribE,869008,869294,869008,286,4840,utRho25
1254,ribF,42766,42814,42766,48,46,utRho25
1255,ridA,8941892,8941892,8941826,66,62,utRho25
1256,rihA,1369204,1369204,1368824,380,42,utRho25
1257,rihB,4510504,4510504,4510372,132,36,utRho25
1258,rimJ,2251044,2251124,2251044,80,0,utRho25
1259,rimK,1783752,1783934,1783752,182,128,utRho25
1260,rimL,2997486,2997876,2997486,390,0,utRho25
1261,rimO,1756140,1756140,1756070,70,38,utRho25
1262,rimP,6636350,6636350,6636012,338,502,utRho25
1263,rlmA,3814172,3814172,3814120,52,0,utRho25
1264,rlmD,5830086,5830086,5830000,86,0,utRho25
1265,rlmE,6655520,6655520,6655328,192,734,utRho25
1266,rlmF,1684384,1684664,1684384,280,0,utRho25
1267,rlmG,6471784,6471784,6471750,34,52,utRho25
1268,rlmI,2060002,2060002,2059938,64,0,utRho25
1269,rlmJ,7290700,7290770,7290700,70,78,utRho25
1270,rlmL,2015344,2015688,2015344,344,106,utRho25
1271,rlpA,1330444,1330444,1330380,64,14,utRho25
1272,rluA,120900,120900,120692,208,62,utRho25
1273,rluF,8460324,8460708,8460324,384,96,utRho25
1274,rmf,2031006,2031430,2031006,424,220,utRho25
1275,rna,1290068,1290068,1290006,62,0,utRho25
1276,rnb,2698258,2698258,2697824,434,172,utRho25
1277,rnc,10816892,10816892,10816252,640,27036,utRho25
1278,rnd,3776122,3776122,3775982,140,0,utRho25
1279,rne,2289746,2289746,2288734,1012,2128,utRho25
1280,rnhA,472082,472082,472004,78,970,utRho25
1281,rnk,1288360,1288360,1287934,426,0,utRho25
1282,rnlA,5531788,5531836,5531788,48,112,utRho25
1283,rnlB,5533414,5533968,5533414,554,294,utRho25
1284,rnpB,19623552,19623552,19623552,0,0,utRho25
1285,rob,9270706,9270706,9270620,86,36,utRho25
1286,rodZ,5285868,5285868,5285688,180,118,utRho25
1287,rpe,7030306,7030306,7030118,188,196,utRho25
1288,rph,15266320,15266320,15266196,124,100,utRho25
1289,rpiA,6118706,6118706,6118650,56,70,utRho25
1290,rpiB,8626514,8626700,8626514,186,0,utRho25
1291,rpiR,8626274,8626274,8625982,292,36,utRho25
1292,rplJ,8359246,8359992,8359246,746,6444,utRho25
1293,rplK,8356708,8356894,8356708,186,138,utRho25
1294,rplM,6757344,6757344,6757302,42,1160,utRho25
1295,rplN,6896444,6896444,6896298,146,878,utRho25
1296,rplS,5489284,5489284,5489060,224,10230,utRho25
1297,rplT,7199052,7199052,7198996,56,976,utRho25
1298,rplU,6667036,6667036,6666902,134,100,utRho25
1299,rplY,4564866,4565034,4564866,168,176,utRho25
1300,rpmA,6666450,6666450,6666238,212,1136,utRho25
1301,rpmB,15247980,15247980,15246696,1284,51284,utRho25
1302,rpmE,8253816,8254026,8253816,210,288,utRho25
1303,rpmF,2294676,2294734,2294676,58,11544,utRho25
1304,rpmH,7768130,7768672,7768130,542,2124,utRho25
1305,rpmI,3600854,3600854,3599998,856,3838,utRho25
1306,rpoB,8362126,8362490,8362126,364,264,utRho25
1307,rpoD,6424946,6426094,6424946,1148,33250,utRho25
1308,rpoE,5420372,5420372,5420024,348,30,utRho25
1309,rpoH,7202006,7202006,7201566,440,1596,utRho25
1310,rpoN,6689324,6689434,6689324,110,48,utRho25
1311,rpoS,5736236,5736236,5735102,1134,696,utRho25
1312,rpoZ,7644154,7644212,7644154,58,32,utRho25
1313,rppH,5937986,5937986,5937954,32,182,utRho25
1314,rprA,3540744,3540744,3540744,0,0,utRho25
1315,rpsA,1923434,1923990,1923434,556,24272,utRho25
1316,rpsF,8850050,8850236,8850050,186,8632,utRho25
1317,rpsI,6756580,6756580,6756414,166,6728,utRho25
1318,rpsJ,6906884,6906884,6906540,344,2564,utRho25
1319,rpsL,6949242,6949242,6949104,138,1632,utRho25
1320,rpsM,6885130,6885130,6884942,188,208,utRho25
1321,rpsO,13247144,13247144,13246736,408,96,utRho25
1322,rpsP,5492508,5492508,5492370,138,84,utRho25
1323,rpsT,42420,42420,42156,264,86,utRho25
1324,rpsU,12842584,12843124,12842584,540,1892,utRho25
1325,rraA,8238716,8238716,8238660,56,394,utRho25
1326,rraB,8956768,8956946,8956768,178,54,utRho25
1327,rrsA,8070478,8071062,8070478,584,1850,utRho25
1328,rrsB,16665468,16666636,16665468,1168,3888,utRho25
1329,rrsC,7883032,7883616,7883032,584,1098,utRho25
1330,rrsD,6858094,6858094,6857524,570,440,utRho25
1331,rrsE,8415726,8416294,8415726,568,536,utRho25
1332,rrsG,5462896,5462896,5462314,582,1600,utRho25
1333,rrsH,446970,447542,446970,572,454,utRho25
1334,rsd,8393908,8393908,8393616,292,76,utRho25
1335,rseA,5419264,5419264,5418808,456,590,utRho25
1336,rseP,392940,393092,392940,152,118,utRho25
1337,rseX,4067298,4067298,4067298,0,0,utRho25
1338,rsfS,1338144,1338144,1338072,72,268,utRho25
1339,rsgA,8783132,8783132,8783018,114,18,utRho25
1340,rsmA,105176,105176,104860,316,200,utRho25
1341,rsmB,6869982,6870414,6869982,432,72,utRho25
1342,rsmC,9215736,9215736,9215400,336,0,utRho25
1343,rsmD,7208594,7208786,7208594,192,0,utRho25
1344,rsmE,6182036,6182268,6182036,232,54,utRho25
1345,rsmG,7847512,7847512,7847360,152,124,utRho25
1346,rsmH,180020,180188,180020,168,6,utRho25
1347,rsmI,6587106,6587106,6586670,436,218,utRho25
1348,rssA,2578212,2578412,2578212,200,0,utRho25
1349,rssB,2580440,2580484,2580440,44,84,utRho25
1350,rstA,3364276,3364300,3364276,24,0,utRho25
1351,rsuA,4561096,4561096,4560966,130,58,utRho25
1352,rsxA,3411510,3411534,3411510,24,0,utRho25
1353,rtcA,7114004,7114004,7113698,306,50,utRho25
1354,rtcB,7116214,7116214,7116158,56,58,utRho25
1355,rtn,4541356,4541452,4541356,96,0,utRho25
1356,rutA,2148052,2148052,2148022,30,0,utRho25
1357,rutG,2140090,2140090,2139678,412,0,utRho25
1358,rutR,2148226,2148484,2148226,258,0,utRho25
1359,ruvA,7784096,7784096,7783904,192,0,utRho25
1360,ruvB,7782176,7782176,7781424,752,892,utRho25
1361,ruvC,3894878,3894878,3894752,126,0,utRho25
1362,rybB,1776114,1776114,1776114,0,0,utRho25
1363,rydB,3529860,3529860,3529322,538,0,utRho25
1364,rydC,2983012,2983012,2983012,0,0,utRho25
1365,ryfA,5307398,5307710,5307398,312,0,utRho25
1366,ryfD,5468590,5468590,5468590,0,0,utRho25
1367,ryhB,7162032,7162032,7162032,0,0,utRho25
1368,ryjA,8556132,8556132,8556132,0,0,utRho25
1369,ryjB,9055954,9055954,9055954,0,0,utRho25
1370,sad,3229598,3229598,3229406,192,114,utRho25
1371,safA,3168056,3168056,3167918,138,88,utRho25
1372,sanA,4465368,4465756,4465368,388,34,utRho25
1373,sapF,2705314,2705314,2705268,46,0,utRho25
1374,sbcB,4165456,4165512,4165456,56,0,utRho25
1375,sbcC,831694,831694,831506,188,6,utRho25
1376,sbcD,833954,833954,833904,50,158,utRho25
1377,sbmA,793106,793278,793106,172,384,utRho25
1378,sbmC,4162650,4162650,4162524,126,0,utRho25
1379,sdaA,3793618,3793864,3793618,246,838,utRho25
1380,sdaC,5856070,5856458,5856070,388,15914,utRho25
1381,sdhC,1509916,1510354,1509916,438,7964,utRho25
1382,sdhD,1510808,1511120,1510808,312,174,utRho25
1383,sdiA,3993834,3993834,3993664,170,30,utRho25
1384,secE,8354354,8354716,8354354,362,364,utRho25
1385,secG,6645180,6645180,6645010,170,260,utRho25
1386,selA,7522594,7522594,7522498,96,136,utRho25
1387,selB,7519850,7519850,7519722,128,50,utRho25
1388,selC,7672396,7672444,7672396,48,100,utRho25
1389,selD,3696058,3696058,3696016,42,234,utRho25
1390,seqA,1425884,1425974,1425884,90,0,utRho25
1391,serA,6117098,6117098,6116820,278,0,utRho25
1392,serB,9249712,9249790,9249712,78,66,utRho25
1393,serC,3830380,3830612,3830380,232,40,utRho25
1394,serS,1878730,1878856,1878730,126,290,utRho25
1395,serT,2063438,2063438,2063424,14,0,utRho25
1396,serU,4087124,4087124,4087114,10,2,utRho25
1397,serV,5637394,5637394,5637290,104,84,utRho25
1398,serW,1852014,1852014,1851942,72,370,utRho25
1399,serX,2195352,2195352,2195304,48,12,utRho25
1400,setB,4527426,4527726,4527426,300,2,utRho25
1401,setC,7673488,7673906,7673488,418,390,utRho25
1402,sfmA,1116124,1116424,1116124,300,0,utRho25
1403,sfmC,1117606,1117948,1117606,342,80,utRho25
1404,sfsA,323030,323030,322972,58,58,utRho25
1405,sfsB,6669592,6669818,6669592,226,24,utRho25
1406,sgrR,154676,154676,154598,78,108,utRho25
1407,sgrS,154734,154734,154734,0,0,utRho25
1408,shiA,4107068,4107286,4107068,218,0,utRho25
1409,sibA,4306622,4306622,4306622,0,0,utRho25
1410,sibB,4307292,4307292,4307292,0,0,utRho25
1411,sibC,6113702,6113702,6113702,0,0,utRho25
1412,sibD,6389730,6389730,6389730,0,0,utRho25
1413,sibE,6390480,6390480,6390480,0,0,utRho25
1414,sixA,4913998,4913998,4913624,374,0,utRho25
1415,slp,7307872,7307922,7307872,50,0,utRho25
1416,slt,9261400,9261466,9261400,66,42,utRho25
1417,slyA,3442028,3442028,3441648,380,2,utRho25
1418,slyB,3439496,3439752,3439496,256,56,utRho25
1419,slyD,6957398,6957398,6956994,404,308,utRho25
1420,slyX,6954862,6955280,6954862,418,6282,utRho25
1421,smf,6867372,6867372,6867120,252,0,utRho25
1422,smpB,5509534,5509792,5509534,258,332,utRho25
1423,smrA,2811872,2811958,2811872,86,290,utRho25
1424,smrB,4896872,4897212,4896872,340,92,utRho25
1425,smtA,1946808,1947074,1946808,266,0,utRho25
1426,sodA,8201518,8201620,8201518,102,776,utRho25
1427,sodB,3470646,3470756,3470646,110,0,utRho25
1428,sodC,3449358,3449358,3449310,48,0,utRho25
1429,sohB,2658568,2658664,2658568,96,178,utRho25
1430,sokB,2984232,2984238,2984232,6,20,utRho25
1431,solA,2241218,2241218,2241172,46,92,utRho25
1432,soxR,8554894,8554938,8554894,44,0,utRho25
1433,soxS,8554846,8554846,8554766,80,0,utRho25
1434,speA,6172096,6172096,6171822,274,398,utRho25
1435,speB,6167892,6167892,6167594,298,8,utRho25
1436,speC,6218350,6218350,6218310,40,48,utRho25
1437,spf,8099798,8099798,8099798,0,0,utRho25
1438,sppA,3697422,3697674,3697422,252,152,utRho25
1439,spy,3651376,3651376,3651250,126,0,utRho25
1440,sra,3112092,3112092,3111926,166,0,utRho25
1441,sraB,2293178,2293178,2293178,0,0,utRho25
1442,sraC,3846132,3846132,3846132,0,0,utRho25
1443,srlA,5651582,5651664,5651582,82,132,utRho25
1444,srlR,5657720,5658094,5657720,374,344,utRho25
1445,srmB,5425752,5425792,5425752,40,0,utRho25
1446,sroA,151216,151216,151216,0,0,utRho25
1447,sroG,6369436,6369436,6369436,0,0,utRho25
1448,sroH,8380974,8380974,8380974,0,0,utRho25
1449,ssb,8548022,8548250,8548022,228,6,utRho25
1450,sseA,5304782,5304988,5304782,206,1970,utRho25
1451,sspA,6755138,6755138,6754840,298,74,utRho25
1452,ssrA,5511014,5511186,5511014,172,464,utRho25
1453,ssrS,12223036,12223932,12223036,896,3540,utRho25
1454,sstT,6479726,6479888,6479726,162,0,utRho25
1455,ssuB,1988282,1988282,1988088,194,4,utRho25
1456,ssuE,1995126,1995126,1995024,102,0,utRho25
1457,sthA,8321604,8321604,8321580,24,62,utRho25
1458,stpA,5597156,5597156,5596990,166,2,utRho25
1459,sucA,3034344,3034824,3034344,480,304,utRho25
1460,sufA,3528836,3528836,3528772,64,0,utRho25
1461,sufE,3518962,3518962,3518580,382,4,utRho25
1462,sugE,8753588,8753750,8753588,162,2,utRho25
1463,sulA,2041894,2041894,2041838,56,4346,utRho25
1464,syd,5850738,5850738,5850560,178,0,utRho25
1465,symE,9159834,9159834,9159680,154,0,utRho25
1466,symR,9159670,9159670,9159670,0,0,utRho25
1467,tabA,8949566,8949724,8949566,158,0,utRho25
1468,talA,5157140,5157332,5157140,192,0,utRho25
1469,talB,16382,16476,16382,94,4214,utRho25
1470,tam,3214442,3214692,3214442,250,60,utRho25
1471,tamA,8884540,8884764,8884540,224,308,utRho25
1472,tar,3945432,3945432,3945382,50,0,utRho25
1473,tas,5943138,5943194,5943138,56,0,utRho25
1474,tatA,16087636,16087780,16087636,144,4,utRho25
1475,tatE,1317742,1317894,1317742,152,0,utRho25
1476,tauA,770410,770464,770410,54,0,utRho25
1477,tdcA,6534186,6534186,6534130,56,0,utRho25
1478,tdcG,6519652,6519652,6519298,354,148,utRho25
1479,tdcR,6534380,6534760,6534380,380,0,utRho25
1480,tdk,2586986,2587054,2586986,68,136,utRho25
1481,tehA,3001072,3001146,3001072,74,0,utRho25
1482,tesA,1039898,1039898,1039530,368,306,utRho25
1483,tesB,950402,950402,950322,80,0,utRho25
1484,tfaE,2418532,2418532,2418238,294,278,utRho25
1485,tfaQ,3269912,3269912,3269770,142,2,utRho25
1486,tff,379424,379256,379424,168,94,utRho25
1487,tgt,852110,852274,852110,164,0,utRho25
1488,thiD,4369346,4369346,4369032,314,0,utRho25
1489,thiI,882936,883098,882936,162,0,utRho25
1490,thiM,4370902,4370902,4370602,300,26,utRho25
1491,thiQ,146170,146170,145854,316,2754,utRho25
1492,thrL,592,760,592,168,216,utRho25
1493,thrS,7210932,7210932,7210280,652,400,utRho25
1494,thrU,8350762,8350776,8350762,14,388,utRho25
1495,thrV,6847414,6847414,6847310,104,202992,utRho25
1496,thrW,525682,525742,525682,60,36,utRho25
1497,thyA,5930696,5930696,5930310,386,178,utRho25
1498,tig,909986,910266,909986,280,412,utRho25
1499,tisB,7706674,7707106,7706674,432,948,utRho25
1500,tktA,6163414,6163414,6163270,144,50,utRho25
1501,tktB,5158616,5159272,5158616,656,264,utRho25
1502,tldD,6784368,6784368,6784056,312,0,utRho25
1503,tmcA,5191876,5191876,5191718,158,0,utRho25
1504,tnaC,15553644,15553740,15553644,96,100,utRho25
1505,tolB,1555074,1555480,1555074,406,628,utRho25
1506,tolC,6356008,6356230,6356008,222,76,utRho25
1507,tomB,961588,961588,961416,172,176,utRho25
1508,tonB,2622108,2622178,2622108,70,0,utRho25
1509,topA,2661578,2662096,2661578,518,370,utRho25
1510,torC,2116112,2116168,2116112,56,130,utRho25
1511,torR,2115968,2115968,2115908,60,170,utRho25
1512,torS,2112364,2112364,2112356,8,0,utRho25
1513,torT,2112414,2112522,2112414,108,0,utRho25
1514,tpiA,8223138,8223138,8223014,124,2,utRho25
1515,tppB,3425342,3425538,3425342,196,164,utRho25
1516,tpr,2574376,2574376,2574376,0,0,utRho25
1517,tpx,2777688,2777688,2777622,66,472,utRho25
1518,tqsA,3347780,3347826,3347780,46,2,utRho25
1519,treA,2494850,2494850,2494752,98,2,utRho25
1520,treB,8932420,8932420,8932360,60,24,utRho25
1521,treF,7339102,7339184,7339102,82,8,utRho25
1522,treR,8934694,8934694,8934492,202,28,utRho25
1523,trg,2984878,2984940,2984878,62,24,utRho25
1524,trkG,2847342,2847564,2847342,222,568,utRho25
1525,trmA,8326590,8326590,8326540,50,84,utRho25
1526,trpA,2634678,2634678,2634444,234,68,utRho25
1527,trpC,2639888,2639888,2639570,318,38,utRho25
1528,trpL,5292432,5292432,5292328,104,0,utRho25
1529,trpR,9265408,9265520,9265408,112,64,utRho25
1530,trpS,7027394,7027394,7027276,118,266,utRho25
1531,trpT,7893560,7893914,7893560,354,104602,utRho25
1532,trxA,7931294,7931522,7931294,228,892,utRho25
1533,trxB,1864156,1864156,1864100,56,40,utRho25
1534,trxC,5437350,5437470,5437350,120,108,utRho25
1535,tsaD,6421256,6421256,6421086,170,162,utRho25
1536,tsgA,6985038,6985136,6985038,98,2,utRho25
1537,tsr,9182824,9183314,9182824,490,54,utRho25
1538,tsx,864490,864490,864026,464,100,utRho25
1539,ttcA,2823970,2823970,2823896,74,958,utRho25
1540,ttdA,6412848,6412926,6412848,78,62,utRho25
1541,ttdR,6412760,6412760,6412512,248,58,utRho25
1542,tufA,6943448,6943448,6942658,790,26376,utRho25
1543,tus,3368346,3368518,3368346,172,92,utRho25
1544,tusA,7218040,7218040,7217992,48,268,utRho25
1545,tusB,6950218,6950218,6949930,288,164,utRho25
1546,tynA,2902996,2902996,2902698,298,0,utRho25
1547,typA,8116460,8116814,8116460,354,584,utRho25
1548,tyrB,8534164,8534228,8534164,64,150,utRho25
1549,tyrP,3979004,3979362,3979004,358,28,utRho25
1550,tyrR,2773384,2773440,2773384,56,22,utRho25
1551,tyrS,3434566,3434566,3434444,122,0,utRho25
1552,tyrT,2575330,2575330,2575244,86,30,utRho25
1553,uacT,6062378,6062734,6062378,356,92,utRho25
1554,ubiC,8504886,8505012,8504886,126,96,utRho25
1555,ubiD,8049618,8049976,8049618,358,1306,utRho25
1556,ubiE,8037494,8037710,8037494,216,82,utRho25
1557,ubiG,4679078,4679134,4679078,56,0,utRho25
1558,ucpA,5089342,5089342,5089246,96,42,utRho25
1559,udp,8032782,8032862,8032782,80,0,utRho25
1560,ugd,4199470,4199470,4199226,244,0,utRho25
1561,ugpB,7184852,7184852,7184650,202,590,utRho25
1562,ugpQ,7176600,7176600,7176226,374,0,utRho25
1563,uhpT,7694396,7694396,7694334,62,0,utRho25
1564,uidA,3392304,3392304,3392142,162,0,utRho25
1565,uidC,3386012,3386012,3385702,310,4,utRho25
1566,uidR,3394150,3394150,3394104,46,0,utRho25
1567,ulaA,8839854,8839960,8839854,106,20,utRho25
1568,ulaG,8839350,8839350,8839250,100,4,utRho25
1569,ulaR,8837124,8837124,8836906,218,0,utRho25
1570,umpG,5741372,5741372,5740548,824,80,utRho25
1571,umpH,1400704,1400704,1400652,52,18,utRho25
1572,umuD,2461476,2461534,2461476,58,0,utRho25
1573,ung,5433476,5433508,5433476,32,0,utRho25
1574,uof,2843316,2843316,2842900,416,404,utRho25
1575,upp,5241818,5241818,5241744,74,82,utRho25
1576,usg,4873780,4873780,4873298,482,42,utRho25
1577,ushA,1009772,1009828,1009772,56,8,utRho25
1578,uspA,7279966,7280222,7279966,256,406,utRho25
1579,uspB,7279696,7279696,7279440,256,118,utRho25
1580,uspC,3959172,3959506,3959172,334,30,utRho25
1581,uspE,2797318,2797318,2797244,74,98,utRho25
1582,uspF,2871282,2871282,2871238,44,58,utRho25
1583,uspG,1283806,1283806,1283734,72,130,utRho25
1584,uvrA,8547872,8547872,8547742,130,224,utRho25
1585,uvrB,1626304,1627052,1626304,748,154,utRho25
1586,uvrC,3989758,3989758,3989412,346,0,utRho25
1587,uvrD,7995814,7995966,7995814,152,28,utRho25
1588,uvrY,3990812,3990812,3990718,94,78,utRho25
1589,uxaB,3221474,3221474,3221360,114,56,utRho25
1590,uxaC,6489714,6489714,6489482,232,36,utRho25
1591,uxuA,9103036,9103272,9103036,236,324,utRho25
1592,uxuR,9108916,9109152,9108916,236,12,utRho25
1593,valS,8967854,8967854,8967674,180,168,utRho25
1594,valU,5041848,5041862,5041848,14,46,utRho25
1595,valV,3492830,3492870,3492830,40,2,utRho25
1596,ves,3649968,3649968,3649874,94,0,utRho25
1597,waaA,7616512,7617080,7616512,568,552,utRho25
1598,waaH,7580298,7580298,7580162,136,0,utRho25
1599,waaQ,7616476,7616476,7616196,280,552,utRho25
1600,waaU,7598996,7598996,7598624,372,42,utRho25
1601,waaY,7602272,7602272,7601930,342,7978,utRho25
1602,wbbH,4214888,4214888,4214452,436,1626,utRho25
1603,wbbK,4209212,4209212,4209018,194,334,utRho25
1604,wcaM,4231868,4231868,4231792,76,0,utRho25
1605,wrbA,2135516,2135516,2135416,100,0,utRho25
1606,wza,4275166,4275166,4274486,680,52,utRho25
1607,wzxC,4240674,4240674,4240316,358,0,utRho25
1608,wzzB,4196950,4196950,4196602,348,198,utRho25
1609,xanP,7657642,7657890,7657642,248,60,utRho25
1610,xanQ,6048520,6048702,6048520,182,62,utRho25
1611,xapA,5049820,5049820,5049756,64,0,utRho25
1612,xapR,10090252,10090252,10089908,344,0,utRho25
1613,xdhA,6000514,6000690,6000514,176,162,utRho25
1614,xerD,6079702,6079702,6079486,216,36,utRho25
1615,xseA,5268394,5268464,5268394,70,76,utRho25
1616,xseB,882746,882746,882686,60,30,utRho25
1617,xthA,3664798,3664856,3664798,58,0,utRho25
1618,xylA,7461614,7461614,7461530,84,1768,utRho25
1619,xylE,8484540,8484540,8484508,32,0,utRho25
1620,xylF,7462138,7462262,7462138,124,240,utRho25
1621,xylR,7469812,7469958,7469812,146,88,utRho25
1622,yaaA,13230,13230,12918,312,204,utRho25
1623,yaaI,23876,23876,23572,304,72,utRho25
1624,yaaJ,16034,16034,15918,116,94,utRho25
1625,yaaU,91184,91614,91184,430,52,utRho25
1626,yaaW,23084,23084,22712,372,108,utRho25
1627,yaaX,10060,10468,10060,408,150,utRho25
1628,yabI,142542,142702,142542,160,136,utRho25
1629,yacC,273880,273880,273834,46,2,utRho25
1630,yacH,262932,262932,262520,412,0,utRho25
1631,yacL,268678,268776,268678,98,0,utRho25
1632,yadD,293796,293936,293796,140,2,utRho25
1633,yadE,289930,290162,289930,232,156,utRho25
1634,yadN,314110,314110,313766,344,44,utRho25
1635,yadS,355572,355572,355248,324,172,utRho25
1636,yadV,312470,312470,312402,68,166,utRho25
1637,yaeF,434270,434270,434006,264,14,utRho25
1638,yaeP,428374,428374,428250,124,126,utRho25
1639,yaeQ,428176,428582,428176,406,128,utRho25
1640,yaeR,423716,423754,423716,38,48,utRho25
1641,yafC,462166,462166,461762,404,402,utRho25
1642,yafD,462128,462244,462128,116,460,utRho25
1643,yafK,491986,491986,491610,376,186,utRho25
1644,yafL,493282,493424,493282,142,2,utRho25
1645,yafN,503938,504010,503938,72,32,utRho25
1646,yafS,469568,469632,469568,64,186,utRho25
1647,yafT,474470,474670,474470,200,22,utRho25
1648,yafV,480432,480432,480378,54,0,utRho25
1649,yafZ,536052,536052,536010,42,10,utRho25
1650,yagE,564446,564556,564446,110,58,utRho25
1651,yagG,570414,570790,570414,376,82,utRho25
1652,yagI,578384,578384,578324,60,0,utRho25
1653,yagK,586236,586236,585896,340,494,utRho25
1654,yagL,588062,588062,587836,226,12,utRho25
1655,yagN,591342,591342,591158,184,30,utRho25
1656,yahA,663746,664742,663746,996,998,utRho25
1657,yahC,670136,670136,670044,92,22,utRho25
1658,yahE,671478,671850,671478,372,208,utRho25
1659,yahM,690504,690808,690504,304,442,utRho25
1660,yahN,692872,692872,692674,198,412,utRho25
1661,yahO,692864,692968,692864,104,296,utRho25
1662,yaiE,816296,816354,816296,58,80,utRho25
1663,yaiI,811396,811528,811396,132,82,utRho25
1664,yaiO,761946,761946,761684,262,148,utRho25
1665,yaiP,767970,767970,767870,100,0,utRho25
1666,yaiS,769660,769660,769232,428,650,utRho25
1667,yaiV,788922,788922,788922,0,0,utRho25
1668,yaiY,799094,799094,798666,428,56,utRho25
1669,yaiZ,798888,799186,798888,298,6,utRho25
1670,yajC,854410,854574,854410,164,100,utRho25
1671,yajD,860938,861210,860938,272,224,utRho25
1672,yajI,866068,866068,865702,366,282,utRho25
1673,yajL,887496,887496,887282,214,136,utRho25
1674,yajQ,889316,889366,889316,50,166,utRho25
1675,yajR,893374,893374,893332,42,34,utRho25
1676,ybaB,987418,988152,987418,734,444,utRho25
1677,ybaL,1006590,1006590,1006476,114,32,utRho25
1678,ybaM,980648,980648,980542,106,78,utRho25
1679,ybaN,981436,981764,981436,328,278,utRho25
1680,ybaO,936704,936766,936704,62,0,utRho25
1681,ybaP,1016568,1016568,1016160,408,700,utRho25
1682,ybaQ,1016348,1016436,1016348,88,154,utRho25
1683,ybaS,1023146,1023282,1023146,136,56,utRho25
1684,ybaV,927504,927874,927504,370,0,utRho25
1685,ybaY,950490,950758,950490,268,76,utRho25
1686,ybbB,1062724,1062724,1062452,272,0,utRho25
1687,ybbJ,1030154,1030154,1029718,436,400,utRho25
1688,ybbL,1031784,1031838,1031784,54,4,utRho25
1689,ybbN,1037136,1037136,1036558,578,972,utRho25
1690,ybbO,1038658,1038658,1038298,360,484,utRho25
1691,ybbY,1080718,1081130,1080718,412,102,utRho25
1692,ybcH,1176140,1176140,1175962,178,52,utRho25
1693,ybcI,1113264,1113264,1113106,158,84,utRho25
1694,ybcJ,1114050,1114050,1113746,304,138,utRho25
1695,ybcK,1137502,1137804,1137502,302,166,utRho25
1696,ybcL,1141690,1141786,1141690,96,6,utRho25
1697,ybcN,1144628,1144932,1144628,304,84,utRho25
1698,ybcQ,1147548,1147912,1147548,364,0,utRho25
1699,ybcW,1159610,1159760,1159610,150,44,utRho25
1700,ybdD,1263982,1264364,1263982,382,66,utRho25
1701,ybdF,1212106,1212106,1211772,334,38,utRho25
1702,ybdH,1267048,1267048,1266954,94,2,utRho25
1703,ybdJ,1212822,1212822,1212398,424,56,utRho25
1704,ybdK,1215122,1215122,1214766,356,156,utRho25
1705,ybdL,1267114,1267172,1267114,58,68,utRho25
1706,ybdM,1271110,1271110,1270752,358,56,utRho25
1707,ybdN,1273372,1273372,1273138,234,62,utRho25
1708,ybdR,1283844,1284176,1283844,332,198,utRho25
1709,ybeD,1325412,1325412,1325284,128,1066,utRho25
1710,ybeF,1323090,1323090,1322756,334,268,utRho25
1711,ybeL,1349986,1350036,1349986,50,0,utRho25
1712,ybeQ,1353412,1353412,1353094,318,86,utRho25
1713,ybeR,1353120,1353422,1353120,302,86,utRho25
1714,ybeT,1358832,1358832,1358812,20,0,utRho25
1715,ybeU,1358924,1359016,1358924,92,26,utRho25
1716,ybeZ,1386938,1386938,1386834,104,332,utRho25
1717,ybfA,1458074,1458268,1458074,194,78,utRho25
1718,ybfE,1423878,1423878,1423796,82,194,utRho25
1719,ybfF,1425692,1425692,1425604,88,192,utRho25
1720,ybfH,1433282,1433282,1433194,88,26,utRho25
1721,ybgA,1477840,1478002,1477840,162,88,utRho25
1722,ybgC,1549288,1549504,1549288,216,20,utRho25
1723,ybgD,1505916,1505916,1505590,326,3482,utRho25
1724,ybgI,1485238,1485654,1485238,416,0,utRho25
1725,ybgO,1498370,1498370,1497964,406,212,utRho25
1726,ybgS,1570992,1570992,1570634,358,152,utRho25
1727,ybhA,1597184,1597184,1596862,322,110,utRho25
1728,ybhB,1616070,1616070,1615818,252,0,utRho25
1729,ybhC,1614642,1614642,1614562,80,14,utRho25
1730,ybhD,1601418,1601418,1601276,142,32,utRho25
1731,ybhH,1601104,1601518,1601104,414,32,utRho25
1732,ybhK,1633384,1633384,1633294,90,0,utRho25
1733,ybhM,1641556,1641586,1641556,30,86,utRho25
1734,ybhN,1645296,1645296,1644996,300,100,utRho25
1735,ybhQ,1649202,1649260,1649202,58,82,utRho25
1736,ybiA,1665920,1665920,1665900,20,0,utRho25
1737,ybiI,1676968,1676968,1676912,56,34,utRho25
1738,ybiO,1691328,1691328,1690960,368,188,utRho25
1739,ybiP,1705252,1705252,1705194,58,54,utRho25
1740,ybiS,1711572,1711572,1711488,84,0,utRho25
1741,ybiT,1711894,1711926,1711894,32,14,utRho25
1742,ybiU,1718212,1718212,1718122,90,22,utRho25
1743,ybiV,1720176,1720176,1720056,120,0,utRho25
1744,ybiW,1725566,1725566,1725212,354,390,utRho25
1745,ybiX,1678548,1678548,1678414,134,262,utRho25
1746,ybjC,1781784,1781826,1781784,42,0,utRho25
1747,ybjE,1830154,1830154,1829714,440,250,utRho25
1748,ybjG,1767016,1767016,1766776,240,306,utRho25
1749,ybjL,1779882,1779882,1779638,244,0,utRho25
1750,ybjM,1779770,1780178,1779770,408,0,utRho25
1751,ybjO,1795704,1795978,1795704,274,0,utRho25
1752,ybjP,1809046,1809046,1808934,112,0,utRho25
1753,ybjQ,1809034,1809186,1809034,152,76,utRho25
1754,ybjS,1813796,1813796,1813506,290,60,utRho25
1755,ybjX,1838206,1838206,1838168,38,16,utRho25
1756,ycaD,1891438,1891742,1891438,304,84,utRho25
1757,ycaI,1928210,1928640,1928210,430,78,utRho25
1758,ycaK,1899094,1899336,1899094,242,210,utRho25
1759,ycaL,1920264,1920528,1920264,264,0,utRho25
1760,ycaM,1894240,1894458,1894240,218,184,utRho25
1761,ycaR,1941284,1941346,1941284,62,134,utRho25
1762,ycbB,1961862,1962094,1961862,232,118,utRho25
1763,ycbJ,1943344,1943504,1943344,160,0,utRho25
1764,ycbK,1966046,1966150,1966046,104,40,utRho25
1765,ycbZ,2036920,2036920,2036598,322,44,utRho25
1766,yccA,2062886,2062886,2062836,50,0,utRho25
1767,yccF,2048730,2048730,2048696,34,0,utRho25
1768,yccS,2047988,2047988,2047766,222,186,utRho25
1769,yccT,2055674,2055674,2055546,128,176,utRho25
1770,yccX,2059960,2060128,2059960,168,4,utRho25
1771,ycdT,2185682,2185752,2185682,70,0,utRho25
1772,ycdU,2191266,2191686,2191266,420,12,utRho25
1773,ycdZ,2200504,2200592,2200504,88,0,utRho25
1774,yceA,2233544,2233614,2233544,70,24,utRho25
1775,yceD,2293298,2293588,2293298,290,1436,utRho25
1776,yceF,2293522,2293522,2293190,332,816,utRho25
1777,yceH,2252154,2252314,2252154,160,390,utRho25
1778,yceI,2237282,2237282,2236952,330,138,utRho25
1779,yceJ,2238142,2238142,2238092,50,62,utRho25
1780,yceM,2253208,2253612,2253208,404,0,utRho25
1781,yceO,2239264,2239264,2238894,370,340,utRho25
1782,yceQ,2288760,2289004,2288760,244,1840,utRho25
1783,ycfD,2376540,2376540,2376480,60,0,utRho25
1784,ycfJ,2334814,2335198,2334814,384,0,utRho25
1785,ycfS,2340834,2340834,2340748,86,0,utRho25
1786,ycfT,2350658,2350658,2350330,328,108,utRho25
1787,ycfZ,2362760,2362760,2362534,226,188,utRho25
1788,ycgB,2474570,2474570,2474482,88,0,utRho25
1789,ycgG,2434614,2434656,2434614,42,234,utRho25
1790,ycgJ,2452956,2453200,2452956,244,0,utRho25
1791,ycgL,2455218,2455362,2455218,144,4,utRho25
1792,ycgN,2457366,2457660,2457366,294,166,utRho25
1793,ycgR,2489112,2489112,2489054,58,0,utRho25
1794,ycgV,2512222,2512222,2511904,318,448,utRho25
1795,ycgX,2426568,2426568,2426214,354,454,utRho25
1796,ycgY,2490166,2490320,2490166,154,56,utRho25
1797,ycgZ,2431504,2431578,2431504,74,94,utRho25
1798,ychE,2596904,2597196,2596904,292,20,utRho25
1799,ychF,2515764,2515764,2515624,140,0,utRho25
1800,ychH,2517476,2517582,2517476,106,540,utRho25
1801,ychJ,2578354,2578354,2578264,90,0,utRho25
1802,ychN,2547310,2547310,2547198,112,0,utRho25
1803,ychO,2547520,2547850,2547520,330,40,utRho25
1804,ychQ,2533798,2533848,2533798,50,0,utRho25
1805,yciA,2624828,2624828,2624492,336,10,utRho25
1806,yciB,2626110,2626110,2625780,330,144,utRho25
1807,yciC,2627396,2627396,2627326,70,0,utRho25
1808,yciE,2630794,2630794,2630448,346,22,utRho25
1809,yciG,5264368,5264368,5264140,228,0,utRho25
1810,yciI,2621784,2621784,2621730,54,0,utRho25
1811,yciN,2661606,2661606,2661336,270,192,utRho25
1812,yciS,2680270,2680486,2680270,216,0,utRho25
1813,yciT,2689088,2689088,2688692,396,104,utRho25
1814,yciU,2614718,2614718,2614300,418,116,utRho25
1815,yciV,2646376,2646440,2646376,64,0,utRho25
1816,yciW,2700472,2700472,2700214,258,90,utRho25
1817,yciZ,2689276,2689276,2689218,58,192,utRho25
1818,ycjD,2703792,2703792,2703520,272,0,utRho25
1819,ycjG,2777748,2777860,2777748,112,0,utRho25
1820,ycjM,2740006,2740432,2740006,426,108,utRho25
1821,ycjW,2767982,2767982,2767922,60,0,utRho25
1822,ycjX,2768138,2768234,2768138,96,132,utRho25
1823,ycjY,5568288,5568288,5567460,828,172,utRho25
1824,ydaE,2836438,2836438,2836016,422,80,utRho25
1825,ydaN,2816048,2816100,2816048,52,0,utRho25
1826,ydaS,2840340,2840730,2840340,390,234,utRho25
1827,ydbC,2948376,2948442,2948376,66,0,utRho25
1828,ydbD,2950132,2950288,2950132,156,0,utRho25
1829,ydbH,2885800,2886102,2885800,302,2230,utRho25
1830,ydbJ,2881712,2882116,2881712,404,540,utRho25
1831,ydbK,2881692,2881692,2881568,124,200,utRho25
1832,ydcA,2983294,2983354,2983294,60,46,utRho25
1833,ydcF,2974404,2974470,2974404,66,4,utRho25
1834,ydcI,2990268,2990268,2990142,126,0,utRho25
1835,ydcJ,2990266,2990576,2990266,310,0,utRho25
1836,ydcK,3001280,3001280,3000898,382,60,utRho25
1837,ydcL,3004646,3004914,3004646,268,16,utRho25
1838,ydcN,3012308,3012344,3012308,36,54,utRho25
1839,ydcP,3013508,3013562,3013508,54,26,utRho25
1840,ydcR,3019956,3020006,3019956,50,0,utRho25
1841,ydcS,3022906,3023308,3022906,402,4,utRho25
1842,ydcX,3034442,3034778,3034442,336,230,utRho25
1843,ydcY,3035220,3035296,3035220,76,0,utRho25
1844,ydcZ,3036750,3036750,3036662,88,18,utRho25
1845,yddB,3155332,3155332,3155238,94,0,utRho25
1846,yddE,3071738,3071738,3071716,22,0,utRho25
1847,yddG,3094410,3094410,3094338,72,12,utRho25
1848,yddJ,3089732,3089732,3089438,294,176,utRho25
1849,yddW,3137704,3137704,3137646,58,0,utRho25
1850,ydeA,3233910,3234056,3233910,146,12,utRho25
1851,ydeE,3242528,3242664,3242528,136,0,utRho25
1852,ydeI,3249118,3249118,3248994,124,0,utRho25
1853,ydeJ,3249376,3249546,3249376,170,0,utRho25
1854,ydeN,3165458,3165458,3165048,410,0,utRho25
1855,ydeP,3173328,3173328,3172972,356,102,utRho25
1856,ydeR,3176596,3176596,3176592,4,36,utRho25
1857,ydfA,3296872,3297016,3296872,144,0,utRho25
1858,ydfG,3254982,3255034,3254982,52,0,utRho25
1859,ydfH,3256652,3256704,3256652,52,0,utRho25
1860,ydfK,3265446,3266144,3265446,698,306,utRho25
1861,ydgA,3379588,3379704,3379588,116,0,utRho25
1862,ydgC,3364124,3364124,3364060,64,0,utRho25
1863,ydgD,3343906,3343920,3343906,14,82,utRho25
1864,ydgH,3356754,3356854,3356754,100,12,utRho25
1865,ydgJ,3408798,3408798,3408616,182,24,utRho25
1866,ydgK,3410414,3410500,3410414,86,374,utRho25
1867,ydhB,3479618,3479618,3479596,22,0,utRho25
1868,ydhC,3479698,3479822,3479698,124,0,utRho25
1869,ydhF,3451310,3451310,3451264,46,0,utRho25
1870,ydhI,3441996,3442050,3441996,54,0,utRho25
1871,ydhL,3451864,3451864,3451840,24,0,utRho25
1872,ydhQ,3492404,3492404,3492254,150,0,utRho25
1873,ydhS,3494136,3494262,3494136,126,10,utRho25
1874,ydhT,3499138,3499138,3499118,20,0,utRho25
1875,ydhY,3509284,3509284,3508954,330,28,utRho25
1876,ydhZ,3510418,3510418,3510282,136,56,utRho25
1877,ydiE,3579206,3579226,3579206,20,0,utRho25
1878,ydiH,3530582,3530582,3530406,176,0,utRho25
1879,ydiM,3541852,3542142,3541852,290,0,utRho25
1880,ydiN,3544818,3545024,3544818,206,0,utRho25
1881,ydiP,3558656,3558656,3558602,54,40,utRho25
1882,ydiU,3582508,3582508,3582488,20,0,utRho25
1883,ydiV,3584174,3584174,3584040,134,0,utRho25
1884,ydiY,3612500,3612500,3612166,334,130,utRho25
1885,ydjA,3697400,3697400,3697352,48,42,utRho25
1886,ydjE,3708082,3708082,3707958,124,0,utRho25
1887,ydjF,3709848,3709848,3709708,140,0,utRho25
1888,ydjM,3620340,3620422,3620340,82,68,utRho25
1889,ydjO,3626696,3626696,3626288,408,0,utRho25
1890,ydjX,3666434,3666802,3666434,368,112,utRho25
1891,yeaE,3731448,3731448,3731272,176,180,utRho25
1892,yeaG,3733530,3733816,3733530,286,0,utRho25
1893,yeaI,3740486,3740770,3740486,284,84,utRho25
1894,yeaJ,3743874,3744082,3743874,208,172,utRho25
1895,yeaL,3748646,3748704,3748646,58,44,utRho25
1896,yeaM,3751296,3751296,3751152,144,0,utRho25
1897,yeaN,3750926,3751346,3750926,420,0,utRho25
1898,yeaO,3753554,3753818,3753554,264,54,utRho25
1899,yeaP,3755314,3755430,3755314,116,8,utRho25
1900,yeaQ,3758780,3758780,3758510,270,28,utRho25
1901,yeaR,3759988,3759988,3759896,92,0,utRho25
1902,yeaY,3781122,3781122,3781064,58,14,utRho25
1903,yebB,3892220,3892502,3892220,282,128,utRho25
1904,yebC,3896370,3896370,3896302,68,0,utRho25
1905,yebE,3859464,3859464,3859414,50,54,utRho25
1906,yebG,3861530,3861530,3861494,36,0,utRho25
1907,yebK,3873180,3873304,3873180,124,0,utRho25
1908,yebQ,3820314,3820552,3820314,238,0,utRho25
1909,yebS,3832238,3832516,3832238,278,64,utRho25
1910,yebV,3843430,3843560,3843430,130,0,utRho25
1911,yebW,3843914,3844242,3843914,328,516,utRho25
1912,yecC,3995646,3995646,3995628,18,36,utRho25
1913,yecD,3901272,3901664,3901272,392,0,utRho25
1914,yecF,3991434,3991636,3991434,202,24,utRho25
1915,yecH,3979304,3979304,3978980,324,28,utRho25
1916,yecJ,3975604,3975604,3975516,88,0,utRho25
1917,yecM,3919968,3919968,3919692,276,48,utRho25
1918,yecR,3976400,3976444,3976400,44,156,utRho25
1919,yecT,3923862,3923944,3923862,82,22,utRho25
1920,yedD,4016522,4016522,4016180,342,36,utRho25
1921,yedE,4016310,4016554,4016310,244,32,utRho25
1922,yedI,4058922,4058922,4058732,190,0,utRho25
1923,yedJ,4066446,4066446,4066158,288,0,utRho25
1924,yedV,4076404,4076404,4076304,100,40,utRho25
1925,yedX,4077680,4077912,4077680,232,52,utRho25
1926,yedY,4078572,4078956,4078572,384,58,utRho25
1927,yeeA,4161322,4161322,4161182,140,76,utRho25
1928,yeeE,4171104,4171104,4171050,54,2,utRho25
1929,yeeJ,4089526,4089822,4089526,296,0,utRho25
1930,yeeN,4113508,4113716,4113508,208,12,utRho25
1931,yeeO,4119444,4119444,4119692,248,440,utRho25
1932,yeeX,4158834,4158834,4158722,112,162,utRho25
1933,yeeZ,4178422,4178422,4178256,166,0,utRho25
1934,yefM,4179466,4179466,4179426,40,4,utRho25
1935,yegD,4295288,4295348,4295288,60,0,utRho25
1936,yegH,4275726,4275804,4275726,78,72,utRho25
1937,yegI,4302154,4302154,4301970,184,0,utRho25
1938,yegJ,4302032,4302370,4302032,338,20,utRho25
1939,yegQ,4331182,4331336,4331182,154,248,utRho25
1940,yegR,4336698,4336698,4336612,86,456,utRho25
1941,yegS,4337086,4337424,4337086,338,80,utRho25
1942,yegT,4357562,4357642,4357562,80,2,utRho25
1943,yegX,4367640,4367640,4367302,338,0,utRho25
1944,yehA,4376944,4376944,4376828,116,94,utRho25
1945,yehE,4385818,4385818,4385592,226,0,utRho25
1946,yehK,4407568,4407944,4407568,376,0,utRho25
1947,yehL,4408804,4409192,4408804,388,0,utRho25
1948,yeiB,4486146,4486146,4485934,212,0,utRho25
1949,yeiE,4499422,4499422,4499236,186,0,utRho25
1950,yeiG,4487776,4487820,4487776,44,106,utRho25
1951,yeiH,4499332,4499434,4499332,102,100,utRho25
1952,yeiI,4503306,4503400,4503306,94,42,utRho25
1953,yeiL,4510580,4510710,4510580,130,20,utRho25
1954,yeiP,4530834,4530900,4530834,66,134,utRho25
1955,yeiQ,4532328,4532490,4532328,162,4,utRho25
1956,yeiR,4535484,4535658,4535484,174,0,utRho25
1957,yeiW,4530840,4530840,4530590,250,116,utRho25
1958,yejA,4544624,4544728,4544624,104,0,utRho25
1959,yejG,4556892,4556892,4556474,418,926,utRho25
1960,yejH,4561244,4561264,4561244,20,4,utRho25
1961,yejK,4568218,4568218,4567894,324,100,utRho25
1962,yejO,4578352,4578352,4577800,552,188,utRho25
1963,yfaD,4713380,4713808,4713380,428,252,utRho25
1964,yfaE,4696676,4697028,4696676,352,112,utRho25
1965,yfaL,4688568,4688568,4688338,230,62,utRho25
1966,yfaP,4656398,4656398,4656286,112,108,utRho25
1967,yfaU,4717892,4717892,4717690,202,2,utRho25
1968,yfaY,4727310,4727310,4727266,44,156,utRho25
1969,yfaZ,4728744,4728744,4728550,194,52,utRho25
1970,yfbK,4771810,4771810,4771444,366,104,utRho25
1971,yfbL,4771500,4771720,4771500,220,90,utRho25
1972,yfbN,4777174,4777174,4776852,322,254,utRho25
1973,yfbO,4776916,4777162,4776916,246,254,utRho25
1974,yfbP,4777990,4778232,4777990,242,144,utRho25
1975,yfbR,4817662,4817724,4817662,62,28,utRho25
1976,yfcI,4847424,4847424,4847078,346,266,utRho25
1977,yfcJ,4880482,4880482,4880240,242,0,utRho25
1978,yfcL,4888502,4888502,4888338,164,24,utRho25
1979,yfcV,4911642,4911642,4911292,350,72,utRho25
1980,yfcZ,4921958,4921958,4921868,90,26,utRho25
1981,yfdF,4925604,4926024,4925604,420,120,utRho25
1982,yfdG,4935474,4935710,4935474,236,0,utRho25
1983,yfdP,4946844,4947040,4946844,196,36,utRho25
1984,yfdX,4988866,4988866,4988804,62,108,utRho25
1985,yfdY,4990672,4990672,4990584,88,40,utRho25
1986,yfeA,5035784,5035784,5035664,120,542,utRho25
1987,yfeC,5036668,5036934,5036668,266,2,utRho25
1988,yfeH,5053818,5053892,5053818,74,0,utRho25
1989,yfeK,5074630,5074684,5074630,54,16,utRho25
1990,yfeO,5018906,5019260,5018906,354,10,utRho25
1991,yfeR,5054078,5054078,5053712,366,0,utRho25
1992,yfeX,5101356,5101356,5101090,266,2,utRho25
1993,yfeY,5102486,5102486,5102432,54,0,utRho25
1994,yfeZ,5103842,5103842,5103452,390,94,utRho25
1995,yffO,5123804,5124222,5123804,418,408,utRho25
1996,yffQ,5126778,5127154,5126778,376,152,utRho25
1997,yffS,5128800,5128986,5128800,186,90,utRho25
1998,yfgC,5232052,5232188,5232052,136,0,utRho25
1999,yfgF,5258062,5258062,5257876,186,402,utRho25
2000,yfgG,5258170,5258580,5258170,410,456,utRho25
2001,yfgH,5259344,5259584,5259344,240,0,utRho25
2002,yfgM,5278866,5278866,5278566,300,212,utRho25
2003,yfhH,5397414,5397518,5397414,104,4,utRho25
2004,yfhM,5304648,5304648,5304574,74,0,utRho25
2005,yfhR,5328408,5328726,5328408,318,30,utRho25
2006,yfiC,5425610,5425610,5425528,82,0,utRho25
2007,yfiE,5430688,5430688,5430640,48,112,utRho25
2008,yfiL,5482630,5482720,5482630,90,0,utRho25
2009,yfiM,5448066,5448358,5448066,292,1646,utRho25
2010,yfiR,5483354,5483750,5483354,396,52,utRho25
2011,yfjH,5517326,5517326,5517200,126,0,utRho25
2012,yfjI,5517710,5517970,5517710,260,0,utRho25
2013,yfjJ,5521014,5521094,5521014,80,0,utRho25
2014,yfjM,5531970,5531970,5531552,418,718,utRho25
2015,yfjP,5535080,5535420,5535080,340,588,utRho25
2016,yfjW,5546570,5546636,5546570,66,0,utRho25
2017,yfjX,5551776,5551838,5551776,62,0,utRho25
2018,ygaC,5601180,5601180,5599988,1192,9342,utRho25
2019,ygaM,5600242,5600292,5600242,50,2888,utRho25
2020,ygaU,5593628,5593628,5593572,56,60,utRho25
2021,ygaZ,5619190,5619234,5619190,44,0,utRho25
2022,ygbA,5713656,5713656,5713612,44,36,utRho25
2023,ygbE,5746784,5746784,5746674,110,68,utRho25
2024,ygbI,5722882,5722882,5722528,354,0,utRho25
2025,ygbK,5724394,5724670,5724394,276,424,utRho25
2026,ygbL,5727074,5727186,5727074,112,14,utRho25
2027,ygbN,5729814,5730202,5729814,388,642,utRho25
2028,ygcG,5811210,5811422,5811210,212,80,utRho25
2029,ygcN,5785144,5785314,5785144,170,170,utRho25
2030,ygcU,5799214,5799214,5798836,378,116,utRho25
2031,ygcW,5800942,5800942,5800546,396,8,utRho25
2032,ygdD,5883442,5883442,5883262,180,252,utRho25
2033,ygdG,5861746,5861930,5861746,184,316,utRho25
2034,ygdI,5886526,5886526,5886290,236,2,utRho25
2035,ygdQ,5940784,5940840,5940784,56,4,utRho25
2036,ygdR,5942494,5942542,5942494,48,128,utRho25
2037,ygeA,5961606,5961606,5961270,336,0,utRho25
2038,ygeH,5983758,5984188,5983758,430,6,utRho25
2039,ygeI,5987162,5987276,5987162,114,108,utRho25
2040,ygeR,6000078,6000078,5999782,296,432,utRho25
2041,ygeV,6011694,6011694,6011572,122,0,utRho25
2042,ygeW,6012234,6012524,6012234,290,688,utRho25
2043,ygfB,6110946,6110946,6110888,58,0,utRho25
2044,ygfK,6031984,6032120,6031984,136,50,utRho25
2045,ygfS,6058328,6058328,6058024,304,100,utRho25
2046,ygfZ,6082564,6082626,6082564,62,122,utRho25
2047,yggC,6149512,6149512,6149378,134,2,utRho25
2048,yggE,6136370,6136370,6136160,210,12,utRho25
2049,yggI,6179176,6179510,6179176,334,100,utRho25
2050,yggL,6204508,6204508,6204266,242,20,utRho25
2051,yggM,6199514,6199514,6199130,384,152,utRho25
2052,yggN,6203596,6203596,6203246,350,124,utRho25
2053,yggX,18623958,18624558,18623958,600,264,utRho25
2054,yghA,6298966,6299324,6298966,358,78,utRho25
2055,yghB,6307058,6307126,6307058,68,46,utRho25
2056,yghD,6222614,6222614,6222252,362,240,utRho25
2057,yghF,6225798,6225798,6225840,42,0,utRho25
2058,yghJ,6238640,6238640,6238224,416,14,utRho25
2059,yghQ,6265186,6265186,6264816,370,332,utRho25
2060,yghT,6267830,6268262,6267830,432,128,utRho25
2061,yghU,6277400,6277454,6277400,54,32,utRho25
2062,yghW,6293506,6293506,6293474,32,60,utRho25
2063,yghZ,6295562,6295794,6295562,232,0,utRho25
2064,ygiD,6365122,6365122,6364868,254,48,utRho25
2065,ygiH,6409066,6409388,6409066,322,84,utRho25
2066,ygiL,6370622,6370828,6370622,206,0,utRho25
2067,ygiM,6402084,6402414,6402084,330,786,utRho25
2068,ygiN,6346156,6346284,6346156,128,630,utRho25
2069,ygiQ,6322620,6322620,6322292,328,46,utRho25
2070,ygiS,6335462,6335462,6335436,26,0,utRho25
2071,ygiV,6338582,6338582,6338462,120,26,utRho25
2072,ygiW,6339774,6339774,6339352,422,150,utRho25
2073,ygiZ,6344506,6344506,6344422,84,76,utRho25
2074,ygjH,6442528,6442528,6442494,34,0,utRho25
2075,ygjI,6452140,6452468,6452140,328,0,utRho25
2076,ygjQ,6472730,6473080,6472730,350,184,utRho25
2077,ygjR,6474564,6474586,6474564,22,0,utRho25
2078,ygjV,6483638,6483638,6483488,150,0,utRho25
2079,yhaB,6535632,6535708,6535632,76,0,utRho25
2080,yhaH,6504498,6504608,6504498,110,456,utRho25
2081,yhaI,6505400,6505822,6505400,422,150,utRho25
2082,yhaJ,6508560,6508560,6508428,132,4,utRho25
2083,yhaK,6508538,6508638,6508538,100,10,utRho25
2084,yhbQ,6599878,6599932,6599878,54,0,utRho25
2085,yhbT,6602736,6602736,6602552,184,0,utRho25
2086,yhbU,6602558,6602970,6602558,412,12,utRho25
2087,yhbX,6643302,6643302,6643226,76,62,utRho25
2088,yhbY,6655518,6655580,6655518,62,222,utRho25
2089,yhcA,6723956,6724224,6723956,268,8,utRho25
2090,yhcB,6760364,6760382,6760364,18,0,utRho25
2091,yhcC,6708470,6708470,6708100,370,4,utRho25
2092,yhcF,6733440,6733852,6733440,412,112,utRho25
2093,yhcH,6739124,6739124,6738956,168,240,utRho25
2094,yhcM,6760312,6760312,6759994,318,52,utRho25
2095,yhcN,6770812,6771076,6770812,264,210,utRho25
2096,yhcO,6772606,6772606,6772258,348,34,utRho25
2097,yhdH,6806560,6806968,6806560,408,444,utRho25
2098,yhdJ,6823234,6823306,6823234,72,0,utRho25
2099,yhdN,6879092,6879092,6879018,74,726,utRho25
2100,yhdT,6814702,6814750,6814702,48,6,utRho25
2101,yhdU,6824994,6825242,6824994,248,168,utRho25
2102,yhdV,6836392,6836780,6836392,388,28,utRho25
2103,yhdW,6837944,6838298,6837944,354,64,utRho25
2104,yheO,6953082,6953082,6952880,202,2,utRho25
2105,yheV,6957970,6957970,6957584,386,100,utRho25
2106,yhfA,6971902,6971902,6971636,266,192,utRho25
2107,yhfG,6983294,6983294,6983240,54,0,utRho25
2108,yhfL,6998622,6998896,6998622,274,252,utRho25
2109,yhfY,7023244,7023244,7022844,400,0,utRho25
2110,yhgA,7086294,7086334,7086294,40,0,utRho25
2111,yhgE,7065176,7065176,7064878,298,48,utRho25
2112,yhgF,7074352,7074770,7074352,418,982,utRho25
2113,yhhA,7173458,7173886,7173458,428,26,utRho25
2114,yhhI,7248346,7248756,7248346,410,0,utRho25
2115,yhhJ,7253696,7253696,7253606,90,2,utRho25
2116,yhhM,7211588,7211588,7211220,368,38,utRho25
2117,yhhN,7211150,7211502,7211150,352,18,utRho25
2118,yhhQ,7218238,7218434,7218238,196,218,utRho25
2119,yhhT,7223682,7223730,7223682,48,0,utRho25
2120,yhhX,7162032,7162032,7161610,422,4,utRho25
2121,yhhY,7162222,7162276,7162222,54,0,utRho25
2122,yhhZ,7163516,7163726,7163516,210,170,utRho25
2123,yhiD,7312220,7312220,7311804,416,3922,utRho25
2124,yhiJ,7265190,7265190,7265180,10,64,utRho25
2125,yhiM,7269270,7269682,7269270,412,1588,utRho25
2126,yhiN,7275000,7275000,7274820,180,120,utRho25
2127,yhjA,7338522,7338522,7338376,146,74,utRho25
2128,yhjB,7344090,7344090,7343788,302,246,utRho25
2129,yhjC,7344272,7344684,7344272,412,174,utRho25
2130,yhjD,7346660,7346724,7346660,64,42,utRho25
2131,yhjE,7349274,7349572,7349274,298,404,utRho25
2132,yhjG,7356824,7356824,7356730,94,20,utRho25
2133,yhjH,7358458,7358458,7358374,84,90,utRho25
2134,yhjJ,7364032,7364032,7363880,152,108,utRho25
2135,yhjK,7371296,7371296,7371158,138,170,utRho25
2136,yhjR,7392750,7392750,7392370,380,0,utRho25
2137,yhjV,7400796,7401126,7400796,330,72,utRho25
2138,yhjX,7424194,7424194,7424014,180,32,utRho25
2139,yhjY,7425966,7425966,7425868,98,0,utRho25
2140,yiaB,7455654,7455654,7455496,158,104,utRho25
2141,yiaD,7432712,7433094,7432712,382,116,utRho25
2142,yiaF,7438194,7438194,7438088,106,80,utRho25
2143,yiaG,7438862,7438956,7438862,94,52,utRho25
2144,yiaJ,7485236,7485236,7485064,172,72,utRho25
2145,yiaK,7485348,7485466,7485348,118,88,utRho25
2146,yiaT,7503924,7503924,7503736,188,0,utRho25
2147,yiaU,7503792,7503984,7503792,192,0,utRho25
2148,yiaY,7515856,7515856,7515654,202,122,utRho25
2149,yibF,7523950,7523950,7523910,40,0,utRho25
2150,yibG,7536128,7536354,7536128,226,676,utRho25
2151,yibL,7553194,7553330,7553194,136,92,utRho25
2152,yibN,7570112,7570112,7570030,82,280,utRho25
2153,yibT,7552848,7552848,7552760,88,392,utRho25
2154,yicC,7633290,7633352,7633290,62,0,utRho25
2155,yicH,7660862,7660914,7660862,52,0,utRho25
2156,yicJ,7673328,7673328,7671858,1470,5056,utRho25
2157,yicN,7685018,7685018,7684804,214,28,utRho25
2158,yicO,7687914,7687914,7687578,336,20,utRho25
2159,yicR,15250308,15250308,15250236,72,0,utRho25
2160,yidB,7755230,7755230,7754930,300,262,utRho25
2161,yidE,7732780,7732780,7732546,234,0,utRho25
2162,yidF,7711580,7711580,7711222,358,0,utRho25
2163,yidQ,7735088,7735456,7735088,368,794,utRho25
2164,yidR,7738824,7738824,7738618,206,144,utRho25
2165,yieE,7787658,7787738,7787658,80,330,utRho25
2166,yieH,7793314,7793548,7793314,234,0,utRho25
2167,yieK,7798928,7798928,7798786,142,0,utRho25
2168,yifB,7900350,7900350,7899998,352,198,utRho25
2169,yifL,7988984,7989044,7988984,60,140,utRho25
2170,yigF,8005750,8005750,8005598,152,1068,utRho25
2171,yigI,8009448,8009448,8009394,54,114,utRho25
2172,yigM,8022100,8022152,8022100,52,302,utRho25
2173,yihA,8101970,8101970,8101458,512,0,utRho25
2174,yihD,8084098,8084138,8084098,40,0,utRho25
2175,yihF,8088110,8088398,8088110,288,132,utRho25
2176,yihG,8093304,8093304,8093204,100,0,utRho25
2177,yihI,8102616,8102694,8102616,78,0,utRho25
2178,yihL,8120506,8120894,8120506,388,138,utRho25
2179,yihN,8124332,8124494,8124332,162,330,utRho25
2180,yihO,8131942,8131942,8131532,410,118,utRho25
2181,yihQ,8138892,8138892,8138552,340,2,utRho25
2182,yihV,8147064,8147478,8147064,414,52,utRho25
2183,yihX,8151096,8151106,8151096,10,28,utRho25
2184,yiiE,8158192,8158582,8158192,390,212,utRho25
2185,yiiF,8159124,8159502,8159124,378,4,utRho25
2186,yiiG,8173762,8174004,8173762,242,0,utRho25
2187,yiiM,8205506,8205644,8205506,138,58,utRho25
2188,yiiQ,8224624,8224624,8224428,196,0,utRho25
2189,yiiS,8225738,8225934,8225738,196,0,utRho25
2190,yijE,8272178,8272216,8272178,38,0,utRho25
2191,yijF,8275728,8275728,8275314,414,610,utRho25
2192,yijO,8296858,8296858,8296634,224,2,utRho25
2193,yjaA,8426240,8426468,8426240,228,100260,utRho25
2194,yjaB,8428312,8428312,8428246,66,0,utRho25
2195,yjaG,8398746,8399008,8398746,262,220,utRho25
2196,yjaH,8401022,8401132,8401022,110,338,utRho25
2197,yjaZ,8379506,8379572,8379506,66,0,utRho25
2198,yjbB,8455204,8455462,8455204,258,22,utRho25
2199,yjbE,16943432,16943624,16943432,192,36,utRho25
2200,yjbL,8520318,8520642,8520318,324,70,utRho25
2201,yjbQ,8540428,8540476,8540428,48,78,utRho25
2202,yjcB,8550328,8550328,8550082,246,538,utRho25
2203,yjcC,8550836,8550942,8550836,106,58,utRho25
2204,yjcD,8556628,8556958,8556628,330,48,utRho25
2205,yjcE,8559658,8559960,8559658,302,76,utRho25
2206,yjcF,8566212,8566212,8566150,62,0,utRho25
2207,yjcO,8594660,8594660,8594250,410,44,utRho25
2208,yjdA,8654128,8654270,8654128,142,0,utRho25
2209,yjdC,8726660,8726660,8726616,44,36,utRho25
2210,yjdK,8704780,8705168,8704780,388,1280,utRho25
2211,yjdL,8713034,8713034,8712822,212,24,utRho25
2212,yjdM,8653672,8653672,8653468,204,1340,utRho25
2213,yjeF,8787354,8788132,8787354,778,754,utRho25
2214,yjeI,8745522,8745618,8745522,96,130,utRho25
2215,yjeJ,8748806,8748806,8748468,338,408,utRho25
2216,yjeV,8785472,8785784,8785472,312,10,utRho25
2217,yjfP,8833512,8833904,8833512,392,0,utRho25
2218,yjfY,8849656,8849656,8849582,74,152,utRho25
2219,yjfZ,8855052,8855052,8854844,208,70,utRho25
2220,yjgA,8916162,8916162,8915730,432,2,utRho25
2221,yjgL,8950802,8950874,8950802,72,28,utRho25
2222,yjgM,8959342,8959342,8959074,268,0,utRho25
2223,yjgN,8959132,8959460,8959132,328,66,utRho25
2224,yjgR,8980170,8980170,8980126,44,48,utRho25
2225,yjgZ,9002116,9002520,9002116,404,656,utRho25
2226,yjhB,9007764,9008116,9007764,352,66,utRho25
2227,yjhG,9048452,9048452,9048188,264,528,utRho25
2228,yjhU,9041080,9041080,9040648,432,604,utRho25
2229,yjiA,9178096,9178096,9177730,366,22,utRho25
2230,yjiJ,9125364,9125364,9125350,14,128,utRho25
2231,yjiK,9127270,9127270,9127422,152,84,utRho25
2232,yjiL,9129604,9129604,9129378,226,60,utRho25
2233,yjiS,9143410,9143502,9143410,92,0,utRho25
2234,yjiY,9182734,9182734,9182558,176,70,utRho25
2235,yjjA,9200674,9200674,9200378,296,98,utRho25
2236,yjjB,18408708,18408708,18407800,908,600,utRho25
2237,yjjJ,9243314,9243538,9243314,224,0,utRho25
2238,yjjK,9261132,9261132,9261044,88,0,utRho25
2239,yjjL,9189764,9189764,9189444,320,0,utRho25
2240,yjjM,9191894,9191894,9191702,192,200,utRho25
2241,yjjP,9206068,9206068,9205716,352,110,utRho25
2242,yjjQ,9206638,9206954,9206638,316,266,utRho25
2243,yjjX,9267798,9267798,9267490,308,64,utRho25
2244,yjjY,9280716,9280804,9280716,88,188,utRho25
2245,yjjZ,9211554,9211608,9211554,54,46,utRho25
2246,yjtD,9281676,9281884,9281676,208,612,utRho25
2247,ykfB,532454,532454,532174,280,54,utRho25
2248,ykfI,527636,527636,527338,298,638,utRho25
2249,ykgB,637050,637050,636638,412,60,utRho25
2250,ykgC,640430,640430,640002,428,0,utRho25
2251,ykgD,640232,640454,640232,222,0,utRho25
2252,ykgE,642962,643216,642962,254,382,utRho25
2253,ykgJ,608524,608524,608364,160,124,utRho25
2254,ykgL,623878,624224,623878,346,94,utRho25
2255,ykgM,625610,625610,625554,56,2,utRho25
2256,ykgR,626570,626570,626484,86,0,utRho25
2257,ylaC,958576,958576,958502,74,462,utRho25
2258,yliE,1745938,1745958,1745938,20,0,utRho25
2259,ymcE,2103660,2103694,2103660,34,0,utRho25
2260,ymdA,2210450,2210828,2210450,378,98,utRho25
2261,ymdB,2211428,2211640,2211428,212,0,utRho25
2262,ymfD,2395322,2395322,2395064,258,128,utRho25
2263,ymfI,2402880,2402994,2402880,114,0,utRho25
2264,ymfJ,2404518,2404518,2404168,350,2,utRho25
2265,ymfK,2406176,2406176,2405866,310,0,utRho25
2266,ymfT,2405766,2406048,2405766,282,0,utRho25
2267,ymgE,2489110,2489456,2489110,346,142,utRho25
2268,ymgF,2437628,2437966,2437628,338,292,utRho25
2269,ymiA,2670112,2670320,2670112,208,64,utRho25
2270,ymjA,2715620,2715620,2715336,284,0,utRho25
2271,ynaI,2791946,2791946,2791844,102,86,utRho25
2272,ynaK,2850438,2850754,2850438,316,50,utRho25
2273,ynbA,2954924,2955242,2954924,318,128,utRho25
2274,yncD,3046552,3046552,3046130,422,0,utRho25
2275,yncE,3046454,3046614,3046454,160,0,utRho25
2276,yncG,3052456,3052494,3052456,38,4,utRho25
2277,yncL,3034492,3034492,3034388,104,110,utRho25
2278,yneE,3218364,3218364,3218044,320,0,utRho25
2279,yneF,3223748,3223748,3223708,40,22,utRho25
2280,yneJ,3229560,3229608,3229560,48,56,utRho25
2281,yneK,3231100,3231526,3231100,426,16,utRho25
2282,yneM,3245176,3245292,3245176,116,106,utRho25
2283,ynfA,3311398,3311398,3311346,52,0,utRho25
2284,ynfB,3311418,3311616,3311418,198,60,utRho25
2285,ynfC,3315094,3315094,3314914,180,0,utRho25
2286,ynfD,3314828,3315130,3314828,302,0,utRho25
2287,ynfE,3316006,3316138,3316006,132,0,utRho25
2288,ynfK,3334670,3334670,3334438,232,44,utRho25
2289,ynfL,3339304,3339304,3339184,120,24,utRho25
2290,ynfM,3339260,3339398,3339260,138,24,utRho25
2291,ynfN,3276598,3276598,3276218,380,60,utRho25
2292,ynfO,3273454,3273512,3273454,58,0,utRho25
2293,ynhG,3517890,3517890,3517450,440,112,utRho25
2294,yniA,3615158,3615592,3615158,434,8,utRho25
2295,yniB,3618526,3618526,3618466,60,6,utRho25
2296,yniC,3618652,3618760,3618652,108,0,utRho25
2297,yniD,3610202,3610330,3610202,128,24,utRho25
2298,ynjE,3678880,3678934,3678880,54,0,utRho25
2299,ynjF,3683222,3683222,3682806,416,16,utRho25
2300,ynjH,3684376,3684376,3684270,106,74,utRho25
2301,ynjI,3690022,3690022,3689742,280,168,utRho25
2302,yoaB,3786642,3786734,3786642,92,0,utRho25
2303,yoaC,3787932,3788146,3787932,214,56,utRho25
2304,yoaE,3803544,3803544,3803170,374,16,utRho25
2305,yoaF,3755444,3755444,3755064,380,16,utRho25
2306,yoaH,3789866,3789866,3789462,404,216,utRho25
2307,yobB,3850418,3850880,3850418,462,2,utRho25
2308,yobF,3815586,3815586,3815182,404,372,utRho25
2309,yobH,3817800,3817850,3817800,50,102,utRho25
2310,yodB,4084352,4084736,4084352,384,44,utRho25
2311,yodC,4057008,4057008,4056740,268,22,utRho25
2312,yohC,4451358,4451358,4451262,96,44,utRho25
2313,yohD,4451526,4451602,4451526,76,78,utRho25
2314,yohJ,4460986,4461248,4460986,262,432,utRho25
2315,yohO,4431172,4431314,4431172,142,52,utRho25
2316,yojI,4617282,4617282,4617230,52,56,utRho25
2317,ypdI,4988988,4989396,4988988,408,146,utRho25
2318,ypfG,5165786,5165786,5165554,232,18,utRho25
2319,ypfM,5182140,5182140,5181732,408,414,utRho25
2320,yphB,5349590,5349590,5349376,214,2,utRho25
2321,ypjA,5565644,5565644,5565452,192,670,utRho25
2322,ypjB,5569636,5569636,5568858,778,40,utRho25
2323,ypjD,5495860,5495774,5495860,86,32,utRho25
2324,yqaE,5594170,5594170,5594056,114,240,utRho25
2325,yqcA,5846100,5846100,5845968,132,0,utRho25
2326,yqcE,5800944,5801184,5800944,240,0,utRho25
2327,yqeC,6030468,6030468,6030114,354,82,utRho25
2328,yqeF,5971618,5971618,5971184,434,492,utRho25
2329,yqeG,5971438,5971694,5971438,256,742,utRho25
2330,yqeH,5975016,5975072,5975016,56,258,utRho25
2331,yqeI,5976688,5977004,5976688,316,94,utRho25
2332,yqeK,5981140,5981140,5980720,420,368,utRho25
2333,yqfA,6086728,6086728,6086296,432,112,utRho25
2334,yqgA,6219042,6219106,6219042,64,20,utRho25
2335,yqgB,6172500,6172500,6172102,398,572,utRho25
2336,yqgE,6185768,6185874,6185768,106,0,utRho25
2337,yqhA,6299150,6299150,6298942,208,46,utRho25
2338,yqhC,6310768,6310768,6310436,332,100,utRho25
2339,yqhD,6310604,6310710,6310604,106,44,utRho25
2340,yqhH,6316842,6317254,6316842,412,44,utRho25
2341,yqiC,6369662,6369680,6369662,18,8,utRho25
2342,yqiJ,6384108,6384416,6384108,308,256,utRho25
2343,yqjA,6495096,6495546,6495096,450,50,utRho25
2344,yqjF,6500932,6501124,6500932,192,664,utRho25
2345,yqjG,6501948,6502048,6501948,100,0,utRho25
2346,yqjH,6433078,6433078,6432982,96,0,utRho25
2347,yqjI,6433506,6433558,6433506,52,0,utRho25
2348,yraH,6574552,6574852,6574552,300,18,utRho25
2349,yraP,6592144,6592818,6592144,674,62,utRho25
2350,yraQ,6596414,6596414,6596276,138,0,utRho25
2351,yraR,6598024,6598024,6597692,332,48,utRho25
2352,yrbG,13360844,13361100,13360844,256,128,utRho25
2353,yrbL,6696842,6696904,6696842,62,140,utRho25
2354,yrbN,6616172,6616172,6615866,306,194,utRho25
2355,yrdB,6860176,6860176,6860046,130,292,utRho25
2356,yrfF,7052548,7052938,7052548,390,28,utRho25
2357,yrhB,7169440,7169518,7169440,78,0,utRho25
2358,ysaB,7451804,7451804,7451424,380,18,utRho25
2359,ysgA,8032686,8032686,8032338,348,492,utRho25
2360,ytfB,8857638,8857638,8857434,204,160,utRho25
2361,ytfE,8864018,8864018,8863966,52,68,utRho25
2362,ytfF,8866296,8866296,8866130,166,714,utRho25
2363,ytfH,8868164,8868226,8868164,62,62,utRho25
2364,ytfI,8875234,8875414,8875234,180,80,utRho25
2365,ytfJ,8878572,8878572,8878524,48,8,utRho25
2366,ytfK,8879022,8879174,8879022,152,362,utRho25
2367,ytfL,8882642,8882642,8882430,212,0,utRho25
2368,ytfQ,8899634,8899924,8899634,290,144,utRho25
2369,ytjB,9249598,9249598,9249578,20,0,utRho25
2370,yzfA,8896588,8896588,8896490,98,0,utRho25
2371,zapA,6111102,6111224,6111102,122,544,utRho25
2372,zapB,8236772,8237030,8236772,258,94,utRho25
2373,zapC,2011700,2011904,2011700,204,20,utRho25
2374,zinT,4082692,4082750,4082692,58,2,utRho25
2375,zipA,5062814,5062814,5062466,348,0,utRho25
2376,zitB,1569716,1569716,1569646,70,58,utRho25
2377,zntA,7212844,7212902,7212844,58,0,utRho25
2378,zntR,6878336,6878336,6878260,76,62,utRho25
2379,znuA,3885322,3885322,3885166,156,2,utRho25
2380,znuC,3885268,3885324,3885268,56,2,utRho25
2381,zraP,8403424,8403424,8403376,48,0,utRho25
2382,zraS,8403810,8403852,8403810,42,180,utRho25
2383,zupT,6364866,6365100,6364866,234,46,utRho25
2384,zur,8520282,8520282,8520006,276,28,utRho25
2385,zwf,3872752,3872752,3872628,124,0,utRho25
0,C0343,2818676,2818728,2818676,52,0,utRho26
1,aaeB,6776526,6776526,6776376,150,0,utRho26
2,aaeR,6778762,6779040,6778762,278,60,utRho26
3,aaeX,6778860,6778860,6778674,186,118,utRho26
4,aat,1854920,1854920,1854864,56,0,utRho26
5,accA,416822,417242,416822,420,112,utRho26
6,accB,6810280,6810872,6810280,592,912,utRho26
7,accD,4868030,4868030,4867852,178,194,utRho26
8,aceB,8430804,8430956,8430804,152,2,utRho26
9,aceE,245938,246034,245938,96,106,utRho26
10,ackA,4826918,4826940,4826918,22,312,utRho26
11,acnA,2670848,2671662,2670848,814,202,utRho26
12,acnB,263038,263230,263038,192,368,utRho26
13,acpP,2303148,2303230,2303148,82,48,utRho26
14,acpS,5402324,5402324,5401996,328,526,utRho26
15,acrA,971396,971396,971238,158,10,utRho26
16,acrB,969370,969370,968806,564,130,utRho26
17,acrD,5174950,5175190,5174950,240,0,utRho26
18,acrE,6827404,6827728,6827404,324,64,utRho26
19,acrR,971398,971522,971398,124,4,utRho26
20,acrZ,1589502,1589546,1589502,44,0,utRho26
21,acs,8575190,8575190,8574742,448,292,utRho26
22,actP,8569870,8569870,8569804,66,148,utRho26
23,ada,4620854,4620854,4620810,44,0,utRho26
24,add,3404404,3404466,3404404,62,0,utRho26
25,ade,7687802,7687928,7687802,126,0,utRho26
26,adhE,2596826,2596826,2596242,584,0,utRho26
27,adhP,3107988,3107988,3107676,312,476,utRho26
28,adiA,8681112,8681112,8681042,70,42,utRho26
29,adiC,8674404,8674404,8674062,342,2,utRho26
30,adiY,8676084,8676084,8675858,226,32,utRho26
31,adk,994278,994350,994278,72,306,utRho26
32,adrA,807374,807406,807374,32,0,utRho26
33,aer,6438240,6438240,6438152,88,0,utRho26
34,aes,1000102,1000102,999946,156,2,utRho26
35,agaR,6557406,6557406,6557330,76,0,utRho26
36,agaS,6563778,6563952,6563778,174,62,utRho26
37,agp,2131118,2131170,2131118,52,0,utRho26
38,agrA,7296126,7296126,7296126,0,0,utRho26
39,agrB,7296588,7296588,7296588,0,0,utRho26
40,ahpC,1277386,1277890,1277386,504,780,utRho26
41,ahpF,1278004,1279506,1278004,1502,25458,utRho26
42,ahr,8992698,8992698,8992418,280,112,utRho26
43,aidB,8828494,8828550,8828494,56,0,utRho26
44,ais,4731512,4731512,4731240,272,126,utRho26
45,alaA,4814816,4815122,4814816,306,38,utRho26
46,alaC,4996798,4996798,4996590,208,0,utRho26
47,alaE,5598140,5598328,5598140,188,40,utRho26
48,alaS,5644180,5644180,5644022,158,540,utRho26
49,alaW,5036612,5036612,5036462,150,18,utRho26
50,aldA,2976380,2976464,2976380,84,270,utRho26
51,aldB,7513070,7513070,7513022,48,24,utRho26
52,alkA,4295118,4295118,4295080,38,0,utRho26
53,alkB,4618890,4618890,4618682,208,148,utRho26
54,allA,1064780,1064902,1064780,122,0,utRho26
55,allD,1092822,1092822,1092726,96,0,utRho26
56,allE,1088112,1088112,1088092,20,0,utRho26
57,allS,1064600,1064600,1064442,158,0,utRho26
58,alr,8531178,8531564,8531178,386,118,utRho26
59,alsE,8617334,8617334,8616956,378,298,utRho26
60,alsK,8615990,8615990,8615598,392,216,utRho26
61,alx,6476740,6477160,6476740,420,56,utRho26
62,amiA,5104482,5104704,5104482,222,0,utRho26
63,amiC,5898378,5898378,5898020,358,0,utRho26
64,amn,4110062,4110122,4110062,60,0,utRho26
65,ampC,8758006,8758006,8757888,118,0,utRho26
66,ampD,237362,237466,237362,104,0,utRho26
67,ampG,907372,907372,907090,282,180,utRho26
68,ampH,792726,792726,792574,152,0,utRho26
69,amyA,4012230,4012312,4012230,82,0,utRho26
70,anmK,3439346,3439346,3439204,142,36,utRho26
71,ansB,6201580,6201580,6201456,124,58,utRho26
72,ansP,3052040,3052040,3051960,80,0,utRho26
73,apaG,104068,104068,103212,856,350,utRho26
74,apaH,102586,102586,102444,142,136,utRho26
75,apbE,4623188,4623188,4623068,120,0,utRho26
76,appA,2081198,2081234,2081198,36,0,utRho26
77,appC,2075420,2075480,2075420,60,0,utRho26
78,appY,1167134,1167362,1167134,228,0,utRho26
79,apt,982620,982824,982620,204,0,utRho26
80,aqpZ,1832424,1832424,1832094,330,0,utRho26
81,araB,140150,140150,140096,54,0,utRho26
82,araC,140482,140774,140482,292,184,utRho26
83,araE,5964416,5964416,5964364,52,12,utRho26
84,araF,3972476,3972476,3972256,220,0,utRho26
85,araH,3967120,3967120,3967086,34,0,utRho26
86,araJ,825058,825058,824962,96,50,utRho26
87,arcA,9281602,9281602,9280612,990,1608,utRho26
88,arcB,6706098,6706098,6706050,48,86,utRho26
89,arcZ,6701154,6701154,6701154,0,0,utRho26
90,arfA,6877346,6877346,6877298,48,12,utRho26
91,argA,5898312,5898484,5898312,172,0,utRho26
92,argC,8309770,8310002,8309770,232,102,utRho26
93,argD,6980442,6980442,6980360,82,0,utRho26
94,argE,8310156,8310156,8309694,462,388,utRho26
95,argF,580680,580680,580610,70,0,utRho26
96,argG,6637124,6637274,6637124,150,222,utRho26
97,argI,8956688,8956688,8956622,66,34,utRho26
98,argO,6137672,6137672,6137616,56,286,utRho26
99,argP,6119460,6119506,6119460,46,0,utRho26
100,argR,6769204,6769406,6769204,202,0,utRho26
101,argS,3920002,3920124,3920002,122,0,utRho26
102,argT,4855698,4855698,4855582,116,0,utRho26
103,argU,1129406,1129446,1129406,40,36,utRho26
104,argW,4932616,4932618,4932616,2,0,utRho26
105,argX,7964728,7964750,7964728,22,28,utRho26
106,aroF,5482402,5482402,5482300,102,82,utRho26
107,aroG,1571182,1571266,1571182,84,94,utRho26
108,aroH,3576636,3576870,3576636,234,0,utRho26
109,aroK,7038760,7038760,7038128,632,352,utRho26
110,aroL,812560,812810,812560,250,114,utRho26
111,aroP,243342,243342,243102,240,0,utRho26
112,arpA,8445382,8445382,8444974,408,0,utRho26
113,arrS,7316108,7316108,7316108,0,0,utRho26
114,arsR,7297024,7297056,7297024,32,0,utRho26
115,artJ,1801252,1801252,1801150,102,0,utRho26
116,artP,1807686,1807686,1807468,218,4,utRho26
117,ascF,5678858,5679048,5678858,190,0,utRho26
118,ascG,5678574,5678574,5678528,46,0,utRho26
119,aslB,7965562,7965916,7965562,354,122,utRho26
120,asnA,7854258,7854310,7854258,52,182,utRho26
121,asnB,1398444,1398444,1398354,90,86,utRho26
122,asnC,23562186,23562186,23562018,168,0,utRho26
123,asnS,1978088,1978088,1977970,118,1678,utRho26
124,asnT,4089082,4089098,4089082,16,12,utRho26
125,asnU,4119690,4119702,4119690,12,16,utRho26
126,asnV,4124504,4124520,4124504,16,4,utRho26
127,aspA,17473728,17473728,17473308,420,180,utRho26
128,aspC,1971486,1971486,1971418,68,14,utRho26
129,aspS,3901402,3901402,3901044,358,312,utRho26
130,aspT,7893560,7893744,7893560,184,120632,utRho26
131,aspV,473826,473862,473826,36,188,utRho26
132,asr,3342654,3342752,3342654,98,0,utRho26
133,astC,3664088,3664088,3663964,124,16,utRho26
134,astE,3654138,3654138,3653846,292,80,utRho26
135,atoD,4646824,4646894,4646824,70,0,utRho26
136,atpB,7844540,7844540,7844102,438,530,utRho26
137,atpC,7832118,7832118,7831944,174,736,utRho26
138,atpI,7845050,7845050,7844880,170,870,utRho26
139,avtA,7479348,7479410,7479348,62,718,utRho26
140,azoR,2965982,2965982,2965720,262,0,utRho26
141,azuC,3976002,3976002,3975918,84,176,utRho26
142,bacA,6408350,6408350,6408262,88,776,utRho26
143,bamA,394052,395856,394052,1804,566,utRho26
144,bamB,5277950,5277950,5277304,646,392,utRho26
145,bamC,5198028,5198028,5197730,298,848,utRho26
146,bamD,5471922,5472292,5471922,370,444,utRho26
147,bamE,5506972,5507210,5506972,238,962,utRho26
148,basS,8666954,8666954,8666544,410,76,utRho26
149,bax,7474468,7474468,7474354,114,132,utRho26
150,bcp,5200874,5200956,5200874,82,234,utRho26
151,bcsB,7385346,7385346,7385214,132,0,utRho26
152,bcsE,7392644,7392916,7392644,272,2,utRho26
153,bdcA,8948128,8948128,8948106,22,150,utRho26
154,bdcR,8948192,8948248,8948192,56,88,utRho26
155,bdm,3112680,3112680,3112560,120,0,utRho26
156,betA,654522,654522,654494,28,2,utRho26
157,betI,658722,658722,658668,54,0,utRho26
158,betT,658842,658926,658842,84,48,utRho26
159,bfr,6933498,6933498,6933450,48,66,utRho26
160,bglG,23440182,23440182,23439402,780,144,utRho26
161,bglX,4444240,4444240,4443978,262,0,utRho26
162,bhsA,2337962,2338146,2337962,184,56,utRho26
163,bioA,1618584,1618584,1618514,70,0,utRho26
164,bioB,1618604,1618688,1618604,84,0,utRho26
165,bioH,7089716,7089716,7089688,28,92,utRho26
166,bisC,7433026,7433026,7432788,238,216,utRho26
167,blc,8755490,8755490,8755444,46,0,utRho26
168,blr,3409024,3409102,3409024,78,54,utRho26
169,bluF,2431226,2431226,2430950,276,176,utRho26
170,bluR,2428226,2428226,2428118,108,4,utRho26
171,bolA,908698,908944,908698,246,2,utRho26
172,borD,1157842,1157842,1157786,56,92,utRho26
173,brnQ,838976,839182,838976,206,534,utRho26
174,bssR,1756492,1756496,1756492,4,0,utRho26
175,bssS,2242116,2242116,2241910,206,548,utRho26
176,btuB,8326798,8327278,8326798,480,414,utRho26
177,cadB,8720212,8720212,8720062,150,136,utRho26
178,cadC,8723926,8723926,8723868,58,0,utRho26
179,caiE,70998,70998,70742,256,6,utRho26
180,caiF,68436,68600,68436,164,270,utRho26
181,caiT,84074,84074,83862,212,2,utRho26
182,can,285406,285406,285340,66,108,utRho26
183,carA,59102,59302,59102,200,0,utRho26
184,carB,61550,61634,61550,84,110,utRho26
185,cas2,5757830,5757830,5757706,124,0,utRho26
186,casA,5768638,5768638,5768276,362,0,utRho26
187,cbl,4121882,4121882,4121828,54,2,utRho26
188,cbpA,2128074,2128074,2127550,524,68,utRho26
189,cbrA,7738628,7738754,7738628,126,0,utRho26
190,cbrB,7794958,7795012,7794958,54,0,utRho26
191,ccmH,4585242,4585242,4584820,422,0,utRho26
192,cdaR,364894,364926,364894,32,124,utRho26
193,cdd,4463638,4463688,4463638,50,0,utRho26
194,cdh,8219814,8219860,8219814,46,78,utRho26
195,cdsA,391110,391354,391110,244,170,utRho26
196,cedA,3627484,3627484,3627326,158,0,utRho26
197,cfa,3482402,3482826,3482402,424,0,utRho26
198,chaC,2544844,2544972,2544844,128,0,utRho26
199,chbB,3643452,3643452,3643238,214,0,utRho26
200,chbG,3634624,3634624,3634270,354,0,utRho26
201,cheW,3946924,3946924,3946678,246,326,utRho26
202,chiA,6939792,6939792,6939706,86,14,utRho26
203,chiP,1416472,1416668,1416472,196,0,utRho26
204,cho,3646984,3647030,3646984,46,0,utRho26
205,chpS,8896804,8896894,8896804,90,52,utRho26
206,cirA,4493884,4493884,4493538,346,112,utRho26
207,citC,1304078,1304078,1303712,366,508,utRho26
208,citT,1293264,1293264,1293160,104,0,utRho26
209,clcA,350104,350214,350104,110,0,utRho26
210,clpA,1846160,1846528,1846160,368,16,utRho26
211,clpB,5468410,5468410,5468346,64,292,utRho26
212,clpP,913154,913354,913154,200,910,utRho26
213,clpS,1845500,1845826,1845500,326,656,utRho26
214,clpX,914404,914852,914404,448,1236,utRho26
215,clsA,2617346,2617346,2617290,56,0,utRho26
216,clsC,2212584,2212710,2212584,126,104,utRho26
217,cmk,1922330,1922402,1922330,72,112,utRho26
218,cnu,3409522,3409898,3409522,376,864,utRho26
219,coaA,8350214,8350214,8350052,162,0,utRho26
220,cobC,1340092,1340092,1339814,278,172,utRho26
221,cobT,4129202,4129202,4128934,268,0,utRho26
222,cobU,4131944,4131944,4131528,416,62,utRho26
223,codB,709768,709844,709768,76,90,utRho26
224,comR,2337726,2337726,2337664,62,0,utRho26
225,copA,1022822,1022822,1022758,64,0,utRho26
226,corA,8002388,8002852,8002388,464,32066,utRho26
227,cpdB,8873258,8873258,8873130,128,0,utRho26
228,cptB,6082198,6082198,6082140,58,0,utRho26
229,cpxA,8210202,8210202,8209950,252,4,utRho26
230,cpxP,8211570,8211640,8211570,70,200,utRho26
231,cpxR,8211372,8211372,8211340,32,0,utRho26
232,cra,175894,176056,175894,162,0,utRho26
233,crcB,1316016,1316016,1315876,140,0,utRho26
234,creA,9270486,9271042,9270486,556,0,utRho26
235,creD,9276320,9276356,9276320,36,0,utRho26
236,crl,515620,515658,515620,38,202,utRho26
237,crp,6971906,6972240,6971906,334,14,utRho26
238,crr,5070960,5071668,5070960,708,1158,utRho26
239,csdA,5886414,5886674,5886414,260,0,utRho26
240,csgB,2207718,2207902,2207718,184,0,utRho26
241,csgD,2206688,2206688,2206392,296,76,utRho26
242,csgG,2203510,2203510,2203368,142,122,utRho26
243,csiD,5577854,5577970,5577854,116,0,utRho26
244,csiE,5330802,5330870,5330802,68,0,utRho26
245,csiR,5590942,5591348,5590942,406,54,utRho26
246,cspA,7439778,7440098,7439778,320,872,utRho26
247,cspB,3283430,3283430,3283108,322,0,utRho26
248,cspC,3815018,3815018,3814870,148,30,utRho26
249,cspD,1845352,1845352,1845180,172,5016,utRho26
250,cspE,1314294,1314584,1314294,290,382,utRho26
251,cspF,3283380,3283710,3283380,330,76,utRho26
252,cspG,2102610,2102922,2102610,312,184,utRho26
253,cspH,2102746,2102746,2102350,396,2,utRho26
254,cspI,3277624,3277624,3277334,290,56,utRho26
255,csrA,5638746,5638746,5638292,454,470,utRho26
256,csrB,5849048,5849048,5849048,0,0,utRho26
257,csrC,8102072,8102072,8102072,0,0,utRho26
258,csrD,6806850,6806850,6806664,186,212,utRho26
259,cstA,1259710,1259788,1259710,78,0,utRho26
260,cueO,274090,274166,274090,76,0,utRho26
261,cueR,1027948,1027986,1027948,38,0,utRho26
262,curA,3037784,3038054,3037784,270,84,utRho26
263,cusC,1191146,1191200,1191146,54,0,utRho26
264,cusR,1190924,1190924,1190886,38,0,utRho26
265,cutA,8730784,8730784,8730712,72,0,utRho26
266,cutC,3918534,3918534,3917920,614,0,utRho26
267,cvpA,4861600,4861600,4861526,74,0,utRho26
268,cvrA,2484328,2484328,2484142,186,0,utRho26
269,cyaA,7981548,7982306,7981548,758,156,utRho26
270,cyaR,4334228,4334224,4334228,4,18,utRho26
271,cyaY,7988166,7988166,7988118,48,130,utRho26
272,cybB,2981522,2981804,2981522,282,0,utRho26
273,cycA,8859560,8859728,8859560,168,2,utRho26
274,cydA,1542340,1542916,1542340,576,2310,utRho26
275,cydC,1858800,1858800,1858390,410,0,utRho26
276,cydD,1862062,1862062,1861924,138,0,utRho26
277,cydX,1548300,1548392,1548300,92,348,utRho26
278,cynR,717418,717418,717380,38,0,utRho26
279,cynT,1435092,1435196,1435092,104,0,utRho26
280,cyoA,903306,903306,903220,86,70,utRho26
281,cyoE,895540,895540,895410,130,140,utRho26
282,cysB,2667576,2667710,2667576,134,334,utRho26
283,cysC,5748056,5748056,5747984,72,0,utRho26
284,cysD,5752736,5752736,5752658,78,4,utRho26
285,cysE,7565362,7565362,7565124,238,622,utRho26
286,cysG,6995508,6995656,6995508,148,652,utRho26
287,cysJ,5783928,5783928,5783796,132,676,utRho26
288,cysK,5064688,5064818,5064688,130,0,utRho26
289,cysP,5087114,5087114,5087056,58,2,utRho26
290,cysS,1109154,1109222,1109154,68,0,utRho26
291,cysT,3984100,3984100,3983974,126,122,utRho26
292,cysZ,5062766,5062926,5062766,160,322,utRho26
293,cytR,8249018,8249018,8248912,106,84,utRho26
294,dacA,1328002,1328002,1327926,76,0,utRho26
295,dacB,6657714,6657926,6657714,212,0,utRho26
296,dacC,1761306,1761454,1761306,148,192,utRho26
297,dadA,2475018,2475142,2475018,124,0,utRho26
298,dam,7032504,7032504,7031826,678,352,utRho26
299,damX,7035200,7035200,7034612,588,1218,utRho26
300,dapA,5199568,5199568,5199520,48,0,utRho26
301,dapB,56576,56748,56576,172,82,utRho26
302,dapD,371954,371954,371894,60,0,utRho26
303,dapE,5183120,5183214,5183120,94,202,utRho26
304,dcp,3254844,3254844,3254760,84,58,utRho26
305,dcrB,7219534,7219910,7219534,376,94,utRho26
306,dctA,7366996,7366996,7366894,102,126,utRho26
307,dcuA,8733686,8733686,8733546,140,140,utRho26
308,dcuB,8698182,8698182,8697488,694,592,utRho26
309,dcuC,1312166,1312166,1311936,230,930,utRho26
310,dcuD,6749166,6749738,6749166,572,158,utRho26
311,dcuR,8701130,8701130,8700068,1062,178,utRho26
312,dcuS,8703370,8703370,8703324,46,56,utRho26
313,dcyD,3999016,3999016,3998960,56,0,utRho26
314,ddpX,3126498,3126498,3126152,346,2,utRho26
315,deaD,6615818,6615818,6615720,98,124,utRho26
316,dedA,4869880,4869880,4869482,398,620,utRho26
317,dedD,4863750,4863750,4863368,382,0,utRho26
318,def,6867300,6867380,6867300,80,0,utRho26
319,degP,361690,361768,361690,78,0,utRho26
320,degQ,6761308,6761486,6761308,178,164,utRho26
321,deoB,9239134,9239206,9239134,72,94,utRho26
322,deoC,9233358,9234646,9233358,1288,352,utRho26
323,dfp,7625406,7625462,7625406,56,0,utRho26
324,dgcZ,3247758,3247758,3247700,58,0,utRho26
325,dgkA,8512914,8513274,8512914,360,528,utRho26
326,dgt,358392,358474,358392,82,66,utRho26
327,dhaK,2501888,2501888,2501676,212,270,utRho26
328,dhaR,2502006,2502132,2502006,126,258,utRho26
329,dicB,3299194,3299218,3299194,24,0,utRho26
330,dicC,3295752,3295752,3295700,52,0,utRho26
331,dinB,501760,501796,501760,36,0,utRho26
332,dinD,7635398,7635520,7635398,122,0,utRho26
333,dinG,1666146,1666140,1666146,6,0,utRho26
334,dinI,2243018,2243018,2242974,44,114,utRho26
335,dinJ,493230,493230,493004,226,0,utRho26
336,dinQ,7295964,7295964,7295576,388,144,utRho26
337,djlA,114536,114728,114536,192,0,utRho26
338,dkgA,6313142,6313246,6313142,104,0,utRho26
339,dkgB,458196,458334,458196,138,0,utRho26
340,dksA,321502,321502,321208,294,750,utRho26
341,dld,4444164,4444370,4444164,206,50,utRho26
342,dmlA,3763424,3763824,3763424,400,364,utRho26
343,dmlR,3763710,3763710,3763618,92,180,utRho26
344,dmsA,1881646,1881918,1881646,272,0,utRho26
345,dnaA,7767922,7767922,7767458,464,264,utRho26
346,dnaB,8528566,8528628,8528566,62,22,utRho26
347,dnaK,24096,24326,24096,230,6722,utRho26
348,dnaN,7765466,7765466,7764642,824,16,utRho26
349,dnaQ,471868,472134,471868,266,1588,utRho26
350,dnaT,18406460,18406460,18406068,392,12,utRho26
351,dnaX,984112,984184,984112,72,54,utRho26
352,dosP,3131486,3131486,3131466,20,0,utRho26
353,dpiB,1303968,1304470,1303968,502,110,utRho26
354,dppA,7415740,7415740,7415410,330,574,utRho26
355,dps,1697900,1697900,1697822,78,0,utRho26
356,dsbA,8086754,8086836,8086754,82,212,utRho26
357,dsbB,2466294,2466294,2466060,234,2,utRho26
358,dsbC,6079266,6079266,6077644,1622,532,utRho26
359,dsbG,1277600,1277600,1277146,454,256,utRho26
360,dsdA,4958242,4958404,4958242,162,132,utRho26
361,dsdC,4955492,4955492,4955258,234,38,utRho26
362,dsdX,4955642,4955694,4955642,52,196,utRho26
363,dsrA,4050626,4050626,4050626,0,0,utRho26
364,dsrB,4049686,4049686,4049646,40,2,utRho26
365,dtpD,1485340,1485340,1485112,228,0,utRho26
366,dusA,8523200,8523338,8523200,138,1542,utRho26
367,dusB,6820492,6820560,6820492,68,0,utRho26
368,dusC,4460790,4460790,4460770,20,0,utRho26
369,dut,7627704,7627864,7627704,160,766,utRho26
370,dxr,386670,387042,386670,372,284,utRho26
371,ebgA,6445102,6445266,6445102,164,0,utRho26
372,ebgR,6442874,6442932,6442874,58,0,utRho26
373,ecnB,8753018,8753106,8753018,88,0,utRho26
374,eco,4607594,4607810,4607594,216,144,utRho26
375,ecpA,621594,621594,621342,252,0,utRho26
376,ecpB,620238,620238,620052,186,0,utRho26
377,ecpR,622964,622964,622672,292,2,utRho26
378,eda,3866218,3866218,3865512,706,60,utRho26
379,edd,3869426,3869426,3869208,218,0,utRho26
380,efeO,2164308,2164486,2164308,178,0,utRho26
381,efeU_1,2162614,2162712,2162614,98,220,utRho26
382,efp,8751134,8751398,8751134,264,438,utRho26
383,elaA,4763372,4763372,4763086,286,0,utRho26
384,elaD,4765308,4765426,4765308,118,40,utRho26
385,elfA,1995530,1995736,1995530,206,0,utRho26
386,elfD,1996642,1996980,1996642,338,0,utRho26
387,emrD,7707690,7707844,7707690,154,20,utRho26
388,emrK,4966896,4966896,4966678,218,120,utRho26
389,emrY,4964668,4964668,4964352,316,188,utRho26
390,emtA,2486250,2486360,2486250,110,0,utRho26
391,endA,12361100,12361388,12361100,288,0,utRho26
392,eno,5817692,5817692,5815882,1810,826,utRho26
393,entC,1249662,1249770,1249662,108,0,utRho26
394,entD,1220508,1220508,1220158,350,12,utRho26
395,entH,1258584,1258600,1258584,16,0,utRho26
396,entS,1244506,1244600,1244506,94,0,utRho26
397,envR,6827266,6827266,6826930,336,0,utRho26
398,epd,12295292,12295292,12294764,528,64,utRho26
399,epmA,8765236,8765286,8765236,50,0,utRho26
400,epmB,8751406,8751406,8751314,92,350,utRho26
401,eptB,7421162,7421162,7420950,212,36,utRho26
402,eptC,8300622,8300622,8300530,92,126,utRho26
403,erfK,4126708,4126708,4126646,62,16,utRho26
404,erpA,353122,353220,353122,98,74,utRho26
405,esrE,8039956,8039956,8039956,0,0,utRho26
406,essD,1153746,1154796,1153746,1050,0,utRho26
407,etk,2088606,2088606,2088420,186,106,utRho26
408,evgA,4967262,4967510,4967262,248,0,utRho26
409,exbB,6304028,6304028,6303968,60,0,utRho26
410,exbD,6302780,6302780,6302486,294,0,utRho26
411,exuR,6493016,6493304,6493016,288,0,utRho26
412,exuT,6490004,6490208,6490004,204,4,utRho26
413,fabA,2032996,2032996,2032940,56,2,utRho26
414,fabB,4883282,4883282,4883210,72,0,utRho26
415,fabH,2297032,2297518,2297032,486,238,utRho26
416,fabI,2702236,2702236,2702078,158,0,utRho26
417,fadB,8062026,8062026,8061942,84,0,utRho26
418,fadD,3779614,3779614,3779492,122,170,utRho26
419,fadE,486812,486812,486606,206,0,utRho26
420,fadH,6463248,6463330,6463248,82,0,utRho26
421,fadI,4921022,4921022,4920938,84,0,utRho26
422,fadL,4922410,4922600,4922410,190,142,utRho26
423,fadM,928720,928804,928720,84,0,utRho26
424,fadR,2469810,2469876,2469810,66,0,utRho26
425,fbaB,4357334,4357334,4357128,206,0,utRho26
426,fdhE,8162722,8162722,8162456,266,302,utRho26
427,fdhF,8598814,8598814,8598732,82,0,utRho26
428,fdnG,3094744,3094802,3094744,58,0,utRho26
429,fdrA,1093012,1093360,1093012,348,0,utRho26
430,feaB,2894994,2895038,2894994,44,0,utRho26
431,feaR,2894734,2894734,2894566,168,0,utRho26
432,fecA,9033454,9033454,9033354,100,36,utRho26
433,fecE,9023288,9023288,9022914,374,1064,utRho26
434,fecI,9036564,9036564,9036470,94,0,utRho26
435,feoA,7080114,7080326,7080114,212,158,utRho26
436,fepA,1225334,1225334,1224988,346,0,utRho26
437,fepB,1249454,1249454,1249020,434,0,utRho26
438,fepD,1244468,1244468,1244378,90,0,utRho26
439,fes,1225374,1225630,1225374,256,0,utRho26
440,ffh,5495706,5495706,5495590,116,418,utRho26
441,ffs,952576,952848,952576,272,176,utRho26
442,fhuA,334884,334968,334884,84,0,utRho26
443,fhuE,2323294,2323294,2323102,192,116,utRho26
444,fhuF,9211504,9211504,9211326,178,116,utRho26
445,fic,6983296,6983296,6982926,370,4,utRho26
446,fieF,8212864,8212938,8212864,74,108,utRho26
447,fimA,9085388,9086230,9085388,842,374,utRho26
448,fimB,9081334,9081914,9081334,580,730,utRho26
449,fimE,9083742,9084074,9083742,332,152,utRho26
450,fimZ,1129214,1129214,1128960,254,0,utRho26
451,fiu,1683296,1683296,1683062,234,0,utRho26
452,fixA,84650,84806,84650,156,16,utRho26
453,fkpA,6955050,6955050,6954838,212,8144,utRho26
454,fldA,2846084,2846084,2845860,224,1180,utRho26
455,fldB,6079644,6079710,6079644,66,0,utRho26
456,flgA,2261770,2261770,2261726,44,104,utRho26
457,flgB,2261986,2262036,2261986,50,102,utRho26
458,flgK,2276702,2276756,2276702,54,4,utRho26
459,flgM,2260330,2260330,2260256,74,2,utRho26
460,flgN,2259828,2259828,2259660,168,0,utRho26
461,flhB,3932432,3932432,3932382,50,154,utRho26
462,flhC,3955864,3955864,3955688,176,0,utRho26
463,flhD,3957154,3957154,3956394,760,610,utRho26
464,fliA,4003638,4003638,4003578,60,0,utRho26
465,fliC,4007352,4007352,4007212,140,80,utRho26
466,fliD,4007634,4007744,4007634,110,0,utRho26
467,fliE,4026186,4026186,4026028,158,4,utRho26
468,fliF,4026292,4026458,4026292,166,112,utRho26
469,fliL,4039168,4039236,4039168,68,16,utRho26
470,flk,4875824,4875900,4875824,76,0,utRho26
471,flu,4142634,4143078,4142634,444,10,utRho26
472,flxA,3292776,3292810,3292776,34,194,utRho26
473,fnr,2799104,2799104,2799052,52,0,utRho26
474,fnrS,2818258,2818258,2818258,0,0,utRho26
475,focA,1909628,1909628,1908932,696,12,utRho26
476,folA,99598,99646,99598,48,0,utRho26
477,folB,6409296,6409296,6409178,118,0,utRho26
478,folD,1115562,1115562,1115482,80,148,utRho26
479,folE,4487696,4487696,4487304,392,260,utRho26
480,fpr,8228998,8228998,8228944,54,0,utRho26
481,frc,4986878,4986878,4986508,370,0,utRho26
482,frdA,8764824,8764824,8764636,188,0,utRho26
483,frdD,8758948,8758948,8758732,216,128,utRho26
484,fre,8052886,8053054,8052886,168,132,utRho26
485,frlA,6999518,6999820,6999518,302,300,utRho26
486,frr,385624,385744,385624,120,260,utRho26
487,frsA,513004,513054,513004,50,0,utRho26
488,fruB,4527194,4527194,4526990,204,0,utRho26
489,frvR,8179804,8179804,8179710,94,114,utRho26
490,fryA,5008986,5008986,5008970,16,0,utRho26
491,fsaA,1727060,1727284,1727060,224,114,utRho26
492,fsr,1009710,1009710,1009392,318,58,utRho26
493,ftnA,3977364,3977432,3977364,68,0,utRho26
494,ftnB,3973550,3973850,3973550,300,0,utRho26
495,ftsA,207122,207964,207122,842,144,utRho26
496,ftsB,5745802,5745802,5745640,162,0,utRho26
497,ftsH,6654204,6654204,6653870,334,1238,utRho26
498,ftsK,1865858,1866448,1865858,590,938,utRho26
499,ftsL,181376,182064,181376,688,10,utRho26
500,ftsP,6325732,6325732,6325338,394,0,utRho26
501,ftsQ,205484,206310,205484,826,606,utRho26
502,ftsX,7204512,7204512,7204172,340,378,utRho26
503,ftsZ,209272,210610,209272,1338,184,utRho26
504,fucA,5867708,5867708,5867376,332,10,utRho26
505,fucP,5868238,5868470,5868238,232,88,utRho26
506,fumA,6753760,6753760,6753508,252,1092,utRho26
507,fumB,8694696,8694696,8694652,44,48,utRho26
508,fumC,3373418,3373418,3373176,242,0,utRho26
509,fur,2842892,2842892,2842584,308,420,utRho26
510,fusA,6947370,6947370,6947028,342,6332,utRho26
511,fxsA,8737206,8737328,8737206,122,1566,utRho26
512,gabD,5581824,5582546,5581824,722,688,utRho26
513,gadA,7335214,7335214,7335160,54,0,utRho26
514,gadB,3144144,3144144,3144090,54,0,utRho26
515,gadC,3141168,3141168,3140978,190,188,utRho26
516,gadE,7315600,7316732,7315600,1132,476,utRho26
517,gadW,7329562,7329562,7329236,326,0,utRho26
518,gadX,14663356,14663356,14663240,116,0,utRho26
519,gadY,7329728,7329728,7329728,0,0,utRho26
520,galE,1584354,1584354,1584110,244,0,utRho26
521,galF,4228702,4228702,4228654,48,98,utRho26
522,galM,1577796,1577796,1577674,122,80,utRho26
523,galP,6176510,6176568,6176510,58,0,utRho26
524,galR,5953138,5953198,5953138,60,0,utRho26
525,galS,4483420,4483420,4483336,84,0,utRho26
526,galU,2582810,2582914,2582810,104,192,utRho26
527,gapA,3724480,3725542,3724480,1062,1742,utRho26
528,garP,6549868,6549868,6549814,54,52,utRho26
529,gatY,4354468,4354468,4354408,60,0,utRho26
530,gatZ,4352864,4352864,4352642,222,1404,utRho26
531,gcd,282558,282558,282450,108,50,utRho26
532,gcl,1067814,1067832,1067814,18,0,utRho26
533,gcvA,5885278,5885278,5885134,144,0,utRho26
534,gcvB,5885392,5885392,5885392,0,0,utRho26
535,gcvR,5199758,5199812,5199758,54,0,utRho26
536,gcvT,6101544,6101544,6101334,210,188,utRho26
537,gdhA,3684616,3684742,3684616,126,30,utRho26
538,gfcA,2099668,2099668,2099488,180,26,utRho26
539,gfcD,2096236,2096236,2095890,346,56,utRho26
540,ghrA,2195648,2195772,2195648,124,0,utRho26
541,ghrB,7434378,7434620,7434378,242,72,utRho26
542,glcA,6242728,6242728,6242558,170,48,utRho26
543,glcC,6256412,6256544,6256412,132,0,utRho26
544,glcD,6256152,6256152,6256042,110,0,utRho26
545,gldA,8278092,8278092,8278070,22,40,utRho26
546,glgA,7136784,7136784,7136066,718,0,utRho26
547,glgB,7147314,7147314,7147004,310,286,utRho26
548,glgC,7139142,7139142,7138656,486,116,utRho26
549,glgP,7133546,7133546,7133162,384,90,utRho26
550,glgS,6384024,6384024,6383878,146,372,utRho26
551,glgX,7142838,7142838,7142638,200,0,utRho26
552,glk,5018922,5018922,5018852,70,0,utRho26
553,glmS,7827622,7827622,7827336,286,138,utRho26
554,glmU,7830652,7830652,7830400,252,108,utRho26
555,glmY,10765360,10765360,10765360,0,0,utRho26
556,glmZ,7972864,7972864,7972864,0,0,utRho26
557,glnA,16232888,16232888,16232136,752,0,utRho26
558,glnB,5375052,5375052,5374816,236,4,utRho26
559,glnD,377310,377310,377300,10,0,utRho26
560,glnE,6399602,6399602,6399282,320,20,utRho26
561,glnH,1696396,1696396,1696008,388,2,utRho26
562,glnK,945112,945196,945112,84,72,utRho26
563,glnL,8112742,8112742,8112678,64,0,utRho26
564,glnQ,1693262,1693262,1692926,336,244,utRho26
565,glnS,1411998,1412186,1411998,188,1036,utRho26
566,gloA,3455602,3455674,3455602,72,0,utRho26
567,gloB,469852,469852,469564,288,502,utRho26
568,glpA,4705166,4705294,4705166,128,0,utRho26
569,glpD,7123942,7124026,7123942,84,0,utRho26
570,glpE,7123698,7123698,7123646,52,0,utRho26
571,glpF,8236322,8236322,8236180,142,398,utRho26
572,glpG,7122960,7122960,7122904,56,0,utRho26
573,glpR,7121782,7121782,7121210,572,766,utRho26
574,glpT,4704902,4704902,4704748,154,192,utRho26
575,glpX,8231212,8231212,8231158,54,156,utRho26
576,glrK,5382246,5382246,5382196,50,4,utRho26
577,gltA,1509534,1509534,1508936,598,924,utRho26
578,gltB,6709018,6709264,6709018,246,4,utRho26
579,gltI,1375792,1375792,1375494,298,806,utRho26
580,gltP,8588536,8588962,8588536,426,114,utRho26
581,gltS,7657382,7657382,7657330,52,230,utRho26
582,gltX,5041568,5041568,5041344,224,164,utRho26
583,gluQ,320286,320286,320224,62,176,utRho26
584,glyA,5371148,5371148,5371014,134,0,utRho26
585,glyQ,7450708,7450708,7450636,72,2,utRho26
586,glyS,7448990,7448990,7448794,196,520,utRho26
587,glyU,5998128,5998128,5998114,14,126,utRho26
588,glyV,8784626,8784720,8784626,94,64,utRho26
589,glyW,3984360,3984360,3984234,126,26,utRho26
590,gmhB,445612,445666,445612,54,0,utRho26
591,gmk,7642776,7642856,7642776,80,0,utRho26
592,gmr,2693686,2693686,2693484,202,0,utRho26
593,gnd,4202648,4202648,4202536,112,674,utRho26
594,gnsB,3275692,3275692,3275564,128,0,utRho26
595,gntK,14310580,14310580,14310368,212,624,utRho26
596,gntP,9102668,9102668,9102592,76,388,utRho26
597,gntR,7157760,7157760,7157452,308,386,utRho26
598,gntT,7092810,7093118,7092810,308,74,utRho26
599,gntU,7154170,7154170,7154122,48,74,utRho26
600,gntX,7089334,7089764,7089334,430,94,utRho26
601,gor,7292224,7292598,7292224,374,228,utRho26
602,gpmA,1575340,1575340,1575190,150,0,utRho26
603,gpmM,7570374,7570520,7570374,146,0,utRho26
604,gpsA,7567620,7567620,7567322,298,2124,utRho26
605,gpt,511828,511954,511828,126,586,utRho26
606,grcA,5433046,5433046,5432898,148,4,utRho26
607,greA,6657728,6657728,6657430,298,514,utRho26
608,greB,7073488,7073624,7073488,136,0,utRho26
609,groL,8741566,8742050,8741566,484,11388,utRho26
610,groS,8741232,8741376,8741232,144,12206,utRho26
611,grpE,5501494,5501494,5501416,78,540,utRho26
612,grxA,1781552,1781552,1781506,46,0,utRho26
613,grxB,2248206,2248206,2248108,98,214,utRho26
614,grxC,7569152,7569152,7568884,268,1406,utRho26
615,grxD,3468324,3468324,3468202,122,3222,utRho26
616,gspA,6911268,6911268,6910796,472,238,utRho26
617,gspC,6910964,6911156,6910964,192,68,utRho26
618,gss,6277220,6277220,6277044,176,0,utRho26
619,gstA,3428654,3428754,3428654,100,0,utRho26
620,gstB,1761038,1761038,1760960,78,0,utRho26
621,guaB,5268214,5268214,5268140,74,0,utRho26
622,gudD,5839026,5839026,5838770,256,0,utRho26
623,gyrA,4678914,4678914,4678840,74,2,utRho26
624,gyrB,7760300,7760300,7760238,62,0,utRho26
625,hcaE,5337964,5338064,5337964,100,6,utRho26
626,hcaR,5337928,5337928,5337792,136,60,utRho26
627,hcaT,5336106,5336106,5335692,414,6,utRho26
628,hchA,4071260,4071670,4071260,410,0,utRho26
629,hcp,1828258,1828258,1827628,630,242,utRho26
630,hcr,1824400,1824400,1824300,100,0,utRho26
631,hdeA,7313582,7313582,7313480,102,0,utRho26
632,hdeD,7313920,7313990,7313920,70,238,utRho26
633,hdfR,7896320,7896320,7895934,386,296,utRho26
634,hdhA,3396244,3396244,3396080,164,114,utRho26
635,helD,2048876,2048942,2048876,66,0,utRho26
636,hemA,2527166,2527428,2527166,262,0,utRho26
637,hemB,779722,779722,779454,268,144,utRho26
638,hemF,5106410,5106450,5106410,40,0,utRho26
639,hemH,996062,996110,996062,48,0,utRho26
640,hemL,349882,349882,349764,118,0,utRho26
641,hemN,8103886,8104090,8103886,204,0,utRho26
642,hepA,127176,127176,126528,648,7780,utRho26
643,hflD,2385372,2385372,2385262,110,130,utRho26
644,hfq,8799602,8800576,8799602,974,3856,utRho26
645,hha,961006,961006,960616,390,0,utRho26
646,hicA,3018442,3018572,3018442,130,0,utRho26
647,higA,6468682,6468682,6468288,394,486,utRho26
648,higB,6468960,6468960,6468910,50,148,utRho26
649,hinT,2323642,2323770,2323642,128,0,utRho26
650,hipB,3184964,3184964,3184884,80,0,utRho26
651,hisB,4186720,4186936,4186720,216,276,utRho26
652,hisJ,4853674,4853674,4853576,98,0,utRho26
653,hisL,8359856,8359984,8359856,128,0,utRho26
654,hisS,5281284,5281284,5281150,134,0,utRho26
655,hlpA,400910,400964,400910,54,0,utRho26
656,hlyE,2460932,2460932,2460788,144,28,utRho26
657,hmp,5371594,5371670,5371594,76,0,utRho26
658,hns,2585916,2585916,2585844,72,4116,utRho26
659,hofM,7045856,7045856,7045502,354,54,utRho26
660,hokA,7441620,7441620,7441200,420,118,utRho26
661,hokC,33902,33902,33806,96,418,utRho26
662,hokE,1215462,1215672,1215462,210,0,utRho26
663,holC,8968546,8968546,8968560,14,42,utRho26
664,holD,9215562,9215606,9215562,44,0,utRho26
665,holE,3850040,3850216,3850040,176,4,utRho26
666,hpt,282720,282862,282720,142,0,utRho26
667,hrpB,324150,324210,324150,60,6,utRho26
668,hscB,5319048,5319048,5318934,114,168,utRho26
669,hscC,1367188,1367188,1366786,402,142,utRho26
670,hsdS,9163004,9163004,9162924,80,458,utRho26
671,hslJ,2883560,2883560,2883486,74,586,utRho26
672,hslO,7059344,7059548,7059344,204,59518,utRho26
673,hslR,7058220,7058696,7058220,476,4784,utRho26
674,hslV,8244708,8244708,8244574,134,30,utRho26
675,hsrA,7881412,7881412,7881224,188,80,utRho26
676,htgA,21286,21660,21286,374,616,utRho26
677,htpG,989634,990240,989634,606,982,utRho26
678,htpX,3825236,3825236,3825152,84,116,utRho26
679,htrE,311036,311036,310852,184,42,utRho26
680,htrL,7587668,7587668,7587366,302,0,utRho26
681,hupA,8400352,8400562,8400352,210,112,utRho26
682,hupB,1845220,1845804,1845220,584,1044,utRho26
683,hyaA,2063968,2064278,2063968,310,20,utRho26
684,hybO,6292726,6292726,6292522,204,250,utRho26
685,hycA,5700922,5700922,5700870,52,0,utRho26
686,hycI,5686204,5686204,5686086,118,236,utRho26
687,hydN,5676264,5676264,5676210,54,0,utRho26
688,hyfA,5202342,5202402,5202342,60,0,utRho26
689,hypA,11402508,11402588,11402508,80,0,utRho26
690,hypB,11403356,11404004,11403356,648,0,utRho26
691,hypF,5676210,5676210,5674850,1360,208,utRho26
692,hypT,9116634,9116634,9116578,56,0,utRho26
693,hyuA,6019660,6020056,6019660,396,0,utRho26
694,iaaA,1733074,1733136,1733074,62,0,utRho26
695,iadA,9119074,9119074,9119052,22,158,utRho26
696,iap,5753072,5753162,5753072,90,44,utRho26
697,ibaG,6673966,6673966,6673606,360,0,utRho26
698,ibpA,7735036,7735036,7734844,192,6606,utRho26
699,ibpB,7733962,7733962,7733794,168,49708,utRho26
700,icd,2389922,2390246,2389922,324,8,utRho26
701,iclR,8447304,8447304,8447256,48,20,utRho26
702,idi,6065876,6066130,6065876,254,0,utRho26
703,idnD,8988870,8988870,8988812,58,0,utRho26
704,idnK,8989194,8989246,8989194,52,0,utRho26
705,ihfA,3591442,3591442,3591104,338,318,utRho26
706,ihfB,1927498,1927656,1927498,158,182,utRho26
707,ileS,43666,44782,43666,1116,726,utRho26
708,ileX,6431194,6431196,6431194,2,104,utRho26
709,ilvA,15820940,15821324,15820940,384,116,utRho26
710,ilvC,7915824,7915940,7915824,116,282,utRho26
711,ilvE,15809552,15809936,15809552,384,800,utRho26
712,ilvI,170840,171260,170840,420,20,utRho26
713,ilvL,23701308,23701932,23701308,624,372,utRho26
714,ilvY,7915734,7915734,7915640,94,194,utRho26
715,inaA,4698998,4698998,4698944,54,0,utRho26
716,infA,1853370,1853370,1852886,484,78,utRho26
717,infC,3602692,3602692,3601276,1416,2230,utRho26
718,insA-5,3958452,3958452,3958430,22,8,utRho26
719,insA-7,9036758,9037054,9036758,296,4,utRho26
720,insC-5,6372080,6372284,6372080,204,318,utRho26
721,insEF-2,785238,785238,785820,582,208,utRho26
722,insEF-4,2190310,2190310,2190892,582,156,utRho26
723,insG,9007098,9007098,9006862,236,0,utRho26
724,insH-1,550596,550596,550234,362,42,utRho26
725,insH-11,7306538,7306538,7306396,142,164,utRho26
726,insH-2,1151548,1151548,1151506,42,18,utRho26
727,insH-3,1378444,1378444,1378026,418,118,utRho26
728,insH-4,2791942,2792152,2791942,210,22,utRho26
729,insH-5,2857852,2857852,2857452,400,0,utRho26
730,insH-6,4135022,4135022,4134642,380,160,utRho26
731,insH-7,4206186,4206186,4205822,364,4468,utRho26
732,insH-9,6260050,6260356,6260050,306,652,utRho26
733,insI-3,9017372,9017372,9017234,138,2,utRho26
734,insJ,7441188,7441360,7441188,172,4,utRho26
735,insK,7442130,7442308,7442130,178,88,utRho26
736,insL-1,30760,30890,30760,130,5182,utRho26
737,insL-2,1216112,1216130,1216112,18,278,utRho26
738,insL-3,5028644,5028662,5028644,18,398,utRho26
739,insN-1,540452,540484,540452,32,0,utRho26
740,intD,1132202,1132202,1131956,246,28,utRho26
741,intR,2826520,2826520,2826470,50,0,utRho26
742,intS,4933026,4933090,4933026,64,74,utRho26
743,intZ,5117386,5117542,5117386,156,8,utRho26
744,iraD,9113152,9113986,9113152,834,124,utRho26
745,iraM,2424246,2424246,2424006,240,0,utRho26
746,iraP,802638,802772,802638,134,66,utRho26
747,iscA,5319924,5319924,5319772,152,668,utRho26
748,iscR,5324398,5324398,5324262,136,1368,utRho26
749,iscX,5313834,5313834,5313472,362,164,utRho26
750,ispF,5743968,5743968,5743560,408,82,utRho26
751,ispG,5283908,5283908,5283608,300,40,utRho26
752,ispU,389568,389806,389568,238,24,utRho26
753,isrA,2811502,2811502,2811618,116,0,utRho26
754,istr-1,7706384,7706384,7706384,0,0,utRho26
755,istr-2,7706514,7706514,7706514,0,0,utRho26
756,ivbL,15412092,15412092,15411952,140,40,utRho26
757,ivy,480638,480686,480638,48,66,utRho26
758,katE,3627628,3627734,3627628,106,122,utRho26
759,katG,8267624,8267670,8267624,46,0,utRho26
760,kbaZ,6557732,6557828,6557732,96,0,utRho26
761,kbl,7585154,7585154,7585102,52,332,utRho26
762,kch,2621046,2621046,2620538,508,0,utRho26
763,kdgR,3820506,3820506,3820198,308,0,utRho26
764,kdpE,1443788,1443788,1443466,322,164,utRho26
765,kdpF,1457698,1457698,1457642,56,76,utRho26
766,kdsA,2535708,2536330,2535708,622,756,utRho26
767,kdsC,6683438,6684546,6683438,1108,2226,utRho26
768,kduI,5968388,5968388,5968248,140,138,utRho26
769,kefF,94160,94492,94160,332,552,utRho26
770,kgtP,5451624,5451624,5451492,132,176,utRho26
771,kup,7862206,7862632,7862206,426,1586,utRho26
772,lacI,735076,735076,735020,56,2,utRho26
773,lacZ,1465508,1465508,1465220,288,256,utRho26
774,ldcA,2486394,2486394,2486160,234,4,utRho26
775,ldhA,2885830,2885830,2885686,144,110,utRho26
776,ldrA,2538954,2538954,2538550,404,536,utRho26
777,ldrB,2540024,2540024,2539620,404,320,utRho26
778,ldrC,2541092,2541092,2540690,402,28,utRho26
779,ldrD,7400544,7400544,7400174,370,6,utRho26
780,lepA,5414392,5414392,5414248,144,658,utRho26
781,lepB,5410928,5410928,5410618,310,740,utRho26
782,leuD,159188,159188,158906,282,122,utRho26
783,leuE,3761600,3761600,3761518,82,92,utRho26
784,leuL,168048,168048,167416,632,84,utRho26
785,leuO,168308,168736,168308,428,116,utRho26
786,leuQ,9212864,9212864,9212802,62,0,utRho26
787,leuU,6644556,6644556,6644316,240,1452,utRho26
788,leuV,9212546,9212546,9212330,216,454,utRho26
789,leuX,8992772,8992810,8992772,38,0,utRho26
790,lexA,8514174,8514230,8514174,56,18,utRho26
791,lhr,3456706,3458174,3456706,1468,184,utRho26
792,ligA,5060402,5060402,5060352,50,6,utRho26
793,ligB,7642576,7642576,7642340,236,0,utRho26
794,lipA,1320602,1320602,1320432,170,0,utRho26
795,lipB,1324802,1324802,1324556,246,4406,utRho26
796,lit,2397032,2397390,2397032,358,460,utRho26
797,livJ,7199524,7199524,7199316,208,854,utRho26
798,livK,7195510,7195510,7195120,390,212,utRho26
799,lldP,7554578,7554798,7554578,220,254,utRho26
800,lnt,1381968,1381968,1381762,206,234,utRho26
801,loiP,6163784,6163826,6163784,42,0,utRho26
802,lolA,1874656,1874738,1874656,82,100,utRho26
803,lolB,2527112,2527112,2527000,112,0,utRho26
804,lolC,2350748,2350854,2350748,106,0,utRho26
805,lon,917630,917776,917630,146,394,utRho26
806,lpcA,486936,487086,486936,150,0,utRho26
807,lpd,255434,255824,255434,390,448,utRho26
808,lplA,9248476,9248476,9248234,242,418,utRho26
809,lplT,5947878,5947878,5947724,154,0,utRho26
810,lpoA,6586422,6586800,6586422,378,100,utRho26
811,lpp,3514592,3514842,3514592,250,112,utRho26
812,lptA,6686598,6686760,6686598,162,94,utRho26
813,lptB,6686792,6687888,6686792,1096,352,utRho26
814,lptD,114672,114672,114218,454,254,utRho26
815,lptF,8972244,8972436,8972244,192,0,utRho26
816,lpxC,213016,213114,213016,98,1778,utRho26
817,lpxD,401920,401942,401920,22,0,utRho26
818,lpxL,2233418,2233418,2233164,254,28,utRho26
819,lpxM,3880456,3880456,3880386,70,0,utRho26
820,lpxP,4991156,4991290,4991156,134,148,utRho26
821,lrhA,4813312,4813312,4813282,30,4,utRho26
822,lrp,1864656,1865190,1864656,534,450,utRho26
823,lspA,50028,50414,50028,386,256,utRho26
824,lsrA,3202920,3202980,3202920,60,0,utRho26
825,lsrR,3202514,3202514,3202482,32,0,utRho26
826,ltaE,1818640,1818640,1818588,52,0,utRho26
827,luxS,5630130,5630130,5629466,664,1138,utRho26
828,lysA,5957902,5957902,5957798,104,0,utRho26
829,lysC,8467232,8467232,8466466,766,176,utRho26
830,lysP,4497120,4497120,4497064,56,18,utRho26
831,lysR,5957900,5958042,5957900,142,0,utRho26
832,lysT,1561028,1561108,1561028,80,0,utRho26
833,lysU,8709610,8709610,8709434,176,22,utRho26
834,macB,1840188,1840694,1840188,506,96,utRho26
835,maeA,3111484,3111484,3111338,146,546,utRho26
836,mak,820236,820288,820236,52,0,utRho26
837,malE,8492928,8492928,8492838,90,92,utRho26
838,malI,3398456,3398456,3398360,96,0,utRho26
839,malK,8493472,8493568,8493472,96,2,utRho26
840,malP,7105020,7105020,7104946,74,310,utRho26
841,malQ,7100798,7100798,7100140,658,232,utRho26
842,malS,14949880,14949988,14949880,108,0,utRho26
843,malT,7106048,7106170,7106048,122,42,utRho26
844,malX,3398626,3398710,3398626,84,0,utRho26
845,malZ,1689980,1690072,1689980,92,236,utRho26
846,manA,3377102,3377152,3377102,50,0,utRho26
847,manX,3803866,3804096,3803866,230,88,utRho26
848,marC,3237882,3237882,3237816,66,120,utRho26
849,marR,3238186,3238240,3238186,54,120,utRho26
850,matP,2036918,2036970,2036918,52,56,utRho26
851,mazE,5822736,5822736,5822678,58,2,utRho26
852,mazG,5821720,5821720,5821370,350,850,utRho26
853,mcbA,1684306,1684306,1684112,194,0,utRho26
854,mcbR,3040192,3040524,3040192,332,0,utRho26
855,mcrA,2420278,2420692,2420278,414,2,utRho26
856,mcrC,9156124,9156124,9155916,208,450,utRho26
857,mdaB,6344814,6345060,6344814,246,10,utRho26
858,mdfA,1767138,1767346,1767138,208,0,utRho26
859,mdh,6768940,6768940,6768536,404,368,utRho26
860,mdoB,9198988,9198988,9198882,106,96,utRho26
861,mdoD,2993290,2993712,2993290,422,0,utRho26
862,mdoG,2218514,2218670,2218514,156,290,utRho26
863,mdtA,4307958,4308032,4307958,74,0,utRho26
864,mdtE,7318168,7318464,7318168,296,262,utRho26
865,mdtK,3486538,3486914,3486538,376,328,utRho26
866,mdtP,8602472,8602472,8602060,412,52,utRho26
867,melA,8683774,8683822,8683774,48,0,utRho26
868,melR,8683300,8683300,8683256,44,208,utRho26
869,menA,8240812,8240812,8240698,114,420,utRho26
870,menB,4753774,4753774,4753638,136,128,utRho26
871,mepH,3468714,3468870,3468714,156,0,utRho26
872,mepM,3883666,3883666,3883270,396,0,utRho26
873,mepS,4539840,4539958,4539840,118,302,utRho26
874,metA,8428318,8428560,8428318,242,0,utRho26
875,metB,8257272,8257344,8257272,72,636,utRho26
876,metC,6304150,6304472,6304150,322,246,utRho26
877,metE,8025768,8026106,8025768,338,32,utRho26
878,metF,8265092,8265232,8265092,140,38,utRho26
879,metG,4388538,4388600,4388538,62,0,utRho26
880,metH,8447010,8447656,8447010,646,302,utRho26
881,metJ,8257116,8257116,8256790,326,208,utRho26
882,metK,6173154,6173412,6173154,258,256,utRho26
883,metN,445428,445428,445290,138,0,utRho26
884,metR,8025710,8025710,8025632,78,0,utRho26
885,metT,1394326,1394326,1394266,60,0,utRho26
886,metY,19910250,19910250,19909734,516,2298,utRho26
887,metZ,11789528,11789548,11789528,20,92,utRho26
888,mfd,2348056,2348056,2347928,128,0,utRho26
889,mglA,4478782,4478782,4478578,204,114,utRho26
890,mglB,4481132,4481132,4480696,436,8500,utRho26
891,mglC,4475918,4475918,4475506,412,0,utRho26
892,mgrB,3817584,3817584,3817532,52,56,utRho26
893,mgrR,3245828,3245828,3245828,0,0,utRho26
894,mgsA,2054082,2054082,2054030,52,190,utRho26
895,mgtL,8934560,8934862,8934560,302,114,utRho26
896,mhpA,737038,737222,737038,184,0,utRho26
897,mhpR,737072,737072,736840,232,0,utRho26
898,mhpT,750772,750918,750772,146,0,utRho26
899,miaA,8797964,8798504,8797964,540,130,utRho26
900,micA,5629604,5629604,5629604,0,0,utRho26
901,micC,2874242,2874238,2874242,4,0,utRho26
902,micF,4626168,4626168,4626168,0,0,utRho26
903,micM,1014408,1014408,1014408,0,0,utRho26
904,minE,2449422,2449422,2449090,332,512,utRho26
905,mioC,7852950,7852950,7852910,40,0,utRho26
906,mipA,3733012,3733012,3732944,68,632,utRho26
907,mlaA,4930270,4930270,4930014,256,0,utRho26
908,mlc,3337206,3337206,3337128,78,2,utRho26
909,mlrA,4429498,4429732,4429498,234,6,utRho26
910,mltA,5894546,5894546,5894356,190,0,utRho26
911,mltD,468050,468050,467910,140,0,utRho26
912,mltF,5391534,5391602,5391534,68,0,utRho26
913,mmuP,550238,550650,550238,412,48,utRho26
914,mngA,1531622,1531968,1531622,346,0,utRho26
915,mngR,1531852,1531852,1531750,102,0,utRho26
916,mnmG,7851348,7851348,7851266,82,50,utRho26
917,mntH,5025470,5025470,5025412,58,0,utRho26
918,mntP,3810918,3811376,3810918,458,2,utRho26
919,mntR,1706160,1706366,1706160,206,0,utRho26
920,mntS,1706128,1706128,1705994,134,2,utRho26
921,moaA,1633654,1634088,1633654,434,154,utRho26
922,moaB,1635954,1636110,1635954,156,42,utRho26
923,mobA,8084242,8084242,8083998,244,0,utRho26
924,mocA,6030112,6030320,6030112,208,146,utRho26
925,modA,1589990,1590178,1589990,188,0,utRho26
926,moeA,1732788,1732788,1732728,60,0,utRho26
927,mokB,2984610,2984610,2984258,352,104,utRho26
928,molR_1,4392888,4392948,4392888,60,0,utRho26
929,motA,3954604,3954604,3954278,326,26,utRho26
930,mpaA,2781278,2781278,2781196,82,12,utRho26
931,mpl,8911456,8911570,8911456,114,0,utRho26
932,mppA,2786108,2786454,2786108,346,0,utRho26
933,mprA,5621494,5621540,5621494,46,48,utRho26
934,mqo,4613848,4613848,4613508,340,4,utRho26
935,mqsA,6336742,6336742,6336492,250,430,utRho26
936,mqsR,6337306,6337306,6337088,218,330,utRho26
937,mraZ,179192,179268,179192,76,106,utRho26
938,mrcA,7045652,7045742,7045652,90,0,utRho26
939,mrcB,329442,329460,329442,18,0,utRho26
940,mreB,13605424,13605424,13604348,1076,864,utRho26
941,mreD,6798166,6798166,6797750,416,142,utRho26
942,mrp,4388360,4388360,4388336,24,0,utRho26
943,mscK,972984,973072,972984,88,2,utRho26
944,mscL,6876002,6876048,6876002,46,792,utRho26
945,mscS,6139742,6139742,6139614,128,0,utRho26
946,msrA,8884522,8884522,8884352,170,384,utRho26
947,msrB,3725168,3725168,3724858,310,20,utRho26
948,msyB,2228426,2228426,2228362,64,106,utRho26
949,mtfA,4087236,4087302,4087236,66,164,utRho26
950,mtgA,6699662,6699662,6699618,44,92,utRho26
951,mtlA,30177504,30178248,30177504,744,2016,utRho26
952,mtn,358366,358366,358306,60,156,utRho26
953,mtr,6611864,6611864,6611634,230,16,utRho26
954,mug,6430992,6430992,6430946,46,1306,utRho26
955,murQ,5091466,5091546,5091466,80,0,utRho26
956,murR,5091586,5091586,5091218,368,0,utRho26
957,mutH,5939164,5939324,5939164,160,0,utRho26
958,mutL,8794092,8794824,8794092,732,414,utRho26
959,mutM,7622554,7622554,7622304,250,58,utRho26
960,mutS,5714038,5714186,5714038,148,488,utRho26
961,mutY,18617466,18618078,18617466,612,6,utRho26
962,nac,4123956,4123956,4123866,90,0,utRho26
963,nadA,1564122,1564170,1564122,48,0,utRho26
964,nadB,5420714,5420840,5420714,126,48,utRho26
965,nadC,237326,237326,237290,36,0,utRho26
966,nadE,3644604,3644916,3644604,312,16,utRho26
967,nadK,5501526,5501662,5501526,136,58,utRho26
968,nagA,1406350,1406350,1405502,848,614,utRho26
969,nagB,1407416,1407416,1407222,194,0,utRho26
970,nagC,1404016,1404016,1403188,828,0,utRho26
971,nagE,1407680,1407888,1407680,208,90,utRho26
972,nagK,2357080,2357186,2357080,106,44,utRho26
973,nanA,6747240,6747240,6747152,88,0,utRho26
974,nanC,9079856,9079856,9079002,854,240,utRho26
975,nanR,6749406,6749406,6748978,428,964,utRho26
976,nanS,9075406,9075406,9075188,218,2,utRho26
977,napF,4607390,4607390,4606994,396,0,utRho26
978,narG,2559614,2559728,2559614,114,0,utRho26
979,narK,2555642,2555914,2555642,272,0,utRho26
980,narP,4580844,4581000,4580844,156,12,utRho26
981,narQ,5171154,5171462,5171154,308,180,utRho26
982,narU,3088326,3088326,3088120,206,610,utRho26
983,narW,3077374,3077374,3074618,2756,364,utRho26
984,narX,2555554,2555554,2555236,318,254,utRho26
985,narZ,3085380,3085380,3085180,200,0,utRho26
986,ndh,2331984,2332170,2331984,186,220,utRho26
987,ndk,5289920,5289920,5289728,192,236,utRho26
988,nemR,6904084,6904092,6904084,8,0,utRho26
989,nepI,7683542,7683542,7683478,64,258,utRho26
990,nfo,4501612,4501680,4501612,68,0,utRho26
991,nfsB,1210906,1210906,1210848,58,0,utRho26
992,nfuA,7090916,7091248,7090916,332,220,utRho26
993,nhaA,34634,34978,34634,344,170,utRho26
994,nhaB,2469534,2469534,2469434,100,0,utRho26
995,nhoA,3067926,3068048,3067926,122,0,utRho26
996,nikA,7226878,7227334,7226878,456,576,utRho26
997,nikR,7237074,7237176,7237074,102,76,utRho26
998,nirB,6987974,6988022,6987974,48,42,utRho26
999,nlpA,7680034,7680034,7679986,48,0,utRho26
1000,nlpC,3585654,3585654,3585462,192,122,utRho26
1001,nlpD,5737658,5737658,5737506,152,0,utRho26
1002,nlpI,6618080,6618080,6617848,232,0,utRho26
1003,nmpC,1153740,1153740,1153650,90,0,utRho26
1004,nohA,3273206,3273206,3272734,472,4,utRho26
1005,norR,5664614,5664614,5664578,36,0,utRho26
1006,norV,5664878,5664952,5664878,74,60,utRho26
1007,nrdA,4689510,4689730,4689510,220,6906,utRho26
1008,nrdD,8925676,8925676,8925320,356,220,utRho26
1009,nrdH,5601312,5601446,5601312,134,76,utRho26
1010,nrdR,865954,866004,865954,50,0,utRho26
1011,nrfA,8575342,8575528,8575342,186,0,utRho26
1012,nsrR,8812088,8812380,8812088,292,270,utRho26
1013,nudB,3897348,3897348,3897264,84,0,utRho26
1014,nudC,8393428,8393806,8393428,378,0,utRho26
1015,nudE,7052658,7052658,7052298,360,0,utRho26
1016,nudG,3682876,3682980,3682876,104,0,utRho26
1017,nudI,4729050,4729108,4729050,58,0,utRho26
1018,nudJ,2388874,2388874,2388576,298,128,utRho26
1019,nuoA,4810670,4810670,4810144,526,1038,utRho26
1020,nuoN,4783434,4783434,4783010,424,122,utRho26
1021,nupC,5026018,5026084,5026018,66,0,utRho26
1022,nupG,6211302,6211428,6211302,126,36,utRho26
1023,ogrK,4335096,4335096,4335040,56,0,utRho26
1024,ogt,2800568,2800568,2800472,96,220,utRho26
1025,ohsC,5401036,5401040,5401036,4,0,utRho26
1026,ompA,2040382,2040382,2040106,276,6526,utRho26
1027,ompC,4625774,4625774,4625498,276,84,utRho26
1028,ompF,1974184,1974184,1973964,220,334,utRho26
1029,ompL,8128958,8128958,8128590,368,528,utRho26
1030,ompN,2874158,2874158,2873786,372,0,utRho26
1031,ompR,7073510,7073510,7073168,342,0,utRho26
1032,ompT,1171330,1171330,1171266,64,36,utRho26
1033,ompW,2627982,2628040,2627982,58,0,utRho26
1034,ompX,1700418,1700900,1700418,482,860,utRho26
1035,omrA,5952378,5952378,5952378,0,0,utRho26
1036,omrB,5952770,5952770,5952770,0,0,utRho26
1037,oppA,2602170,2602364,2602170,194,316,utRho26
1038,orn,8783168,8783208,8783168,40,0,utRho26
1039,osmB,2686952,2686952,2686656,296,464,utRho26
1040,osmC,3113192,3113250,3113192,58,4,utRho26
1041,osmE,3644566,3644566,3644512,54,88,utRho26
1042,osmF,4439046,4439046,4438962,84,134,utRho26
1043,osmY,9222306,9222792,9222306,486,0,utRho26
1044,otsA,3963302,3963302,3963224,78,190,utRho26
1045,otsB,3964930,3964930,3964774,156,254,utRho26
1046,oxc,4984288,4984288,4983900,388,2,utRho26
1047,oxyR,8316914,8316980,8316914,66,204,utRho26
1048,oxyS,8316788,8316788,8316788,0,0,utRho26
1049,paaA,2907730,2907854,2907730,124,0,utRho26
1050,paaX,2927018,2927078,2927018,60,0,utRho26
1051,paaZ,2907340,2907340,2907284,56,0,utRho26
1052,pabA,6981702,6981702,6981658,44,0,utRho26
1053,pabB,3789256,3789610,3789256,354,0,utRho26
1054,pabC,2306186,2306600,2306186,414,86,utRho26
1055,pagP,1313052,1313114,1313052,62,0,utRho26
1056,panB,299260,299260,299202,58,252,utRho26
1057,panC,297840,297840,297590,250,94,utRho26
1058,panD,293490,293490,293388,102,46,utRho26
1059,panZ,7195656,7195968,7195656,312,224,utRho26
1060,parC,6332060,6332060,6331946,114,44,utRho26
1061,patA,6438916,6438988,6438916,72,0,utRho26
1062,patD,3030830,3031156,3030830,326,0,utRho26
1063,pbpC,5294986,5294986,5294650,336,0,utRho26
1064,pbpG,4450132,4450132,4449740,392,54,utRho26
1065,pck,7065358,7065636,7065358,278,1618,utRho26
1066,pcnB,318782,318782,318252,530,0,utRho26
1067,pdhR,244068,244184,244068,116,0,utRho26
1068,pdxB,4875768,4875768,4875702,66,18,utRho26
1069,pdxH,3436068,3436068,3436014,54,0,utRho26
1070,pdxJ,5403626,5403626,5403458,168,6,utRho26
1071,pdxK,5074638,5074638,5074474,164,224,utRho26
1072,pepA,8972278,8972278,8971902,376,0,utRho26
1073,pepD,511618,511618,511432,186,424,utRho26
1074,pepN,1981182,1981244,1981182,62,390,utRho26
1075,pepQ,8062294,8062322,8062294,28,0,utRho26
1076,pepT,2371646,2371688,2371646,42,0,utRho26
1077,pfkA,8214948,8215104,8214948,156,226,utRho26
1078,pfkB,3612646,3612740,3612646,94,0,utRho26
1079,pflA,1902456,1902456,1902160,296,24,utRho26
1080,pflB,1907850,1907850,1907108,742,28,utRho26
1081,pflD,8287716,8287990,8287716,274,16,utRho26
1082,pgaA,2185046,2185046,2184578,468,1160,utRho26
1083,pgi,8467444,8467516,8467444,72,0,utRho26
1084,pgk,12291428,12291428,12290488,940,1004,utRho26
1085,pgl,1597078,1597172,1597078,94,0,utRho26
1086,pgpB,2678324,2678660,2678324,336,0,utRho26
1087,pgpC,5397276,5397276,5397100,176,0,utRho26
1088,pgrR,2783744,2783982,2783744,238,52,utRho26
1089,pheL,5475158,5475198,5475158,40,0,utRho26
1090,pheM,7197204,7197204,7197080,124,244,utRho26
1091,pheP,1203858,1203918,1203858,60,60,utRho26
1092,pheU,8725254,8725254,8725252,2,4,utRho26
1093,pheV,6220730,6220732,6220730,2,0,utRho26
1094,phnC,8650412,8650412,8650330,82,80,utRho26
1095,phoA,803414,803494,803414,80,2,utRho26
1096,phoB,834202,834284,834202,82,52,utRho26
1097,phoE,520316,520316,520200,116,2,utRho26
1098,phoH,2169730,2169984,2169730,254,4,utRho26
1099,phoP,2381016,2381016,2380894,122,290,utRho26
1100,phoQ,2379880,2379880,2379552,328,4,utRho26
1101,phoU,7815330,7815330,7815156,174,74,utRho26
1102,phr,1478842,1479014,1478842,172,0,utRho26
1103,pinE,2419054,2419370,2419054,316,8,utRho26
1104,pinQ,3267168,3267244,3267168,76,0,utRho26
1105,pinR,2867424,2867424,2867348,76,0,utRho26
1106,pitA,7275224,7275284,7275224,60,0,utRho26
1107,pitB,6272806,6272806,6272742,64,40,utRho26
1108,pka,5439862,5439906,5439862,44,0,utRho26
1109,plaP,4174476,4174476,4174124,352,0,utRho26
1110,pldA,8009628,8009724,8009628,96,182,utRho26
1111,pldB,8018028,8018340,8018028,312,252,utRho26
1112,plsB,8513196,8513196,8512932,264,464,utRho26
1113,pmbA,8915890,8915918,8915890,28,0,utRho26
1114,pmrD,4747148,4747148,4747076,72,0,utRho26
1115,pncB,1980828,1980828,1980712,116,0,utRho26
1116,pncC,5648788,5648788,5648692,96,66,utRho26
1117,pnp,6622652,6622652,6622336,316,0,utRho26
1118,pntA,3355950,3355950,3355806,144,0,utRho26
1119,pntB,3353096,3353096,3352720,376,32,utRho26
1120,polA,8093880,8093932,8093880,52,6,utRho26
1121,polB,131606,131606,131560,46,0,utRho26
1122,potD,2365700,2365700,2365658,42,0,utRho26
1123,potE,1436688,1436688,1436530,158,12,utRho26
1124,potF,1787268,1787568,1787268,300,4,utRho26
1125,poxB,1822152,1822152,1822098,54,0,utRho26
1126,ppa,8899372,8899372,8899304,68,2,utRho26
1127,ppc,8306380,8306380,8306196,184,298,utRho26
1128,ppdA,5928440,5928440,5928354,86,52,utRho26
1129,ppdD,235410,235410,235098,312,0,utRho26
1130,pphA,3846770,3846770,3845938,832,1808,utRho26
1131,pphB,5719474,5719520,5719474,46,2,utRho26
1132,ppiA,6984898,6984898,6984594,304,126,utRho26
1133,ppiC,7919682,7919682,7919626,56,0,utRho26
1134,ppiD,923638,923830,923638,192,78,utRho26
1135,ppk,5245748,5246088,5245748,340,0,utRho26
1136,pppA,6228958,6228958,6228704,254,72,utRho26
1137,ppsA,3574322,3574322,3574224,98,0,utRho26
1138,ppsR,3574678,3574890,3574678,212,0,utRho26
1139,pptA,3065716,3066104,3065716,388,0,utRho26
1140,pqiA,2023318,2024002,2023318,684,142,utRho26
1141,prc,3830054,3830054,3829632,422,1426,utRho26
1142,preT,4467978,4468066,4467978,88,184,utRho26
1143,prfC,9218688,9218828,9218688,140,102,utRho26
1144,prkB,6968622,6968980,6968622,358,8,utRho26
1145,prlC,7290476,7290476,7290364,112,454,utRho26
1146,prlF,6553944,6554004,6553944,60,474,utRho26
1147,proB,520432,520776,520432,344,0,utRho26
1148,proC,811372,811372,811288,84,0,utRho26
1149,proK,7417388,7417388,7417384,4,6,utRho26
1150,proL,4572414,4572422,4572414,8,0,utRho26
1151,proP,8660640,8661004,8660640,364,32,utRho26
1152,proS,437674,437674,437550,124,148,utRho26
1153,proV,5609126,5609630,5609126,504,0,utRho26
1154,prpB,697292,697364,697292,72,0,utRho26
1155,prpR,696942,696942,696886,56,0,utRho26
1156,prs,2524354,2524354,2523750,604,3356,utRho26
1157,psd,8781276,8781276,8780720,556,716,utRho26
1158,psiE,8480600,8480650,8480600,50,0,utRho26
1159,pspA,2736076,2736158,2736076,82,0,utRho26
1160,pspF,2736080,2736080,2735824,256,0,utRho26
1161,pspG,8525632,8525680,8525632,48,0,utRho26
1162,pssA,5445156,5445454,5445156,298,934,utRho26
1163,pstB,7817112,7817112,7816732,380,212,utRho26
1164,pstC,7821084,7821084,7820796,288,272,utRho26
1165,pstS,23469408,23469408,23469150,258,192,utRho26
1166,psuG,4517114,4517114,4516734,380,2086,utRho26
1167,psuT,4514992,4514992,4514670,322,0,utRho26
1168,pth,2517084,2517084,2517026,58,0,utRho26
1169,ptrA,5918022,5918022,5917768,254,40,utRho26
1170,ptrB,3857730,3857730,3857678,52,262,utRho26
1171,ptsG,2315252,2315738,2315252,486,228,utRho26
1172,ptsH,5066996,5067528,5066996,532,514,utRho26
1173,purA,8809328,8809374,8809328,46,70,utRho26
1174,purC,5195562,5195562,5195236,326,24,utRho26
1175,purD,8411972,8411972,8411862,110,4,utRho26
1176,purE,1106284,1106284,1106200,84,120,utRho26
1177,purH,8415254,8415254,8415064,190,0,utRho26
1178,purL,5391178,5391178,5391086,92,190,utRho26
1179,purM,5242306,5242394,5242306,88,0,utRho26
1180,purR,3475378,3475688,3475378,310,54,utRho26
1181,purT,3861438,3861762,3861438,324,0,utRho26
1182,purU,2577512,2577512,2577248,264,0,utRho26
1183,putA,2157850,2157850,2157764,86,120,utRho26
1184,putP,2158336,2158610,2158336,274,178,utRho26
1185,puuA,2721936,2721936,2721816,120,0,utRho26
1186,puuC,2725456,2725486,2725456,30,0,utRho26
1187,puuD,2722104,2722240,2722104,136,116,utRho26
1188,puuP,2718746,2718746,2718374,372,100,utRho26
1189,pykA,3874988,3875298,3874988,310,34,utRho26
1190,pykF,3510934,3511396,3510934,462,108,utRho26
1191,pyrC,2245286,2245286,2245214,72,0,utRho26
1192,pyrD,2009464,2009536,2009464,72,0,utRho26
1193,pyrE,7631970,7631970,7631536,434,0,utRho26
1194,pyrF,2683740,2683842,2683740,102,484,utRho26
1195,pyrG,5819594,5819594,5819332,262,1046,utRho26
1196,pyrH,383624,383710,383624,86,162,utRho26
1197,pyrL,8945490,8945490,8945066,424,52,utRho26
1198,qmcA,1031646,1031646,1031546,100,36,utRho26
1199,qor,8528608,8528608,8528462,146,22,utRho26
1200,qseB,6339502,6339656,6339502,154,6,utRho26
1201,queA,849970,850022,849970,52,130,utRho26
1202,queE,5811212,5811212,5810836,376,4,utRho26
1203,queF,5850642,5850696,5850642,54,100,utRho26
1204,queG,8788184,8788184,8788134,50,452,utRho26
1205,racC,2835630,2835630,2835526,104,68,utRho26
1206,racR,2840898,2840898,2840482,416,0,utRho26
1207,raiA,5474208,5474308,5474208,100,48,utRho26
1208,rarD,8008594,8008594,8008356,238,360,utRho26
1209,ravA,7862256,7862256,7862186,70,320,utRho26
1210,rayT,495088,495274,495088,186,128,utRho26
1211,rbn,4763162,4763216,4763162,54,0,utRho26
1212,rbsD,7866644,7866702,7866644,58,0,utRho26
1213,rcnA,4371654,4371834,4371654,180,246,utRho26
1214,rcnB,4373768,4373920,4373768,152,4,utRho26
1215,rcnR,4371806,4371806,4371592,214,438,utRho26
1216,rcsA,4047672,4047936,4047672,264,398,utRho26
1217,rcsB,4631390,4632354,4631390,964,8,utRho26
1218,rcsC,4640162,4640162,4639656,506,0,utRho26
1219,rcsD,4626904,4626976,4626904,72,0,utRho26
1220,rdgB,6193240,6193362,6193240,122,126,utRho26
1221,rdlA,2538646,2538646,2538646,0,0,utRho26
1222,rdlB,2539712,2539716,2539712,4,0,utRho26
1223,rdlC,2540782,2540786,2540782,4,0,utRho26
1224,rdlD,7400272,7400272,7400272,0,0,utRho26
1225,rdoA,8084782,8084830,8084782,48,4,utRho26
1226,recA,11295276,11295276,11295076,200,376,utRho26
1227,recC,5925014,5925014,5924856,158,114,utRho26
1228,recF,7763722,7763722,7762442,1280,674,utRho26
1229,recN,5503518,5503590,5503518,72,0,utRho26
1230,recQ,8011666,8011728,8011666,62,0,utRho26
1231,relA,5828554,5828554,5827302,1252,582,utRho26
1232,relB,3291806,3291806,3291744,62,0,utRho26
1233,rem,3289950,3289950,3289804,146,118,utRho26
1234,rep,7921294,7921354,7921294,60,52,utRho26
1235,rfaD,7587730,7587974,7587730,244,52,utRho26
1236,rfaE,6393852,6393852,6393506,346,90,utRho26
1237,rfaH,8049930,8049930,8049642,288,686,utRho26
1238,rfbX,4219436,4219436,4219168,268,702,utRho26
1239,rfe,7935600,7935832,7935600,232,158,utRho26
1240,rhaB,8194944,8194944,8194896,48,0,utRho26
1241,rhaD,8188770,8188770,8188544,226,0,utRho26
1242,rhaS,8195422,8195472,8195422,50,0,utRho26
1243,rhaT,8201132,8201132,8201050,82,0,utRho26
1244,rhlE,1661566,1661744,1661566,178,2,utRho26
1245,rhoL,47593944,47594772,47593944,828,1404,utRho26
1246,rhsB,7238006,7238384,7238006,378,134,utRho26
1247,rhsC,1458758,1459166,1458758,408,0,utRho26
1248,rhsD,1046132,1046522,1046132,390,12,utRho26
1249,rhtA,1700608,1700608,1700194,414,582,utRho26
1250,rhtC,8015478,8015514,8015478,36,64,utRho26
1251,ribA,2678468,2678468,2678320,148,0,utRho26
1252,ribC,3486916,3486916,3486484,432,650,utRho26
1253,ribE,869008,869294,869008,286,2454,utRho26
1254,ribF,42766,42814,42766,48,4,utRho26
1255,ridA,8941892,8941892,8941826,66,2,utRho26
1256,rihA,1369204,1369204,1368824,380,380,utRho26
1257,rihB,4510504,4510504,4510372,132,0,utRho26
1258,rimJ,2251044,2251124,2251044,80,62,utRho26
1259,rimK,1783752,1783934,1783752,182,140,utRho26
1260,rimL,2997486,2997876,2997486,390,116,utRho26
1261,rimO,1756140,1756140,1756070,70,0,utRho26
1262,rimP,6636350,6636350,6636012,338,880,utRho26
1263,rlmA,3814172,3814172,3814120,52,0,utRho26
1264,rlmD,5830086,5830086,5830000,86,0,utRho26
1265,rlmE,6655520,6655520,6655328,192,286,utRho26
1266,rlmF,1684384,1684664,1684384,280,0,utRho26
1267,rlmG,6471784,6471784,6471750,34,0,utRho26
1268,rlmI,2060002,2060002,2059938,64,0,utRho26
1269,rlmJ,7290700,7290770,7290700,70,4,utRho26
1270,rlmL,2015344,2015688,2015344,344,384,utRho26
1271,rlpA,1330444,1330444,1330380,64,0,utRho26
1272,rluA,120900,120900,120692,208,280,utRho26
1273,rluF,8460324,8460708,8460324,384,0,utRho26
1274,rmf,2031006,2031430,2031006,424,196,utRho26
1275,rna,1290068,1290068,1290006,62,0,utRho26
1276,rnb,2698258,2698258,2697824,434,84,utRho26
1277,rnc,10816892,10816892,10816252,640,27004,utRho26
1278,rnd,3776122,3776122,3775982,140,0,utRho26
1279,rne,2289746,2289746,2288734,1012,1702,utRho26
1280,rnhA,472082,472082,472004,78,550,utRho26
1281,rnk,1288360,1288360,1287934,426,0,utRho26
1282,rnlA,5531788,5531836,5531788,48,256,utRho26
1283,rnlB,5533414,5533968,5533414,554,336,utRho26
1284,rnpB,19623552,19623552,19623552,0,0,utRho26
1285,rob,9270706,9270706,9270620,86,0,utRho26
1286,rodZ,5285868,5285868,5285688,180,38,utRho26
1287,rpe,7030306,7030306,7030118,188,40,utRho26
1288,rph,15266320,15266320,15266196,124,224,utRho26
1289,rpiA,6118706,6118706,6118650,56,30,utRho26
1290,rpiB,8626514,8626700,8626514,186,2,utRho26
1291,rpiR,8626274,8626274,8625982,292,0,utRho26
1292,rplJ,8359246,8359992,8359246,746,6880,utRho26
1293,rplK,8356708,8356894,8356708,186,122,utRho26
1294,rplM,6757344,6757344,6757302,42,474,utRho26
1295,rplN,6896444,6896444,6896298,146,1008,utRho26
1296,rplS,5489284,5489284,5489060,224,11574,utRho26
1297,rplT,7199052,7199052,7198996,56,568,utRho26
1298,rplU,6667036,6667036,6666902,134,2,utRho26
1299,rplY,4564866,4565034,4564866,168,0,utRho26
1300,rpmA,6666450,6666450,6666238,212,508,utRho26
1301,rpmB,15247980,15247980,15246696,1284,48964,utRho26
1302,rpmE,8253816,8254026,8253816,210,416,utRho26
1303,rpmF,2294676,2294734,2294676,58,12120,utRho26
1304,rpmH,7768130,7768672,7768130,542,1778,utRho26
1305,rpmI,3600854,3600854,3599998,856,6478,utRho26
1306,rpoB,8362126,8362490,8362126,364,192,utRho26
1307,rpoD,6424946,6426094,6424946,1148,28778,utRho26
1308,rpoE,5420372,5420372,5420024,348,8,utRho26
1309,rpoH,7202006,7202006,7201566,440,1944,utRho26
1310,rpoN,6689324,6689434,6689324,110,2,utRho26
1311,rpoS,5736236,5736236,5735102,1134,804,utRho26
1312,rpoZ,7644154,7644212,7644154,58,50,utRho26
1313,rppH,5937986,5937986,5937954,32,0,utRho26
1314,rprA,3540744,3540744,3540744,0,0,utRho26
1315,rpsA,1923434,1923990,1923434,556,29414,utRho26
1316,rpsF,8850050,8850236,8850050,186,5932,utRho26
1317,rpsI,6756580,6756580,6756414,166,6698,utRho26
1318,rpsJ,6906884,6906884,6906540,344,1960,utRho26
1319,rpsL,6949242,6949242,6949104,138,642,utRho26
1320,rpsM,6885130,6885130,6884942,188,32,utRho26
1321,rpsO,13247144,13247144,13246736,408,544,utRho26
1322,rpsP,5492508,5492508,5492370,138,0,utRho26
1323,rpsT,42420,42420,42156,264,282,utRho26
1324,rpsU,12842584,12843124,12842584,540,776,utRho26
1325,rraA,8238716,8238716,8238660,56,210,utRho26
1326,rraB,8956768,8956946,8956768,178,112,utRho26
1327,rrsA,8070478,8071062,8070478,584,1266,utRho26
1328,rrsB,16665468,16666636,16665468,1168,2984,utRho26
1329,rrsC,7883032,7883616,7883032,584,618,utRho26
1330,rrsD,6858094,6858094,6857524,570,334,utRho26
1331,rrsE,8415726,8416294,8415726,568,700,utRho26
1332,rrsG,5462896,5462896,5462314,582,1190,utRho26
1333,rrsH,446970,447542,446970,572,532,utRho26
1334,rsd,8393908,8393908,8393616,292,0,utRho26
1335,rseA,5419264,5419264,5418808,456,362,utRho26
1336,rseP,392940,393092,392940,152,2,utRho26
1337,rseX,4067298,4067298,4067298,0,0,utRho26
1338,rsfS,1338144,1338144,1338072,72,64,utRho26
1339,rsgA,8783132,8783132,8783018,114,0,utRho26
1340,rsmA,105176,105176,104860,316,168,utRho26
1341,rsmB,6869982,6870414,6869982,432,24,utRho26
1342,rsmC,9215736,9215736,9215400,336,100,utRho26
1343,rsmD,7208594,7208786,7208594,192,0,utRho26
1344,rsmE,6182036,6182268,6182036,232,0,utRho26
1345,rsmG,7847512,7847512,7847360,152,84,utRho26
1346,rsmH,180020,180188,180020,168,0,utRho26
1347,rsmI,6587106,6587106,6586670,436,110,utRho26
1348,rssA,2578212,2578412,2578212,200,0,utRho26
1349,rssB,2580440,2580484,2580440,44,0,utRho26
1350,rstA,3364276,3364300,3364276,24,0,utRho26
1351,rsuA,4561096,4561096,4560966,130,2,utRho26
1352,rsxA,3411510,3411534,3411510,24,76,utRho26
1353,rtcA,7114004,7114004,7113698,306,108,utRho26
1354,rtcB,7116214,7116214,7116158,56,24,utRho26
1355,rtn,4541356,4541452,4541356,96,0,utRho26
1356,rutA,2148052,2148052,2148022,30,0,utRho26
1357,rutG,2140090,2140090,2139678,412,0,utRho26
1358,rutR,2148226,2148484,2148226,258,0,utRho26
1359,ruvA,7784096,7784096,7783904,192,48,utRho26
1360,ruvB,7782176,7782176,7781424,752,304,utRho26
1361,ruvC,3894878,3894878,3894752,126,0,utRho26
1362,rybB,1776114,1776114,1776114,0,0,utRho26
1363,rydB,3529860,3529860,3529322,538,278,utRho26
1364,rydC,2983012,2983012,2983012,0,0,utRho26
1365,ryfA,5307398,5307710,5307398,312,0,utRho26
1366,ryfD,5468590,5468590,5468590,0,0,utRho26
1367,ryhB,7162032,7162032,7162032,0,0,utRho26
1368,ryjA,8556132,8556132,8556132,0,0,utRho26
1369,ryjB,9055954,9055954,9055954,0,0,utRho26
1370,sad,3229598,3229598,3229406,192,0,utRho26
1371,safA,3168056,3168056,3167918,138,0,utRho26
1372,sanA,4465368,4465756,4465368,388,226,utRho26
1373,sapF,2705314,2705314,2705268,46,0,utRho26
1374,sbcB,4165456,4165512,4165456,56,0,utRho26
1375,sbcC,831694,831694,831506,188,0,utRho26
1376,sbcD,833954,833954,833904,50,66,utRho26
1377,sbmA,793106,793278,793106,172,402,utRho26
1378,sbmC,4162650,4162650,4162524,126,0,utRho26
1379,sdaA,3793618,3793864,3793618,246,416,utRho26
1380,sdaC,5856070,5856458,5856070,388,10222,utRho26
1381,sdhC,1509916,1510354,1509916,438,6452,utRho26
1382,sdhD,1510808,1511120,1510808,312,456,utRho26
1383,sdiA,3993834,3993834,3993664,170,4,utRho26
1384,secE,8354354,8354716,8354354,362,158,utRho26
1385,secG,6645180,6645180,6645010,170,210,utRho26
1386,selA,7522594,7522594,7522498,96,2,utRho26
1387,selB,7519850,7519850,7519722,128,0,utRho26
1388,selC,7672396,7672444,7672396,48,200,utRho26
1389,selD,3696058,3696058,3696016,42,96,utRho26
1390,seqA,1425884,1425974,1425884,90,126,utRho26
1391,serA,6117098,6117098,6116820,278,0,utRho26
1392,serB,9249712,9249790,9249712,78,0,utRho26
1393,serC,3830380,3830612,3830380,232,0,utRho26
1394,serS,1878730,1878856,1878730,126,614,utRho26
1395,serT,2063438,2063438,2063424,14,0,utRho26
1396,serU,4087124,4087124,4087114,10,0,utRho26
1397,serV,5637394,5637394,5637290,104,126,utRho26
1398,serW,1852014,1852014,1851942,72,298,utRho26
1399,serX,2195352,2195352,2195304,48,60,utRho26
1400,setB,4527426,4527726,4527426,300,76,utRho26
1401,setC,7673488,7673906,7673488,418,146,utRho26
1402,sfmA,1116124,1116424,1116124,300,176,utRho26
1403,sfmC,1117606,1117948,1117606,342,0,utRho26
1404,sfsA,323030,323030,322972,58,34,utRho26
1405,sfsB,6669592,6669818,6669592,226,2,utRho26
1406,sgrR,154676,154676,154598,78,0,utRho26
1407,sgrS,154734,154734,154734,0,0,utRho26
1408,shiA,4107068,4107286,4107068,218,0,utRho26
1409,sibA,4306622,4306622,4306622,0,0,utRho26
1410,sibB,4307292,4307292,4307292,0,0,utRho26
1411,sibC,6113702,6113702,6113702,0,0,utRho26
1412,sibD,6389730,6389730,6389730,0,0,utRho26
1413,sibE,6390480,6390480,6390480,0,0,utRho26
1414,sixA,4913998,4913998,4913624,374,0,utRho26
1415,slp,7307872,7307922,7307872,50,22,utRho26
1416,slt,9261400,9261466,9261400,66,0,utRho26
1417,slyA,3442028,3442028,3441648,380,48,utRho26
1418,slyB,3439496,3439752,3439496,256,90,utRho26
1419,slyD,6957398,6957398,6956994,404,594,utRho26
1420,slyX,6954862,6955280,6954862,418,7988,utRho26
1421,smf,6867372,6867372,6867120,252,0,utRho26
1422,smpB,5509534,5509792,5509534,258,700,utRho26
1423,smrA,2811872,2811958,2811872,86,150,utRho26
1424,smrB,4896872,4897212,4896872,340,2,utRho26
1425,smtA,1946808,1947074,1946808,266,0,utRho26
1426,sodA,8201518,8201620,8201518,102,946,utRho26
1427,sodB,3470646,3470756,3470646,110,196,utRho26
1428,sodC,3449358,3449358,3449310,48,0,utRho26
1429,sohB,2658568,2658664,2658568,96,80,utRho26
1430,sokB,2984232,2984238,2984232,6,54,utRho26
1431,solA,2241218,2241218,2241172,46,38,utRho26
1432,soxR,8554894,8554938,8554894,44,0,utRho26
1433,soxS,8554846,8554846,8554766,80,0,utRho26
1434,speA,6172096,6172096,6171822,274,468,utRho26
1435,speB,6167892,6167892,6167594,298,170,utRho26
1436,speC,6218350,6218350,6218310,40,0,utRho26
1437,spf,8099798,8099798,8099798,0,0,utRho26
1438,sppA,3697422,3697674,3697422,252,4,utRho26
1439,spy,3651376,3651376,3651250,126,0,utRho26
1440,sra,3112092,3112092,3111926,166,0,utRho26
1441,sraB,2293178,2293178,2293178,0,0,utRho26
1442,sraC,3846132,3846132,3846132,0,0,utRho26
1443,srlA,5651582,5651664,5651582,82,0,utRho26
1444,srlR,5657720,5658094,5657720,374,108,utRho26
1445,srmB,5425752,5425792,5425752,40,258,utRho26
1446,sroA,151216,151216,151216,0,0,utRho26
1447,sroG,6369436,6369436,6369436,0,0,utRho26
1448,sroH,8380974,8380974,8380974,0,0,utRho26
1449,ssb,8548022,8548250,8548022,228,60,utRho26
1450,sseA,5304782,5304988,5304782,206,1740,utRho26
1451,sspA,6755138,6755138,6754840,298,0,utRho26
1452,ssrA,5511014,5511186,5511014,172,306,utRho26
1453,ssrS,12223036,12223932,12223036,896,1928,utRho26
1454,sstT,6479726,6479888,6479726,162,0,utRho26
1455,ssuB,1988282,1988282,1988088,194,0,utRho26
1456,ssuE,1995126,1995126,1995024,102,0,utRho26
1457,sthA,8321604,8321604,8321580,24,78,utRho26
1458,stpA,5597156,5597156,5596990,166,0,utRho26
1459,sucA,3034344,3034824,3034344,480,260,utRho26
1460,sufA,3528836,3528836,3528772,64,56,utRho26
1461,sufE,3518962,3518962,3518580,382,14,utRho26
1462,sugE,8753588,8753750,8753588,162,2,utRho26
1463,sulA,2041894,2041894,2041838,56,4268,utRho26
1464,syd,5850738,5850738,5850560,178,100,utRho26
1465,symE,9159834,9159834,9159680,154,0,utRho26
1466,symR,9159670,9159670,9159670,0,0,utRho26
1467,tabA,8949566,8949724,8949566,158,0,utRho26
1468,talA,5157140,5157332,5157140,192,0,utRho26
1469,talB,16382,16476,16382,94,4036,utRho26
1470,tam,3214442,3214692,3214442,250,0,utRho26
1471,tamA,8884540,8884764,8884540,224,198,utRho26
1472,tar,3945432,3945432,3945382,50,82,utRho26
1473,tas,5943138,5943194,5943138,56,4,utRho26
1474,tatA,16087636,16087780,16087636,144,72,utRho26
1475,tatE,1317742,1317894,1317742,152,80,utRho26
1476,tauA,770410,770464,770410,54,96,utRho26
1477,tdcA,6534186,6534186,6534130,56,4,utRho26
1478,tdcG,6519652,6519652,6519298,354,4,utRho26
1479,tdcR,6534380,6534760,6534380,380,4,utRho26
1480,tdk,2586986,2587054,2586986,68,58,utRho26
1481,tehA,3001072,3001146,3001072,74,0,utRho26
1482,tesA,1039898,1039898,1039530,368,170,utRho26
1483,tesB,950402,950402,950322,80,32,utRho26
1484,tfaE,2418532,2418532,2418238,294,260,utRho26
1485,tfaQ,3269912,3269912,3269770,142,12,utRho26
1486,tff,379424,379256,379424,168,0,utRho26
1487,tgt,852110,852274,852110,164,0,utRho26
1488,thiD,4369346,4369346,4369032,314,118,utRho26
1489,thiI,882936,883098,882936,162,4,utRho26
1490,thiM,4370902,4370902,4370602,300,146,utRho26
1491,thiQ,146170,146170,145854,316,1902,utRho26
1492,thrL,592,760,592,168,324,utRho26
1493,thrS,7210932,7210932,7210280,652,368,utRho26
1494,thrU,8350762,8350776,8350762,14,578,utRho26
1495,thrV,6847414,6847414,6847310,104,202524,utRho26
1496,thrW,525682,525742,525682,60,150,utRho26
1497,thyA,5930696,5930696,5930310,386,8,utRho26
1498,tig,909986,910266,909986,280,292,utRho26
1499,tisB,7706674,7707106,7706674,432,842,utRho26
1500,tktA,6163414,6163414,6163270,144,118,utRho26
1501,tktB,5158616,5159272,5158616,656,240,utRho26
1502,tldD,6784368,6784368,6784056,312,0,utRho26
1503,tmcA,5191876,5191876,5191718,158,62,utRho26
1504,tnaC,15553644,15553740,15553644,96,24,utRho26
1505,tolB,1555074,1555480,1555074,406,228,utRho26
1506,tolC,6356008,6356230,6356008,222,88,utRho26
1507,tomB,961588,961588,961416,172,140,utRho26
1508,tonB,2622108,2622178,2622108,70,2,utRho26
1509,topA,2661578,2662096,2661578,518,30,utRho26
1510,torC,2116112,2116168,2116112,56,124,utRho26
1511,torR,2115968,2115968,2115908,60,66,utRho26
1512,torS,2112364,2112364,2112356,8,0,utRho26
1513,torT,2112414,2112522,2112414,108,0,utRho26
1514,tpiA,8223138,8223138,8223014,124,0,utRho26
1515,tppB,3425342,3425538,3425342,196,476,utRho26
1516,tpr,2574376,2574376,2574376,0,0,utRho26
1517,tpx,2777688,2777688,2777622,66,370,utRho26
1518,tqsA,3347780,3347826,3347780,46,0,utRho26
1519,treA,2494850,2494850,2494752,98,144,utRho26
1520,treB,8932420,8932420,8932360,60,56,utRho26
1521,treF,7339102,7339184,7339102,82,0,utRho26
1522,treR,8934694,8934694,8934492,202,56,utRho26
1523,trg,2984878,2984940,2984878,62,0,utRho26
1524,trkG,2847342,2847564,2847342,222,396,utRho26
1525,trmA,8326590,8326590,8326540,50,0,utRho26
1526,trpA,2634678,2634678,2634444,234,2,utRho26
1527,trpC,2639888,2639888,2639570,318,0,utRho26
1528,trpL,5292432,5292432,5292328,104,0,utRho26
1529,trpR,9265408,9265520,9265408,112,2,utRho26
1530,trpS,7027394,7027394,7027276,118,106,utRho26
1531,trpT,7893560,7893914,7893560,354,121180,utRho26
1532,trxA,7931294,7931522,7931294,228,1346,utRho26
1533,trxB,1864156,1864156,1864100,56,0,utRho26
1534,trxC,5437350,5437470,5437350,120,272,utRho26
1535,tsaD,6421256,6421256,6421086,170,4,utRho26
1536,tsgA,6985038,6985136,6985038,98,14,utRho26
1537,tsr,9182824,9183314,9182824,490,6,utRho26
1538,tsx,864490,864490,864026,464,94,utRho26
1539,ttcA,2823970,2823970,2823896,74,874,utRho26
1540,ttdA,6412848,6412926,6412848,78,130,utRho26
1541,ttdR,6412760,6412760,6412512,248,162,utRho26
1542,tufA,6943448,6943448,6942658,790,24942,utRho26
1543,tus,3368346,3368518,3368346,172,0,utRho26
1544,tusA,7218040,7218040,7217992,48,330,utRho26
1545,tusB,6950218,6950218,6949930,288,200,utRho26
1546,tynA,2902996,2902996,2902698,298,0,utRho26
1547,typA,8116460,8116814,8116460,354,464,utRho26
1548,tyrB,8534164,8534228,8534164,64,208,utRho26
1549,tyrP,3979004,3979362,3979004,358,0,utRho26
1550,tyrR,2773384,2773440,2773384,56,100,utRho26
1551,tyrS,3434566,3434566,3434444,122,0,utRho26
1552,tyrT,2575330,2575330,2575244,86,62,utRho26
1553,uacT,6062378,6062734,6062378,356,38,utRho26
1554,ubiC,8504886,8505012,8504886,126,0,utRho26
1555,ubiD,8049618,8049976,8049618,358,686,utRho26
1556,ubiE,8037494,8037710,8037494,216,4,utRho26
1557,ubiG,4679078,4679134,4679078,56,0,utRho26
1558,ucpA,5089342,5089342,5089246,96,0,utRho26
1559,udp,8032782,8032862,8032782,80,232,utRho26
1560,ugd,4199470,4199470,4199226,244,0,utRho26
1561,ugpB,7184852,7184852,7184650,202,588,utRho26
1562,ugpQ,7176600,7176600,7176226,374,0,utRho26
1563,uhpT,7694396,7694396,7694334,62,0,utRho26
1564,uidA,3392304,3392304,3392142,162,0,utRho26
1565,uidC,3386012,3386012,3385702,310,0,utRho26
1566,uidR,3394150,3394150,3394104,46,0,utRho26
1567,ulaA,8839854,8839960,8839854,106,44,utRho26
1568,ulaG,8839350,8839350,8839250,100,0,utRho26
1569,ulaR,8837124,8837124,8836906,218,0,utRho26
1570,umpG,5741372,5741372,5740548,824,28,utRho26
1571,umpH,1400704,1400704,1400652,52,154,utRho26
1572,umuD,2461476,2461534,2461476,58,0,utRho26
1573,ung,5433476,5433508,5433476,32,0,utRho26
1574,uof,2843316,2843316,2842900,416,412,utRho26
1575,upp,5241818,5241818,5241744,74,92,utRho26
1576,usg,4873780,4873780,4873298,482,0,utRho26
1577,ushA,1009772,1009828,1009772,56,0,utRho26
1578,uspA,7279966,7280222,7279966,256,712,utRho26
1579,uspB,7279696,7279696,7279440,256,136,utRho26
1580,uspC,3959172,3959506,3959172,334,92,utRho26
1581,uspE,2797318,2797318,2797244,74,0,utRho26
1582,uspF,2871282,2871282,2871238,44,138,utRho26
1583,uspG,1283806,1283806,1283734,72,312,utRho26
1584,uvrA,8547872,8547872,8547742,130,242,utRho26
1585,uvrB,1626304,1627052,1626304,748,158,utRho26
1586,uvrC,3989758,3989758,3989412,346,0,utRho26
1587,uvrD,7995814,7995966,7995814,152,4,utRho26
1588,uvrY,3990812,3990812,3990718,94,38,utRho26
1589,uxaB,3221474,3221474,3221360,114,0,utRho26
1590,uxaC,6489714,6489714,6489482,232,108,utRho26
1591,uxuA,9103036,9103272,9103036,236,338,utRho26
1592,uxuR,9108916,9109152,9108916,236,0,utRho26
1593,valS,8967854,8967854,8967674,180,98,utRho26
1594,valU,5041848,5041862,5041848,14,0,utRho26
1595,valV,3492830,3492870,3492830,40,40,utRho26
1596,ves,3649968,3649968,3649874,94,0,utRho26
1597,waaA,7616512,7617080,7616512,568,272,utRho26
1598,waaH,7580298,7580298,7580162,136,0,utRho26
1599,waaQ,7616476,7616476,7616196,280,392,utRho26
1600,waaU,7598996,7598996,7598624,372,6,utRho26
1601,waaY,7602272,7602272,7601930,342,7950,utRho26
1602,wbbH,4214888,4214888,4214452,436,782,utRho26
1603,wbbK,4209212,4209212,4209018,194,122,utRho26
1604,wcaM,4231868,4231868,4231792,76,0,utRho26
1605,wrbA,2135516,2135516,2135416,100,0,utRho26
1606,wza,4275166,4275166,4274486,680,0,utRho26
1607,wzxC,4240674,4240674,4240316,358,254,utRho26
1608,wzzB,4196950,4196950,4196602,348,90,utRho26
1609,xanP,7657642,7657890,7657642,248,0,utRho26
1610,xanQ,6048520,6048702,6048520,182,16,utRho26
1611,xapA,5049820,5049820,5049756,64,0,utRho26
1612,xapR,10090252,10090252,10089908,344,0,utRho26
1613,xdhA,6000514,6000690,6000514,176,362,utRho26
1614,xerD,6079702,6079702,6079486,216,64,utRho26
1615,xseA,5268394,5268464,5268394,70,64,utRho26
1616,xseB,882746,882746,882686,60,0,utRho26
1617,xthA,3664798,3664856,3664798,58,0,utRho26
1618,xylA,7461614,7461614,7461530,84,1832,utRho26
1619,xylE,8484540,8484540,8484508,32,0,utRho26
1620,xylF,7462138,7462262,7462138,124,34,utRho26
1621,xylR,7469812,7469958,7469812,146,0,utRho26
1622,yaaA,13230,13230,12918,312,36,utRho26
1623,yaaI,23876,23876,23572,304,168,utRho26
1624,yaaJ,16034,16034,15918,116,202,utRho26
1625,yaaU,91184,91614,91184,430,0,utRho26
1626,yaaW,23084,23084,22712,372,86,utRho26
1627,yaaX,10060,10468,10060,408,0,utRho26
1628,yabI,142542,142702,142542,160,0,utRho26
1629,yacC,273880,273880,273834,46,2,utRho26
1630,yacH,262932,262932,262520,412,132,utRho26
1631,yacL,268678,268776,268678,98,144,utRho26
1632,yadD,293796,293936,293796,140,0,utRho26
1633,yadE,289930,290162,289930,232,66,utRho26
1634,yadN,314110,314110,313766,344,82,utRho26
1635,yadS,355572,355572,355248,324,622,utRho26
1636,yadV,312470,312470,312402,68,550,utRho26
1637,yaeF,434270,434270,434006,264,0,utRho26
1638,yaeP,428374,428374,428250,124,56,utRho26
1639,yaeQ,428176,428582,428176,406,56,utRho26
1640,yaeR,423716,423754,423716,38,0,utRho26
1641,yafC,462166,462166,461762,404,238,utRho26
1642,yafD,462128,462244,462128,116,364,utRho26
1643,yafK,491986,491986,491610,376,20,utRho26
1644,yafL,493282,493424,493282,142,0,utRho26
1645,yafN,503938,504010,503938,72,0,utRho26
1646,yafS,469568,469632,469568,64,296,utRho26
1647,yafT,474470,474670,474470,200,0,utRho26
1648,yafV,480432,480432,480378,54,66,utRho26
1649,yafZ,536052,536052,536010,42,0,utRho26
1650,yagE,564446,564556,564446,110,0,utRho26
1651,yagG,570414,570790,570414,376,0,utRho26
1652,yagI,578384,578384,578324,60,2,utRho26
1653,yagK,586236,586236,585896,340,358,utRho26
1654,yagL,588062,588062,587836,226,0,utRho26
1655,yagN,591342,591342,591158,184,26,utRho26
1656,yahA,663746,664742,663746,996,1472,utRho26
1657,yahC,670136,670136,670044,92,8,utRho26
1658,yahE,671478,671850,671478,372,0,utRho26
1659,yahM,690504,690808,690504,304,100,utRho26
1660,yahN,692872,692872,692674,198,430,utRho26
1661,yahO,692864,692968,692864,104,198,utRho26
1662,yaiE,816296,816354,816296,58,0,utRho26
1663,yaiI,811396,811528,811396,132,0,utRho26
1664,yaiO,761946,761946,761684,262,0,utRho26
1665,yaiP,767970,767970,767870,100,0,utRho26
1666,yaiS,769660,769660,769232,428,52,utRho26
1667,yaiV,788922,788922,788922,0,0,utRho26
1668,yaiY,799094,799094,798666,428,120,utRho26
1669,yaiZ,798888,799186,798888,298,0,utRho26
1670,yajC,854410,854574,854410,164,50,utRho26
1671,yajD,860938,861210,860938,272,2,utRho26
1672,yajI,866068,866068,865702,366,36,utRho26
1673,yajL,887496,887496,887282,214,16,utRho26
1674,yajQ,889316,889366,889316,50,0,utRho26
1675,yajR,893374,893374,893332,42,0,utRho26
1676,ybaB,987418,988152,987418,734,336,utRho26
1677,ybaL,1006590,1006590,1006476,114,72,utRho26
1678,ybaM,980648,980648,980542,106,6,utRho26
1679,ybaN,981436,981764,981436,328,328,utRho26
1680,ybaO,936704,936766,936704,62,0,utRho26
1681,ybaP,1016568,1016568,1016160,408,334,utRho26
1682,ybaQ,1016348,1016436,1016348,88,108,utRho26
1683,ybaS,1023146,1023282,1023146,136,0,utRho26
1684,ybaV,927504,927874,927504,370,0,utRho26
1685,ybaY,950490,950758,950490,268,0,utRho26
1686,ybbB,1062724,1062724,1062452,272,176,utRho26
1687,ybbJ,1030154,1030154,1029718,436,328,utRho26
1688,ybbL,1031784,1031838,1031784,54,8,utRho26
1689,ybbN,1037136,1037136,1036558,578,844,utRho26
1690,ybbO,1038658,1038658,1038298,360,160,utRho26
1691,ybbY,1080718,1081130,1080718,412,190,utRho26
1692,ybcH,1176140,1176140,1175962,178,88,utRho26
1693,ybcI,1113264,1113264,1113106,158,18,utRho26
1694,ybcJ,1114050,1114050,1113746,304,84,utRho26
1695,ybcK,1137502,1137804,1137502,302,114,utRho26
1696,ybcL,1141690,1141786,1141690,96,0,utRho26
1697,ybcN,1144628,1144932,1144628,304,0,utRho26
1698,ybcQ,1147548,1147912,1147548,364,32,utRho26
1699,ybcW,1159610,1159760,1159610,150,0,utRho26
1700,ybdD,1263982,1264364,1263982,382,6,utRho26
1701,ybdF,1212106,1212106,1211772,334,0,utRho26
1702,ybdH,1267048,1267048,1266954,94,2,utRho26
1703,ybdJ,1212822,1212822,1212398,424,182,utRho26
1704,ybdK,1215122,1215122,1214766,356,4,utRho26
1705,ybdL,1267114,1267172,1267114,58,0,utRho26
1706,ybdM,1271110,1271110,1270752,358,4,utRho26
1707,ybdN,1273372,1273372,1273138,234,22,utRho26
1708,ybdR,1283844,1284176,1283844,332,520,utRho26
1709,ybeD,1325412,1325412,1325284,128,558,utRho26
1710,ybeF,1323090,1323090,1322756,334,118,utRho26
1711,ybeL,1349986,1350036,1349986,50,88,utRho26
1712,ybeQ,1353412,1353412,1353094,318,2,utRho26
1713,ybeR,1353120,1353422,1353120,302,2,utRho26
1714,ybeT,1358832,1358832,1358812,20,0,utRho26
1715,ybeU,1358924,1359016,1358924,92,0,utRho26
1716,ybeZ,1386938,1386938,1386834,104,264,utRho26
1717,ybfA,1458074,1458268,1458074,194,0,utRho26
1718,ybfE,1423878,1423878,1423796,82,198,utRho26
1719,ybfF,1425692,1425692,1425604,88,148,utRho26
1720,ybfH,1433282,1433282,1433194,88,56,utRho26
1721,ybgA,1477840,1478002,1477840,162,2,utRho26
1722,ybgC,1549288,1549504,1549288,216,0,utRho26
1723,ybgD,1505916,1505916,1505590,326,892,utRho26
1724,ybgI,1485238,1485654,1485238,416,0,utRho26
1725,ybgO,1498370,1498370,1497964,406,84,utRho26
1726,ybgS,1570992,1570992,1570634,358,0,utRho26
1727,ybhA,1597184,1597184,1596862,322,0,utRho26
1728,ybhB,1616070,1616070,1615818,252,0,utRho26
1729,ybhC,1614642,1614642,1614562,80,8,utRho26
1730,ybhD,1601418,1601418,1601276,142,0,utRho26
1731,ybhH,1601104,1601518,1601104,414,0,utRho26
1732,ybhK,1633384,1633384,1633294,90,66,utRho26
1733,ybhM,1641556,1641586,1641556,30,42,utRho26
1734,ybhN,1645296,1645296,1644996,300,0,utRho26
1735,ybhQ,1649202,1649260,1649202,58,60,utRho26
1736,ybiA,1665920,1665920,1665900,20,0,utRho26
1737,ybiI,1676968,1676968,1676912,56,108,utRho26
1738,ybiO,1691328,1691328,1690960,368,80,utRho26
1739,ybiP,1705252,1705252,1705194,58,4,utRho26
1740,ybiS,1711572,1711572,1711488,84,198,utRho26
1741,ybiT,1711894,1711926,1711894,32,0,utRho26
1742,ybiU,1718212,1718212,1718122,90,0,utRho26
1743,ybiV,1720176,1720176,1720056,120,0,utRho26
1744,ybiW,1725566,1725566,1725212,354,572,utRho26
1745,ybiX,1678548,1678548,1678414,134,334,utRho26
1746,ybjC,1781784,1781826,1781784,42,0,utRho26
1747,ybjE,1830154,1830154,1829714,440,90,utRho26
1748,ybjG,1767016,1767016,1766776,240,32,utRho26
1749,ybjL,1779882,1779882,1779638,244,0,utRho26
1750,ybjM,1779770,1780178,1779770,408,0,utRho26
1751,ybjO,1795704,1795978,1795704,274,0,utRho26
1752,ybjP,1809046,1809046,1808934,112,0,utRho26
1753,ybjQ,1809034,1809186,1809034,152,0,utRho26
1754,ybjS,1813796,1813796,1813506,290,14,utRho26
1755,ybjX,1838206,1838206,1838168,38,0,utRho26
1756,ycaD,1891438,1891742,1891438,304,0,utRho26
1757,ycaI,1928210,1928640,1928210,430,56,utRho26
1758,ycaK,1899094,1899336,1899094,242,82,utRho26
1759,ycaL,1920264,1920528,1920264,264,0,utRho26
1760,ycaM,1894240,1894458,1894240,218,74,utRho26
1761,ycaR,1941284,1941346,1941284,62,234,utRho26
1762,ycbB,1961862,1962094,1961862,232,376,utRho26
1763,ycbJ,1943344,1943504,1943344,160,0,utRho26
1764,ycbK,1966046,1966150,1966046,104,0,utRho26
1765,ycbZ,2036920,2036920,2036598,322,56,utRho26
1766,yccA,2062886,2062886,2062836,50,50,utRho26
1767,yccF,2048730,2048730,2048696,34,0,utRho26
1768,yccS,2047988,2047988,2047766,222,78,utRho26
1769,yccT,2055674,2055674,2055546,128,0,utRho26
1770,yccX,2059960,2060128,2059960,168,2,utRho26
1771,ycdT,2185682,2185752,2185682,70,86,utRho26
1772,ycdU,2191266,2191686,2191266,420,0,utRho26
1773,ycdZ,2200504,2200592,2200504,88,26,utRho26
1774,yceA,2233544,2233614,2233544,70,0,utRho26
1775,yceD,2293298,2293588,2293298,290,2276,utRho26
1776,yceF,2293522,2293522,2293190,332,1358,utRho26
1777,yceH,2252154,2252314,2252154,160,244,utRho26
1778,yceI,2237282,2237282,2236952,330,100,utRho26
1779,yceJ,2238142,2238142,2238092,50,4,utRho26
1780,yceM,2253208,2253612,2253208,404,24,utRho26
1781,yceO,2239264,2239264,2238894,370,186,utRho26
1782,yceQ,2288760,2289004,2288760,244,1402,utRho26
1783,ycfD,2376540,2376540,2376480,60,42,utRho26
1784,ycfJ,2334814,2335198,2334814,384,0,utRho26
1785,ycfS,2340834,2340834,2340748,86,0,utRho26
1786,ycfT,2350658,2350658,2350330,328,160,utRho26
1787,ycfZ,2362760,2362760,2362534,226,12,utRho26
1788,ycgB,2474570,2474570,2474482,88,0,utRho26
1789,ycgG,2434614,2434656,2434614,42,28,utRho26
1790,ycgJ,2452956,2453200,2452956,244,0,utRho26
1791,ycgL,2455218,2455362,2455218,144,56,utRho26
1792,ycgN,2457366,2457660,2457366,294,116,utRho26
1793,ycgR,2489112,2489112,2489054,58,0,utRho26
1794,ycgV,2512222,2512222,2511904,318,248,utRho26
1795,ycgX,2426568,2426568,2426214,354,378,utRho26
1796,ycgY,2490166,2490320,2490166,154,50,utRho26
1797,ycgZ,2431504,2431578,2431504,74,4,utRho26
1798,ychE,2596904,2597196,2596904,292,94,utRho26
1799,ychF,2515764,2515764,2515624,140,0,utRho26
1800,ychH,2517476,2517582,2517476,106,576,utRho26
1801,ychJ,2578354,2578354,2578264,90,0,utRho26
1802,ychN,2547310,2547310,2547198,112,0,utRho26
1803,ychO,2547520,2547850,2547520,330,132,utRho26
1804,ychQ,2533798,2533848,2533798,50,0,utRho26
1805,yciA,2624828,2624828,2624492,336,2,utRho26
1806,yciB,2626110,2626110,2625780,330,428,utRho26
1807,yciC,2627396,2627396,2627326,70,28,utRho26
1808,yciE,2630794,2630794,2630448,346,0,utRho26
1809,yciG,5264368,5264368,5264140,228,224,utRho26
1810,yciI,2621784,2621784,2621730,54,0,utRho26
1811,yciN,2661606,2661606,2661336,270,0,utRho26
1812,yciS,2680270,2680486,2680270,216,0,utRho26
1813,yciT,2689088,2689088,2688692,396,188,utRho26
1814,yciU,2614718,2614718,2614300,418,222,utRho26
1815,yciV,2646376,2646440,2646376,64,0,utRho26
1816,yciW,2700472,2700472,2700214,258,12,utRho26
1817,yciZ,2689276,2689276,2689218,58,158,utRho26
1818,ycjD,2703792,2703792,2703520,272,0,utRho26
1819,ycjG,2777748,2777860,2777748,112,40,utRho26
1820,ycjM,2740006,2740432,2740006,426,98,utRho26
1821,ycjW,2767982,2767982,2767922,60,0,utRho26
1822,ycjX,2768138,2768234,2768138,96,76,utRho26
1823,ycjY,5568288,5568288,5567460,828,152,utRho26
1824,ydaE,2836438,2836438,2836016,422,90,utRho26
1825,ydaN,2816048,2816100,2816048,52,0,utRho26
1826,ydaS,2840340,2840730,2840340,390,0,utRho26
1827,ydbC,2948376,2948442,2948376,66,2,utRho26
1828,ydbD,2950132,2950288,2950132,156,0,utRho26
1829,ydbH,2885800,2886102,2885800,302,1722,utRho26
1830,ydbJ,2881712,2882116,2881712,404,562,utRho26
1831,ydbK,2881692,2881692,2881568,124,96,utRho26
1832,ydcA,2983294,2983354,2983294,60,0,utRho26
1833,ydcF,2974404,2974470,2974404,66,0,utRho26
1834,ydcI,2990268,2990268,2990142,126,0,utRho26
1835,ydcJ,2990266,2990576,2990266,310,0,utRho26
1836,ydcK,3001280,3001280,3000898,382,0,utRho26
1837,ydcL,3004646,3004914,3004646,268,0,utRho26
1838,ydcN,3012308,3012344,3012308,36,118,utRho26
1839,ydcP,3013508,3013562,3013508,54,0,utRho26
1840,ydcR,3019956,3020006,3019956,50,0,utRho26
1841,ydcS,3022906,3023308,3022906,402,94,utRho26
1842,ydcX,3034442,3034778,3034442,336,4,utRho26
1843,ydcY,3035220,3035296,3035220,76,10,utRho26
1844,ydcZ,3036750,3036750,3036662,88,26,utRho26
1845,yddB,3155332,3155332,3155238,94,0,utRho26
1846,yddE,3071738,3071738,3071716,22,0,utRho26
1847,yddG,3094410,3094410,3094338,72,0,utRho26
1848,yddJ,3089732,3089732,3089438,294,110,utRho26
1849,yddW,3137704,3137704,3137646,58,0,utRho26
1850,ydeA,3233910,3234056,3233910,146,6,utRho26
1851,ydeE,3242528,3242664,3242528,136,0,utRho26
1852,ydeI,3249118,3249118,3248994,124,0,utRho26
1853,ydeJ,3249376,3249546,3249376,170,0,utRho26
1854,ydeN,3165458,3165458,3165048,410,0,utRho26
1855,ydeP,3173328,3173328,3172972,356,188,utRho26
1856,ydeR,3176596,3176596,3176592,4,0,utRho26
1857,ydfA,3296872,3297016,3296872,144,0,utRho26
1858,ydfG,3254982,3255034,3254982,52,58,utRho26
1859,ydfH,3256652,3256704,3256652,52,0,utRho26
1860,ydfK,3265446,3266144,3265446,698,300,utRho26
1861,ydgA,3379588,3379704,3379588,116,0,utRho26
1862,ydgC,3364124,3364124,3364060,64,0,utRho26
1863,ydgD,3343906,3343920,3343906,14,0,utRho26
1864,ydgH,3356754,3356854,3356754,100,24,utRho26
1865,ydgJ,3408798,3408798,3408616,182,24,utRho26
1866,ydgK,3410414,3410500,3410414,86,370,utRho26
1867,ydhB,3479618,3479618,3479596,22,0,utRho26
1868,ydhC,3479698,3479822,3479698,124,0,utRho26
1869,ydhF,3451310,3451310,3451264,46,0,utRho26
1870,ydhI,3441996,3442050,3441996,54,0,utRho26
1871,ydhL,3451864,3451864,3451840,24,0,utRho26
1872,ydhQ,3492404,3492404,3492254,150,0,utRho26
1873,ydhS,3494136,3494262,3494136,126,38,utRho26
1874,ydhT,3499138,3499138,3499118,20,0,utRho26
1875,ydhY,3509284,3509284,3508954,330,0,utRho26
1876,ydhZ,3510418,3510418,3510282,136,0,utRho26
1877,ydiE,3579206,3579226,3579206,20,0,utRho26
1878,ydiH,3530582,3530582,3530406,176,74,utRho26
1879,ydiM,3541852,3542142,3541852,290,4,utRho26
1880,ydiN,3544818,3545024,3544818,206,0,utRho26
1881,ydiP,3558656,3558656,3558602,54,138,utRho26
1882,ydiU,3582508,3582508,3582488,20,0,utRho26
1883,ydiV,3584174,3584174,3584040,134,58,utRho26
1884,ydiY,3612500,3612500,3612166,334,78,utRho26
1885,ydjA,3697400,3697400,3697352,48,0,utRho26
1886,ydjE,3708082,3708082,3707958,124,0,utRho26
1887,ydjF,3709848,3709848,3709708,140,0,utRho26
1888,ydjM,3620340,3620422,3620340,82,0,utRho26
1889,ydjO,3626696,3626696,3626288,408,2,utRho26
1890,ydjX,3666434,3666802,3666434,368,8,utRho26
1891,yeaE,3731448,3731448,3731272,176,166,utRho26
1892,yeaG,3733530,3733816,3733530,286,92,utRho26
1893,yeaI,3740486,3740770,3740486,284,136,utRho26
1894,yeaJ,3743874,3744082,3743874,208,0,utRho26
1895,yeaL,3748646,3748704,3748646,58,42,utRho26
1896,yeaM,3751296,3751296,3751152,144,0,utRho26
1897,yeaN,3750926,3751346,3750926,420,0,utRho26
1898,yeaO,3753554,3753818,3753554,264,0,utRho26
1899,yeaP,3755314,3755430,3755314,116,26,utRho26
1900,yeaQ,3758780,3758780,3758510,270,4,utRho26
1901,yeaR,3759988,3759988,3759896,92,0,utRho26
1902,yeaY,3781122,3781122,3781064,58,6,utRho26
1903,yebB,3892220,3892502,3892220,282,90,utRho26
1904,yebC,3896370,3896370,3896302,68,46,utRho26
1905,yebE,3859464,3859464,3859414,50,0,utRho26
1906,yebG,3861530,3861530,3861494,36,0,utRho26
1907,yebK,3873180,3873304,3873180,124,0,utRho26
1908,yebQ,3820314,3820552,3820314,238,0,utRho26
1909,yebS,3832238,3832516,3832238,278,0,utRho26
1910,yebV,3843430,3843560,3843430,130,0,utRho26
1911,yebW,3843914,3844242,3843914,328,214,utRho26
1912,yecC,3995646,3995646,3995628,18,0,utRho26
1913,yecD,3901272,3901664,3901272,392,92,utRho26
1914,yecF,3991434,3991636,3991434,202,0,utRho26
1915,yecH,3979304,3979304,3978980,324,0,utRho26
1916,yecJ,3975604,3975604,3975516,88,0,utRho26
1917,yecM,3919968,3919968,3919692,276,0,utRho26
1918,yecR,3976400,3976444,3976400,44,354,utRho26
1919,yecT,3923862,3923944,3923862,82,0,utRho26
1920,yedD,4016522,4016522,4016180,342,4,utRho26
1921,yedE,4016310,4016554,4016310,244,6,utRho26
1922,yedI,4058922,4058922,4058732,190,0,utRho26
1923,yedJ,4066446,4066446,4066158,288,0,utRho26
1924,yedV,4076404,4076404,4076304,100,0,utRho26
1925,yedX,4077680,4077912,4077680,232,12,utRho26
1926,yedY,4078572,4078956,4078572,384,0,utRho26
1927,yeeA,4161322,4161322,4161182,140,72,utRho26
1928,yeeE,4171104,4171104,4171050,54,132,utRho26
1929,yeeJ,4089526,4089822,4089526,296,20,utRho26
1930,yeeN,4113508,4113716,4113508,208,2,utRho26
1931,yeeO,4119444,4119444,4119692,248,266,utRho26
1932,yeeX,4158834,4158834,4158722,112,150,utRho26
1933,yeeZ,4178422,4178422,4178256,166,0,utRho26
1934,yefM,4179466,4179466,4179426,40,0,utRho26
1935,yegD,4295288,4295348,4295288,60,0,utRho26
1936,yegH,4275726,4275804,4275726,78,0,utRho26
1937,yegI,4302154,4302154,4301970,184,0,utRho26
1938,yegJ,4302032,4302370,4302032,338,24,utRho26
1939,yegQ,4331182,4331336,4331182,154,72,utRho26
1940,yegR,4336698,4336698,4336612,86,312,utRho26
1941,yegS,4337086,4337424,4337086,338,252,utRho26
1942,yegT,4357562,4357642,4357562,80,168,utRho26
1943,yegX,4367640,4367640,4367302,338,0,utRho26
1944,yehA,4376944,4376944,4376828,116,0,utRho26
1945,yehE,4385818,4385818,4385592,226,0,utRho26
1946,yehK,4407568,4407944,4407568,376,0,utRho26
1947,yehL,4408804,4409192,4408804,388,0,utRho26
1948,yeiB,4486146,4486146,4485934,212,0,utRho26
1949,yeiE,4499422,4499422,4499236,186,0,utRho26
1950,yeiG,4487776,4487820,4487776,44,4,utRho26
1951,yeiH,4499332,4499434,4499332,102,30,utRho26
1952,yeiI,4503306,4503400,4503306,94,0,utRho26
1953,yeiL,4510580,4510710,4510580,130,0,utRho26
1954,yeiP,4530834,4530900,4530834,66,80,utRho26
1955,yeiQ,4532328,4532490,4532328,162,0,utRho26
1956,yeiR,4535484,4535658,4535484,174,2,utRho26
1957,yeiW,4530840,4530840,4530590,250,74,utRho26
1958,yejA,4544624,4544728,4544624,104,0,utRho26
1959,yejG,4556892,4556892,4556474,418,760,utRho26
1960,yejH,4561244,4561264,4561244,20,0,utRho26
1961,yejK,4568218,4568218,4567894,324,0,utRho26
1962,yejO,4578352,4578352,4577800,552,160,utRho26
1963,yfaD,4713380,4713808,4713380,428,244,utRho26
1964,yfaE,4696676,4697028,4696676,352,238,utRho26
1965,yfaL,4688568,4688568,4688338,230,32,utRho26
1966,yfaP,4656398,4656398,4656286,112,0,utRho26
1967,yfaU,4717892,4717892,4717690,202,0,utRho26
1968,yfaY,4727310,4727310,4727266,44,400,utRho26
1969,yfaZ,4728744,4728744,4728550,194,110,utRho26
1970,yfbK,4771810,4771810,4771444,366,60,utRho26
1971,yfbL,4771500,4771720,4771500,220,60,utRho26
1972,yfbN,4777174,4777174,4776852,322,0,utRho26
1973,yfbO,4776916,4777162,4776916,246,0,utRho26
1974,yfbP,4777990,4778232,4777990,242,322,utRho26
1975,yfbR,4817662,4817724,4817662,62,56,utRho26
1976,yfcI,4847424,4847424,4847078,346,8,utRho26
1977,yfcJ,4880482,4880482,4880240,242,122,utRho26
1978,yfcL,4888502,4888502,4888338,164,0,utRho26
1979,yfcV,4911642,4911642,4911292,350,0,utRho26
1980,yfcZ,4921958,4921958,4921868,90,36,utRho26
1981,yfdF,4925604,4926024,4925604,420,136,utRho26
1982,yfdG,4935474,4935710,4935474,236,0,utRho26
1983,yfdP,4946844,4947040,4946844,196,0,utRho26
1984,yfdX,4988866,4988866,4988804,62,76,utRho26
1985,yfdY,4990672,4990672,4990584,88,34,utRho26
1986,yfeA,5035784,5035784,5035664,120,262,utRho26
1987,yfeC,5036668,5036934,5036668,266,24,utRho26
1988,yfeH,5053818,5053892,5053818,74,0,utRho26
1989,yfeK,5074630,5074684,5074630,54,130,utRho26
1990,yfeO,5018906,5019260,5018906,354,114,utRho26
1991,yfeR,5054078,5054078,5053712,366,0,utRho26
1992,yfeX,5101356,5101356,5101090,266,0,utRho26
1993,yfeY,5102486,5102486,5102432,54,0,utRho26
1994,yfeZ,5103842,5103842,5103452,390,118,utRho26
1995,yffO,5123804,5124222,5123804,418,304,utRho26
1996,yffQ,5126778,5127154,5126778,376,0,utRho26
1997,yffS,5128800,5128986,5128800,186,0,utRho26
1998,yfgC,5232052,5232188,5232052,136,0,utRho26
1999,yfgF,5258062,5258062,5257876,186,776,utRho26
2000,yfgG,5258170,5258580,5258170,410,818,utRho26
2001,yfgH,5259344,5259584,5259344,240,2,utRho26
2002,yfgM,5278866,5278866,5278566,300,94,utRho26
2003,yfhH,5397414,5397518,5397414,104,0,utRho26
2004,yfhM,5304648,5304648,5304574,74,0,utRho26
2005,yfhR,5328408,5328726,5328408,318,228,utRho26
2006,yfiC,5425610,5425610,5425528,82,120,utRho26
2007,yfiE,5430688,5430688,5430640,48,0,utRho26
2008,yfiL,5482630,5482720,5482630,90,58,utRho26
2009,yfiM,5448066,5448358,5448066,292,1288,utRho26
2010,yfiR,5483354,5483750,5483354,396,0,utRho26
2011,yfjH,5517326,5517326,5517200,126,106,utRho26
2012,yfjI,5517710,5517970,5517710,260,0,utRho26
2013,yfjJ,5521014,5521094,5521014,80,0,utRho26
2014,yfjM,5531970,5531970,5531552,418,1062,utRho26
2015,yfjP,5535080,5535420,5535080,340,420,utRho26
2016,yfjW,5546570,5546636,5546570,66,0,utRho26
2017,yfjX,5551776,5551838,5551776,62,0,utRho26
2018,ygaC,5601180,5601180,5599988,1192,5146,utRho26
2019,ygaM,5600242,5600292,5600242,50,1434,utRho26
2020,ygaU,5593628,5593628,5593572,56,172,utRho26
2021,ygaZ,5619190,5619234,5619190,44,2,utRho26
2022,ygbA,5713656,5713656,5713612,44,0,utRho26
2023,ygbE,5746784,5746784,5746674,110,0,utRho26
2024,ygbI,5722882,5722882,5722528,354,0,utRho26
2025,ygbK,5724394,5724670,5724394,276,0,utRho26
2026,ygbL,5727074,5727186,5727074,112,0,utRho26
2027,ygbN,5729814,5730202,5729814,388,2,utRho26
2028,ygcG,5811210,5811422,5811210,212,2,utRho26
2029,ygcN,5785144,5785314,5785144,170,2,utRho26
2030,ygcU,5799214,5799214,5798836,378,62,utRho26
2031,ygcW,5800942,5800942,5800546,396,76,utRho26
2032,ygdD,5883442,5883442,5883262,180,4,utRho26
2033,ygdG,5861746,5861930,5861746,184,112,utRho26
2034,ygdI,5886526,5886526,5886290,236,0,utRho26
2035,ygdQ,5940784,5940840,5940784,56,6,utRho26
2036,ygdR,5942494,5942542,5942494,48,0,utRho26
2037,ygeA,5961606,5961606,5961270,336,0,utRho26
2038,ygeH,5983758,5984188,5983758,430,78,utRho26
2039,ygeI,5987162,5987276,5987162,114,148,utRho26
2040,ygeR,6000078,6000078,5999782,296,206,utRho26
2041,ygeV,6011694,6011694,6011572,122,106,utRho26
2042,ygeW,6012234,6012524,6012234,290,232,utRho26
2043,ygfB,6110946,6110946,6110888,58,18,utRho26
2044,ygfK,6031984,6032120,6031984,136,32,utRho26
2045,ygfS,6058328,6058328,6058024,304,0,utRho26
2046,ygfZ,6082564,6082626,6082564,62,92,utRho26
2047,yggC,6149512,6149512,6149378,134,4,utRho26
2048,yggE,6136370,6136370,6136160,210,56,utRho26
2049,yggI,6179176,6179510,6179176,334,192,utRho26
2050,yggL,6204508,6204508,6204266,242,408,utRho26
2051,yggM,6199514,6199514,6199130,384,122,utRho26
2052,yggN,6203596,6203596,6203246,350,182,utRho26
2053,yggX,18623958,18624558,18623958,600,234,utRho26
2054,yghA,6298966,6299324,6298966,358,0,utRho26
2055,yghB,6307058,6307126,6307058,68,74,utRho26
2056,yghD,6222614,6222614,6222252,362,32,utRho26
2057,yghF,6225798,6225798,6225840,42,0,utRho26
2058,yghJ,6238640,6238640,6238224,416,0,utRho26
2059,yghQ,6265186,6265186,6264816,370,92,utRho26
2060,yghT,6267830,6268262,6267830,432,0,utRho26
2061,yghU,6277400,6277454,6277400,54,0,utRho26
2062,yghW,6293506,6293506,6293474,32,0,utRho26
2063,yghZ,6295562,6295794,6295562,232,0,utRho26
2064,ygiD,6365122,6365122,6364868,254,248,utRho26
2065,ygiH,6409066,6409388,6409066,322,4,utRho26
2066,ygiL,6370622,6370828,6370622,206,42,utRho26
2067,ygiM,6402084,6402414,6402084,330,178,utRho26
2068,ygiN,6346156,6346284,6346156,128,2,utRho26
2069,ygiQ,6322620,6322620,6322292,328,70,utRho26
2070,ygiS,6335462,6335462,6335436,26,50,utRho26
2071,ygiV,6338582,6338582,6338462,120,28,utRho26
2072,ygiW,6339774,6339774,6339352,422,12,utRho26
2073,ygiZ,6344506,6344506,6344422,84,44,utRho26
2074,ygjH,6442528,6442528,6442494,34,0,utRho26
2075,ygjI,6452140,6452468,6452140,328,140,utRho26
2076,ygjQ,6472730,6473080,6472730,350,204,utRho26
2077,ygjR,6474564,6474586,6474564,22,46,utRho26
2078,ygjV,6483638,6483638,6483488,150,0,utRho26
2079,yhaB,6535632,6535708,6535632,76,0,utRho26
2080,yhaH,6504498,6504608,6504498,110,96,utRho26
2081,yhaI,6505400,6505822,6505400,422,140,utRho26
2082,yhaJ,6508560,6508560,6508428,132,2,utRho26
2083,yhaK,6508538,6508638,6508538,100,0,utRho26
2084,yhbQ,6599878,6599932,6599878,54,178,utRho26
2085,yhbT,6602736,6602736,6602552,184,68,utRho26
2086,yhbU,6602558,6602970,6602558,412,68,utRho26
2087,yhbX,6643302,6643302,6643226,76,6,utRho26
2088,yhbY,6655518,6655580,6655518,62,400,utRho26
2089,yhcA,6723956,6724224,6723956,268,4,utRho26
2090,yhcB,6760364,6760382,6760364,18,0,utRho26
2091,yhcC,6708470,6708470,6708100,370,50,utRho26
2092,yhcF,6733440,6733852,6733440,412,242,utRho26
2093,yhcH,6739124,6739124,6738956,168,0,utRho26
2094,yhcM,6760312,6760312,6759994,318,0,utRho26
2095,yhcN,6770812,6771076,6770812,264,250,utRho26
2096,yhcO,6772606,6772606,6772258,348,0,utRho26
2097,yhdH,6806560,6806968,6806560,408,390,utRho26
2098,yhdJ,6823234,6823306,6823234,72,0,utRho26
2099,yhdN,6879092,6879092,6879018,74,210,utRho26
2100,yhdT,6814702,6814750,6814702,48,80,utRho26
2101,yhdU,6824994,6825242,6824994,248,0,utRho26
2102,yhdV,6836392,6836780,6836392,388,0,utRho26
2103,yhdW,6837944,6838298,6837944,354,0,utRho26
2104,yheO,6953082,6953082,6952880,202,0,utRho26
2105,yheV,6957970,6957970,6957584,386,98,utRho26
2106,yhfA,6971902,6971902,6971636,266,4,utRho26
2107,yhfG,6983294,6983294,6983240,54,2,utRho26
2108,yhfL,6998622,6998896,6998622,274,50,utRho26
2109,yhfY,7023244,7023244,7022844,400,0,utRho26
2110,yhgA,7086294,7086334,7086294,40,0,utRho26
2111,yhgE,7065176,7065176,7064878,298,62,utRho26
2112,yhgF,7074352,7074770,7074352,418,704,utRho26
2113,yhhA,7173458,7173886,7173458,428,130,utRho26
2114,yhhI,7248346,7248756,7248346,410,0,utRho26
2115,yhhJ,7253696,7253696,7253606,90,2,utRho26
2116,yhhM,7211588,7211588,7211220,368,388,utRho26
2117,yhhN,7211150,7211502,7211150,352,196,utRho26
2118,yhhQ,7218238,7218434,7218238,196,40,utRho26
2119,yhhT,7223682,7223730,7223682,48,2,utRho26
2120,yhhX,7162032,7162032,7161610,422,0,utRho26
2121,yhhY,7162222,7162276,7162222,54,0,utRho26
2122,yhhZ,7163516,7163726,7163516,210,4,utRho26
2123,yhiD,7312220,7312220,7311804,416,4408,utRho26
2124,yhiJ,7265190,7265190,7265180,10,0,utRho26
2125,yhiM,7269270,7269682,7269270,412,618,utRho26
2126,yhiN,7275000,7275000,7274820,180,38,utRho26
2127,yhjA,7338522,7338522,7338376,146,74,utRho26
2128,yhjB,7344090,7344090,7343788,302,356,utRho26
2129,yhjC,7344272,7344684,7344272,412,20,utRho26
2130,yhjD,7346660,7346724,7346660,64,0,utRho26
2131,yhjE,7349274,7349572,7349274,298,22,utRho26
2132,yhjG,7356824,7356824,7356730,94,0,utRho26
2133,yhjH,7358458,7358458,7358374,84,122,utRho26
2134,yhjJ,7364032,7364032,7363880,152,0,utRho26
2135,yhjK,7371296,7371296,7371158,138,352,utRho26
2136,yhjR,7392750,7392750,7392370,380,2,utRho26
2137,yhjV,7400796,7401126,7400796,330,112,utRho26
2138,yhjX,7424194,7424194,7424014,180,108,utRho26
2139,yhjY,7425966,7425966,7425868,98,84,utRho26
2140,yiaB,7455654,7455654,7455496,158,56,utRho26
2141,yiaD,7432712,7433094,7432712,382,268,utRho26
2142,yiaF,7438194,7438194,7438088,106,0,utRho26
2143,yiaG,7438862,7438956,7438862,94,108,utRho26
2144,yiaJ,7485236,7485236,7485064,172,14,utRho26
2145,yiaK,7485348,7485466,7485348,118,86,utRho26
2146,yiaT,7503924,7503924,7503736,188,0,utRho26
2147,yiaU,7503792,7503984,7503792,192,8,utRho26
2148,yiaY,7515856,7515856,7515654,202,22,utRho26
2149,yibF,7523950,7523950,7523910,40,32,utRho26
2150,yibG,7536128,7536354,7536128,226,600,utRho26
2151,yibL,7553194,7553330,7553194,136,236,utRho26
2152,yibN,7570112,7570112,7570030,82,26,utRho26
2153,yibT,7552848,7552848,7552760,88,538,utRho26
2154,yicC,7633290,7633352,7633290,62,108,utRho26
2155,yicH,7660862,7660914,7660862,52,0,utRho26
2156,yicJ,7673328,7673328,7671858,1470,3070,utRho26
2157,yicN,7685018,7685018,7684804,214,90,utRho26
2158,yicO,7687914,7687914,7687578,336,0,utRho26
2159,yicR,15250308,15250308,15250236,72,0,utRho26
2160,yidB,7755230,7755230,7754930,300,66,utRho26
2161,yidE,7732780,7732780,7732546,234,134,utRho26
2162,yidF,7711580,7711580,7711222,358,158,utRho26
2163,yidQ,7735088,7735456,7735088,368,1272,utRho26
2164,yidR,7738824,7738824,7738618,206,0,utRho26
2165,yieE,7787658,7787738,7787658,80,72,utRho26
2166,yieH,7793314,7793548,7793314,234,0,utRho26
2167,yieK,7798928,7798928,7798786,142,0,utRho26
2168,yifB,7900350,7900350,7899998,352,284,utRho26
2169,yifL,7988984,7989044,7988984,60,258,utRho26
2170,yigF,8005750,8005750,8005598,152,832,utRho26
2171,yigI,8009448,8009448,8009394,54,74,utRho26
2172,yigM,8022100,8022152,8022100,52,0,utRho26
2173,yihA,8101970,8101970,8101458,512,282,utRho26
2174,yihD,8084098,8084138,8084098,40,0,utRho26
2175,yihF,8088110,8088398,8088110,288,246,utRho26
2176,yihG,8093304,8093304,8093204,100,246,utRho26
2177,yihI,8102616,8102694,8102616,78,0,utRho26
2178,yihL,8120506,8120894,8120506,388,74,utRho26
2179,yihN,8124332,8124494,8124332,162,236,utRho26
2180,yihO,8131942,8131942,8131532,410,40,utRho26
2181,yihQ,8138892,8138892,8138552,340,0,utRho26
2182,yihV,8147064,8147478,8147064,414,0,utRho26
2183,yihX,8151096,8151106,8151096,10,0,utRho26
2184,yiiE,8158192,8158582,8158192,390,108,utRho26
2185,yiiF,8159124,8159502,8159124,378,64,utRho26
2186,yiiG,8173762,8174004,8173762,242,32,utRho26
2187,yiiM,8205506,8205644,8205506,138,258,utRho26
2188,yiiQ,8224624,8224624,8224428,196,0,utRho26
2189,yiiS,8225738,8225934,8225738,196,2,utRho26
2190,yijE,8272178,8272216,8272178,38,0,utRho26
2191,yijF,8275728,8275728,8275314,414,706,utRho26
2192,yijO,8296858,8296858,8296634,224,52,utRho26
2193,yjaA,8426240,8426468,8426240,228,114196,utRho26
2194,yjaB,8428312,8428312,8428246,66,0,utRho26
2195,yjaG,8398746,8399008,8398746,262,6,utRho26
2196,yjaH,8401022,8401132,8401022,110,118,utRho26
2197,yjaZ,8379506,8379572,8379506,66,0,utRho26
2198,yjbB,8455204,8455462,8455204,258,0,utRho26
2199,yjbE,16943432,16943624,16943432,192,140,utRho26
2200,yjbL,8520318,8520642,8520318,324,0,utRho26
2201,yjbQ,8540428,8540476,8540428,48,0,utRho26
2202,yjcB,8550328,8550328,8550082,246,82,utRho26
2203,yjcC,8550836,8550942,8550836,106,0,utRho26
2204,yjcD,8556628,8556958,8556628,330,0,utRho26
2205,yjcE,8559658,8559960,8559658,302,52,utRho26
2206,yjcF,8566212,8566212,8566150,62,0,utRho26
2207,yjcO,8594660,8594660,8594250,410,0,utRho26
2208,yjdA,8654128,8654270,8654128,142,0,utRho26
2209,yjdC,8726660,8726660,8726616,44,0,utRho26
2210,yjdK,8704780,8705168,8704780,388,630,utRho26
2211,yjdL,8713034,8713034,8712822,212,0,utRho26
2212,yjdM,8653672,8653672,8653468,204,1416,utRho26
2213,yjeF,8787354,8788132,8787354,778,638,utRho26
2214,yjeI,8745522,8745618,8745522,96,68,utRho26
2215,yjeJ,8748806,8748806,8748468,338,252,utRho26
2216,yjeV,8785472,8785784,8785472,312,36,utRho26
2217,yjfP,8833512,8833904,8833512,392,0,utRho26
2218,yjfY,8849656,8849656,8849582,74,0,utRho26
2219,yjfZ,8855052,8855052,8854844,208,2,utRho26
2220,yjgA,8916162,8916162,8915730,432,76,utRho26
2221,yjgL,8950802,8950874,8950802,72,0,utRho26
2222,yjgM,8959342,8959342,8959074,268,0,utRho26
2223,yjgN,8959132,8959460,8959132,328,36,utRho26
2224,yjgR,8980170,8980170,8980126,44,0,utRho26
2225,yjgZ,9002116,9002520,9002116,404,258,utRho26
2226,yjhB,9007764,9008116,9007764,352,160,utRho26
2227,yjhG,9048452,9048452,9048188,264,652,utRho26
2228,yjhU,9041080,9041080,9040648,432,200,utRho26
2229,yjiA,9178096,9178096,9177730,366,0,utRho26
2230,yjiJ,9125364,9125364,9125350,14,0,utRho26
2231,yjiK,9127270,9127270,9127422,152,278,utRho26
2232,yjiL,9129604,9129604,9129378,226,0,utRho26
2233,yjiS,9143410,9143502,9143410,92,0,utRho26
2234,yjiY,9182734,9182734,9182558,176,4,utRho26
2235,yjjA,9200674,9200674,9200378,296,118,utRho26
2236,yjjB,18408708,18408708,18407800,908,192,utRho26
2237,yjjJ,9243314,9243538,9243314,224,0,utRho26
2238,yjjK,9261132,9261132,9261044,88,4,utRho26
2239,yjjL,9189764,9189764,9189444,320,0,utRho26
2240,yjjM,9191894,9191894,9191702,192,374,utRho26
2241,yjjP,9206068,9206068,9205716,352,22,utRho26
2242,yjjQ,9206638,9206954,9206638,316,20,utRho26
2243,yjjX,9267798,9267798,9267490,308,12,utRho26
2244,yjjY,9280716,9280804,9280716,88,364,utRho26
2245,yjjZ,9211554,9211608,9211554,54,56,utRho26
2246,yjtD,9281676,9281884,9281676,208,174,utRho26
2247,ykfB,532454,532454,532174,280,84,utRho26
2248,ykfI,527636,527636,527338,298,188,utRho26
2249,ykgB,637050,637050,636638,412,0,utRho26
2250,ykgC,640430,640430,640002,428,0,utRho26
2251,ykgD,640232,640454,640232,222,2,utRho26
2252,ykgE,642962,643216,642962,254,276,utRho26
2253,ykgJ,608524,608524,608364,160,192,utRho26
2254,ykgL,623878,624224,623878,346,104,utRho26
2255,ykgM,625610,625610,625554,56,138,utRho26
2256,ykgR,626570,626570,626484,86,0,utRho26
2257,ylaC,958576,958576,958502,74,248,utRho26
2258,yliE,1745938,1745958,1745938,20,0,utRho26
2259,ymcE,2103660,2103694,2103660,34,0,utRho26
2260,ymdA,2210450,2210828,2210450,378,2,utRho26
2261,ymdB,2211428,2211640,2211428,212,0,utRho26
2262,ymfD,2395322,2395322,2395064,258,102,utRho26
2263,ymfI,2402880,2402994,2402880,114,0,utRho26
2264,ymfJ,2404518,2404518,2404168,350,38,utRho26
2265,ymfK,2406176,2406176,2405866,310,2,utRho26
2266,ymfT,2405766,2406048,2405766,282,2,utRho26
2267,ymgE,2489110,2489456,2489110,346,72,utRho26
2268,ymgF,2437628,2437966,2437628,338,0,utRho26
2269,ymiA,2670112,2670320,2670112,208,164,utRho26
2270,ymjA,2715620,2715620,2715336,284,2,utRho26
2271,ynaI,2791946,2791946,2791844,102,0,utRho26
2272,ynaK,2850438,2850754,2850438,316,96,utRho26
2273,ynbA,2954924,2955242,2954924,318,160,utRho26
2274,yncD,3046552,3046552,3046130,422,0,utRho26
2275,yncE,3046454,3046614,3046454,160,0,utRho26
2276,yncG,3052456,3052494,3052456,38,82,utRho26
2277,yncL,3034492,3034492,3034388,104,4,utRho26
2278,yneE,3218364,3218364,3218044,320,0,utRho26
2279,yneF,3223748,3223748,3223708,40,0,utRho26
2280,yneJ,3229560,3229608,3229560,48,0,utRho26
2281,yneK,3231100,3231526,3231100,426,94,utRho26
2282,yneM,3245176,3245292,3245176,116,0,utRho26
2283,ynfA,3311398,3311398,3311346,52,0,utRho26
2284,ynfB,3311418,3311616,3311418,198,2,utRho26
2285,ynfC,3315094,3315094,3314914,180,0,utRho26
2286,ynfD,3314828,3315130,3314828,302,0,utRho26
2287,ynfE,3316006,3316138,3316006,132,70,utRho26
2288,ynfK,3334670,3334670,3334438,232,0,utRho26
2289,ynfL,3339304,3339304,3339184,120,0,utRho26
2290,ynfM,3339260,3339398,3339260,138,0,utRho26
2291,ynfN,3276598,3276598,3276218,380,68,utRho26
2292,ynfO,3273454,3273512,3273454,58,2,utRho26
2293,ynhG,3517890,3517890,3517450,440,328,utRho26
2294,yniA,3615158,3615592,3615158,434,0,utRho26
2295,yniB,3618526,3618526,3618466,60,0,utRho26
2296,yniC,3618652,3618760,3618652,108,0,utRho26
2297,yniD,3610202,3610330,3610202,128,0,utRho26
2298,ynjE,3678880,3678934,3678880,54,0,utRho26
2299,ynjF,3683222,3683222,3682806,416,16,utRho26
2300,ynjH,3684376,3684376,3684270,106,94,utRho26
2301,ynjI,3690022,3690022,3689742,280,106,utRho26
2302,yoaB,3786642,3786734,3786642,92,120,utRho26
2303,yoaC,3787932,3788146,3787932,214,202,utRho26
2304,yoaE,3803544,3803544,3803170,374,130,utRho26
2305,yoaF,3755444,3755444,3755064,380,26,utRho26
2306,yoaH,3789866,3789866,3789462,404,0,utRho26
2307,yobB,3850418,3850880,3850418,462,136,utRho26
2308,yobF,3815586,3815586,3815182,404,256,utRho26
2309,yobH,3817800,3817850,3817800,50,0,utRho26
2310,yodB,4084352,4084736,4084352,384,0,utRho26
2311,yodC,4057008,4057008,4056740,268,56,utRho26
2312,yohC,4451358,4451358,4451262,96,0,utRho26
2313,yohD,4451526,4451602,4451526,76,0,utRho26
2314,yohJ,4460986,4461248,4460986,262,388,utRho26
2315,yohO,4431172,4431314,4431172,142,0,utRho26
2316,yojI,4617282,4617282,4617230,52,0,utRho26
2317,ypdI,4988988,4989396,4988988,408,98,utRho26
2318,ypfG,5165786,5165786,5165554,232,0,utRho26
2319,ypfM,5182140,5182140,5181732,408,668,utRho26
2320,yphB,5349590,5349590,5349376,214,0,utRho26
2321,ypjA,5565644,5565644,5565452,192,470,utRho26
2322,ypjB,5569636,5569636,5568858,778,92,utRho26
2323,ypjD,5495860,5495774,5495860,86,66,utRho26
2324,yqaE,5594170,5594170,5594056,114,76,utRho26
2325,yqcA,5846100,5846100,5845968,132,124,utRho26
2326,yqcE,5800944,5801184,5800944,240,26,utRho26
2327,yqeC,6030468,6030468,6030114,354,146,utRho26
2328,yqeF,5971618,5971618,5971184,434,412,utRho26
2329,yqeG,5971438,5971694,5971438,256,314,utRho26
2330,yqeH,5975016,5975072,5975016,56,102,utRho26
2331,yqeI,5976688,5977004,5976688,316,0,utRho26
2332,yqeK,5981140,5981140,5980720,420,402,utRho26
2333,yqfA,6086728,6086728,6086296,432,4,utRho26
2334,yqgA,6219042,6219106,6219042,64,0,utRho26
2335,yqgB,6172500,6172500,6172102,398,294,utRho26
2336,yqgE,6185768,6185874,6185768,106,40,utRho26
2337,yqhA,6299150,6299150,6298942,208,38,utRho26
2338,yqhC,6310768,6310768,6310436,332,48,utRho26
2339,yqhD,6310604,6310710,6310604,106,48,utRho26
2340,yqhH,6316842,6317254,6316842,412,0,utRho26
2341,yqiC,6369662,6369680,6369662,18,0,utRho26
2342,yqiJ,6384108,6384416,6384108,308,20,utRho26
2343,yqjA,6495096,6495546,6495096,450,108,utRho26
2344,yqjF,6500932,6501124,6500932,192,130,utRho26
2345,yqjG,6501948,6502048,6501948,100,0,utRho26
2346,yqjH,6433078,6433078,6432982,96,34,utRho26
2347,yqjI,6433506,6433558,6433506,52,118,utRho26
2348,yraH,6574552,6574852,6574552,300,0,utRho26
2349,yraP,6592144,6592818,6592144,674,114,utRho26
2350,yraQ,6596414,6596414,6596276,138,0,utRho26
2351,yraR,6598024,6598024,6597692,332,0,utRho26
2352,yrbG,13360844,13361100,13360844,256,264,utRho26
2353,yrbL,6696842,6696904,6696842,62,0,utRho26
2354,yrbN,6616172,6616172,6615866,306,412,utRho26
2355,yrdB,6860176,6860176,6860046,130,36,utRho26
2356,yrfF,7052548,7052938,7052548,390,0,utRho26
2357,yrhB,7169440,7169518,7169440,78,0,utRho26
2358,ysaB,7451804,7451804,7451424,380,4,utRho26
2359,ysgA,8032686,8032686,8032338,348,130,utRho26
2360,ytfB,8857638,8857638,8857434,204,154,utRho26
2361,ytfE,8864018,8864018,8863966,52,0,utRho26
2362,ytfF,8866296,8866296,8866130,166,276,utRho26
2363,ytfH,8868164,8868226,8868164,62,0,utRho26
2364,ytfI,8875234,8875414,8875234,180,0,utRho26
2365,ytfJ,8878572,8878572,8878524,48,90,utRho26
2366,ytfK,8879022,8879174,8879022,152,108,utRho26
2367,ytfL,8882642,8882642,8882430,212,0,utRho26
2368,ytfQ,8899634,8899924,8899634,290,158,utRho26
2369,ytjB,9249598,9249598,9249578,20,0,utRho26
2370,yzfA,8896588,8896588,8896490,98,0,utRho26
2371,zapA,6111102,6111224,6111102,122,246,utRho26
2372,zapB,8236772,8237030,8236772,258,340,utRho26
2373,zapC,2011700,2011904,2011700,204,0,utRho26
2374,zinT,4082692,4082750,4082692,58,0,utRho26
2375,zipA,5062814,5062814,5062466,348,62,utRho26
2376,zitB,1569716,1569716,1569646,70,74,utRho26
2377,zntA,7212844,7212902,7212844,58,0,utRho26
2378,zntR,6878336,6878336,6878260,76,2,utRho26
2379,znuA,3885322,3885322,3885166,156,2,utRho26
2380,znuC,3885268,3885324,3885268,56,2,utRho26
2381,zraP,8403424,8403424,8403376,48,4,utRho26
2382,zraS,8403810,8403852,8403810,42,0,utRho26
2383,zupT,6364866,6365100,6364866,234,248,utRho26
2384,zur,8520282,8520282,8520006,276,2,utRho26
2385,zwf,3872752,3872752,3872628,124,52,utRho26
0,C0343,2818676,2818728,2818676,52,0,utRho27
1,aaeB,6776526,6776526,6776376,150,0,utRho27
2,aaeR,6778762,6779040,6778762,278,140,utRho27
3,aaeX,6778860,6778860,6778674,186,96,utRho27
4,aat,1854920,1854920,1854864,56,32,utRho27
5,accA,416822,417242,416822,420,310,utRho27
6,accB,6810280,6810872,6810280,592,440,utRho27
7,accD,4868030,4868030,4867852,178,0,utRho27
8,aceB,8430804,8430956,8430804,152,128,utRho27
9,aceE,245938,246034,245938,96,98,utRho27
10,ackA,4826918,4826940,4826918,22,218,utRho27
11,acnA,2670848,2671662,2670848,814,322,utRho27
12,acnB,263038,263230,263038,192,442,utRho27
13,acpP,2303148,2303230,2303148,82,252,utRho27
14,acpS,5402324,5402324,5401996,328,420,utRho27
15,acrA,971396,971396,971238,158,0,utRho27
16,acrB,969370,969370,968806,564,78,utRho27
17,acrD,5174950,5175190,5174950,240,338,utRho27
18,acrE,6827404,6827728,6827404,324,0,utRho27
19,acrR,971398,971522,971398,124,0,utRho27
20,acrZ,1589502,1589546,1589502,44,0,utRho27
21,acs,8575190,8575190,8574742,448,656,utRho27
22,actP,8569870,8569870,8569804,66,0,utRho27
23,ada,4620854,4620854,4620810,44,0,utRho27
24,add,3404404,3404466,3404404,62,24,utRho27
25,ade,7687802,7687928,7687802,126,86,utRho27
26,adhE,2596826,2596826,2596242,584,0,utRho27
27,adhP,3107988,3107988,3107676,312,120,utRho27
28,adiA,8681112,8681112,8681042,70,2,utRho27
29,adiC,8674404,8674404,8674062,342,22,utRho27
30,adiY,8676084,8676084,8675858,226,44,utRho27
31,adk,994278,994350,994278,72,188,utRho27
32,adrA,807374,807406,807374,32,0,utRho27
33,aer,6438240,6438240,6438152,88,0,utRho27
34,aes,1000102,1000102,999946,156,190,utRho27
35,agaR,6557406,6557406,6557330,76,0,utRho27
36,agaS,6563778,6563952,6563778,174,0,utRho27
37,agp,2131118,2131170,2131118,52,0,utRho27
38,agrA,7296126,7296126,7296126,0,0,utRho27
39,agrB,7296588,7296588,7296588,0,0,utRho27
40,ahpC,1277386,1277890,1277386,504,686,utRho27
41,ahpF,1278004,1279506,1278004,1502,23294,utRho27
42,ahr,8992698,8992698,8992418,280,202,utRho27
43,aidB,8828494,8828550,8828494,56,32,utRho27
44,ais,4731512,4731512,4731240,272,0,utRho27
45,alaA,4814816,4815122,4814816,306,20,utRho27
46,alaC,4996798,4996798,4996590,208,16,utRho27
47,alaE,5598140,5598328,5598140,188,182,utRho27
48,alaS,5644180,5644180,5644022,158,356,utRho27
49,alaW,5036612,5036612,5036462,150,6,utRho27
50,aldA,2976380,2976464,2976380,84,0,utRho27
51,aldB,7513070,7513070,7513022,48,40,utRho27
52,alkA,4295118,4295118,4295080,38,36,utRho27
53,alkB,4618890,4618890,4618682,208,80,utRho27
54,allA,1064780,1064902,1064780,122,76,utRho27
55,allD,1092822,1092822,1092726,96,0,utRho27
56,allE,1088112,1088112,1088092,20,36,utRho27
57,allS,1064600,1064600,1064442,158,178,utRho27
58,alr,8531178,8531564,8531178,386,264,utRho27
59,alsE,8617334,8617334,8616956,378,642,utRho27
60,alsK,8615990,8615990,8615598,392,208,utRho27
61,alx,6476740,6477160,6476740,420,20,utRho27
62,amiA,5104482,5104704,5104482,222,34,utRho27
63,amiC,5898378,5898378,5898020,358,194,utRho27
64,amn,4110062,4110122,4110062,60,0,utRho27
65,ampC,8758006,8758006,8757888,118,0,utRho27
66,ampD,237362,237466,237362,104,4,utRho27
67,ampG,907372,907372,907090,282,96,utRho27
68,ampH,792726,792726,792574,152,44,utRho27
69,amyA,4012230,4012312,4012230,82,0,utRho27
70,anmK,3439346,3439346,3439204,142,24,utRho27
71,ansB,6201580,6201580,6201456,124,162,utRho27
72,ansP,3052040,3052040,3051960,80,6,utRho27
73,apaG,104068,104068,103212,856,158,utRho27
74,apaH,102586,102586,102444,142,48,utRho27
75,apbE,4623188,4623188,4623068,120,0,utRho27
76,appA,2081198,2081234,2081198,36,0,utRho27
77,appC,2075420,2075480,2075420,60,0,utRho27
78,appY,1167134,1167362,1167134,228,0,utRho27
79,apt,982620,982824,982620,204,96,utRho27
80,aqpZ,1832424,1832424,1832094,330,64,utRho27
81,araB,140150,140150,140096,54,0,utRho27
82,araC,140482,140774,140482,292,134,utRho27
83,araE,5964416,5964416,5964364,52,0,utRho27
84,araF,3972476,3972476,3972256,220,4,utRho27
85,araH,3967120,3967120,3967086,34,24,utRho27
86,araJ,825058,825058,824962,96,214,utRho27
87,arcA,9281602,9281602,9280612,990,1694,utRho27
88,arcB,6706098,6706098,6706050,48,14,utRho27
89,arcZ,6701154,6701154,6701154,0,0,utRho27
90,arfA,6877346,6877346,6877298,48,68,utRho27
91,argA,5898312,5898484,5898312,172,0,utRho27
92,argC,8309770,8310002,8309770,232,50,utRho27
93,argD,6980442,6980442,6980360,82,4,utRho27
94,argE,8310156,8310156,8309694,462,76,utRho27
95,argF,580680,580680,580610,70,0,utRho27
96,argG,6637124,6637274,6637124,150,0,utRho27
97,argI,8956688,8956688,8956622,66,0,utRho27
98,argO,6137672,6137672,6137616,56,170,utRho27
99,argP,6119460,6119506,6119460,46,10,utRho27
100,argR,6769204,6769406,6769204,202,48,utRho27
101,argS,3920002,3920124,3920002,122,0,utRho27
102,argT,4855698,4855698,4855582,116,18,utRho27
103,argU,1129406,1129446,1129406,40,0,utRho27
104,argW,4932616,4932618,4932616,2,0,utRho27
105,argX,7964728,7964750,7964728,22,2,utRho27
106,aroF,5482402,5482402,5482300,102,26,utRho27
107,aroG,1571182,1571266,1571182,84,46,utRho27
108,aroH,3576636,3576870,3576636,234,232,utRho27
109,aroK,7038760,7038760,7038128,632,228,utRho27
110,aroL,812560,812810,812560,250,28,utRho27
111,aroP,243342,243342,243102,240,42,utRho27
112,arpA,8445382,8445382,8444974,408,8,utRho27
113,arrS,7316108,7316108,7316108,0,0,utRho27
114,arsR,7297024,7297056,7297024,32,0,utRho27
115,artJ,1801252,1801252,1801150,102,0,utRho27
116,artP,1807686,1807686,1807468,218,118,utRho27
117,ascF,5678858,5679048,5678858,190,50,utRho27
118,ascG,5678574,5678574,5678528,46,20,utRho27
119,aslB,7965562,7965916,7965562,354,204,utRho27
120,asnA,7854258,7854310,7854258,52,36,utRho27
121,asnB,1398444,1398444,1398354,90,92,utRho27
122,asnC,23562186,23562186,23562018,168,0,utRho27
123,asnS,1978088,1978088,1977970,118,850,utRho27
124,asnT,4089082,4089098,4089082,16,0,utRho27
125,asnU,4119690,4119702,4119690,12,0,utRho27
126,asnV,4124504,4124520,4124504,16,0,utRho27
127,aspA,17473728,17473728,17473308,420,452,utRho27
128,aspC,1971486,1971486,1971418,68,2,utRho27
129,aspS,3901402,3901402,3901044,358,110,utRho27
130,aspT,7893560,7893744,7893560,184,58620,utRho27
131,aspV,473826,473862,473826,36,108,utRho27
132,asr,3342654,3342752,3342654,98,64,utRho27
133,astC,3664088,3664088,3663964,124,24,utRho27
134,astE,3654138,3654138,3653846,292,94,utRho27
135,atoD,4646824,4646894,4646824,70,108,utRho27
136,atpB,7844540,7844540,7844102,438,136,utRho27
137,atpC,7832118,7832118,7831944,174,326,utRho27
138,atpI,7845050,7845050,7844880,170,770,utRho27
139,avtA,7479348,7479410,7479348,62,444,utRho27
140,azoR,2965982,2965982,2965720,262,572,utRho27
141,azuC,3976002,3976002,3975918,84,92,utRho27
142,bacA,6408350,6408350,6408262,88,926,utRho27
143,bamA,394052,395856,394052,1804,1126,utRho27
144,bamB,5277950,5277950,5277304,646,944,utRho27
145,bamC,5198028,5198028,5197730,298,470,utRho27
146,bamD,5471922,5472292,5471922,370,496,utRho27
147,bamE,5506972,5507210,5506972,238,966,utRho27
148,basS,8666954,8666954,8666544,410,354,utRho27
149,bax,7474468,7474468,7474354,114,218,utRho27
150,bcp,5200874,5200956,5200874,82,44,utRho27
151,bcsB,7385346,7385346,7385214,132,0,utRho27
152,bcsE,7392644,7392916,7392644,272,62,utRho27
153,bdcA,8948128,8948128,8948106,22,50,utRho27
154,bdcR,8948192,8948248,8948192,56,64,utRho27
155,bdm,3112680,3112680,3112560,120,0,utRho27
156,betA,654522,654522,654494,28,20,utRho27
157,betI,658722,658722,658668,54,218,utRho27
158,betT,658842,658926,658842,84,178,utRho27
159,bfr,6933498,6933498,6933450,48,0,utRho27
160,bglG,23440182,23440182,23439402,780,270,utRho27
161,bglX,4444240,4444240,4443978,262,0,utRho27
162,bhsA,2337962,2338146,2337962,184,158,utRho27
163,bioA,1618584,1618584,1618514,70,84,utRho27
164,bioB,1618604,1618688,1618604,84,84,utRho27
165,bioH,7089716,7089716,7089688,28,42,utRho27
166,bisC,7433026,7433026,7432788,238,0,utRho27
167,blc,8755490,8755490,8755444,46,0,utRho27
168,blr,3409024,3409102,3409024,78,184,utRho27
169,bluF,2431226,2431226,2430950,276,364,utRho27
170,bluR,2428226,2428226,2428118,108,20,utRho27
171,bolA,908698,908944,908698,246,32,utRho27
172,borD,1157842,1157842,1157786,56,60,utRho27
173,brnQ,838976,839182,838976,206,1492,utRho27
174,bssR,1756492,1756496,1756492,4,0,utRho27
175,bssS,2242116,2242116,2241910,206,578,utRho27
176,btuB,8326798,8327278,8326798,480,470,utRho27
177,cadB,8720212,8720212,8720062,150,184,utRho27
178,cadC,8723926,8723926,8723868,58,142,utRho27
179,caiE,70998,70998,70742,256,0,utRho27
180,caiF,68436,68600,68436,164,236,utRho27
181,caiT,84074,84074,83862,212,22,utRho27
182,can,285406,285406,285340,66,230,utRho27
183,carA,59102,59302,59102,200,2,utRho27
184,carB,61550,61634,61550,84,38,utRho27
185,cas2,5757830,5757830,5757706,124,92,utRho27
186,casA,5768638,5768638,5768276,362,62,utRho27
187,cbl,4121882,4121882,4121828,54,0,utRho27
188,cbpA,2128074,2128074,2127550,524,110,utRho27
189,cbrA,7738628,7738754,7738628,126,48,utRho27
190,cbrB,7794958,7795012,7794958,54,54,utRho27
191,ccmH,4585242,4585242,4584820,422,104,utRho27
192,cdaR,364894,364926,364894,32,48,utRho27
193,cdd,4463638,4463688,4463638,50,0,utRho27
194,cdh,8219814,8219860,8219814,46,144,utRho27
195,cdsA,391110,391354,391110,244,202,utRho27
196,cedA,3627484,3627484,3627326,158,178,utRho27
197,cfa,3482402,3482826,3482402,424,0,utRho27
198,chaC,2544844,2544972,2544844,128,0,utRho27
199,chbB,3643452,3643452,3643238,214,78,utRho27
200,chbG,3634624,3634624,3634270,354,0,utRho27
201,cheW,3946924,3946924,3946678,246,64,utRho27
202,chiA,6939792,6939792,6939706,86,76,utRho27
203,chiP,1416472,1416668,1416472,196,0,utRho27
204,cho,3646984,3647030,3646984,46,0,utRho27
205,chpS,8896804,8896894,8896804,90,126,utRho27
206,cirA,4493884,4493884,4493538,346,0,utRho27
207,citC,1304078,1304078,1303712,366,230,utRho27
208,citT,1293264,1293264,1293160,104,0,utRho27
209,clcA,350104,350214,350104,110,0,utRho27
210,clpA,1846160,1846528,1846160,368,220,utRho27
211,clpB,5468410,5468410,5468346,64,540,utRho27
212,clpP,913154,913354,913154,200,1364,utRho27
213,clpS,1845500,1845826,1845500,326,426,utRho27
214,clpX,914404,914852,914404,448,2982,utRho27
215,clsA,2617346,2617346,2617290,56,0,utRho27
216,clsC,2212584,2212710,2212584,126,86,utRho27
217,cmk,1922330,1922402,1922330,72,0,utRho27
218,cnu,3409522,3409898,3409522,376,548,utRho27
219,coaA,8350214,8350214,8350052,162,318,utRho27
220,cobC,1340092,1340092,1339814,278,96,utRho27
221,cobT,4129202,4129202,4128934,268,24,utRho27
222,cobU,4131944,4131944,4131528,416,0,utRho27
223,codB,709768,709844,709768,76,16,utRho27
224,comR,2337726,2337726,2337664,62,0,utRho27
225,copA,1022822,1022822,1022758,64,0,utRho27
226,corA,8002388,8002852,8002388,464,12096,utRho27
227,cpdB,8873258,8873258,8873130,128,34,utRho27
228,cptB,6082198,6082198,6082140,58,0,utRho27
229,cpxA,8210202,8210202,8209950,252,76,utRho27
230,cpxP,8211570,8211640,8211570,70,130,utRho27
231,cpxR,8211372,8211372,8211340,32,0,utRho27
232,cra,175894,176056,175894,162,100,utRho27
233,crcB,1316016,1316016,1315876,140,0,utRho27
234,creA,9270486,9271042,9270486,556,208,utRho27
235,creD,9276320,9276356,9276320,36,266,utRho27
236,crl,515620,515658,515620,38,358,utRho27
237,crp,6971906,6972240,6971906,334,140,utRho27
238,crr,5070960,5071668,5070960,708,1634,utRho27
239,csdA,5886414,5886674,5886414,260,44,utRho27
240,csgB,2207718,2207902,2207718,184,0,utRho27
241,csgD,2206688,2206688,2206392,296,356,utRho27
242,csgG,2203510,2203510,2203368,142,632,utRho27
243,csiD,5577854,5577970,5577854,116,0,utRho27
244,csiE,5330802,5330870,5330802,68,172,utRho27
245,csiR,5590942,5591348,5590942,406,100,utRho27
246,cspA,7439778,7440098,7439778,320,366,utRho27
247,cspB,3283430,3283430,3283108,322,0,utRho27
248,cspC,3815018,3815018,3814870,148,192,utRho27
249,cspD,1845352,1845352,1845180,172,2802,utRho27
250,cspE,1314294,1314584,1314294,290,332,utRho27
251,cspF,3283380,3283710,3283380,330,286,utRho27
252,cspG,2102610,2102922,2102610,312,486,utRho27
253,cspH,2102746,2102746,2102350,396,412,utRho27
254,cspI,3277624,3277624,3277334,290,184,utRho27
255,csrA,5638746,5638746,5638292,454,608,utRho27
256,csrB,5849048,5849048,5849048,0,0,utRho27
257,csrC,8102072,8102072,8102072,0,0,utRho27
258,csrD,6806850,6806850,6806664,186,48,utRho27
259,cstA,1259710,1259788,1259710,78,0,utRho27
260,cueO,274090,274166,274090,76,0,utRho27
261,cueR,1027948,1027986,1027948,38,0,utRho27
262,curA,3037784,3038054,3037784,270,44,utRho27
263,cusC,1191146,1191200,1191146,54,0,utRho27
264,cusR,1190924,1190924,1190886,38,56,utRho27
265,cutA,8730784,8730784,8730712,72,0,utRho27
266,cutC,3918534,3918534,3917920,614,130,utRho27
267,cvpA,4861600,4861600,4861526,74,0,utRho27
268,cvrA,2484328,2484328,2484142,186,0,utRho27
269,cyaA,7981548,7982306,7981548,758,510,utRho27
270,cyaR,4334228,4334224,4334228,4,0,utRho27
271,cyaY,7988166,7988166,7988118,48,434,utRho27
272,cybB,2981522,2981804,2981522,282,8,utRho27
273,cycA,8859560,8859728,8859560,168,92,utRho27
274,cydA,1542340,1542916,1542340,576,3878,utRho27
275,cydC,1858800,1858800,1858390,410,56,utRho27
276,cydD,1862062,1862062,1861924,138,0,utRho27
277,cydX,1548300,1548392,1548300,92,238,utRho27
278,cynR,717418,717418,717380,38,0,utRho27
279,cynT,1435092,1435196,1435092,104,0,utRho27
280,cyoA,903306,903306,903220,86,88,utRho27
281,cyoE,895540,895540,895410,130,20,utRho27
282,cysB,2667576,2667710,2667576,134,272,utRho27
283,cysC,5748056,5748056,5747984,72,40,utRho27
284,cysD,5752736,5752736,5752658,78,84,utRho27
285,cysE,7565362,7565362,7565124,238,274,utRho27
286,cysG,6995508,6995656,6995508,148,1046,utRho27
287,cysJ,5783928,5783928,5783796,132,948,utRho27
288,cysK,5064688,5064818,5064688,130,0,utRho27
289,cysP,5087114,5087114,5087056,58,42,utRho27
290,cysS,1109154,1109222,1109154,68,106,utRho27
291,cysT,3984100,3984100,3983974,126,14,utRho27
292,cysZ,5062766,5062926,5062766,160,162,utRho27
293,cytR,8249018,8249018,8248912,106,140,utRho27
294,dacA,1328002,1328002,1327926,76,0,utRho27
295,dacB,6657714,6657926,6657714,212,36,utRho27
296,dacC,1761306,1761454,1761306,148,36,utRho27
297,dadA,2475018,2475142,2475018,124,70,utRho27
298,dam,7032504,7032504,7031826,678,350,utRho27
299,damX,7035200,7035200,7034612,588,1144,utRho27
300,dapA,5199568,5199568,5199520,48,0,utRho27
301,dapB,56576,56748,56576,172,36,utRho27
302,dapD,371954,371954,371894,60,38,utRho27
303,dapE,5183120,5183214,5183120,94,184,utRho27
304,dcp,3254844,3254844,3254760,84,4,utRho27
305,dcrB,7219534,7219910,7219534,376,58,utRho27
306,dctA,7366996,7366996,7366894,102,208,utRho27
307,dcuA,8733686,8733686,8733546,140,642,utRho27
308,dcuB,8698182,8698182,8697488,694,782,utRho27
309,dcuC,1312166,1312166,1311936,230,960,utRho27
310,dcuD,6749166,6749738,6749166,572,724,utRho27
311,dcuR,8701130,8701130,8700068,1062,426,utRho27
312,dcuS,8703370,8703370,8703324,46,54,utRho27
313,dcyD,3999016,3999016,3998960,56,0,utRho27
314,ddpX,3126498,3126498,3126152,346,0,utRho27
315,deaD,6615818,6615818,6615720,98,0,utRho27
316,dedA,4869880,4869880,4869482,398,484,utRho27
317,dedD,4863750,4863750,4863368,382,26,utRho27
318,def,6867300,6867380,6867300,80,134,utRho27
319,degP,361690,361768,361690,78,0,utRho27
320,degQ,6761308,6761486,6761308,178,160,utRho27
321,deoB,9239134,9239206,9239134,72,32,utRho27
322,deoC,9233358,9234646,9233358,1288,104,utRho27
323,dfp,7625406,7625462,7625406,56,6,utRho27
324,dgcZ,3247758,3247758,3247700,58,0,utRho27
325,dgkA,8512914,8513274,8512914,360,134,utRho27
326,dgt,358392,358474,358392,82,94,utRho27
327,dhaK,2501888,2501888,2501676,212,12,utRho27
328,dhaR,2502006,2502132,2502006,126,0,utRho27
329,dicB,3299194,3299218,3299194,24,0,utRho27
330,dicC,3295752,3295752,3295700,52,0,utRho27
331,dinB,501760,501796,501760,36,0,utRho27
332,dinD,7635398,7635520,7635398,122,152,utRho27
333,dinG,1666146,1666140,1666146,6,0,utRho27
334,dinI,2243018,2243018,2242974,44,38,utRho27
335,dinJ,493230,493230,493004,226,132,utRho27
336,dinQ,7295964,7295964,7295576,388,292,utRho27
337,djlA,114536,114728,114536,192,16,utRho27
338,dkgA,6313142,6313246,6313142,104,48,utRho27
339,dkgB,458196,458334,458196,138,166,utRho27
340,dksA,321502,321502,321208,294,314,utRho27
341,dld,4444164,4444370,4444164,206,0,utRho27
342,dmlA,3763424,3763824,3763424,400,22,utRho27
343,dmlR,3763710,3763710,3763618,92,0,utRho27
344,dmsA,1881646,1881918,1881646,272,54,utRho27
345,dnaA,7767922,7767922,7767458,464,60,utRho27
346,dnaB,8528566,8528628,8528566,62,148,utRho27
347,dnaK,24096,24326,24096,230,8272,utRho27
348,dnaN,7765466,7765466,7764642,824,190,utRho27
349,dnaQ,471868,472134,471868,266,2448,utRho27
350,dnaT,18406460,18406460,18406068,392,0,utRho27
351,dnaX,984112,984184,984112,72,86,utRho27
352,dosP,3131486,3131486,3131466,20,0,utRho27
353,dpiB,1303968,1304470,1303968,502,80,utRho27
354,dppA,7415740,7415740,7415410,330,396,utRho27
355,dps,1697900,1697900,1697822,78,16,utRho27
356,dsbA,8086754,8086836,8086754,82,384,utRho27
357,dsbB,2466294,2466294,2466060,234,0,utRho27
358,dsbC,6079266,6079266,6077644,1622,792,utRho27
359,dsbG,1277600,1277600,1277146,454,222,utRho27
360,dsdA,4958242,4958404,4958242,162,130,utRho27
361,dsdC,4955492,4955492,4955258,234,28,utRho27
362,dsdX,4955642,4955694,4955642,52,290,utRho27
363,dsrA,4050626,4050626,4050626,0,0,utRho27
364,dsrB,4049686,4049686,4049646,40,88,utRho27
365,dtpD,1485340,1485340,1485112,228,6,utRho27
366,dusA,8523200,8523338,8523200,138,496,utRho27
367,dusB,6820492,6820560,6820492,68,0,utRho27
368,dusC,4460790,4460790,4460770,20,0,utRho27
369,dut,7627704,7627864,7627704,160,126,utRho27
370,dxr,386670,387042,386670,372,164,utRho27
371,ebgA,6445102,6445266,6445102,164,40,utRho27
372,ebgR,6442874,6442932,6442874,58,0,utRho27
373,ecnB,8753018,8753106,8753018,88,8,utRho27
374,eco,4607594,4607810,4607594,216,50,utRho27
375,ecpA,621594,621594,621342,252,52,utRho27
376,ecpB,620238,620238,620052,186,16,utRho27
377,ecpR,622964,622964,622672,292,0,utRho27
378,eda,3866218,3866218,3865512,706,0,utRho27
379,edd,3869426,3869426,3869208,218,0,utRho27
380,efeO,2164308,2164486,2164308,178,0,utRho27
381,efeU_1,2162614,2162712,2162614,98,74,utRho27
382,efp,8751134,8751398,8751134,264,356,utRho27
383,elaA,4763372,4763372,4763086,286,62,utRho27
384,elaD,4765308,4765426,4765308,118,90,utRho27
385,elfA,1995530,1995736,1995530,206,0,utRho27
386,elfD,1996642,1996980,1996642,338,38,utRho27
387,emrD,7707690,7707844,7707690,154,8,utRho27
388,emrK,4966896,4966896,4966678,218,0,utRho27
389,emrY,4964668,4964668,4964352,316,696,utRho27
390,emtA,2486250,2486360,2486250,110,0,utRho27
391,endA,12361100,12361388,12361100,288,0,utRho27
392,eno,5817692,5817692,5815882,1810,350,utRho27
393,entC,1249662,1249770,1249662,108,0,utRho27
394,entD,1220508,1220508,1220158,350,100,utRho27
395,entH,1258584,1258600,1258584,16,0,utRho27
396,entS,1244506,1244600,1244506,94,0,utRho27
397,envR,6827266,6827266,6826930,336,0,utRho27
398,epd,12295292,12295292,12294764,528,228,utRho27
399,epmA,8765236,8765286,8765236,50,24,utRho27
400,epmB,8751406,8751406,8751314,92,228,utRho27
401,eptB,7421162,7421162,7420950,212,84,utRho27
402,eptC,8300622,8300622,8300530,92,170,utRho27
403,erfK,4126708,4126708,4126646,62,168,utRho27
404,erpA,353122,353220,353122,98,38,utRho27
405,esrE,8039956,8039956,8039956,0,0,utRho27
406,essD,1153746,1154796,1153746,1050,188,utRho27
407,etk,2088606,2088606,2088420,186,28,utRho27
408,evgA,4967262,4967510,4967262,248,102,utRho27
409,exbB,6304028,6304028,6303968,60,68,utRho27
410,exbD,6302780,6302780,6302486,294,126,utRho27
411,exuR,6493016,6493304,6493016,288,122,utRho27
412,exuT,6490004,6490208,6490004,204,4,utRho27
413,fabA,2032996,2032996,2032940,56,40,utRho27
414,fabB,4883282,4883282,4883210,72,116,utRho27
415,fabH,2297032,2297518,2297032,486,228,utRho27
416,fabI,2702236,2702236,2702078,158,48,utRho27
417,fadB,8062026,8062026,8061942,84,0,utRho27
418,fadD,3779614,3779614,3779492,122,196,utRho27
419,fadE,486812,486812,486606,206,86,utRho27
420,fadH,6463248,6463330,6463248,82,0,utRho27
421,fadI,4921022,4921022,4920938,84,0,utRho27
422,fadL,4922410,4922600,4922410,190,276,utRho27
423,fadM,928720,928804,928720,84,0,utRho27
424,fadR,2469810,2469876,2469810,66,0,utRho27
425,fbaB,4357334,4357334,4357128,206,0,utRho27
426,fdhE,8162722,8162722,8162456,266,72,utRho27
427,fdhF,8598814,8598814,8598732,82,0,utRho27
428,fdnG,3094744,3094802,3094744,58,0,utRho27
429,fdrA,1093012,1093360,1093012,348,0,utRho27
430,feaB,2894994,2895038,2894994,44,0,utRho27
431,feaR,2894734,2894734,2894566,168,0,utRho27
432,fecA,9033454,9033454,9033354,100,0,utRho27
433,fecE,9023288,9023288,9022914,374,1266,utRho27
434,fecI,9036564,9036564,9036470,94,58,utRho27
435,feoA,7080114,7080326,7080114,212,260,utRho27
436,fepA,1225334,1225334,1224988,346,306,utRho27
437,fepB,1249454,1249454,1249020,434,104,utRho27
438,fepD,1244468,1244468,1244378,90,0,utRho27
439,fes,1225374,1225630,1225374,256,106,utRho27
440,ffh,5495706,5495706,5495590,116,226,utRho27
441,ffs,952576,952848,952576,272,106,utRho27
442,fhuA,334884,334968,334884,84,30,utRho27
443,fhuE,2323294,2323294,2323102,192,36,utRho27
444,fhuF,9211504,9211504,9211326,178,0,utRho27
445,fic,6983296,6983296,6982926,370,74,utRho27
446,fieF,8212864,8212938,8212864,74,0,utRho27
447,fimA,9085388,9086230,9085388,842,1110,utRho27
448,fimB,9081334,9081914,9081334,580,2746,utRho27
449,fimE,9083742,9084074,9083742,332,620,utRho27
450,fimZ,1129214,1129214,1128960,254,14,utRho27
451,fiu,1683296,1683296,1683062,234,12,utRho27
452,fixA,84650,84806,84650,156,0,utRho27
453,fkpA,6955050,6955050,6954838,212,8390,utRho27
454,fldA,2846084,2846084,2845860,224,752,utRho27
455,fldB,6079644,6079710,6079644,66,0,utRho27
456,flgA,2261770,2261770,2261726,44,146,utRho27
457,flgB,2261986,2262036,2261986,50,0,utRho27
458,flgK,2276702,2276756,2276702,54,44,utRho27
459,flgM,2260330,2260330,2260256,74,0,utRho27
460,flgN,2259828,2259828,2259660,168,0,utRho27
461,flhB,3932432,3932432,3932382,50,326,utRho27
462,flhC,3955864,3955864,3955688,176,0,utRho27
463,flhD,3957154,3957154,3956394,760,562,utRho27
464,fliA,4003638,4003638,4003578,60,26,utRho27
465,fliC,4007352,4007352,4007212,140,60,utRho27
466,fliD,4007634,4007744,4007634,110,142,utRho27
467,fliE,4026186,4026186,4026028,158,86,utRho27
468,fliF,4026292,4026458,4026292,166,26,utRho27
469,fliL,4039168,4039236,4039168,68,2,utRho27
470,flk,4875824,4875900,4875824,76,0,utRho27
471,flu,4142634,4143078,4142634,444,12,utRho27
472,flxA,3292776,3292810,3292776,34,68,utRho27
473,fnr,2799104,2799104,2799052,52,10,utRho27
474,fnrS,2818258,2818258,2818258,0,0,utRho27
475,focA,1909628,1909628,1908932,696,0,utRho27
476,folA,99598,99646,99598,48,0,utRho27
477,folB,6409296,6409296,6409178,118,86,utRho27
478,folD,1115562,1115562,1115482,80,0,utRho27
479,folE,4487696,4487696,4487304,392,176,utRho27
480,fpr,8228998,8228998,8228944,54,0,utRho27
481,frc,4986878,4986878,4986508,370,116,utRho27
482,frdA,8764824,8764824,8764636,188,156,utRho27
483,frdD,8758948,8758948,8758732,216,494,utRho27
484,fre,8052886,8053054,8052886,168,120,utRho27
485,frlA,6999518,6999820,6999518,302,210,utRho27
486,frr,385624,385744,385624,120,420,utRho27
487,frsA,513004,513054,513004,50,0,utRho27
488,fruB,4527194,4527194,4526990,204,0,utRho27
489,frvR,8179804,8179804,8179710,94,0,utRho27
490,fryA,5008986,5008986,5008970,16,4,utRho27
491,fsaA,1727060,1727284,1727060,224,42,utRho27
492,fsr,1009710,1009710,1009392,318,276,utRho27
493,ftnA,3977364,3977432,3977364,68,0,utRho27
494,ftnB,3973550,3973850,3973550,300,154,utRho27
495,ftsA,207122,207964,207122,842,348,utRho27
496,ftsB,5745802,5745802,5745640,162,140,utRho27
497,ftsH,6654204,6654204,6653870,334,1486,utRho27
498,ftsK,1865858,1866448,1865858,590,270,utRho27
499,ftsL,181376,182064,181376,688,306,utRho27
500,ftsP,6325732,6325732,6325338,394,184,utRho27
501,ftsQ,205484,206310,205484,826,468,utRho27
502,ftsX,7204512,7204512,7204172,340,400,utRho27
503,ftsZ,209272,210610,209272,1338,84,utRho27
504,fucA,5867708,5867708,5867376,332,236,utRho27
505,fucP,5868238,5868470,5868238,232,154,utRho27
506,fumA,6753760,6753760,6753508,252,1380,utRho27
507,fumB,8694696,8694696,8694652,44,0,utRho27
508,fumC,3373418,3373418,3373176,242,0,utRho27
509,fur,2842892,2842892,2842584,308,116,utRho27
510,fusA,6947370,6947370,6947028,342,3288,utRho27
511,fxsA,8737206,8737328,8737206,122,1636,utRho27
512,gabD,5581824,5582546,5581824,722,592,utRho27
513,gadA,7335214,7335214,7335160,54,0,utRho27
514,gadB,3144144,3144144,3144090,54,12,utRho27
515,gadC,3141168,3141168,3140978,190,1204,utRho27
516,gadE,7315600,7316732,7315600,1132,882,utRho27
517,gadW,7329562,7329562,7329236,326,216,utRho27
518,gadX,14663356,14663356,14663240,116,0,utRho27
519,gadY,7329728,7329728,7329728,0,0,utRho27
520,galE,1584354,1584354,1584110,244,0,utRho27
521,galF,4228702,4228702,4228654,48,160,utRho27
522,galM,1577796,1577796,1577674,122,124,utRho27
523,galP,6176510,6176568,6176510,58,6,utRho27
524,galR,5953138,5953198,5953138,60,2,utRho27
525,galS,4483420,4483420,4483336,84,6,utRho27
526,galU,2582810,2582914,2582810,104,66,utRho27
527,gapA,3724480,3725542,3724480,1062,370,utRho27
528,garP,6549868,6549868,6549814,54,150,utRho27
529,gatY,4354468,4354468,4354408,60,0,utRho27
530,gatZ,4352864,4352864,4352642,222,76,utRho27
531,gcd,282558,282558,282450,108,72,utRho27
532,gcl,1067814,1067832,1067814,18,0,utRho27
533,gcvA,5885278,5885278,5885134,144,0,utRho27
534,gcvB,5885392,5885392,5885392,0,0,utRho27
535,gcvR,5199758,5199812,5199758,54,0,utRho27
536,gcvT,6101544,6101544,6101334,210,164,utRho27
537,gdhA,3684616,3684742,3684616,126,46,utRho27
538,gfcA,2099668,2099668,2099488,180,50,utRho27
539,gfcD,2096236,2096236,2095890,346,46,utRho27
540,ghrA,2195648,2195772,2195648,124,2,utRho27
541,ghrB,7434378,7434620,7434378,242,34,utRho27
542,glcA,6242728,6242728,6242558,170,388,utRho27
543,glcC,6256412,6256544,6256412,132,26,utRho27
544,glcD,6256152,6256152,6256042,110,44,utRho27
545,gldA,8278092,8278092,8278070,22,92,utRho27
546,glgA,7136784,7136784,7136066,718,288,utRho27
547,glgB,7147314,7147314,7147004,310,382,utRho27
548,glgC,7139142,7139142,7138656,486,0,utRho27
549,glgP,7133546,7133546,7133162,384,216,utRho27
550,glgS,6384024,6384024,6383878,146,390,utRho27
551,glgX,7142838,7142838,7142638,200,0,utRho27
552,glk,5018922,5018922,5018852,70,120,utRho27
553,glmS,7827622,7827622,7827336,286,162,utRho27
554,glmU,7830652,7830652,7830400,252,36,utRho27
555,glmY,10765360,10765360,10765360,0,0,utRho27
556,glmZ,7972864,7972864,7972864,0,0,utRho27
557,glnA,16232888,16232888,16232136,752,0,utRho27
558,glnB,5375052,5375052,5374816,236,0,utRho27
559,glnD,377310,377310,377300,10,0,utRho27
560,glnE,6399602,6399602,6399282,320,0,utRho27
561,glnH,1696396,1696396,1696008,388,94,utRho27
562,glnK,945112,945196,945112,84,0,utRho27
563,glnL,8112742,8112742,8112678,64,0,utRho27
564,glnQ,1693262,1693262,1692926,336,24,utRho27
565,glnS,1411998,1412186,1411998,188,3060,utRho27
566,gloA,3455602,3455674,3455602,72,0,utRho27
567,gloB,469852,469852,469564,288,294,utRho27
568,glpA,4705166,4705294,4705166,128,8,utRho27
569,glpD,7123942,7124026,7123942,84,48,utRho27
570,glpE,7123698,7123698,7123646,52,0,utRho27
571,glpF,8236322,8236322,8236180,142,274,utRho27
572,glpG,7122960,7122960,7122904,56,170,utRho27
573,glpR,7121782,7121782,7121210,572,680,utRho27
574,glpT,4704902,4704902,4704748,154,68,utRho27
575,glpX,8231212,8231212,8231158,54,44,utRho27
576,glrK,5382246,5382246,5382196,50,0,utRho27
577,gltA,1509534,1509534,1508936,598,1088,utRho27
578,gltB,6709018,6709264,6709018,246,68,utRho27
579,gltI,1375792,1375792,1375494,298,798,utRho27
580,gltP,8588536,8588962,8588536,426,558,utRho27
581,gltS,7657382,7657382,7657330,52,158,utRho27
582,gltX,5041568,5041568,5041344,224,254,utRho27
583,gluQ,320286,320286,320224,62,32,utRho27
584,glyA,5371148,5371148,5371014,134,0,utRho27
585,glyQ,7450708,7450708,7450636,72,96,utRho27
586,glyS,7448990,7448990,7448794,196,244,utRho27
587,glyU,5998128,5998128,5998114,14,14,utRho27
588,glyV,8784626,8784720,8784626,94,12,utRho27
589,glyW,3984360,3984360,3984234,126,0,utRho27
590,gmhB,445612,445666,445612,54,0,utRho27
591,gmk,7642776,7642856,7642776,80,0,utRho27
592,gmr,2693686,2693686,2693484,202,0,utRho27
593,gnd,4202648,4202648,4202536,112,274,utRho27
594,gnsB,3275692,3275692,3275564,128,0,utRho27
595,gntK,14310580,14310580,14310368,212,40,utRho27
596,gntP,9102668,9102668,9102592,76,612,utRho27
597,gntR,7157760,7157760,7157452,308,324,utRho27
598,gntT,7092810,7093118,7092810,308,378,utRho27
599,gntU,7154170,7154170,7154122,48,112,utRho27
600,gntX,7089334,7089764,7089334,430,100,utRho27
601,gor,7292224,7292598,7292224,374,24,utRho27
602,gpmA,1575340,1575340,1575190,150,32,utRho27
603,gpmM,7570374,7570520,7570374,146,140,utRho27
604,gpsA,7567620,7567620,7567322,298,1768,utRho27
605,gpt,511828,511954,511828,126,232,utRho27
606,grcA,5433046,5433046,5432898,148,320,utRho27
607,greA,6657728,6657728,6657430,298,856,utRho27
608,greB,7073488,7073624,7073488,136,84,utRho27
609,groL,8741566,8742050,8741566,484,20626,utRho27
610,groS,8741232,8741376,8741232,144,18654,utRho27
611,grpE,5501494,5501494,5501416,78,528,utRho27
612,grxA,1781552,1781552,1781506,46,0,utRho27
613,grxB,2248206,2248206,2248108,98,218,utRho27
614,grxC,7569152,7569152,7568884,268,766,utRho27
615,grxD,3468324,3468324,3468202,122,1458,utRho27
616,gspA,6911268,6911268,6910796,472,354,utRho27
617,gspC,6910964,6911156,6910964,192,156,utRho27
618,gss,6277220,6277220,6277044,176,36,utRho27
619,gstA,3428654,3428754,3428654,100,0,utRho27
620,gstB,1761038,1761038,1760960,78,266,utRho27
621,guaB,5268214,5268214,5268140,74,226,utRho27
622,gudD,5839026,5839026,5838770,256,32,utRho27
623,gyrA,4678914,4678914,4678840,74,24,utRho27
624,gyrB,7760300,7760300,7760238,62,86,utRho27
625,hcaE,5337964,5338064,5337964,100,104,utRho27
626,hcaR,5337928,5337928,5337792,136,42,utRho27
627,hcaT,5336106,5336106,5335692,414,62,utRho27
628,hchA,4071260,4071670,4071260,410,190,utRho27
629,hcp,1828258,1828258,1827628,630,142,utRho27
630,hcr,1824400,1824400,1824300,100,0,utRho27
631,hdeA,7313582,7313582,7313480,102,18,utRho27
632,hdeD,7313920,7313990,7313920,70,892,utRho27
633,hdfR,7896320,7896320,7895934,386,134,utRho27
634,hdhA,3396244,3396244,3396080,164,118,utRho27
635,helD,2048876,2048942,2048876,66,0,utRho27
636,hemA,2527166,2527428,2527166,262,202,utRho27
637,hemB,779722,779722,779454,268,48,utRho27
638,hemF,5106410,5106450,5106410,40,132,utRho27
639,hemH,996062,996110,996062,48,0,utRho27
640,hemL,349882,349882,349764,118,0,utRho27
641,hemN,8103886,8104090,8103886,204,8,utRho27
642,hepA,127176,127176,126528,648,21712,utRho27
643,hflD,2385372,2385372,2385262,110,32,utRho27
644,hfq,8799602,8800576,8799602,974,4848,utRho27
645,hha,961006,961006,960616,390,0,utRho27
646,hicA,3018442,3018572,3018442,130,42,utRho27
647,higA,6468682,6468682,6468288,394,332,utRho27
648,higB,6468960,6468960,6468910,50,366,utRho27
649,hinT,2323642,2323770,2323642,128,0,utRho27
650,hipB,3184964,3184964,3184884,80,94,utRho27
651,hisB,4186720,4186936,4186720,216,308,utRho27
652,hisJ,4853674,4853674,4853576,98,46,utRho27
653,hisL,8359856,8359984,8359856,128,0,utRho27
654,hisS,5281284,5281284,5281150,134,0,utRho27
655,hlpA,400910,400964,400910,54,32,utRho27
656,hlyE,2460932,2460932,2460788,144,178,utRho27
657,hmp,5371594,5371670,5371594,76,0,utRho27
658,hns,2585916,2585916,2585844,72,3732,utRho27
659,hofM,7045856,7045856,7045502,354,22,utRho27
660,hokA,7441620,7441620,7441200,420,456,utRho27
661,hokC,33902,33902,33806,96,262,utRho27
662,hokE,1215462,1215672,1215462,210,0,utRho27
663,holC,8968546,8968546,8968560,14,22,utRho27
664,holD,9215562,9215606,9215562,44,0,utRho27
665,holE,3850040,3850216,3850040,176,6,utRho27
666,hpt,282720,282862,282720,142,138,utRho27
667,hrpB,324150,324210,324150,60,0,utRho27
668,hscB,5319048,5319048,5318934,114,184,utRho27
669,hscC,1367188,1367188,1366786,402,254,utRho27
670,hsdS,9163004,9163004,9162924,80,600,utRho27
671,hslJ,2883560,2883560,2883486,74,770,utRho27
672,hslO,7059344,7059548,7059344,204,113844,utRho27
673,hslR,7058220,7058696,7058220,476,9996,utRho27
674,hslV,8244708,8244708,8244574,134,0,utRho27
675,hsrA,7881412,7881412,7881224,188,28,utRho27
676,htgA,21286,21660,21286,374,606,utRho27
677,htpG,989634,990240,989634,606,424,utRho27
678,htpX,3825236,3825236,3825152,84,144,utRho27
679,htrE,311036,311036,310852,184,44,utRho27
680,htrL,7587668,7587668,7587366,302,138,utRho27
681,hupA,8400352,8400562,8400352,210,108,utRho27
682,hupB,1845220,1845804,1845220,584,168,utRho27
683,hyaA,2063968,2064278,2063968,310,68,utRho27
684,hybO,6292726,6292726,6292522,204,286,utRho27
685,hycA,5700922,5700922,5700870,52,0,utRho27
686,hycI,5686204,5686204,5686086,118,272,utRho27
687,hydN,5676264,5676264,5676210,54,0,utRho27
688,hyfA,5202342,5202402,5202342,60,0,utRho27
689,hypA,11402508,11402588,11402508,80,232,utRho27
690,hypB,11403356,11404004,11403356,648,72,utRho27
691,hypF,5676210,5676210,5674850,1360,288,utRho27
692,hypT,9116634,9116634,9116578,56,0,utRho27
693,hyuA,6019660,6020056,6019660,396,0,utRho27
694,iaaA,1733074,1733136,1733074,62,82,utRho27
695,iadA,9119074,9119074,9119052,22,86,utRho27
696,iap,5753072,5753162,5753072,90,40,utRho27
697,ibaG,6673966,6673966,6673606,360,20,utRho27
698,ibpA,7735036,7735036,7734844,192,10512,utRho27
699,ibpB,7733962,7733962,7733794,168,106208,utRho27
700,icd,2389922,2390246,2389922,324,2,utRho27
701,iclR,8447304,8447304,8447256,48,66,utRho27
702,idi,6065876,6066130,6065876,254,26,utRho27
703,idnD,8988870,8988870,8988812,58,0,utRho27
704,idnK,8989194,8989246,8989194,52,80,utRho27
705,ihfA,3591442,3591442,3591104,338,250,utRho27
706,ihfB,1927498,1927656,1927498,158,56,utRho27
707,ileS,43666,44782,43666,1116,578,utRho27
708,ileX,6431194,6431196,6431194,2,0,utRho27
709,ilvA,15820940,15821324,15820940,384,8,utRho27
710,ilvC,7915824,7915940,7915824,116,176,utRho27
711,ilvE,15809552,15809936,15809552,384,880,utRho27
712,ilvI,170840,171260,170840,420,0,utRho27
713,ilvL,23701308,23701932,23701308,624,234,utRho27
714,ilvY,7915734,7915734,7915640,94,144,utRho27
715,inaA,4698998,4698998,4698944,54,40,utRho27
716,infA,1853370,1853370,1852886,484,94,utRho27
717,infC,3602692,3602692,3601276,1416,782,utRho27
718,insA-5,3958452,3958452,3958430,22,28,utRho27
719,insA-7,9036758,9037054,9036758,296,124,utRho27
720,insC-5,6372080,6372284,6372080,204,352,utRho27
721,insEF-2,785238,785238,785820,582,322,utRho27
722,insEF-4,2190310,2190310,2190892,582,284,utRho27
723,insG,9007098,9007098,9006862,236,0,utRho27
724,insH-1,550596,550596,550234,362,188,utRho27
725,insH-11,7306538,7306538,7306396,142,126,utRho27
726,insH-2,1151548,1151548,1151506,42,120,utRho27
727,insH-3,1378444,1378444,1378026,418,398,utRho27
728,insH-4,2791942,2792152,2791942,210,18,utRho27
729,insH-5,2857852,2857852,2857452,400,20,utRho27
730,insH-6,4135022,4135022,4134642,380,248,utRho27
731,insH-7,4206186,4206186,4205822,364,2192,utRho27
732,insH-9,6260050,6260356,6260050,306,426,utRho27
733,insI-3,9017372,9017372,9017234,138,18,utRho27
734,insJ,7441188,7441360,7441188,172,244,utRho27
735,insK,7442130,7442308,7442130,178,0,utRho27
736,insL-1,30760,30890,30760,130,12532,utRho27
737,insL-2,1216112,1216130,1216112,18,268,utRho27
738,insL-3,5028644,5028662,5028644,18,224,utRho27
739,insN-1,540452,540484,540452,32,0,utRho27
740,intD,1132202,1132202,1131956,246,44,utRho27
741,intR,2826520,2826520,2826470,50,0,utRho27
742,intS,4933026,4933090,4933026,64,12,utRho27
743,intZ,5117386,5117542,5117386,156,138,utRho27
744,iraD,9113152,9113986,9113152,834,132,utRho27
745,iraM,2424246,2424246,2424006,240,62,utRho27
746,iraP,802638,802772,802638,134,0,utRho27
747,iscA,5319924,5319924,5319772,152,366,utRho27
748,iscR,5324398,5324398,5324262,136,1144,utRho27
749,iscX,5313834,5313834,5313472,362,296,utRho27
750,ispF,5743968,5743968,5743560,408,44,utRho27
751,ispG,5283908,5283908,5283608,300,0,utRho27
752,ispU,389568,389806,389568,238,0,utRho27
753,isrA,2811502,2811502,2811618,116,0,utRho27
754,istr-1,7706384,7706384,7706384,0,0,utRho27
755,istr-2,7706514,7706514,7706514,0,0,utRho27
756,ivbL,15412092,15412092,15411952,140,76,utRho27
757,ivy,480638,480686,480638,48,80,utRho27
758,katE,3627628,3627734,3627628,106,154,utRho27
759,katG,8267624,8267670,8267624,46,52,utRho27
760,kbaZ,6557732,6557828,6557732,96,0,utRho27
761,kbl,7585154,7585154,7585102,52,220,utRho27
762,kch,2621046,2621046,2620538,508,204,utRho27
763,kdgR,3820506,3820506,3820198,308,94,utRho27
764,kdpE,1443788,1443788,1443466,322,46,utRho27
765,kdpF,1457698,1457698,1457642,56,0,utRho27
766,kdsA,2535708,2536330,2535708,622,602,utRho27
767,kdsC,6683438,6684546,6683438,1108,3256,utRho27
768,kduI,5968388,5968388,5968248,140,144,utRho27
769,kefF,94160,94492,94160,332,808,utRho27
770,kgtP,5451624,5451624,5451492,132,434,utRho27
771,kup,7862206,7862632,7862206,426,2142,utRho27
772,lacI,735076,735076,735020,56,38,utRho27
773,lacZ,1465508,1465508,1465220,288,320,utRho27
774,ldcA,2486394,2486394,2486160,234,0,utRho27
775,ldhA,2885830,2885830,2885686,144,462,utRho27
776,ldrA,2538954,2538954,2538550,404,314,utRho27
777,ldrB,2540024,2540024,2539620,404,82,utRho27
778,ldrC,2541092,2541092,2540690,402,12,utRho27
779,ldrD,7400544,7400544,7400174,370,134,utRho27
780,lepA,5414392,5414392,5414248,144,298,utRho27
781,lepB,5410928,5410928,5410618,310,1612,utRho27
782,leuD,159188,159188,158906,282,118,utRho27
783,leuE,3761600,3761600,3761518,82,90,utRho27
784,leuL,168048,168048,167416,632,234,utRho27
785,leuO,168308,168736,168308,428,12,utRho27
786,leuQ,9212864,9212864,9212802,62,0,utRho27
787,leuU,6644556,6644556,6644316,240,1134,utRho27
788,leuV,9212546,9212546,9212330,216,148,utRho27
789,leuX,8992772,8992810,8992772,38,0,utRho27
790,lexA,8514174,8514230,8514174,56,550,utRho27
791,lhr,3456706,3458174,3456706,1468,348,utRho27
792,ligA,5060402,5060402,5060352,50,0,utRho27
793,ligB,7642576,7642576,7642340,236,0,utRho27
794,lipA,1320602,1320602,1320432,170,0,utRho27
795,lipB,1324802,1324802,1324556,246,8326,utRho27
796,lit,2397032,2397390,2397032,358,340,utRho27
797,livJ,7199524,7199524,7199316,208,1358,utRho27
798,livK,7195510,7195510,7195120,390,1026,utRho27
799,lldP,7554578,7554798,7554578,220,64,utRho27
800,lnt,1381968,1381968,1381762,206,736,utRho27
801,loiP,6163784,6163826,6163784,42,0,utRho27
802,lolA,1874656,1874738,1874656,82,458,utRho27
803,lolB,2527112,2527112,2527000,112,114,utRho27
804,lolC,2350748,2350854,2350748,106,24,utRho27
805,lon,917630,917776,917630,146,1630,utRho27
806,lpcA,486936,487086,486936,150,0,utRho27
807,lpd,255434,255824,255434,390,284,utRho27
808,lplA,9248476,9248476,9248234,242,684,utRho27
809,lplT,5947878,5947878,5947724,154,0,utRho27
810,lpoA,6586422,6586800,6586422,378,0,utRho27
811,lpp,3514592,3514842,3514592,250,206,utRho27
812,lptA,6686598,6686760,6686598,162,246,utRho27
813,lptB,6686792,6687888,6686792,1096,920,utRho27
814,lptD,114672,114672,114218,454,88,utRho27
815,lptF,8972244,8972436,8972244,192,0,utRho27
816,lpxC,213016,213114,213016,98,484,utRho27
817,lpxD,401920,401942,401920,22,0,utRho27
818,lpxL,2233418,2233418,2233164,254,0,utRho27
819,lpxM,3880456,3880456,3880386,70,0,utRho27
820,lpxP,4991156,4991290,4991156,134,62,utRho27
821,lrhA,4813312,4813312,4813282,30,12,utRho27
822,lrp,1864656,1865190,1864656,534,156,utRho27
823,lspA,50028,50414,50028,386,480,utRho27
824,lsrA,3202920,3202980,3202920,60,0,utRho27
825,lsrR,3202514,3202514,3202482,32,0,utRho27
826,ltaE,1818640,1818640,1818588,52,0,utRho27
827,luxS,5630130,5630130,5629466,664,620,utRho27
828,lysA,5957902,5957902,5957798,104,0,utRho27
829,lysC,8467232,8467232,8466466,766,400,utRho27
830,lysP,4497120,4497120,4497064,56,90,utRho27
831,lysR,5957900,5958042,5957900,142,0,utRho27
832,lysT,1561028,1561108,1561028,80,24,utRho27
833,lysU,8709610,8709610,8709434,176,252,utRho27
834,macB,1840188,1840694,1840188,506,208,utRho27
835,maeA,3111484,3111484,3111338,146,130,utRho27
836,mak,820236,820288,820236,52,34,utRho27
837,malE,8492928,8492928,8492838,90,0,utRho27
838,malI,3398456,3398456,3398360,96,18,utRho27
839,malK,8493472,8493568,8493472,96,20,utRho27
840,malP,7105020,7105020,7104946,74,192,utRho27
841,malQ,7100798,7100798,7100140,658,464,utRho27
842,malS,14949880,14949988,14949880,108,36,utRho27
843,malT,7106048,7106170,7106048,122,0,utRho27
844,malX,3398626,3398710,3398626,84,18,utRho27
845,malZ,1689980,1690072,1689980,92,308,utRho27
846,manA,3377102,3377152,3377102,50,0,utRho27
847,manX,3803866,3804096,3803866,230,0,utRho27
848,marC,3237882,3237882,3237816,66,16,utRho27
849,marR,3238186,3238240,3238186,54,32,utRho27
850,matP,2036918,2036970,2036918,52,0,utRho27
851,mazE,5822736,5822736,5822678,58,0,utRho27
852,mazG,5821720,5821720,5821370,350,596,utRho27
853,mcbA,1684306,1684306,1684112,194,20,utRho27
854,mcbR,3040192,3040524,3040192,332,0,utRho27
855,mcrA,2420278,2420692,2420278,414,0,utRho27
856,mcrC,9156124,9156124,9155916,208,306,utRho27
857,mdaB,6344814,6345060,6344814,246,38,utRho27
858,mdfA,1767138,1767346,1767138,208,0,utRho27
859,mdh,6768940,6768940,6768536,404,54,utRho27
860,mdoB,9198988,9198988,9198882,106,128,utRho27
861,mdoD,2993290,2993712,2993290,422,0,utRho27
862,mdoG,2218514,2218670,2218514,156,60,utRho27
863,mdtA,4307958,4308032,4307958,74,0,utRho27
864,mdtE,7318168,7318464,7318168,296,352,utRho27
865,mdtK,3486538,3486914,3486538,376,614,utRho27
866,mdtP,8602472,8602472,8602060,412,56,utRho27
867,melA,8683774,8683822,8683774,48,0,utRho27
868,melR,8683300,8683300,8683256,44,208,utRho27
869,menA,8240812,8240812,8240698,114,116,utRho27
870,menB,4753774,4753774,4753638,136,54,utRho27
871,mepH,3468714,3468870,3468714,156,0,utRho27
872,mepM,3883666,3883666,3883270,396,160,utRho27
873,mepS,4539840,4539958,4539840,118,38,utRho27
874,metA,8428318,8428560,8428318,242,0,utRho27
875,metB,8257272,8257344,8257272,72,306,utRho27
876,metC,6304150,6304472,6304150,322,224,utRho27
877,metE,8025768,8026106,8025768,338,180,utRho27
878,metF,8265092,8265232,8265092,140,112,utRho27
879,metG,4388538,4388600,4388538,62,54,utRho27
880,metH,8447010,8447656,8447010,646,1792,utRho27
881,metJ,8257116,8257116,8256790,326,102,utRho27
882,metK,6173154,6173412,6173154,258,72,utRho27
883,metN,445428,445428,445290,138,0,utRho27
884,metR,8025710,8025710,8025632,78,0,utRho27
885,metT,1394326,1394326,1394266,60,40,utRho27
886,metY,19910250,19910250,19909734,516,90,utRho27
887,metZ,11789528,11789548,11789528,20,240,utRho27
888,mfd,2348056,2348056,2347928,128,0,utRho27
889,mglA,4478782,4478782,4478578,204,58,utRho27
890,mglB,4481132,4481132,4480696,436,5444,utRho27
891,mglC,4475918,4475918,4475506,412,254,utRho27
892,mgrB,3817584,3817584,3817532,52,0,utRho27
893,mgrR,3245828,3245828,3245828,0,0,utRho27
894,mgsA,2054082,2054082,2054030,52,38,utRho27
895,mgtL,8934560,8934862,8934560,302,204,utRho27
896,mhpA,737038,737222,737038,184,84,utRho27
897,mhpR,737072,737072,736840,232,60,utRho27
898,mhpT,750772,750918,750772,146,36,utRho27
899,miaA,8797964,8798504,8797964,540,404,utRho27
900,micA,5629604,5629604,5629604,0,0,utRho27
901,micC,2874242,2874238,2874242,4,0,utRho27
902,micF,4626168,4626168,4626168,0,0,utRho27
903,micM,1014408,1014408,1014408,0,0,utRho27
904,minE,2449422,2449422,2449090,332,198,utRho27
905,mioC,7852950,7852950,7852910,40,0,utRho27
906,mipA,3733012,3733012,3732944,68,400,utRho27
907,mlaA,4930270,4930270,4930014,256,242,utRho27
908,mlc,3337206,3337206,3337128,78,0,utRho27
909,mlrA,4429498,4429732,4429498,234,34,utRho27
910,mltA,5894546,5894546,5894356,190,108,utRho27
911,mltD,468050,468050,467910,140,78,utRho27
912,mltF,5391534,5391602,5391534,68,0,utRho27
913,mmuP,550238,550650,550238,412,188,utRho27
914,mngA,1531622,1531968,1531622,346,0,utRho27
915,mngR,1531852,1531852,1531750,102,0,utRho27
916,mnmG,7851348,7851348,7851266,82,56,utRho27
917,mntH,5025470,5025470,5025412,58,0,utRho27
918,mntP,3810918,3811376,3810918,458,0,utRho27
919,mntR,1706160,1706366,1706160,206,12,utRho27
920,mntS,1706128,1706128,1705994,134,12,utRho27
921,moaA,1633654,1634088,1633654,434,0,utRho27
922,moaB,1635954,1636110,1635954,156,0,utRho27
923,mobA,8084242,8084242,8083998,244,180,utRho27
924,mocA,6030112,6030320,6030112,208,14,utRho27
925,modA,1589990,1590178,1589990,188,0,utRho27
926,moeA,1732788,1732788,1732728,60,0,utRho27
927,mokB,2984610,2984610,2984258,352,36,utRho27
928,molR_1,4392888,4392948,4392888,60,0,utRho27
929,motA,3954604,3954604,3954278,326,0,utRho27
930,mpaA,2781278,2781278,2781196,82,42,utRho27
931,mpl,8911456,8911570,8911456,114,0,utRho27
932,mppA,2786108,2786454,2786108,346,0,utRho27
933,mprA,5621494,5621540,5621494,46,0,utRho27
934,mqo,4613848,4613848,4613508,340,0,utRho27
935,mqsA,6336742,6336742,6336492,250,198,utRho27
936,mqsR,6337306,6337306,6337088,218,288,utRho27
937,mraZ,179192,179268,179192,76,20,utRho27
938,mrcA,7045652,7045742,7045652,90,0,utRho27
939,mrcB,329442,329460,329442,18,0,utRho27
940,mreB,13605424,13605424,13604348,1076,564,utRho27
941,mreD,6798166,6798166,6797750,416,90,utRho27
942,mrp,4388360,4388360,4388336,24,68,utRho27
943,mscK,972984,973072,972984,88,84,utRho27
944,mscL,6876002,6876048,6876002,46,690,utRho27
945,mscS,6139742,6139742,6139614,128,0,utRho27
946,msrA,8884522,8884522,8884352,170,354,utRho27
947,msrB,3725168,3725168,3724858,310,4,utRho27
948,msyB,2228426,2228426,2228362,64,114,utRho27
949,mtfA,4087236,4087302,4087236,66,160,utRho27
950,mtgA,6699662,6699662,6699618,44,30,utRho27
951,mtlA,30177504,30178248,30177504,744,3008,utRho27
952,mtn,358366,358366,358306,60,96,utRho27
953,mtr,6611864,6611864,6611634,230,20,utRho27
954,mug,6430992,6430992,6430946,46,1402,utRho27
955,murQ,5091466,5091546,5091466,80,0,utRho27
956,murR,5091586,5091586,5091218,368,0,utRho27
957,mutH,5939164,5939324,5939164,160,174,utRho27
958,mutL,8794092,8794824,8794092,732,206,utRho27
959,mutM,7622554,7622554,7622304,250,104,utRho27
960,mutS,5714038,5714186,5714038,148,286,utRho27
961,mutY,18617466,18618078,18617466,612,0,utRho27
962,nac,4123956,4123956,4123866,90,0,utRho27
963,nadA,1564122,1564170,1564122,48,66,utRho27
964,nadB,5420714,5420840,5420714,126,0,utRho27
965,nadC,237326,237326,237290,36,4,utRho27
966,nadE,3644604,3644916,3644604,312,70,utRho27
967,nadK,5501526,5501662,5501526,136,112,utRho27
968,nagA,1406350,1406350,1405502,848,1044,utRho27
969,nagB,1407416,1407416,1407222,194,96,utRho27
970,nagC,1404016,1404016,1403188,828,0,utRho27
971,nagE,1407680,1407888,1407680,208,580,utRho27
972,nagK,2357080,2357186,2357080,106,0,utRho27
973,nanA,6747240,6747240,6747152,88,100,utRho27
974,nanC,9079856,9079856,9079002,854,396,utRho27
975,nanR,6749406,6749406,6748978,428,1034,utRho27
976,nanS,9075406,9075406,9075188,218,0,utRho27
977,napF,4607390,4607390,4606994,396,46,utRho27
978,narG,2559614,2559728,2559614,114,52,utRho27
979,narK,2555642,2555914,2555642,272,70,utRho27
980,narP,4580844,4581000,4580844,156,206,utRho27
981,narQ,5171154,5171462,5171154,308,274,utRho27
982,narU,3088326,3088326,3088120,206,202,utRho27
983,narW,3077374,3077374,3074618,2756,184,utRho27
984,narX,2555554,2555554,2555236,318,76,utRho27
985,narZ,3085380,3085380,3085180,200,0,utRho27
986,ndh,2331984,2332170,2331984,186,202,utRho27
987,ndk,5289920,5289920,5289728,192,128,utRho27
988,nemR,6904084,6904092,6904084,8,0,utRho27
989,nepI,7683542,7683542,7683478,64,20,utRho27
990,nfo,4501612,4501680,4501612,68,16,utRho27
991,nfsB,1210906,1210906,1210848,58,28,utRho27
992,nfuA,7090916,7091248,7090916,332,1018,utRho27
993,nhaA,34634,34978,34634,344,550,utRho27
994,nhaB,2469534,2469534,2469434,100,12,utRho27
995,nhoA,3067926,3068048,3067926,122,0,utRho27
996,nikA,7226878,7227334,7226878,456,342,utRho27
997,nikR,7237074,7237176,7237074,102,68,utRho27
998,nirB,6987974,6988022,6987974,48,18,utRho27
999,nlpA,7680034,7680034,7679986,48,0,utRho27
1000,nlpC,3585654,3585654,3585462,192,46,utRho27
1001,nlpD,5737658,5737658,5737506,152,52,utRho27
1002,nlpI,6618080,6618080,6617848,232,0,utRho27
1003,nmpC,1153740,1153740,1153650,90,0,utRho27
1004,nohA,3273206,3273206,3272734,472,118,utRho27
1005,norR,5664614,5664614,5664578,36,0,utRho27
1006,norV,5664878,5664952,5664878,74,42,utRho27
1007,nrdA,4689510,4689730,4689510,220,5272,utRho27
1008,nrdD,8925676,8925676,8925320,356,556,utRho27
1009,nrdH,5601312,5601446,5601312,134,266,utRho27
1010,nrdR,865954,866004,865954,50,0,utRho27
1011,nrfA,8575342,8575528,8575342,186,8,utRho27
1012,nsrR,8812088,8812380,8812088,292,68,utRho27
1013,nudB,3897348,3897348,3897264,84,0,utRho27
1014,nudC,8393428,8393806,8393428,378,0,utRho27
1015,nudE,7052658,7052658,7052298,360,812,utRho27
1016,nudG,3682876,3682980,3682876,104,50,utRho27
1017,nudI,4729050,4729108,4729050,58,0,utRho27
1018,nudJ,2388874,2388874,2388576,298,130,utRho27
1019,nuoA,4810670,4810670,4810144,526,1028,utRho27
1020,nuoN,4783434,4783434,4783010,424,126,utRho27
1021,nupC,5026018,5026084,5026018,66,0,utRho27
1022,nupG,6211302,6211428,6211302,126,32,utRho27
1023,ogrK,4335096,4335096,4335040,56,50,utRho27
1024,ogt,2800568,2800568,2800472,96,444,utRho27
1025,ohsC,5401036,5401040,5401036,4,60,utRho27
1026,ompA,2040382,2040382,2040106,276,3528,utRho27
1027,ompC,4625774,4625774,4625498,276,6,utRho27
1028,ompF,1974184,1974184,1973964,220,118,utRho27
1029,ompL,8128958,8128958,8128590,368,720,utRho27
1030,ompN,2874158,2874158,2873786,372,0,utRho27
1031,ompR,7073510,7073510,7073168,342,84,utRho27
1032,ompT,1171330,1171330,1171266,64,104,utRho27
1033,ompW,2627982,2628040,2627982,58,0,utRho27
1034,ompX,1700418,1700900,1700418,482,1188,utRho27
1035,omrA,5952378,5952378,5952378,0,0,utRho27
1036,omrB,5952770,5952770,5952770,0,0,utRho27
1037,oppA,2602170,2602364,2602170,194,186,utRho27
1038,orn,8783168,8783208,8783168,40,12,utRho27
1039,osmB,2686952,2686952,2686656,296,1286,utRho27
1040,osmC,3113192,3113250,3113192,58,178,utRho27
1041,osmE,3644566,3644566,3644512,54,32,utRho27
1042,osmF,4439046,4439046,4438962,84,160,utRho27
1043,osmY,9222306,9222792,9222306,486,70,utRho27
1044,otsA,3963302,3963302,3963224,78,50,utRho27
1045,otsB,3964930,3964930,3964774,156,454,utRho27
1046,oxc,4984288,4984288,4983900,388,308,utRho27
1047,oxyR,8316914,8316980,8316914,66,70,utRho27
1048,oxyS,8316788,8316788,8316788,0,0,utRho27
1049,paaA,2907730,2907854,2907730,124,0,utRho27
1050,paaX,2927018,2927078,2927018,60,0,utRho27
1051,paaZ,2907340,2907340,2907284,56,4,utRho27
1052,pabA,6981702,6981702,6981658,44,32,utRho27
1053,pabB,3789256,3789610,3789256,354,44,utRho27
1054,pabC,2306186,2306600,2306186,414,88,utRho27
1055,pagP,1313052,1313114,1313052,62,0,utRho27
1056,panB,299260,299260,299202,58,504,utRho27
1057,panC,297840,297840,297590,250,8,utRho27
1058,panD,293490,293490,293388,102,56,utRho27
1059,panZ,7195656,7195968,7195656,312,96,utRho27
1060,parC,6332060,6332060,6331946,114,0,utRho27
1061,patA,6438916,6438988,6438916,72,68,utRho27
1062,patD,3030830,3031156,3030830,326,0,utRho27
1063,pbpC,5294986,5294986,5294650,336,0,utRho27
1064,pbpG,4450132,4450132,4449740,392,0,utRho27
1065,pck,7065358,7065636,7065358,278,884,utRho27
1066,pcnB,318782,318782,318252,530,132,utRho27
1067,pdhR,244068,244184,244068,116,0,utRho27
1068,pdxB,4875768,4875768,4875702,66,0,utRho27
1069,pdxH,3436068,3436068,3436014,54,0,utRho27
1070,pdxJ,5403626,5403626,5403458,168,0,utRho27
1071,pdxK,5074638,5074638,5074474,164,50,utRho27
1072,pepA,8972278,8972278,8971902,376,0,utRho27
1073,pepD,511618,511618,511432,186,258,utRho27
1074,pepN,1981182,1981244,1981182,62,138,utRho27
1075,pepQ,8062294,8062322,8062294,28,148,utRho27
1076,pepT,2371646,2371688,2371646,42,40,utRho27
1077,pfkA,8214948,8215104,8214948,156,120,utRho27
1078,pfkB,3612646,3612740,3612646,94,52,utRho27
1079,pflA,1902456,1902456,1902160,296,0,utRho27
1080,pflB,1907850,1907850,1907108,742,48,utRho27
1081,pflD,8287716,8287990,8287716,274,54,utRho27
1082,pgaA,2185046,2185046,2184578,468,1438,utRho27
1083,pgi,8467444,8467516,8467444,72,0,utRho27
1084,pgk,12291428,12291428,12290488,940,284,utRho27
1085,pgl,1597078,1597172,1597078,94,0,utRho27
1086,pgpB,2678324,2678660,2678324,336,34,utRho27
1087,pgpC,5397276,5397276,5397100,176,60,utRho27
1088,pgrR,2783744,2783982,2783744,238,24,utRho27
1089,pheL,5475158,5475198,5475158,40,0,utRho27
1090,pheM,7197204,7197204,7197080,124,0,utRho27
1091,pheP,1203858,1203918,1203858,60,8,utRho27
1092,pheU,8725254,8725254,8725252,2,0,utRho27
1093,pheV,6220730,6220732,6220730,2,0,utRho27
1094,phnC,8650412,8650412,8650330,82,0,utRho27
1095,phoA,803414,803494,803414,80,0,utRho27
1096,phoB,834202,834284,834202,82,394,utRho27
1097,phoE,520316,520316,520200,116,32,utRho27
1098,phoH,2169730,2169984,2169730,254,36,utRho27
1099,phoP,2381016,2381016,2380894,122,194,utRho27
1100,phoQ,2379880,2379880,2379552,328,96,utRho27
1101,phoU,7815330,7815330,7815156,174,72,utRho27
1102,phr,1478842,1479014,1478842,172,0,utRho27
1103,pinE,2419054,2419370,2419054,316,112,utRho27
1104,pinQ,3267168,3267244,3267168,76,0,utRho27
1105,pinR,2867424,2867424,2867348,76,0,utRho27
1106,pitA,7275224,7275284,7275224,60,0,utRho27
1107,pitB,6272806,6272806,6272742,64,158,utRho27
1108,pka,5439862,5439906,5439862,44,46,utRho27
1109,plaP,4174476,4174476,4174124,352,16,utRho27
1110,pldA,8009628,8009724,8009628,96,152,utRho27
1111,pldB,8018028,8018340,8018028,312,262,utRho27
1112,plsB,8513196,8513196,8512932,264,110,utRho27
1113,pmbA,8915890,8915918,8915890,28,0,utRho27
1114,pmrD,4747148,4747148,4747076,72,0,utRho27
1115,pncB,1980828,1980828,1980712,116,8,utRho27
1116,pncC,5648788,5648788,5648692,96,0,utRho27
1117,pnp,6622652,6622652,6622336,316,0,utRho27
1118,pntA,3355950,3355950,3355806,144,0,utRho27
1119,pntB,3353096,3353096,3352720,376,90,utRho27
1120,polA,8093880,8093932,8093880,52,38,utRho27
1121,polB,131606,131606,131560,46,0,utRho27
1122,potD,2365700,2365700,2365658,42,56,utRho27
1123,potE,1436688,1436688,1436530,158,32,utRho27
1124,potF,1787268,1787568,1787268,300,0,utRho27
1125,poxB,1822152,1822152,1822098,54,16,utRho27
1126,ppa,8899372,8899372,8899304,68,152,utRho27
1127,ppc,8306380,8306380,8306196,184,1058,utRho27
1128,ppdA,5928440,5928440,5928354,86,30,utRho27
1129,ppdD,235410,235410,235098,312,40,utRho27
1130,pphA,3846770,3846770,3845938,832,708,utRho27
1131,pphB,5719474,5719520,5719474,46,0,utRho27
1132,ppiA,6984898,6984898,6984594,304,180,utRho27
1133,ppiC,7919682,7919682,7919626,56,0,utRho27
1134,ppiD,923638,923830,923638,192,20,utRho27
1135,ppk,5245748,5246088,5245748,340,176,utRho27
1136,pppA,6228958,6228958,6228704,254,0,utRho27
1137,ppsA,3574322,3574322,3574224,98,0,utRho27
1138,ppsR,3574678,3574890,3574678,212,0,utRho27
1139,pptA,3065716,3066104,3065716,388,158,utRho27
1140,pqiA,2023318,2024002,2023318,684,46,utRho27
1141,prc,3830054,3830054,3829632,422,608,utRho27
1142,preT,4467978,4468066,4467978,88,16,utRho27
1143,prfC,9218688,9218828,9218688,140,2,utRho27
1144,prkB,6968622,6968980,6968622,358,126,utRho27
1145,prlC,7290476,7290476,7290364,112,1090,utRho27
1146,prlF,6553944,6554004,6553944,60,486,utRho27
1147,proB,520432,520776,520432,344,8,utRho27
1148,proC,811372,811372,811288,84,0,utRho27
1149,proK,7417388,7417388,7417384,4,0,utRho27
1150,proL,4572414,4572422,4572414,8,88,utRho27
1151,proP,8660640,8661004,8660640,364,140,utRho27
1152,proS,437674,437674,437550,124,68,utRho27
1153,proV,5609126,5609630,5609126,504,158,utRho27
1154,prpB,697292,697364,697292,72,0,utRho27
1155,prpR,696942,696942,696886,56,0,utRho27
1156,prs,2524354,2524354,2523750,604,1800,utRho27
1157,psd,8781276,8781276,8780720,556,400,utRho27
1158,psiE,8480600,8480650,8480600,50,0,utRho27
1159,pspA,2736076,2736158,2736076,82,0,utRho27
1160,pspF,2736080,2736080,2735824,256,0,utRho27
1161,pspG,8525632,8525680,8525632,48,44,utRho27
1162,pssA,5445156,5445454,5445156,298,306,utRho27
1163,pstB,7817112,7817112,7816732,380,40,utRho27
1164,pstC,7821084,7821084,7820796,288,70,utRho27
1165,pstS,23469408,23469408,23469150,258,0,utRho27
1166,psuG,4517114,4517114,4516734,380,2420,utRho27
1167,psuT,4514992,4514992,4514670,322,196,utRho27
1168,pth,2517084,2517084,2517026,58,82,utRho27
1169,ptrA,5918022,5918022,5917768,254,48,utRho27
1170,ptrB,3857730,3857730,3857678,52,118,utRho27
1171,ptsG,2315252,2315738,2315252,486,98,utRho27
1172,ptsH,5066996,5067528,5066996,532,252,utRho27
1173,purA,8809328,8809374,8809328,46,220,utRho27
1174,purC,5195562,5195562,5195236,326,0,utRho27
1175,purD,8411972,8411972,8411862,110,20,utRho27
1176,purE,1106284,1106284,1106200,84,0,utRho27
1177,purH,8415254,8415254,8415064,190,0,utRho27
1178,purL,5391178,5391178,5391086,92,40,utRho27
1179,purM,5242306,5242394,5242306,88,0,utRho27
1180,purR,3475378,3475688,3475378,310,44,utRho27
1181,purT,3861438,3861762,3861438,324,4,utRho27
1182,purU,2577512,2577512,2577248,264,0,utRho27
1183,putA,2157850,2157850,2157764,86,32,utRho27
1184,putP,2158336,2158610,2158336,274,82,utRho27
1185,puuA,2721936,2721936,2721816,120,0,utRho27
1186,puuC,2725456,2725486,2725456,30,24,utRho27
1187,puuD,2722104,2722240,2722104,136,0,utRho27
1188,puuP,2718746,2718746,2718374,372,110,utRho27
1189,pykA,3874988,3875298,3874988,310,0,utRho27
1190,pykF,3510934,3511396,3510934,462,186,utRho27
1191,pyrC,2245286,2245286,2245214,72,8,utRho27
1192,pyrD,2009464,2009536,2009464,72,36,utRho27
1193,pyrE,7631970,7631970,7631536,434,26,utRho27
1194,pyrF,2683740,2683842,2683740,102,1424,utRho27
1195,pyrG,5819594,5819594,5819332,262,248,utRho27
1196,pyrH,383624,383710,383624,86,206,utRho27
1197,pyrL,8945490,8945490,8945066,424,440,utRho27
1198,qmcA,1031646,1031646,1031546,100,268,utRho27
1199,qor,8528608,8528608,8528462,146,204,utRho27
1200,qseB,6339502,6339656,6339502,154,0,utRho27
1201,queA,849970,850022,849970,52,210,utRho27
1202,queE,5811212,5811212,5810836,376,12,utRho27
1203,queF,5850642,5850696,5850642,54,258,utRho27
1204,queG,8788184,8788184,8788134,50,200,utRho27
1205,racC,2835630,2835630,2835526,104,0,utRho27
1206,racR,2840898,2840898,2840482,416,64,utRho27
1207,raiA,5474208,5474308,5474208,100,52,utRho27
1208,rarD,8008594,8008594,8008356,238,312,utRho27
1209,ravA,7862256,7862256,7862186,70,394,utRho27
1210,rayT,495088,495274,495088,186,80,utRho27
1211,rbn,4763162,4763216,4763162,54,62,utRho27
1212,rbsD,7866644,7866702,7866644,58,0,utRho27
1213,rcnA,4371654,4371834,4371654,180,124,utRho27
1214,rcnB,4373768,4373920,4373768,152,148,utRho27
1215,rcnR,4371806,4371806,4371592,214,276,utRho27
1216,rcsA,4047672,4047936,4047672,264,488,utRho27
1217,rcsB,4631390,4632354,4631390,964,228,utRho27
1218,rcsC,4640162,4640162,4639656,506,32,utRho27
1219,rcsD,4626904,4626976,4626904,72,4,utRho27
1220,rdgB,6193240,6193362,6193240,122,262,utRho27
1221,rdlA,2538646,2538646,2538646,0,0,utRho27
1222,rdlB,2539712,2539716,2539712,4,0,utRho27
1223,rdlC,2540782,2540786,2540782,4,0,utRho27
1224,rdlD,7400272,7400272,7400272,0,0,utRho27
1225,rdoA,8084782,8084830,8084782,48,0,utRho27
1226,recA,11295276,11295276,11295076,200,100,utRho27
1227,recC,5925014,5925014,5924856,158,20,utRho27
1228,recF,7763722,7763722,7762442,1280,844,utRho27
1229,recN,5503518,5503590,5503518,72,0,utRho27
1230,recQ,8011666,8011728,8011666,62,20,utRho27
1231,relA,5828554,5828554,5827302,1252,320,utRho27
1232,relB,3291806,3291806,3291744,62,0,utRho27
1233,rem,3289950,3289950,3289804,146,0,utRho27
1234,rep,7921294,7921354,7921294,60,34,utRho27
1235,rfaD,7587730,7587974,7587730,244,156,utRho27
1236,rfaE,6393852,6393852,6393506,346,28,utRho27
1237,rfaH,8049930,8049930,8049642,288,708,utRho27
1238,rfbX,4219436,4219436,4219168,268,148,utRho27
1239,rfe,7935600,7935832,7935600,232,170,utRho27
1240,rhaB,8194944,8194944,8194896,48,0,utRho27
1241,rhaD,8188770,8188770,8188544,226,0,utRho27
1242,rhaS,8195422,8195472,8195422,50,0,utRho27
1243,rhaT,8201132,8201132,8201050,82,0,utRho27
1244,rhlE,1661566,1661744,1661566,178,20,utRho27
1245,rhoL,47593944,47594772,47593944,828,1860,utRho27
1246,rhsB,7238006,7238384,7238006,378,160,utRho27
1247,rhsC,1458758,1459166,1458758,408,0,utRho27
1248,rhsD,1046132,1046522,1046132,390,4,utRho27
1249,rhtA,1700608,1700608,1700194,414,1080,utRho27
1250,rhtC,8015478,8015514,8015478,36,34,utRho27
1251,ribA,2678468,2678468,2678320,148,28,utRho27
1252,ribC,3486916,3486916,3486484,432,1040,utRho27
1253,ribE,869008,869294,869008,286,6314,utRho27
1254,ribF,42766,42814,42766,48,70,utRho27
1255,ridA,8941892,8941892,8941826,66,0,utRho27
1256,rihA,1369204,1369204,1368824,380,0,utRho27
1257,rihB,4510504,4510504,4510372,132,150,utRho27
1258,rimJ,2251044,2251124,2251044,80,30,utRho27
1259,rimK,1783752,1783934,1783752,182,28,utRho27
1260,rimL,2997486,2997876,2997486,390,60,utRho27
1261,rimO,1756140,1756140,1756070,70,12,utRho27
1262,rimP,6636350,6636350,6636012,338,106,utRho27
1263,rlmA,3814172,3814172,3814120,52,0,utRho27
1264,rlmD,5830086,5830086,5830000,86,0,utRho27
1265,rlmE,6655520,6655520,6655328,192,782,utRho27
1266,rlmF,1684384,1684664,1684384,280,74,utRho27
1267,rlmG,6471784,6471784,6471750,34,28,utRho27
1268,rlmI,2060002,2060002,2059938,64,0,utRho27
1269,rlmJ,7290700,7290770,7290700,70,0,utRho27
1270,rlmL,2015344,2015688,2015344,344,196,utRho27
1271,rlpA,1330444,1330444,1330380,64,130,utRho27
1272,rluA,120900,120900,120692,208,236,utRho27
1273,rluF,8460324,8460708,8460324,384,14,utRho27
1274,rmf,2031006,2031430,2031006,424,608,utRho27
1275,rna,1290068,1290068,1290006,62,0,utRho27
1276,rnb,2698258,2698258,2697824,434,78,utRho27
1277,rnc,10816892,10816892,10816252,640,23580,utRho27
1278,rnd,3776122,3776122,3775982,140,0,utRho27
1279,rne,2289746,2289746,2288734,1012,622,utRho27
1280,rnhA,472082,472082,472004,78,1018,utRho27
1281,rnk,1288360,1288360,1287934,426,164,utRho27
1282,rnlA,5531788,5531836,5531788,48,66,utRho27
1283,rnlB,5533414,5533968,5533414,554,1032,utRho27
1284,rnpB,19623552,19623552,19623552,0,0,utRho27
1285,rob,9270706,9270706,9270620,86,82,utRho27
1286,rodZ,5285868,5285868,5285688,180,136,utRho27
1287,rpe,7030306,7030306,7030118,188,2,utRho27
1288,rph,15266320,15266320,15266196,124,4,utRho27
1289,rpiA,6118706,6118706,6118650,56,0,utRho27
1290,rpiB,8626514,8626700,8626514,186,8,utRho27
1291,rpiR,8626274,8626274,8625982,292,16,utRho27
1292,rplJ,8359246,8359992,8359246,746,3668,utRho27
1293,rplK,8356708,8356894,8356708,186,80,utRho27
1294,rplM,6757344,6757344,6757302,42,684,utRho27
1295,rplN,6896444,6896444,6896298,146,1024,utRho27
1296,rplS,5489284,5489284,5489060,224,4292,utRho27
1297,rplT,7199052,7199052,7198996,56,364,utRho27
1298,rplU,6667036,6667036,6666902,134,160,utRho27
1299,rplY,4564866,4565034,4564866,168,60,utRho27
1300,rpmA,6666450,6666450,6666238,212,276,utRho27
1301,rpmB,15247980,15247980,15246696,1284,25360,utRho27
1302,rpmE,8253816,8254026,8253816,210,364,utRho27
1303,rpmF,2294676,2294734,2294676,58,5446,utRho27
1304,rpmH,7768130,7768672,7768130,542,456,utRho27
1305,rpmI,3600854,3600854,3599998,856,2382,utRho27
1306,rpoB,8362126,8362490,8362126,364,252,utRho27
1307,rpoD,6424946,6426094,6424946,1148,47914,utRho27
1308,rpoE,5420372,5420372,5420024,348,64,utRho27
1309,rpoH,7202006,7202006,7201566,440,2036,utRho27
1310,rpoN,6689324,6689434,6689324,110,52,utRho27
1311,rpoS,5736236,5736236,5735102,1134,1082,utRho27
1312,rpoZ,7644154,7644212,7644154,58,52,utRho27
1313,rppH,5937986,5937986,5937954,32,200,utRho27
1314,rprA,3540744,3540744,3540744,0,0,utRho27
1315,rpsA,1923434,1923990,1923434,556,9642,utRho27
1316,rpsF,8850050,8850236,8850050,186,5904,utRho27
1317,rpsI,6756580,6756580,6756414,166,3624,utRho27
1318,rpsJ,6906884,6906884,6906540,344,1862,utRho27
1319,rpsL,6949242,6949242,6949104,138,1700,utRho27
1320,rpsM,6885130,6885130,6884942,188,318,utRho27
1321,rpsO,13247144,13247144,13246736,408,536,utRho27
1322,rpsP,5492508,5492508,5492370,138,0,utRho27
1323,rpsT,42420,42420,42156,264,168,utRho27
1324,rpsU,12842584,12843124,12842584,540,0,utRho27
1325,rraA,8238716,8238716,8238660,56,244,utRho27
1326,rraB,8956768,8956946,8956768,178,42,utRho27
1327,rrsA,8070478,8071062,8070478,584,1450,utRho27
1328,rrsB,16665468,16666636,16665468,1168,3244,utRho27
1329,rrsC,7883032,7883616,7883032,584,674,utRho27
1330,rrsD,6858094,6858094,6857524,570,560,utRho27
1331,rrsE,8415726,8416294,8415726,568,594,utRho27
1332,rrsG,5462896,5462896,5462314,582,1528,utRho27
1333,rrsH,446970,447542,446970,572,636,utRho27
1334,rsd,8393908,8393908,8393616,292,22,utRho27
1335,rseA,5419264,5419264,5418808,456,738,utRho27
1336,rseP,392940,393092,392940,152,22,utRho27
1337,rseX,4067298,4067298,4067298,0,0,utRho27
1338,rsfS,1338144,1338144,1338072,72,0,utRho27
1339,rsgA,8783132,8783132,8783018,114,220,utRho27
1340,rsmA,105176,105176,104860,316,112,utRho27
1341,rsmB,6869982,6870414,6869982,432,12,utRho27
1342,rsmC,9215736,9215736,9215400,336,32,utRho27
1343,rsmD,7208594,7208786,7208594,192,0,utRho27
1344,rsmE,6182036,6182268,6182036,232,224,utRho27
1345,rsmG,7847512,7847512,7847360,152,0,utRho27
1346,rsmH,180020,180188,180020,168,0,utRho27
1347,rsmI,6587106,6587106,6586670,436,0,utRho27
1348,rssA,2578212,2578412,2578212,200,52,utRho27
1349,rssB,2580440,2580484,2580440,44,120,utRho27
1350,rstA,3364276,3364300,3364276,24,0,utRho27
1351,rsuA,4561096,4561096,4560966,130,24,utRho27
1352,rsxA,3411510,3411534,3411510,24,44,utRho27
1353,rtcA,7114004,7114004,7113698,306,126,utRho27
1354,rtcB,7116214,7116214,7116158,56,0,utRho27
1355,rtn,4541356,4541452,4541356,96,0,utRho27
1356,rutA,2148052,2148052,2148022,30,0,utRho27
1357,rutG,2140090,2140090,2139678,412,0,utRho27
1358,rutR,2148226,2148484,2148226,258,94,utRho27
1359,ruvA,7784096,7784096,7783904,192,20,utRho27
1360,ruvB,7782176,7782176,7781424,752,120,utRho27
1361,ruvC,3894878,3894878,3894752,126,0,utRho27
1362,rybB,1776114,1776114,1776114,0,0,utRho27
1363,rydB,3529860,3529860,3529322,538,166,utRho27
1364,rydC,2983012,2983012,2983012,0,0,utRho27
1365,ryfA,5307398,5307710,5307398,312,0,utRho27
1366,ryfD,5468590,5468590,5468590,0,0,utRho27
1367,ryhB,7162032,7162032,7162032,0,0,utRho27
1368,ryjA,8556132,8556132,8556132,0,0,utRho27
1369,ryjB,9055954,9055954,9055954,0,0,utRho27
1370,sad,3229598,3229598,3229406,192,0,utRho27
1371,safA,3168056,3168056,3167918,138,208,utRho27
1372,sanA,4465368,4465756,4465368,388,0,utRho27
1373,sapF,2705314,2705314,2705268,46,100,utRho27
1374,sbcB,4165456,4165512,4165456,56,0,utRho27
1375,sbcC,831694,831694,831506,188,0,utRho27
1376,sbcD,833954,833954,833904,50,452,utRho27
1377,sbmA,793106,793278,793106,172,546,utRho27
1378,sbmC,4162650,4162650,4162524,126,2,utRho27
1379,sdaA,3793618,3793864,3793618,246,916,utRho27
1380,sdaC,5856070,5856458,5856070,388,28742,utRho27
1381,sdhC,1509916,1510354,1509916,438,3618,utRho27
1382,sdhD,1510808,1511120,1510808,312,150,utRho27
1383,sdiA,3993834,3993834,3993664,170,72,utRho27
1384,secE,8354354,8354716,8354354,362,178,utRho27
1385,secG,6645180,6645180,6645010,170,210,utRho27
1386,selA,7522594,7522594,7522498,96,0,utRho27
1387,selB,7519850,7519850,7519722,128,12,utRho27
1388,selC,7672396,7672444,7672396,48,34,utRho27
1389,selD,3696058,3696058,3696016,42,378,utRho27
1390,seqA,1425884,1425974,1425884,90,2,utRho27
1391,serA,6117098,6117098,6116820,278,0,utRho27
1392,serB,9249712,9249790,9249712,78,26,utRho27
1393,serC,3830380,3830612,3830380,232,0,utRho27
1394,serS,1878730,1878856,1878730,126,450,utRho27
1395,serT,2063438,2063438,2063424,14,0,utRho27
1396,serU,4087124,4087124,4087114,10,46,utRho27
1397,serV,5637394,5637394,5637290,104,56,utRho27
1398,serW,1852014,1852014,1851942,72,58,utRho27
1399,serX,2195352,2195352,2195304,48,48,utRho27
1400,setB,4527426,4527726,4527426,300,74,utRho27
1401,setC,7673488,7673906,7673488,418,194,utRho27
1402,sfmA,1116124,1116424,1116124,300,0,utRho27
1403,sfmC,1117606,1117948,1117606,342,60,utRho27
1404,sfsA,323030,323030,322972,58,40,utRho27
1405,sfsB,6669592,6669818,6669592,226,164,utRho27
1406,sgrR,154676,154676,154598,78,54,utRho27
1407,sgrS,154734,154734,154734,0,0,utRho27
1408,shiA,4107068,4107286,4107068,218,0,utRho27
1409,sibA,4306622,4306622,4306622,0,0,utRho27
1410,sibB,4307292,4307292,4307292,0,0,utRho27
1411,sibC,6113702,6113702,6113702,0,0,utRho27
1412,sibD,6389730,6389730,6389730,0,0,utRho27
1413,sibE,6390480,6390480,6390480,0,0,utRho27
1414,sixA,4913998,4913998,4913624,374,58,utRho27
1415,slp,7307872,7307922,7307872,50,0,utRho27
1416,slt,9261400,9261466,9261400,66,0,utRho27
1417,slyA,3442028,3442028,3441648,380,0,utRho27
1418,slyB,3439496,3439752,3439496,256,88,utRho27
1419,slyD,6957398,6957398,6956994,404,170,utRho27
1420,slyX,6954862,6955280,6954862,418,8476,utRho27
1421,smf,6867372,6867372,6867120,252,362,utRho27
1422,smpB,5509534,5509792,5509534,258,510,utRho27
1423,smrA,2811872,2811958,2811872,86,224,utRho27
1424,smrB,4896872,4897212,4896872,340,108,utRho27
1425,smtA,1946808,1947074,1946808,266,0,utRho27
1426,sodA,8201518,8201620,8201518,102,398,utRho27
1427,sodB,3470646,3470756,3470646,110,0,utRho27
1428,sodC,3449358,3449358,3449310,48,0,utRho27
1429,sohB,2658568,2658664,2658568,96,48,utRho27
1430,sokB,2984232,2984238,2984232,6,0,utRho27
1431,solA,2241218,2241218,2241172,46,76,utRho27
1432,soxR,8554894,8554938,8554894,44,74,utRho27
1433,soxS,8554846,8554846,8554766,80,102,utRho27
1434,speA,6172096,6172096,6171822,274,180,utRho27
1435,speB,6167892,6167892,6167594,298,98,utRho27
1436,speC,6218350,6218350,6218310,40,18,utRho27
1437,spf,8099798,8099798,8099798,0,0,utRho27
1438,sppA,3697422,3697674,3697422,252,150,utRho27
1439,spy,3651376,3651376,3651250,126,0,utRho27
1440,sra,3112092,3112092,3111926,166,62,utRho27
1441,sraB,2293178,2293178,2293178,0,0,utRho27
1442,sraC,3846132,3846132,3846132,0,0,utRho27
1443,srlA,5651582,5651664,5651582,82,82,utRho27
1444,srlR,5657720,5658094,5657720,374,212,utRho27
1445,srmB,5425752,5425792,5425752,40,0,utRho27
1446,sroA,151216,151216,151216,0,0,utRho27
1447,sroG,6369436,6369436,6369436,0,0,utRho27
1448,sroH,8380974,8380974,8380974,0,0,utRho27
1449,ssb,8548022,8548250,8548022,228,384,utRho27
1450,sseA,5304782,5304988,5304782,206,606,utRho27
1451,sspA,6755138,6755138,6754840,298,120,utRho27
1452,ssrA,5511014,5511186,5511014,172,262,utRho27
1453,ssrS,12223036,12223932,12223036,896,3076,utRho27
1454,sstT,6479726,6479888,6479726,162,224,utRho27
1455,ssuB,1988282,1988282,1988088,194,36,utRho27
1456,ssuE,1995126,1995126,1995024,102,0,utRho27
1457,sthA,8321604,8321604,8321580,24,110,utRho27
1458,stpA,5597156,5597156,5596990,166,42,utRho27
1459,sucA,3034344,3034824,3034344,480,160,utRho27
1460,sufA,3528836,3528836,3528772,64,24,utRho27
1461,sufE,3518962,3518962,3518580,382,192,utRho27
1462,sugE,8753588,8753750,8753588,162,0,utRho27
1463,sulA,2041894,2041894,2041838,56,9142,utRho27
1464,syd,5850738,5850738,5850560,178,458,utRho27
1465,symE,9159834,9159834,9159680,154,78,utRho27
1466,symR,9159670,9159670,9159670,0,0,utRho27
1467,tabA,8949566,8949724,8949566,158,0,utRho27
1468,talA,5157140,5157332,5157140,192,0,utRho27
1469,talB,16382,16476,16382,94,1020,utRho27
1470,tam,3214442,3214692,3214442,250,106,utRho27
1471,tamA,8884540,8884764,8884540,224,198,utRho27
1472,tar,3945432,3945432,3945382,50,0,utRho27
1473,tas,5943138,5943194,5943138,56,2,utRho27
1474,tatA,16087636,16087780,16087636,144,132,utRho27
1475,tatE,1317742,1317894,1317742,152,0,utRho27
1476,tauA,770410,770464,770410,54,0,utRho27
1477,tdcA,6534186,6534186,6534130,56,0,utRho27
1478,tdcG,6519652,6519652,6519298,354,50,utRho27
1479,tdcR,6534380,6534760,6534380,380,2,utRho27
1480,tdk,2586986,2587054,2586986,68,4,utRho27
1481,tehA,3001072,3001146,3001072,74,0,utRho27
1482,tesA,1039898,1039898,1039530,368,524,utRho27
1483,tesB,950402,950402,950322,80,0,utRho27
1484,tfaE,2418532,2418532,2418238,294,44,utRho27
1485,tfaQ,3269912,3269912,3269770,142,10,utRho27
1486,tff,379424,379256,379424,168,144,utRho27
1487,tgt,852110,852274,852110,164,0,utRho27
1488,thiD,4369346,4369346,4369032,314,0,utRho27
1489,thiI,882936,883098,882936,162,0,utRho27
1490,thiM,4370902,4370902,4370602,300,210,utRho27
1491,thiQ,146170,146170,145854,316,2664,utRho27
1492,thrL,592,760,592,168,112,utRho27
1493,thrS,7210932,7210932,7210280,652,476,utRho27
1494,thrU,8350762,8350776,8350762,14,600,utRho27
1495,thrV,6847414,6847414,6847310,104,134342,utRho27
1496,thrW,525682,525742,525682,60,212,utRho27
1497,thyA,5930696,5930696,5930310,386,308,utRho27
1498,tig,909986,910266,909986,280,54,utRho27
1499,tisB,7706674,7707106,7706674,432,984,utRho27
1500,tktA,6163414,6163414,6163270,144,24,utRho27
1501,tktB,5158616,5159272,5158616,656,404,utRho27
1502,tldD,6784368,6784368,6784056,312,0,utRho27
1503,tmcA,5191876,5191876,5191718,158,58,utRho27
1504,tnaC,15553644,15553740,15553644,96,236,utRho27
1505,tolB,1555074,1555480,1555074,406,700,utRho27
1506,tolC,6356008,6356230,6356008,222,40,utRho27
1507,tomB,961588,961588,961416,172,152,utRho27
1508,tonB,2622108,2622178,2622108,70,2,utRho27
1509,topA,2661578,2662096,2661578,518,156,utRho27
1510,torC,2116112,2116168,2116112,56,360,utRho27
1511,torR,2115968,2115968,2115908,60,492,utRho27
1512,torS,2112364,2112364,2112356,8,0,utRho27
1513,torT,2112414,2112522,2112414,108,0,utRho27
1514,tpiA,8223138,8223138,8223014,124,46,utRho27
1515,tppB,3425342,3425538,3425342,196,222,utRho27
1516,tpr,2574376,2574376,2574376,0,0,utRho27
1517,tpx,2777688,2777688,2777622,66,786,utRho27
1518,tqsA,3347780,3347826,3347780,46,22,utRho27
1519,treA,2494850,2494850,2494752,98,0,utRho27
1520,treB,8932420,8932420,8932360,60,0,utRho27
1521,treF,7339102,7339184,7339102,82,60,utRho27
1522,treR,8934694,8934694,8934492,202,48,utRho27
1523,trg,2984878,2984940,2984878,62,0,utRho27
1524,trkG,2847342,2847564,2847342,222,288,utRho27
1525,trmA,8326590,8326590,8326540,50,0,utRho27
1526,trpA,2634678,2634678,2634444,234,182,utRho27
1527,trpC,2639888,2639888,2639570,318,0,utRho27
1528,trpL,5292432,5292432,5292328,104,0,utRho27
1529,trpR,9265408,9265520,9265408,112,0,utRho27
1530,trpS,7027394,7027394,7027276,118,162,utRho27
1531,trpT,7893560,7893914,7893560,354,58788,utRho27
1532,trxA,7931294,7931522,7931294,228,1494,utRho27
1533,trxB,1864156,1864156,1864100,56,0,utRho27
1534,trxC,5437350,5437470,5437350,120,310,utRho27
1535,tsaD,6421256,6421256,6421086,170,12,utRho27
1536,tsgA,6985038,6985136,6985038,98,102,utRho27
1537,tsr,9182824,9183314,9182824,490,538,utRho27
1538,tsx,864490,864490,864026,464,216,utRho27
1539,ttcA,2823970,2823970,2823896,74,1028,utRho27
1540,ttdA,6412848,6412926,6412848,78,0,utRho27
1541,ttdR,6412760,6412760,6412512,248,60,utRho27
1542,tufA,6943448,6943448,6942658,790,18170,utRho27
1543,tus,3368346,3368518,3368346,172,132,utRho27
1544,tusA,7218040,7218040,7217992,48,596,utRho27
1545,tusB,6950218,6950218,6949930,288,90,utRho27
1546,tynA,2902996,2902996,2902698,298,20,utRho27
1547,typA,8116460,8116814,8116460,354,496,utRho27
1548,tyrB,8534164,8534228,8534164,64,152,utRho27
1549,tyrP,3979004,3979362,3979004,358,12,utRho27
1550,tyrR,2773384,2773440,2773384,56,64,utRho27
1551,tyrS,3434566,3434566,3434444,122,44,utRho27
1552,tyrT,2575330,2575330,2575244,86,0,utRho27
1553,uacT,6062378,6062734,6062378,356,62,utRho27
1554,ubiC,8504886,8505012,8504886,126,30,utRho27
1555,ubiD,8049618,8049976,8049618,358,748,utRho27
1556,ubiE,8037494,8037710,8037494,216,46,utRho27
1557,ubiG,4679078,4679134,4679078,56,0,utRho27
1558,ucpA,5089342,5089342,5089246,96,144,utRho27
1559,udp,8032782,8032862,8032782,80,88,utRho27
1560,ugd,4199470,4199470,4199226,244,224,utRho27
1561,ugpB,7184852,7184852,7184650,202,638,utRho27
1562,ugpQ,7176600,7176600,7176226,374,0,utRho27
1563,uhpT,7694396,7694396,7694334,62,198,utRho27
1564,uidA,3392304,3392304,3392142,162,0,utRho27
1565,uidC,3386012,3386012,3385702,310,0,utRho27
1566,uidR,3394150,3394150,3394104,46,38,utRho27
1567,ulaA,8839854,8839960,8839854,106,198,utRho27
1568,ulaG,8839350,8839350,8839250,100,48,utRho27
1569,ulaR,8837124,8837124,8836906,218,6,utRho27
1570,umpG,5741372,5741372,5740548,824,0,utRho27
1571,umpH,1400704,1400704,1400652,52,0,utRho27
1572,umuD,2461476,2461534,2461476,58,0,utRho27
1573,ung,5433476,5433508,5433476,32,0,utRho27
1574,uof,2843316,2843316,2842900,416,200,utRho27
1575,upp,5241818,5241818,5241744,74,8,utRho27
1576,usg,4873780,4873780,4873298,482,48,utRho27
1577,ushA,1009772,1009828,1009772,56,0,utRho27
1578,uspA,7279966,7280222,7279966,256,604,utRho27
1579,uspB,7279696,7279696,7279440,256,296,utRho27
1580,uspC,3959172,3959506,3959172,334,130,utRho27
1581,uspE,2797318,2797318,2797244,74,0,utRho27
1582,uspF,2871282,2871282,2871238,44,92,utRho27
1583,uspG,1283806,1283806,1283734,72,522,utRho27
1584,uvrA,8547872,8547872,8547742,130,190,utRho27
1585,uvrB,1626304,1627052,1626304,748,144,utRho27
1586,uvrC,3989758,3989758,3989412,346,112,utRho27
1587,uvrD,7995814,7995966,7995814,152,72,utRho27
1588,uvrY,3990812,3990812,3990718,94,0,utRho27
1589,uxaB,3221474,3221474,3221360,114,0,utRho27
1590,uxaC,6489714,6489714,6489482,232,40,utRho27
1591,uxuA,9103036,9103272,9103036,236,422,utRho27
1592,uxuR,9108916,9109152,9108916,236,34,utRho27
1593,valS,8967854,8967854,8967674,180,292,utRho27
1594,valU,5041848,5041862,5041848,14,42,utRho27
1595,valV,3492830,3492870,3492830,40,64,utRho27
1596,ves,3649968,3649968,3649874,94,8,utRho27
1597,waaA,7616512,7617080,7616512,568,696,utRho27
1598,waaH,7580298,7580298,7580162,136,0,utRho27
1599,waaQ,7616476,7616476,7616196,280,446,utRho27
1600,waaU,7598996,7598996,7598624,372,60,utRho27
1601,waaY,7602272,7602272,7601930,342,4670,utRho27
1602,wbbH,4214888,4214888,4214452,436,1060,utRho27
1603,wbbK,4209212,4209212,4209018,194,168,utRho27
1604,wcaM,4231868,4231868,4231792,76,0,utRho27
1605,wrbA,2135516,2135516,2135416,100,58,utRho27
1606,wza,4275166,4275166,4274486,680,44,utRho27
1607,wzxC,4240674,4240674,4240316,358,46,utRho27
1608,wzzB,4196950,4196950,4196602,348,12,utRho27
1609,xanP,7657642,7657890,7657642,248,42,utRho27
1610,xanQ,6048520,6048702,6048520,182,0,utRho27
1611,xapA,5049820,5049820,5049756,64,0,utRho27
1612,xapR,10090252,10090252,10089908,344,232,utRho27
1613,xdhA,6000514,6000690,6000514,176,122,utRho27
1614,xerD,6079702,6079702,6079486,216,0,utRho27
1615,xseA,5268394,5268464,5268394,70,0,utRho27
1616,xseB,882746,882746,882686,60,90,utRho27
1617,xthA,3664798,3664856,3664798,58,26,utRho27
1618,xylA,7461614,7461614,7461530,84,2168,utRho27
1619,xylE,8484540,8484540,8484508,32,0,utRho27
1620,xylF,7462138,7462262,7462138,124,320,utRho27
1621,xylR,7469812,7469958,7469812,146,0,utRho27
1622,yaaA,13230,13230,12918,312,262,utRho27
1623,yaaI,23876,23876,23572,304,72,utRho27
1624,yaaJ,16034,16034,15918,116,104,utRho27
1625,yaaU,91184,91614,91184,430,116,utRho27
1626,yaaW,23084,23084,22712,372,318,utRho27
1627,yaaX,10060,10468,10060,408,0,utRho27
1628,yabI,142542,142702,142542,160,0,utRho27
1629,yacC,273880,273880,273834,46,36,utRho27
1630,yacH,262932,262932,262520,412,96,utRho27
1631,yacL,268678,268776,268678,98,0,utRho27
1632,yadD,293796,293936,293796,140,2,utRho27
1633,yadE,289930,290162,289930,232,94,utRho27
1634,yadN,314110,314110,313766,344,0,utRho27
1635,yadS,355572,355572,355248,324,192,utRho27
1636,yadV,312470,312470,312402,68,138,utRho27
1637,yaeF,434270,434270,434006,264,92,utRho27
1638,yaeP,428374,428374,428250,124,0,utRho27
1639,yaeQ,428176,428582,428176,406,24,utRho27
1640,yaeR,423716,423754,423716,38,0,utRho27
1641,yafC,462166,462166,461762,404,396,utRho27
1642,yafD,462128,462244,462128,116,486,utRho27
1643,yafK,491986,491986,491610,376,332,utRho27
1644,yafL,493282,493424,493282,142,24,utRho27
1645,yafN,503938,504010,503938,72,0,utRho27
1646,yafS,469568,469632,469568,64,152,utRho27
1647,yafT,474470,474670,474470,200,64,utRho27
1648,yafV,480432,480432,480378,54,0,utRho27
1649,yafZ,536052,536052,536010,42,0,utRho27
1650,yagE,564446,564556,564446,110,0,utRho27
1651,yagG,570414,570790,570414,376,120,utRho27
1652,yagI,578384,578384,578324,60,0,utRho27
1653,yagK,586236,586236,585896,340,670,utRho27
1654,yagL,588062,588062,587836,226,112,utRho27
1655,yagN,591342,591342,591158,184,252,utRho27
1656,yahA,663746,664742,663746,996,1288,utRho27
1657,yahC,670136,670136,670044,92,32,utRho27
1658,yahE,671478,671850,671478,372,370,utRho27
1659,yahM,690504,690808,690504,304,370,utRho27
1660,yahN,692872,692872,692674,198,318,utRho27
1661,yahO,692864,692968,692864,104,108,utRho27
1662,yaiE,816296,816354,816296,58,18,utRho27
1663,yaiI,811396,811528,811396,132,0,utRho27
1664,yaiO,761946,761946,761684,262,174,utRho27
1665,yaiP,767970,767970,767870,100,46,utRho27
1666,yaiS,769660,769660,769232,428,134,utRho27
1667,yaiV,788922,788922,788922,0,0,utRho27
1668,yaiY,799094,799094,798666,428,294,utRho27
1669,yaiZ,798888,799186,798888,298,70,utRho27
1670,yajC,854410,854574,854410,164,82,utRho27
1671,yajD,860938,861210,860938,272,28,utRho27
1672,yajI,866068,866068,865702,366,0,utRho27
1673,yajL,887496,887496,887282,214,46,utRho27
1674,yajQ,889316,889366,889316,50,88,utRho27
1675,yajR,893374,893374,893332,42,0,utRho27
1676,ybaB,987418,988152,987418,734,92,utRho27
1677,ybaL,1006590,1006590,1006476,114,28,utRho27
1678,ybaM,980648,980648,980542,106,76,utRho27
1679,ybaN,981436,981764,981436,328,218,utRho27
1680,ybaO,936704,936766,936704,62,0,utRho27
1681,ybaP,1016568,1016568,1016160,408,400,utRho27
1682,ybaQ,1016348,1016436,1016348,88,76,utRho27
1683,ybaS,1023146,1023282,1023146,136,120,utRho27
1684,ybaV,927504,927874,927504,370,36,utRho27
1685,ybaY,950490,950758,950490,268,0,utRho27
1686,ybbB,1062724,1062724,1062452,272,138,utRho27
1687,ybbJ,1030154,1030154,1029718,436,402,utRho27
1688,ybbL,1031784,1031838,1031784,54,6,utRho27
1689,ybbN,1037136,1037136,1036558,578,234,utRho27
1690,ybbO,1038658,1038658,1038298,360,188,utRho27
1691,ybbY,1080718,1081130,1080718,412,448,utRho27
1692,ybcH,1176140,1176140,1175962,178,12,utRho27
1693,ybcI,1113264,1113264,1113106,158,68,utRho27
1694,ybcJ,1114050,1114050,1113746,304,46,utRho27
1695,ybcK,1137502,1137804,1137502,302,18,utRho27
1696,ybcL,1141690,1141786,1141690,96,0,utRho27
1697,ybcN,1144628,1144932,1144628,304,16,utRho27
1698,ybcQ,1147548,1147912,1147548,364,68,utRho27
1699,ybcW,1159610,1159760,1159610,150,0,utRho27
1700,ybdD,1263982,1264364,1263982,382,454,utRho27
1701,ybdF,1212106,1212106,1211772,334,4,utRho27
1702,ybdH,1267048,1267048,1266954,94,0,utRho27
1703,ybdJ,1212822,1212822,1212398,424,234,utRho27
1704,ybdK,1215122,1215122,1214766,356,0,utRho27
1705,ybdL,1267114,1267172,1267114,58,2,utRho27
1706,ybdM,1271110,1271110,1270752,358,194,utRho27
1707,ybdN,1273372,1273372,1273138,234,0,utRho27
1708,ybdR,1283844,1284176,1283844,332,566,utRho27
1709,ybeD,1325412,1325412,1325284,128,1142,utRho27
1710,ybeF,1323090,1323090,1322756,334,166,utRho27
1711,ybeL,1349986,1350036,1349986,50,0,utRho27
1712,ybeQ,1353412,1353412,1353094,318,74,utRho27
1713,ybeR,1353120,1353422,1353120,302,74,utRho27
1714,ybeT,1358832,1358832,1358812,20,0,utRho27
1715,ybeU,1358924,1359016,1358924,92,2,utRho27
1716,ybeZ,1386938,1386938,1386834,104,424,utRho27
1717,ybfA,1458074,1458268,1458074,194,54,utRho27
1718,ybfE,1423878,1423878,1423796,82,38,utRho27
1719,ybfF,1425692,1425692,1425604,88,32,utRho27
1720,ybfH,1433282,1433282,1433194,88,58,utRho27
1721,ybgA,1477840,1478002,1477840,162,202,utRho27
1722,ybgC,1549288,1549504,1549288,216,12,utRho27
1723,ybgD,1505916,1505916,1505590,326,6284,utRho27
1724,ybgI,1485238,1485654,1485238,416,0,utRho27
1725,ybgO,1498370,1498370,1497964,406,184,utRho27
1726,ybgS,1570992,1570992,1570634,358,100,utRho27
1727,ybhA,1597184,1597184,1596862,322,0,utRho27
1728,ybhB,1616070,1616070,1615818,252,60,utRho27
1729,ybhC,1614642,1614642,1614562,80,0,utRho27
1730,ybhD,1601418,1601418,1601276,142,0,utRho27
1731,ybhH,1601104,1601518,1601104,414,4,utRho27
1732,ybhK,1633384,1633384,1633294,90,82,utRho27
1733,ybhM,1641556,1641586,1641556,30,0,utRho27
1734,ybhN,1645296,1645296,1644996,300,0,utRho27
1735,ybhQ,1649202,1649260,1649202,58,28,utRho27
1736,ybiA,1665920,1665920,1665900,20,0,utRho27
1737,ybiI,1676968,1676968,1676912,56,10,utRho27
1738,ybiO,1691328,1691328,1690960,368,50,utRho27
1739,ybiP,1705252,1705252,1705194,58,24,utRho27
1740,ybiS,1711572,1711572,1711488,84,0,utRho27
1741,ybiT,1711894,1711926,1711894,32,0,utRho27
1742,ybiU,1718212,1718212,1718122,90,44,utRho27
1743,ybiV,1720176,1720176,1720056,120,0,utRho27
1744,ybiW,1725566,1725566,1725212,354,242,utRho27
1745,ybiX,1678548,1678548,1678414,134,242,utRho27
1746,ybjC,1781784,1781826,1781784,42,0,utRho27
1747,ybjE,1830154,1830154,1829714,440,706,utRho27
1748,ybjG,1767016,1767016,1766776,240,212,utRho27
1749,ybjL,1779882,1779882,1779638,244,74,utRho27
1750,ybjM,1779770,1780178,1779770,408,414,utRho27
1751,ybjO,1795704,1795978,1795704,274,0,utRho27
1752,ybjP,1809046,1809046,1808934,112,0,utRho27
1753,ybjQ,1809034,1809186,1809034,152,0,utRho27
1754,ybjS,1813796,1813796,1813506,290,36,utRho27
1755,ybjX,1838206,1838206,1838168,38,0,utRho27
1756,ycaD,1891438,1891742,1891438,304,0,utRho27
1757,ycaI,1928210,1928640,1928210,430,206,utRho27
1758,ycaK,1899094,1899336,1899094,242,126,utRho27
1759,ycaL,1920264,1920528,1920264,264,120,utRho27
1760,ycaM,1894240,1894458,1894240,218,62,utRho27
1761,ycaR,1941284,1941346,1941284,62,118,utRho27
1762,ycbB,1961862,1962094,1961862,232,338,utRho27
1763,ycbJ,1943344,1943504,1943344,160,0,utRho27
1764,ycbK,1966046,1966150,1966046,104,144,utRho27
1765,ycbZ,2036920,2036920,2036598,322,0,utRho27
1766,yccA,2062886,2062886,2062836,50,54,utRho27
1767,yccF,2048730,2048730,2048696,34,0,utRho27
1768,yccS,2047988,2047988,2047766,222,544,utRho27
1769,yccT,2055674,2055674,2055546,128,176,utRho27
1770,yccX,2059960,2060128,2059960,168,32,utRho27
1771,ycdT,2185682,2185752,2185682,70,44,utRho27
1772,ycdU,2191266,2191686,2191266,420,396,utRho27
1773,ycdZ,2200504,2200592,2200504,88,0,utRho27
1774,yceA,2233544,2233614,2233544,70,6,utRho27
1775,yceD,2293298,2293588,2293298,290,806,utRho27
1776,yceF,2293522,2293522,2293190,332,430,utRho27
1777,yceH,2252154,2252314,2252154,160,126,utRho27
1778,yceI,2237282,2237282,2236952,330,14,utRho27
1779,yceJ,2238142,2238142,2238092,50,98,utRho27
1780,yceM,2253208,2253612,2253208,404,264,utRho27
1781,yceO,2239264,2239264,2238894,370,388,utRho27
1782,yceQ,2288760,2289004,2288760,244,512,utRho27
1783,ycfD,2376540,2376540,2376480,60,56,utRho27
1784,ycfJ,2334814,2335198,2334814,384,10,utRho27
1785,ycfS,2340834,2340834,2340748,86,0,utRho27
1786,ycfT,2350658,2350658,2350330,328,32,utRho27
1787,ycfZ,2362760,2362760,2362534,226,258,utRho27
1788,ycgB,2474570,2474570,2474482,88,50,utRho27
1789,ycgG,2434614,2434656,2434614,42,294,utRho27
1790,ycgJ,2452956,2453200,2452956,244,2,utRho27
1791,ycgL,2455218,2455362,2455218,144,18,utRho27
1792,ycgN,2457366,2457660,2457366,294,0,utRho27
1793,ycgR,2489112,2489112,2489054,58,0,utRho27
1794,ycgV,2512222,2512222,2511904,318,248,utRho27
1795,ycgX,2426568,2426568,2426214,354,766,utRho27
1796,ycgY,2490166,2490320,2490166,154,166,utRho27
1797,ycgZ,2431504,2431578,2431504,74,56,utRho27
1798,ychE,2596904,2597196,2596904,292,0,utRho27
1799,ychF,2515764,2515764,2515624,140,0,utRho27
1800,ychH,2517476,2517582,2517476,106,1014,utRho27
1801,ychJ,2578354,2578354,2578264,90,52,utRho27
1802,ychN,2547310,2547310,2547198,112,0,utRho27
1803,ychO,2547520,2547850,2547520,330,120,utRho27
1804,ychQ,2533798,2533848,2533798,50,0,utRho27
1805,yciA,2624828,2624828,2624492,336,22,utRho27
1806,yciB,2626110,2626110,2625780,330,132,utRho27
1807,yciC,2627396,2627396,2627326,70,8,utRho27
1808,yciE,2630794,2630794,2630448,346,40,utRho27
1809,yciG,5264368,5264368,5264140,228,0,utRho27
1810,yciI,2621784,2621784,2621730,54,34,utRho27
1811,yciN,2661606,2661606,2661336,270,98,utRho27
1812,yciS,2680270,2680486,2680270,216,166,utRho27
1813,yciT,2689088,2689088,2688692,396,250,utRho27
1814,yciU,2614718,2614718,2614300,418,188,utRho27
1815,yciV,2646376,2646440,2646376,64,0,utRho27
1816,yciW,2700472,2700472,2700214,258,14,utRho27
1817,yciZ,2689276,2689276,2689218,58,180,utRho27
1818,ycjD,2703792,2703792,2703520,272,0,utRho27
1819,ycjG,2777748,2777860,2777748,112,136,utRho27
1820,ycjM,2740006,2740432,2740006,426,64,utRho27
1821,ycjW,2767982,2767982,2767922,60,54,utRho27
1822,ycjX,2768138,2768234,2768138,96,28,utRho27
1823,ycjY,5568288,5568288,5567460,828,48,utRho27
1824,ydaE,2836438,2836438,2836016,422,124,utRho27
1825,ydaN,2816048,2816100,2816048,52,6,utRho27
1826,ydaS,2840340,2840730,2840340,390,168,utRho27
1827,ydbC,2948376,2948442,2948376,66,0,utRho27
1828,ydbD,2950132,2950288,2950132,156,80,utRho27
1829,ydbH,2885800,2886102,2885800,302,3304,utRho27
1830,ydbJ,2881712,2882116,2881712,404,552,utRho27
1831,ydbK,2881692,2881692,2881568,124,116,utRho27
1832,ydcA,2983294,2983354,2983294,60,0,utRho27
1833,ydcF,2974404,2974470,2974404,66,32,utRho27
1834,ydcI,2990268,2990268,2990142,126,0,utRho27
1835,ydcJ,2990266,2990576,2990266,310,32,utRho27
1836,ydcK,3001280,3001280,3000898,382,30,utRho27
1837,ydcL,3004646,3004914,3004646,268,0,utRho27
1838,ydcN,3012308,3012344,3012308,36,74,utRho27
1839,ydcP,3013508,3013562,3013508,54,0,utRho27
1840,ydcR,3019956,3020006,3019956,50,0,utRho27
1841,ydcS,3022906,3023308,3022906,402,54,utRho27
1842,ydcX,3034442,3034778,3034442,336,92,utRho27
1843,ydcY,3035220,3035296,3035220,76,0,utRho27
1844,ydcZ,3036750,3036750,3036662,88,64,utRho27
1845,yddB,3155332,3155332,3155238,94,0,utRho27
1846,yddE,3071738,3071738,3071716,22,0,utRho27
1847,yddG,3094410,3094410,3094338,72,0,utRho27
1848,yddJ,3089732,3089732,3089438,294,122,utRho27
1849,yddW,3137704,3137704,3137646,58,0,utRho27
1850,ydeA,3233910,3234056,3233910,146,46,utRho27
1851,ydeE,3242528,3242664,3242528,136,0,utRho27
1852,ydeI,3249118,3249118,3248994,124,0,utRho27
1853,ydeJ,3249376,3249546,3249376,170,30,utRho27
1854,ydeN,3165458,3165458,3165048,410,0,utRho27
1855,ydeP,3173328,3173328,3172972,356,96,utRho27
1856,ydeR,3176596,3176596,3176592,4,0,utRho27
1857,ydfA,3296872,3297016,3296872,144,0,utRho27
1858,ydfG,3254982,3255034,3254982,52,6,utRho27
1859,ydfH,3256652,3256704,3256652,52,0,utRho27
1860,ydfK,3265446,3266144,3265446,698,596,utRho27
1861,ydgA,3379588,3379704,3379588,116,0,utRho27
1862,ydgC,3364124,3364124,3364060,64,0,utRho27
1863,ydgD,3343906,3343920,3343906,14,54,utRho27
1864,ydgH,3356754,3356854,3356754,100,0,utRho27
1865,ydgJ,3408798,3408798,3408616,182,68,utRho27
1866,ydgK,3410414,3410500,3410414,86,504,utRho27
1867,ydhB,3479618,3479618,3479596,22,0,utRho27
1868,ydhC,3479698,3479822,3479698,124,22,utRho27
1869,ydhF,3451310,3451310,3451264,46,0,utRho27
1870,ydhI,3441996,3442050,3441996,54,0,utRho27
1871,ydhL,3451864,3451864,3451840,24,30,utRho27
1872,ydhQ,3492404,3492404,3492254,150,0,utRho27
1873,ydhS,3494136,3494262,3494136,126,112,utRho27
1874,ydhT,3499138,3499138,3499118,20,0,utRho27
1875,ydhY,3509284,3509284,3508954,330,0,utRho27
1876,ydhZ,3510418,3510418,3510282,136,0,utRho27
1877,ydiE,3579206,3579226,3579206,20,28,utRho27
1878,ydiH,3530582,3530582,3530406,176,0,utRho27
1879,ydiM,3541852,3542142,3541852,290,82,utRho27
1880,ydiN,3544818,3545024,3544818,206,146,utRho27
1881,ydiP,3558656,3558656,3558602,54,74,utRho27
1882,ydiU,3582508,3582508,3582488,20,96,utRho27
1883,ydiV,3584174,3584174,3584040,134,40,utRho27
1884,ydiY,3612500,3612500,3612166,334,14,utRho27
1885,ydjA,3697400,3697400,3697352,48,60,utRho27
1886,ydjE,3708082,3708082,3707958,124,42,utRho27
1887,ydjF,3709848,3709848,3709708,140,94,utRho27
1888,ydjM,3620340,3620422,3620340,82,0,utRho27
1889,ydjO,3626696,3626696,3626288,408,0,utRho27
1890,ydjX,3666434,3666802,3666434,368,20,utRho27
1891,yeaE,3731448,3731448,3731272,176,78,utRho27
1892,yeaG,3733530,3733816,3733530,286,0,utRho27
1893,yeaI,3740486,3740770,3740486,284,48,utRho27
1894,yeaJ,3743874,3744082,3743874,208,0,utRho27
1895,yeaL,3748646,3748704,3748646,58,80,utRho27
1896,yeaM,3751296,3751296,3751152,144,0,utRho27
1897,yeaN,3750926,3751346,3750926,420,0,utRho27
1898,yeaO,3753554,3753818,3753554,264,32,utRho27
1899,yeaP,3755314,3755430,3755314,116,0,utRho27
1900,yeaQ,3758780,3758780,3758510,270,0,utRho27
1901,yeaR,3759988,3759988,3759896,92,68,utRho27
1902,yeaY,3781122,3781122,3781064,58,0,utRho27
1903,yebB,3892220,3892502,3892220,282,270,utRho27
1904,yebC,3896370,3896370,3896302,68,0,utRho27
1905,yebE,3859464,3859464,3859414,50,46,utRho27
1906,yebG,3861530,3861530,3861494,36,2,utRho27
1907,yebK,3873180,3873304,3873180,124,54,utRho27
1908,yebQ,3820314,3820552,3820314,238,66,utRho27
1909,yebS,3832238,3832516,3832238,278,14,utRho27
1910,yebV,3843430,3843560,3843430,130,0,utRho27
1911,yebW,3843914,3844242,3843914,328,660,utRho27
1912,yecC,3995646,3995646,3995628,18,0,utRho27
1913,yecD,3901272,3901664,3901272,392,186,utRho27
1914,yecF,3991434,3991636,3991434,202,0,utRho27
1915,yecH,3979304,3979304,3978980,324,0,utRho27
1916,yecJ,3975604,3975604,3975516,88,0,utRho27
1917,yecM,3919968,3919968,3919692,276,0,utRho27
1918,yecR,3976400,3976444,3976400,44,190,utRho27
1919,yecT,3923862,3923944,3923862,82,14,utRho27
1920,yedD,4016522,4016522,4016180,342,188,utRho27
1921,yedE,4016310,4016554,4016310,244,232,utRho27
1922,yedI,4058922,4058922,4058732,190,64,utRho27
1923,yedJ,4066446,4066446,4066158,288,0,utRho27
1924,yedV,4076404,4076404,4076304,100,158,utRho27
1925,yedX,4077680,4077912,4077680,232,0,utRho27
1926,yedY,4078572,4078956,4078572,384,70,utRho27
1927,yeeA,4161322,4161322,4161182,140,20,utRho27
1928,yeeE,4171104,4171104,4171050,54,4,utRho27
1929,yeeJ,4089526,4089822,4089526,296,0,utRho27
1930,yeeN,4113508,4113716,4113508,208,150,utRho27
1931,yeeO,4119444,4119444,4119692,248,256,utRho27
1932,yeeX,4158834,4158834,4158722,112,46,utRho27
1933,yeeZ,4178422,4178422,4178256,166,38,utRho27
1934,yefM,4179466,4179466,4179426,40,0,utRho27
1935,yegD,4295288,4295348,4295288,60,0,utRho27
1936,yegH,4275726,4275804,4275726,78,56,utRho27
1937,yegI,4302154,4302154,4301970,184,0,utRho27
1938,yegJ,4302032,4302370,4302032,338,4,utRho27
1939,yegQ,4331182,4331336,4331182,154,108,utRho27
1940,yegR,4336698,4336698,4336612,86,598,utRho27
1941,yegS,4337086,4337424,4337086,338,354,utRho27
1942,yegT,4357562,4357642,4357562,80,48,utRho27
1943,yegX,4367640,4367640,4367302,338,0,utRho27
1944,yehA,4376944,4376944,4376828,116,28,utRho27
1945,yehE,4385818,4385818,4385592,226,12,utRho27
1946,yehK,4407568,4407944,4407568,376,0,utRho27
1947,yehL,4408804,4409192,4408804,388,60,utRho27
1948,yeiB,4486146,4486146,4485934,212,0,utRho27
1949,yeiE,4499422,4499422,4499236,186,0,utRho27
1950,yeiG,4487776,4487820,4487776,44,0,utRho27
1951,yeiH,4499332,4499434,4499332,102,8,utRho27
1952,yeiI,4503306,4503400,4503306,94,0,utRho27
1953,yeiL,4510580,4510710,4510580,130,0,utRho27
1954,yeiP,4530834,4530900,4530834,66,24,utRho27
1955,yeiQ,4532328,4532490,4532328,162,0,utRho27
1956,yeiR,4535484,4535658,4535484,174,0,utRho27
1957,yeiW,4530840,4530840,4530590,250,76,utRho27
1958,yejA,4544624,4544728,4544624,104,18,utRho27
1959,yejG,4556892,4556892,4556474,418,1544,utRho27
1960,yejH,4561244,4561264,4561244,20,30,utRho27
1961,yejK,4568218,4568218,4567894,324,0,utRho27
1962,yejO,4578352,4578352,4577800,552,128,utRho27
1963,yfaD,4713380,4713808,4713380,428,164,utRho27
1964,yfaE,4696676,4697028,4696676,352,364,utRho27
1965,yfaL,4688568,4688568,4688338,230,10,utRho27
1966,yfaP,4656398,4656398,4656286,112,132,utRho27
1967,yfaU,4717892,4717892,4717690,202,0,utRho27
1968,yfaY,4727310,4727310,4727266,44,60,utRho27
1969,yfaZ,4728744,4728744,4728550,194,26,utRho27
1970,yfbK,4771810,4771810,4771444,366,44,utRho27
1971,yfbL,4771500,4771720,4771500,220,44,utRho27
1972,yfbN,4777174,4777174,4776852,322,202,utRho27
1973,yfbO,4776916,4777162,4776916,246,202,utRho27
1974,yfbP,4777990,4778232,4777990,242,292,utRho27
1975,yfbR,4817662,4817724,4817662,62,0,utRho27
1976,yfcI,4847424,4847424,4847078,346,342,utRho27
1977,yfcJ,4880482,4880482,4880240,242,4,utRho27
1978,yfcL,4888502,4888502,4888338,164,12,utRho27
1979,yfcV,4911642,4911642,4911292,350,118,utRho27
1980,yfcZ,4921958,4921958,4921868,90,18,utRho27
1981,yfdF,4925604,4926024,4925604,420,0,utRho27
1982,yfdG,4935474,4935710,4935474,236,104,utRho27
1983,yfdP,4946844,4947040,4946844,196,0,utRho27
1984,yfdX,4988866,4988866,4988804,62,84,utRho27
1985,yfdY,4990672,4990672,4990584,88,96,utRho27
1986,yfeA,5035784,5035784,5035664,120,474,utRho27
1987,yfeC,5036668,5036934,5036668,266,0,utRho27
1988,yfeH,5053818,5053892,5053818,74,0,utRho27
1989,yfeK,5074630,5074684,5074630,54,120,utRho27
1990,yfeO,5018906,5019260,5018906,354,66,utRho27
1991,yfeR,5054078,5054078,5053712,366,0,utRho27
1992,yfeX,5101356,5101356,5101090,266,0,utRho27
1993,yfeY,5102486,5102486,5102432,54,0,utRho27
1994,yfeZ,5103842,5103842,5103452,390,48,utRho27
1995,yffO,5123804,5124222,5123804,418,276,utRho27
1996,yffQ,5126778,5127154,5126778,376,102,utRho27
1997,yffS,5128800,5128986,5128800,186,108,utRho27
1998,yfgC,5232052,5232188,5232052,136,0,utRho27
1999,yfgF,5258062,5258062,5257876,186,804,utRho27
2000,yfgG,5258170,5258580,5258170,410,712,utRho27
2001,yfgH,5259344,5259584,5259344,240,0,utRho27
2002,yfgM,5278866,5278866,5278566,300,54,utRho27
2003,yfhH,5397414,5397518,5397414,104,22,utRho27
2004,yfhM,5304648,5304648,5304574,74,0,utRho27
2005,yfhR,5328408,5328726,5328408,318,64,utRho27
2006,yfiC,5425610,5425610,5425528,82,84,utRho27
2007,yfiE,5430688,5430688,5430640,48,96,utRho27
2008,yfiL,5482630,5482720,5482630,90,128,utRho27
2009,yfiM,5448066,5448358,5448066,292,792,utRho27
2010,yfiR,5483354,5483750,5483354,396,354,utRho27
2011,yfjH,5517326,5517326,5517200,126,0,utRho27
2012,yfjI,5517710,5517970,5517710,260,0,utRho27
2013,yfjJ,5521014,5521094,5521014,80,48,utRho27
2014,yfjM,5531970,5531970,5531552,418,996,utRho27
2015,yfjP,5535080,5535420,5535080,340,440,utRho27
2016,yfjW,5546570,5546636,5546570,66,0,utRho27
2017,yfjX,5551776,5551838,5551776,62,0,utRho27
2018,ygaC,5601180,5601180,5599988,1192,9276,utRho27
2019,ygaM,5600242,5600292,5600242,50,3264,utRho27
2020,ygaU,5593628,5593628,5593572,56,0,utRho27
2021,ygaZ,5619190,5619234,5619190,44,0,utRho27
2022,ygbA,5713656,5713656,5713612,44,20,utRho27
2023,ygbE,5746784,5746784,5746674,110,0,utRho27
2024,ygbI,5722882,5722882,5722528,354,0,utRho27
2025,ygbK,5724394,5724670,5724394,276,90,utRho27
2026,ygbL,5727074,5727186,5727074,112,0,utRho27
2027,ygbN,5729814,5730202,5729814,388,236,utRho27
2028,ygcG,5811210,5811422,5811210,212,40,utRho27
2029,ygcN,5785144,5785314,5785144,170,20,utRho27
2030,ygcU,5799214,5799214,5798836,378,204,utRho27
2031,ygcW,5800942,5800942,5800546,396,52,utRho27
2032,ygdD,5883442,5883442,5883262,180,250,utRho27
2033,ygdG,5861746,5861930,5861746,184,110,utRho27
2034,ygdI,5886526,5886526,5886290,236,0,utRho27
2035,ygdQ,5940784,5940840,5940784,56,94,utRho27
2036,ygdR,5942494,5942542,5942494,48,98,utRho27
2037,ygeA,5961606,5961606,5961270,336,44,utRho27
2038,ygeH,5983758,5984188,5983758,430,0,utRho27
2039,ygeI,5987162,5987276,5987162,114,154,utRho27
2040,ygeR,6000078,6000078,5999782,296,46,utRho27
2041,ygeV,6011694,6011694,6011572,122,0,utRho27
2042,ygeW,6012234,6012524,6012234,290,346,utRho27
2043,ygfB,6110946,6110946,6110888,58,0,utRho27
2044,ygfK,6031984,6032120,6031984,136,0,utRho27
2045,ygfS,6058328,6058328,6058024,304,60,utRho27
2046,ygfZ,6082564,6082626,6082564,62,0,utRho27
2047,yggC,6149512,6149512,6149378,134,0,utRho27
2048,yggE,6136370,6136370,6136160,210,386,utRho27
2049,yggI,6179176,6179510,6179176,334,92,utRho27
2050,yggL,6204508,6204508,6204266,242,0,utRho27
2051,yggM,6199514,6199514,6199130,384,196,utRho27
2052,yggN,6203596,6203596,6203246,350,26,utRho27
2053,yggX,18623958,18624558,18623958,600,0,utRho27
2054,yghA,6298966,6299324,6298966,358,70,utRho27
2055,yghB,6307058,6307126,6307058,68,6,utRho27
2056,yghD,6222614,6222614,6222252,362,118,utRho27
2057,yghF,6225798,6225798,6225840,42,0,utRho27
2058,yghJ,6238640,6238640,6238224,416,0,utRho27
2059,yghQ,6265186,6265186,6264816,370,206,utRho27
2060,yghT,6267830,6268262,6267830,432,140,utRho27
2061,yghU,6277400,6277454,6277400,54,30,utRho27
2062,yghW,6293506,6293506,6293474,32,4,utRho27
2063,yghZ,6295562,6295794,6295562,232,0,utRho27
2064,ygiD,6365122,6365122,6364868,254,0,utRho27
2065,ygiH,6409066,6409388,6409066,322,190,utRho27
2066,ygiL,6370622,6370828,6370622,206,0,utRho27
2067,ygiM,6402084,6402414,6402084,330,464,utRho27
2068,ygiN,6346156,6346284,6346156,128,420,utRho27
2069,ygiQ,6322620,6322620,6322292,328,8,utRho27
2070,ygiS,6335462,6335462,6335436,26,0,utRho27
2071,ygiV,6338582,6338582,6338462,120,0,utRho27
2072,ygiW,6339774,6339774,6339352,422,124,utRho27
2073,ygiZ,6344506,6344506,6344422,84,0,utRho27
2074,ygjH,6442528,6442528,6442494,34,0,utRho27
2075,ygjI,6452140,6452468,6452140,328,38,utRho27
2076,ygjQ,6472730,6473080,6472730,350,276,utRho27
2077,ygjR,6474564,6474586,6474564,22,38,utRho27
2078,ygjV,6483638,6483638,6483488,150,0,utRho27
2079,yhaB,6535632,6535708,6535632,76,72,utRho27
2080,yhaH,6504498,6504608,6504498,110,496,utRho27
2081,yhaI,6505400,6505822,6505400,422,124,utRho27
2082,yhaJ,6508560,6508560,6508428,132,30,utRho27
2083,yhaK,6508538,6508638,6508538,100,0,utRho27
2084,yhbQ,6599878,6599932,6599878,54,174,utRho27
2085,yhbT,6602736,6602736,6602552,184,224,utRho27
2086,yhbU,6602558,6602970,6602558,412,410,utRho27
2087,yhbX,6643302,6643302,6643226,76,106,utRho27
2088,yhbY,6655518,6655580,6655518,62,366,utRho27
2089,yhcA,6723956,6724224,6723956,268,44,utRho27
2090,yhcB,6760364,6760382,6760364,18,0,utRho27
2091,yhcC,6708470,6708470,6708100,370,130,utRho27
2092,yhcF,6733440,6733852,6733440,412,220,utRho27
2093,yhcH,6739124,6739124,6738956,168,136,utRho27
2094,yhcM,6760312,6760312,6759994,318,64,utRho27
2095,yhcN,6770812,6771076,6770812,264,72,utRho27
2096,yhcO,6772606,6772606,6772258,348,0,utRho27
2097,yhdH,6806560,6806968,6806560,408,328,utRho27
2098,yhdJ,6823234,6823306,6823234,72,0,utRho27
2099,yhdN,6879092,6879092,6879018,74,640,utRho27
2100,yhdT,6814702,6814750,6814702,48,40,utRho27
2101,yhdU,6824994,6825242,6824994,248,172,utRho27
2102,yhdV,6836392,6836780,6836392,388,156,utRho27
2103,yhdW,6837944,6838298,6837944,354,0,utRho27
2104,yheO,6953082,6953082,6952880,202,22,utRho27
2105,yheV,6957970,6957970,6957584,386,72,utRho27
2106,yhfA,6971902,6971902,6971636,266,256,utRho27
2107,yhfG,6983294,6983294,6983240,54,0,utRho27
2108,yhfL,6998622,6998896,6998622,274,224,utRho27
2109,yhfY,7023244,7023244,7022844,400,0,utRho27
2110,yhgA,7086294,7086334,7086294,40,0,utRho27
2111,yhgE,7065176,7065176,7064878,298,106,utRho27
2112,yhgF,7074352,7074770,7074352,418,1586,utRho27
2113,yhhA,7173458,7173886,7173458,428,52,utRho27
2114,yhhI,7248346,7248756,7248346,410,26,utRho27
2115,yhhJ,7253696,7253696,7253606,90,2,utRho27
2116,yhhM,7211588,7211588,7211220,368,572,utRho27
2117,yhhN,7211150,7211502,7211150,352,338,utRho27
2118,yhhQ,7218238,7218434,7218238,196,410,utRho27
2119,yhhT,7223682,7223730,7223682,48,12,utRho27
2120,yhhX,7162032,7162032,7161610,422,108,utRho27
2121,yhhY,7162222,7162276,7162222,54,4,utRho27
2122,yhhZ,7163516,7163726,7163516,210,20,utRho27
2123,yhiD,7312220,7312220,7311804,416,4804,utRho27
2124,yhiJ,7265190,7265190,7265180,10,80,utRho27
2125,yhiM,7269270,7269682,7269270,412,1544,utRho27
2126,yhiN,7275000,7275000,7274820,180,274,utRho27
2127,yhjA,7338522,7338522,7338376,146,0,utRho27
2128,yhjB,7344090,7344090,7343788,302,372,utRho27
2129,yhjC,7344272,7344684,7344272,412,108,utRho27
2130,yhjD,7346660,7346724,7346660,64,0,utRho27
2131,yhjE,7349274,7349572,7349274,298,208,utRho27
2132,yhjG,7356824,7356824,7356730,94,30,utRho27
2133,yhjH,7358458,7358458,7358374,84,60,utRho27
2134,yhjJ,7364032,7364032,7363880,152,122,utRho27
2135,yhjK,7371296,7371296,7371158,138,178,utRho27
2136,yhjR,7392750,7392750,7392370,380,0,utRho27
2137,yhjV,7400796,7401126,7400796,330,542,utRho27
2138,yhjX,7424194,7424194,7424014,180,0,utRho27
2139,yhjY,7425966,7425966,7425868,98,62,utRho27
2140,yiaB,7455654,7455654,7455496,158,272,utRho27
2141,yiaD,7432712,7433094,7432712,382,30,utRho27
2142,yiaF,7438194,7438194,7438088,106,186,utRho27
2143,yiaG,7438862,7438956,7438862,94,10,utRho27
2144,yiaJ,7485236,7485236,7485064,172,222,utRho27
2145,yiaK,7485348,7485466,7485348,118,176,utRho27
2146,yiaT,7503924,7503924,7503736,188,0,utRho27
2147,yiaU,7503792,7503984,7503792,192,0,utRho27
2148,yiaY,7515856,7515856,7515654,202,108,utRho27
2149,yibF,7523950,7523950,7523910,40,0,utRho27
2150,yibG,7536128,7536354,7536128,226,1390,utRho27
2151,yibL,7553194,7553330,7553194,136,76,utRho27
2152,yibN,7570112,7570112,7570030,82,70,utRho27
2153,yibT,7552848,7552848,7552760,88,406,utRho27
2154,yicC,7633290,7633352,7633290,62,0,utRho27
2155,yicH,7660862,7660914,7660862,52,0,utRho27
2156,yicJ,7673328,7673328,7671858,1470,6712,utRho27
2157,yicN,7685018,7685018,7684804,214,8,utRho27
2158,yicO,7687914,7687914,7687578,336,86,utRho27
2159,yicR,15250308,15250308,15250236,72,0,utRho27
2160,yidB,7755230,7755230,7754930,300,198,utRho27
2161,yidE,7732780,7732780,7732546,234,78,utRho27
2162,yidF,7711580,7711580,7711222,358,76,utRho27
2163,yidQ,7735088,7735456,7735088,368,1050,utRho27
2164,yidR,7738824,7738824,7738618,206,96,utRho27
2165,yieE,7787658,7787738,7787658,80,528,utRho27
2166,yieH,7793314,7793548,7793314,234,0,utRho27
2167,yieK,7798928,7798928,7798786,142,104,utRho27
2168,yifB,7900350,7900350,7899998,352,102,utRho27
2169,yifL,7988984,7989044,7988984,60,172,utRho27
2170,yigF,8005750,8005750,8005598,152,1030,utRho27
2171,yigI,8009448,8009448,8009394,54,108,utRho27
2172,yigM,8022100,8022152,8022100,52,130,utRho27
2173,yihA,8101970,8101970,8101458,512,52,utRho27
2174,yihD,8084098,8084138,8084098,40,26,utRho27
2175,yihF,8088110,8088398,8088110,288,208,utRho27
2176,yihG,8093304,8093304,8093204,100,94,utRho27
2177,yihI,8102616,8102694,8102616,78,0,utRho27
2178,yihL,8120506,8120894,8120506,388,128,utRho27
2179,yihN,8124332,8124494,8124332,162,498,utRho27
2180,yihO,8131942,8131942,8131532,410,114,utRho27
2181,yihQ,8138892,8138892,8138552,340,0,utRho27
2182,yihV,8147064,8147478,8147064,414,24,utRho27
2183,yihX,8151096,8151106,8151096,10,0,utRho27
2184,yiiE,8158192,8158582,8158192,390,224,utRho27
2185,yiiF,8159124,8159502,8159124,378,4,utRho27
2186,yiiG,8173762,8174004,8173762,242,0,utRho27
2187,yiiM,8205506,8205644,8205506,138,216,utRho27
2188,yiiQ,8224624,8224624,8224428,196,0,utRho27
2189,yiiS,8225738,8225934,8225738,196,50,utRho27
2190,yijE,8272178,8272216,8272178,38,0,utRho27
2191,yijF,8275728,8275728,8275314,414,1072,utRho27
2192,yijO,8296858,8296858,8296634,224,98,utRho27
2193,yjaA,8426240,8426468,8426240,228,55420,utRho27
2194,yjaB,8428312,8428312,8428246,66,70,utRho27
2195,yjaG,8398746,8399008,8398746,262,0,utRho27
2196,yjaH,8401022,8401132,8401022,110,2,utRho27
2197,yjaZ,8379506,8379572,8379506,66,0,utRho27
2198,yjbB,8455204,8455462,8455204,258,48,utRho27
2199,yjbE,16943432,16943624,16943432,192,36,utRho27
2200,yjbL,8520318,8520642,8520318,324,8,utRho27
2201,yjbQ,8540428,8540476,8540428,48,120,utRho27
2202,yjcB,8550328,8550328,8550082,246,152,utRho27
2203,yjcC,8550836,8550942,8550836,106,108,utRho27
2204,yjcD,8556628,8556958,8556628,330,206,utRho27
2205,yjcE,8559658,8559960,8559658,302,248,utRho27
2206,yjcF,8566212,8566212,8566150,62,0,utRho27
2207,yjcO,8594660,8594660,8594250,410,92,utRho27
2208,yjdA,8654128,8654270,8654128,142,0,utRho27
2209,yjdC,8726660,8726660,8726616,44,54,utRho27
2210,yjdK,8704780,8705168,8704780,388,1222,utRho27
2211,yjdL,8713034,8713034,8712822,212,0,utRho27
2212,yjdM,8653672,8653672,8653468,204,1106,utRho27
2213,yjeF,8787354,8788132,8787354,778,652,utRho27
2214,yjeI,8745522,8745618,8745522,96,114,utRho27
2215,yjeJ,8748806,8748806,8748468,338,1136,utRho27
2216,yjeV,8785472,8785784,8785472,312,0,utRho27
2217,yjfP,8833512,8833904,8833512,392,122,utRho27
2218,yjfY,8849656,8849656,8849582,74,52,utRho27
2219,yjfZ,8855052,8855052,8854844,208,34,utRho27
2220,yjgA,8916162,8916162,8915730,432,86,utRho27
2221,yjgL,8950802,8950874,8950802,72,162,utRho27
2222,yjgM,8959342,8959342,8959074,268,0,utRho27
2223,yjgN,8959132,8959460,8959132,328,40,utRho27
2224,yjgR,8980170,8980170,8980126,44,394,utRho27
2225,yjgZ,9002116,9002520,9002116,404,796,utRho27
2226,yjhB,9007764,9008116,9007764,352,374,utRho27
2227,yjhG,9048452,9048452,9048188,264,596,utRho27
2228,yjhU,9041080,9041080,9040648,432,678,utRho27
2229,yjiA,9178096,9178096,9177730,366,0,utRho27
2230,yjiJ,9125364,9125364,9125350,14,0,utRho27
2231,yjiK,9127270,9127270,9127422,152,148,utRho27
2232,yjiL,9129604,9129604,9129378,226,60,utRho27
2233,yjiS,9143410,9143502,9143410,92,0,utRho27
2234,yjiY,9182734,9182734,9182558,176,66,utRho27
2235,yjjA,9200674,9200674,9200378,296,132,utRho27
2236,yjjB,18408708,18408708,18407800,908,800,utRho27
2237,yjjJ,9243314,9243538,9243314,224,0,utRho27
2238,yjjK,9261132,9261132,9261044,88,60,utRho27
2239,yjjL,9189764,9189764,9189444,320,0,utRho27
2240,yjjM,9191894,9191894,9191702,192,626,utRho27
2241,yjjP,9206068,9206068,9205716,352,218,utRho27
2242,yjjQ,9206638,9206954,9206638,316,94,utRho27
2243,yjjX,9267798,9267798,9267490,308,326,utRho27
2244,yjjY,9280716,9280804,9280716,88,146,utRho27
2245,yjjZ,9211554,9211608,9211554,54,0,utRho27
2246,yjtD,9281676,9281884,9281676,208,254,utRho27
2247,ykfB,532454,532454,532174,280,280,utRho27
2248,ykfI,527636,527636,527338,298,500,utRho27
2249,ykgB,637050,637050,636638,412,60,utRho27
2250,ykgC,640430,640430,640002,428,36,utRho27
2251,ykgD,640232,640454,640232,222,0,utRho27
2252,ykgE,642962,643216,642962,254,492,utRho27
2253,ykgJ,608524,608524,608364,160,76,utRho27
2254,ykgL,623878,624224,623878,346,32,utRho27
2255,ykgM,625610,625610,625554,56,0,utRho27
2256,ykgR,626570,626570,626484,86,2,utRho27
2257,ylaC,958576,958576,958502,74,532,utRho27
2258,yliE,1745938,1745958,1745938,20,0,utRho27
2259,ymcE,2103660,2103694,2103660,34,0,utRho27
2260,ymdA,2210450,2210828,2210450,378,76,utRho27
2261,ymdB,2211428,2211640,2211428,212,92,utRho27
2262,ymfD,2395322,2395322,2395064,258,90,utRho27
2263,ymfI,2402880,2402994,2402880,114,0,utRho27
2264,ymfJ,2404518,2404518,2404168,350,186,utRho27
2265,ymfK,2406176,2406176,2405866,310,0,utRho27
2266,ymfT,2405766,2406048,2405766,282,70,utRho27
2267,ymgE,2489110,2489456,2489110,346,114,utRho27
2268,ymgF,2437628,2437966,2437628,338,60,utRho27
2269,ymiA,2670112,2670320,2670112,208,28,utRho27
2270,ymjA,2715620,2715620,2715336,284,72,utRho27
2271,ynaI,2791946,2791946,2791844,102,0,utRho27
2272,ynaK,2850438,2850754,2850438,316,0,utRho27
2273,ynbA,2954924,2955242,2954924,318,92,utRho27
2274,yncD,3046552,3046552,3046130,422,0,utRho27
2275,yncE,3046454,3046614,3046454,160,0,utRho27
2276,yncG,3052456,3052494,3052456,38,30,utRho27
2277,yncL,3034492,3034492,3034388,104,4,utRho27
2278,yneE,3218364,3218364,3218044,320,0,utRho27
2279,yneF,3223748,3223748,3223708,40,146,utRho27
2280,yneJ,3229560,3229608,3229560,48,24,utRho27
2281,yneK,3231100,3231526,3231100,426,148,utRho27
2282,yneM,3245176,3245292,3245176,116,102,utRho27
2283,ynfA,3311398,3311398,3311346,52,0,utRho27
2284,ynfB,3311418,3311616,3311418,198,0,utRho27
2285,ynfC,3315094,3315094,3314914,180,0,utRho27
2286,ynfD,3314828,3315130,3314828,302,0,utRho27
2287,ynfE,3316006,3316138,3316006,132,0,utRho27
2288,ynfK,3334670,3334670,3334438,232,50,utRho27
2289,ynfL,3339304,3339304,3339184,120,0,utRho27
2290,ynfM,3339260,3339398,3339260,138,0,utRho27
2291,ynfN,3276598,3276598,3276218,380,26,utRho27
2292,ynfO,3273454,3273512,3273454,58,62,utRho27
2293,ynhG,3517890,3517890,3517450,440,30,utRho27
2294,yniA,3615158,3615592,3615158,434,0,utRho27
2295,yniB,3618526,3618526,3618466,60,0,utRho27
2296,yniC,3618652,3618760,3618652,108,104,utRho27
2297,yniD,3610202,3610330,3610202,128,0,utRho27
2298,ynjE,3678880,3678934,3678880,54,0,utRho27
2299,ynjF,3683222,3683222,3682806,416,62,utRho27
2300,ynjH,3684376,3684376,3684270,106,24,utRho27
2301,ynjI,3690022,3690022,3689742,280,36,utRho27
2302,yoaB,3786642,3786734,3786642,92,150,utRho27
2303,yoaC,3787932,3788146,3787932,214,284,utRho27
2304,yoaE,3803544,3803544,3803170,374,12,utRho27
2305,yoaF,3755444,3755444,3755064,380,0,utRho27
2306,yoaH,3789866,3789866,3789462,404,88,utRho27
2307,yobB,3850418,3850880,3850418,462,132,utRho27
2308,yobF,3815586,3815586,3815182,404,220,utRho27
2309,yobH,3817800,3817850,3817800,50,116,utRho27
2310,yodB,4084352,4084736,4084352,384,156,utRho27
2311,yodC,4057008,4057008,4056740,268,0,utRho27
2312,yohC,4451358,4451358,4451262,96,0,utRho27
2313,yohD,4451526,4451602,4451526,76,0,utRho27
2314,yohJ,4460986,4461248,4460986,262,242,utRho27
2315,yohO,4431172,4431314,4431172,142,0,utRho27
2316,yojI,4617282,4617282,4617230,52,86,utRho27
2317,ypdI,4988988,4989396,4988988,408,76,utRho27
2318,ypfG,5165786,5165786,5165554,232,106,utRho27
2319,ypfM,5182140,5182140,5181732,408,432,utRho27
2320,yphB,5349590,5349590,5349376,214,132,utRho27
2321,ypjA,5565644,5565644,5565452,192,712,utRho27
2322,ypjB,5569636,5569636,5568858,778,24,utRho27
2323,ypjD,5495860,5495774,5495860,86,0,utRho27
2324,yqaE,5594170,5594170,5594056,114,96,utRho27
2325,yqcA,5846100,5846100,5845968,132,190,utRho27
2326,yqcE,5800944,5801184,5800944,240,6,utRho27
2327,yqeC,6030468,6030468,6030114,354,28,utRho27
2328,yqeF,5971618,5971618,5971184,434,1078,utRho27
2329,yqeG,5971438,5971694,5971438,256,1016,utRho27
2330,yqeH,5975016,5975072,5975016,56,426,utRho27
2331,yqeI,5976688,5977004,5976688,316,20,utRho27
2332,yqeK,5981140,5981140,5980720,420,854,utRho27
2333,yqfA,6086728,6086728,6086296,432,92,utRho27
2334,yqgA,6219042,6219106,6219042,64,0,utRho27
2335,yqgB,6172500,6172500,6172102,398,28,utRho27
2336,yqgE,6185768,6185874,6185768,106,78,utRho27
2337,yqhA,6299150,6299150,6298942,208,8,utRho27
2338,yqhC,6310768,6310768,6310436,332,134,utRho27
2339,yqhD,6310604,6310710,6310604,106,34,utRho27
2340,yqhH,6316842,6317254,6316842,412,168,utRho27
2341,yqiC,6369662,6369680,6369662,18,22,utRho27
2342,yqiJ,6384108,6384416,6384108,308,246,utRho27
2343,yqjA,6495096,6495546,6495096,450,298,utRho27
2344,yqjF,6500932,6501124,6500932,192,440,utRho27
2345,yqjG,6501948,6502048,6501948,100,0,utRho27
2346,yqjH,6433078,6433078,6432982,96,0,utRho27
2347,yqjI,6433506,6433558,6433506,52,0,utRho27
2348,yraH,6574552,6574852,6574552,300,22,utRho27
2349,yraP,6592144,6592818,6592144,674,230,utRho27
2350,yraQ,6596414,6596414,6596276,138,0,utRho27
2351,yraR,6598024,6598024,6597692,332,0,utRho27
2352,yrbG,13360844,13361100,13360844,256,200,utRho27
2353,yrbL,6696842,6696904,6696842,62,98,utRho27
2354,yrbN,6616172,6616172,6615866,306,4,utRho27
2355,yrdB,6860176,6860176,6860046,130,296,utRho27
2356,yrfF,7052548,7052938,7052548,390,712,utRho27
2357,yrhB,7169440,7169518,7169440,78,102,utRho27
2358,ysaB,7451804,7451804,7451424,380,444,utRho27
2359,ysgA,8032686,8032686,8032338,348,80,utRho27
2360,ytfB,8857638,8857638,8857434,204,146,utRho27
2361,ytfE,8864018,8864018,8863966,52,234,utRho27
2362,ytfF,8866296,8866296,8866130,166,642,utRho27
2363,ytfH,8868164,8868226,8868164,62,0,utRho27
2364,ytfI,8875234,8875414,8875234,180,66,utRho27
2365,ytfJ,8878572,8878572,8878524,48,0,utRho27
2366,ytfK,8879022,8879174,8879022,152,24,utRho27
2367,ytfL,8882642,8882642,8882430,212,4,utRho27
2368,ytfQ,8899634,8899924,8899634,290,132,utRho27
2369,ytjB,9249598,9249598,9249578,20,0,utRho27
2370,yzfA,8896588,8896588,8896490,98,0,utRho27
2371,zapA,6111102,6111224,6111102,122,154,utRho27
2372,zapB,8236772,8237030,8236772,258,202,utRho27
2373,zapC,2011700,2011904,2011700,204,0,utRho27
2374,zinT,4082692,4082750,4082692,58,40,utRho27
2375,zipA,5062814,5062814,5062466,348,48,utRho27
2376,zitB,1569716,1569716,1569646,70,46,utRho27
2377,zntA,7212844,7212902,7212844,58,0,utRho27
2378,zntR,6878336,6878336,6878260,76,46,utRho27
2379,znuA,3885322,3885322,3885166,156,12,utRho27
2380,znuC,3885268,3885324,3885268,56,0,utRho27
2381,zraP,8403424,8403424,8403376,48,18,utRho27
2382,zraS,8403810,8403852,8403810,42,72,utRho27
2383,zupT,6364866,6365100,6364866,234,0,utRho27
2384,zur,8520282,8520282,8520006,276,76,utRho27
2385,zwf,3872752,3872752,3872628,124,32,utRho27
0,C0343,2818676,2818728,2818676,52,0,utRho28
1,aaeB,6776526,6776526,6776376,150,244,utRho28
2,aaeR,6778762,6779040,6778762,278,148,utRho28
3,aaeX,6778860,6778860,6778674,186,122,utRho28
4,aat,1854920,1854920,1854864,56,0,utRho28
5,accA,416822,417242,416822,420,142,utRho28
6,accB,6810280,6810872,6810280,592,1534,utRho28
7,accD,4868030,4868030,4867852,178,22,utRho28
8,aceB,8430804,8430956,8430804,152,196,utRho28
9,aceE,245938,246034,245938,96,346,utRho28
10,ackA,4826918,4826940,4826918,22,254,utRho28
11,acnA,2670848,2671662,2670848,814,230,utRho28
12,acnB,263038,263230,263038,192,262,utRho28
13,acpP,2303148,2303230,2303148,82,330,utRho28
14,acpS,5402324,5402324,5401996,328,1020,utRho28
15,acrA,971396,971396,971238,158,4,utRho28
16,acrB,969370,969370,968806,564,190,utRho28
17,acrD,5174950,5175190,5174950,240,0,utRho28
18,acrE,6827404,6827728,6827404,324,76,utRho28
19,acrR,971398,971522,971398,124,0,utRho28
20,acrZ,1589502,1589546,1589502,44,62,utRho28
21,acs,8575190,8575190,8574742,448,1676,utRho28
22,actP,8569870,8569870,8569804,66,80,utRho28
23,ada,4620854,4620854,4620810,44,0,utRho28
24,add,3404404,3404466,3404404,62,8,utRho28
25,ade,7687802,7687928,7687802,126,8,utRho28
26,adhE,2596826,2596826,2596242,584,76,utRho28
27,adhP,3107988,3107988,3107676,312,286,utRho28
28,adiA,8681112,8681112,8681042,70,110,utRho28
29,adiC,8674404,8674404,8674062,342,12,utRho28
30,adiY,8676084,8676084,8675858,226,20,utRho28
31,adk,994278,994350,994278,72,1142,utRho28
32,adrA,807374,807406,807374,32,28,utRho28
33,aer,6438240,6438240,6438152,88,56,utRho28
34,aes,1000102,1000102,999946,156,42,utRho28
35,agaR,6557406,6557406,6557330,76,0,utRho28
36,agaS,6563778,6563952,6563778,174,12,utRho28
37,agp,2131118,2131170,2131118,52,20,utRho28
38,agrA,7296126,7296126,7296126,0,0,utRho28
39,agrB,7296588,7296588,7296588,0,0,utRho28
40,ahpC,1277386,1277890,1277386,504,974,utRho28
41,ahpF,1278004,1279506,1278004,1502,27728,utRho28
42,ahr,8992698,8992698,8992418,280,268,utRho28
43,aidB,8828494,8828550,8828494,56,0,utRho28
44,ais,4731512,4731512,4731240,272,60,utRho28
45,alaA,4814816,4815122,4814816,306,68,utRho28
46,alaC,4996798,4996798,4996590,208,10,utRho28
47,alaE,5598140,5598328,5598140,188,600,utRho28
48,alaS,5644180,5644180,5644022,158,406,utRho28
49,alaW,5036612,5036612,5036462,150,26,utRho28
50,aldA,2976380,2976464,2976380,84,6,utRho28
51,aldB,7513070,7513070,7513022,48,162,utRho28
52,alkA,4295118,4295118,4295080,38,0,utRho28
53,alkB,4618890,4618890,4618682,208,48,utRho28
54,allA,1064780,1064902,1064780,122,24,utRho28
55,allD,1092822,1092822,1092726,96,0,utRho28
56,allE,1088112,1088112,1088092,20,18,utRho28
57,allS,1064600,1064600,1064442,158,112,utRho28
58,alr,8531178,8531564,8531178,386,404,utRho28
59,alsE,8617334,8617334,8616956,378,1016,utRho28
60,alsK,8615990,8615990,8615598,392,406,utRho28
61,alx,6476740,6477160,6476740,420,216,utRho28
62,amiA,5104482,5104704,5104482,222,44,utRho28
63,amiC,5898378,5898378,5898020,358,28,utRho28
64,amn,4110062,4110122,4110062,60,0,utRho28
65,ampC,8758006,8758006,8757888,118,12,utRho28
66,ampD,237362,237466,237362,104,92,utRho28
67,ampG,907372,907372,907090,282,230,utRho28
68,ampH,792726,792726,792574,152,40,utRho28
69,amyA,4012230,4012312,4012230,82,0,utRho28
70,anmK,3439346,3439346,3439204,142,58,utRho28
71,ansB,6201580,6201580,6201456,124,232,utRho28
72,ansP,3052040,3052040,3051960,80,72,utRho28
73,apaG,104068,104068,103212,856,424,utRho28
74,apaH,102586,102586,102444,142,430,utRho28
75,apbE,4623188,4623188,4623068,120,20,utRho28
76,appA,2081198,2081234,2081198,36,0,utRho28
77,appC,2075420,2075480,2075420,60,0,utRho28
78,appY,1167134,1167362,1167134,228,0,utRho28
79,apt,982620,982824,982620,204,8,utRho28
80,aqpZ,1832424,1832424,1832094,330,122,utRho28
81,araB,140150,140150,140096,54,18,utRho28
82,araC,140482,140774,140482,292,76,utRho28
83,araE,5964416,5964416,5964364,52,4,utRho28
84,araF,3972476,3972476,3972256,220,0,utRho28
85,araH,3967120,3967120,3967086,34,80,utRho28
86,araJ,825058,825058,824962,96,892,utRho28
87,arcA,9281602,9281602,9280612,990,1356,utRho28
88,arcB,6706098,6706098,6706050,48,106,utRho28
89,arcZ,6701154,6701154,6701154,0,0,utRho28
90,arfA,6877346,6877346,6877298,48,54,utRho28
91,argA,5898312,5898484,5898312,172,0,utRho28
92,argC,8309770,8310002,8309770,232,160,utRho28
93,argD,6980442,6980442,6980360,82,86,utRho28
94,argE,8310156,8310156,8309694,462,470,utRho28
95,argF,580680,580680,580610,70,0,utRho28
96,argG,6637124,6637274,6637124,150,78,utRho28
97,argI,8956688,8956688,8956622,66,244,utRho28
98,argO,6137672,6137672,6137616,56,96,utRho28
99,argP,6119460,6119506,6119460,46,36,utRho28
100,argR,6769204,6769406,6769204,202,20,utRho28
101,argS,3920002,3920124,3920002,122,8,utRho28
102,argT,4855698,4855698,4855582,116,60,utRho28
103,argU,1129406,1129446,1129406,40,8,utRho28
104,argW,4932616,4932618,4932616,2,0,utRho28
105,argX,7964728,7964750,7964728,22,8,utRho28
106,aroF,5482402,5482402,5482300,102,0,utRho28
107,aroG,1571182,1571266,1571182,84,90,utRho28
108,aroH,3576636,3576870,3576636,234,148,utRho28
109,aroK,7038760,7038760,7038128,632,1186,utRho28
110,aroL,812560,812810,812560,250,2066,utRho28
111,aroP,243342,243342,243102,240,42,utRho28
112,arpA,8445382,8445382,8444974,408,30,utRho28
113,arrS,7316108,7316108,7316108,0,0,utRho28
114,arsR,7297024,7297056,7297024,32,0,utRho28
115,artJ,1801252,1801252,1801150,102,0,utRho28
116,artP,1807686,1807686,1807468,218,942,utRho28
117,ascF,5678858,5679048,5678858,190,2,utRho28
118,ascG,5678574,5678574,5678528,46,76,utRho28
119,aslB,7965562,7965916,7965562,354,140,utRho28
120,asnA,7854258,7854310,7854258,52,308,utRho28
121,asnB,1398444,1398444,1398354,90,110,utRho28
122,asnC,23562186,23562186,23562018,168,426,utRho28
123,asnS,1978088,1978088,1977970,118,1018,utRho28
124,asnT,4089082,4089098,4089082,16,118,utRho28
125,asnU,4119690,4119702,4119690,12,22,utRho28
126,asnV,4124504,4124520,4124504,16,46,utRho28
127,aspA,17473728,17473728,17473308,420,68,utRho28
128,aspC,1971486,1971486,1971418,68,78,utRho28
129,aspS,3901402,3901402,3901044,358,228,utRho28
130,aspT,7893560,7893744,7893560,184,96744,utRho28
131,aspV,473826,473862,473826,36,264,utRho28
132,asr,3342654,3342752,3342654,98,62,utRho28
133,astC,3664088,3664088,3663964,124,50,utRho28
134,astE,3654138,3654138,3653846,292,136,utRho28
135,atoD,4646824,4646894,4646824,70,118,utRho28
136,atpB,7844540,7844540,7844102,438,406,utRho28
137,atpC,7832118,7832118,7831944,174,704,utRho28
138,atpI,7845050,7845050,7844880,170,790,utRho28
139,avtA,7479348,7479410,7479348,62,768,utRho28
140,azoR,2965982,2965982,2965720,262,210,utRho28
141,azuC,3976002,3976002,3975918,84,30,utRho28
142,bacA,6408350,6408350,6408262,88,10806,utRho28
143,bamA,394052,395856,394052,1804,1996,utRho28
144,bamB,5277950,5277950,5277304,646,582,utRho28
145,bamC,5198028,5198028,5197730,298,410,utRho28
146,bamD,5471922,5472292,5471922,370,420,utRho28
147,bamE,5506972,5507210,5506972,238,714,utRho28
148,basS,8666954,8666954,8666544,410,678,utRho28
149,bax,7474468,7474468,7474354,114,196,utRho28
150,bcp,5200874,5200956,5200874,82,264,utRho28
151,bcsB,7385346,7385346,7385214,132,62,utRho28
152,bcsE,7392644,7392916,7392644,272,10,utRho28
153,bdcA,8948128,8948128,8948106,22,468,utRho28
154,bdcR,8948192,8948248,8948192,56,62,utRho28
155,bdm,3112680,3112680,3112560,120,238,utRho28
156,betA,654522,654522,654494,28,42,utRho28
157,betI,658722,658722,658668,54,220,utRho28
158,betT,658842,658926,658842,84,382,utRho28
159,bfr,6933498,6933498,6933450,48,100,utRho28
160,bglG,23440182,23440182,23439402,780,1302,utRho28
161,bglX,4444240,4444240,4443978,262,86,utRho28
162,bhsA,2337962,2338146,2337962,184,188,utRho28
163,bioA,1618584,1618584,1618514,70,0,utRho28
164,bioB,1618604,1618688,1618604,84,0,utRho28
165,bioH,7089716,7089716,7089688,28,0,utRho28
166,bisC,7433026,7433026,7432788,238,124,utRho28
167,blc,8755490,8755490,8755444,46,66,utRho28
168,blr,3409024,3409102,3409024,78,270,utRho28
169,bluF,2431226,2431226,2430950,276,114,utRho28
170,bluR,2428226,2428226,2428118,108,48,utRho28
171,bolA,908698,908944,908698,246,64,utRho28
172,borD,1157842,1157842,1157786,56,50,utRho28
173,brnQ,838976,839182,838976,206,660,utRho28
174,bssR,1756492,1756496,1756492,4,10,utRho28
175,bssS,2242116,2242116,2241910,206,522,utRho28
176,btuB,8326798,8327278,8326798,480,852,utRho28
177,cadB,8720212,8720212,8720062,150,90,utRho28
178,cadC,8723926,8723926,8723868,58,48,utRho28
179,caiE,70998,70998,70742,256,38,utRho28
180,caiF,68436,68600,68436,164,200,utRho28
181,caiT,84074,84074,83862,212,240,utRho28
182,can,285406,285406,285340,66,86,utRho28
183,carA,59102,59302,59102,200,594,utRho28
184,carB,61550,61634,61550,84,96,utRho28
185,cas2,5757830,5757830,5757706,124,66,utRho28
186,casA,5768638,5768638,5768276,362,118,utRho28
187,cbl,4121882,4121882,4121828,54,152,utRho28
188,cbpA,2128074,2128074,2127550,524,20,utRho28
189,cbrA,7738628,7738754,7738628,126,136,utRho28
190,cbrB,7794958,7795012,7794958,54,122,utRho28
191,ccmH,4585242,4585242,4584820,422,28,utRho28
192,cdaR,364894,364926,364894,32,50,utRho28
193,cdd,4463638,4463688,4463638,50,96,utRho28
194,cdh,8219814,8219860,8219814,46,92,utRho28
195,cdsA,391110,391354,391110,244,722,utRho28
196,cedA,3627484,3627484,3627326,158,42,utRho28
197,cfa,3482402,3482826,3482402,424,0,utRho28
198,chaC,2544844,2544972,2544844,128,280,utRho28
199,chbB,3643452,3643452,3643238,214,28,utRho28
200,chbG,3634624,3634624,3634270,354,64,utRho28
201,cheW,3946924,3946924,3946678,246,150,utRho28
202,chiA,6939792,6939792,6939706,86,856,utRho28
203,chiP,1416472,1416668,1416472,196,28,utRho28
204,cho,3646984,3647030,3646984,46,0,utRho28
205,chpS,8896804,8896894,8896804,90,138,utRho28
206,cirA,4493884,4493884,4493538,346,690,utRho28
207,citC,1304078,1304078,1303712,366,336,utRho28
208,citT,1293264,1293264,1293160,104,0,utRho28
209,clcA,350104,350214,350104,110,8,utRho28
210,clpA,1846160,1846528,1846160,368,194,utRho28
211,clpB,5468410,5468410,5468346,64,484,utRho28
212,clpP,913154,913354,913154,200,806,utRho28
213,clpS,1845500,1845826,1845500,326,200,utRho28
214,clpX,914404,914852,914404,448,1448,utRho28
215,clsA,2617346,2617346,2617290,56,46,utRho28
216,clsC,2212584,2212710,2212584,126,4,utRho28
217,cmk,1922330,1922402,1922330,72,24,utRho28
218,cnu,3409522,3409898,3409522,376,1276,utRho28
219,coaA,8350214,8350214,8350052,162,746,utRho28
220,cobC,1340092,1340092,1339814,278,94,utRho28
221,cobT,4129202,4129202,4128934,268,84,utRho28
222,cobU,4131944,4131944,4131528,416,86,utRho28
223,codB,709768,709844,709768,76,314,utRho28
224,comR,2337726,2337726,2337664,62,0,utRho28
225,copA,1022822,1022822,1022758,64,0,utRho28
226,corA,8002388,8002852,8002388,464,21538,utRho28
227,cpdB,8873258,8873258,8873130,128,116,utRho28
228,cptB,6082198,6082198,6082140,58,0,utRho28
229,cpxA,8210202,8210202,8209950,252,154,utRho28
230,cpxP,8211570,8211640,8211570,70,146,utRho28
231,cpxR,8211372,8211372,8211340,32,0,utRho28
232,cra,175894,176056,175894,162,328,utRho28
233,crcB,1316016,1316016,1315876,140,30,utRho28
234,creA,9270486,9271042,9270486,556,340,utRho28
235,creD,9276320,9276356,9276320,36,184,utRho28
236,crl,515620,515658,515620,38,578,utRho28
237,crp,6971906,6972240,6971906,334,408,utRho28
238,crr,5070960,5071668,5070960,708,1496,utRho28
239,csdA,5886414,5886674,5886414,260,0,utRho28
240,csgB,2207718,2207902,2207718,184,26,utRho28
241,csgD,2206688,2206688,2206392,296,790,utRho28
242,csgG,2203510,2203510,2203368,142,280,utRho28
243,csiD,5577854,5577970,5577854,116,36,utRho28
244,csiE,5330802,5330870,5330802,68,0,utRho28
245,csiR,5590942,5591348,5590942,406,246,utRho28
246,cspA,7439778,7440098,7439778,320,778,utRho28
247,cspB,3283430,3283430,3283108,322,80,utRho28
248,cspC,3815018,3815018,3814870,148,76,utRho28
249,cspD,1845352,1845352,1845180,172,4938,utRho28
250,cspE,1314294,1314584,1314294,290,338,utRho28
251,cspF,3283380,3283710,3283380,330,870,utRho28
252,cspG,2102610,2102922,2102610,312,318,utRho28
253,cspH,2102746,2102746,2102350,396,106,utRho28
254,cspI,3277624,3277624,3277334,290,36,utRho28
255,csrA,5638746,5638746,5638292,454,2166,utRho28
256,csrB,5849048,5849048,5849048,0,0,utRho28
257,csrC,8102072,8102072,8102072,0,0,utRho28
258,csrD,6806850,6806850,6806664,186,208,utRho28
259,cstA,1259710,1259788,1259710,78,0,utRho28
260,cueO,274090,274166,274090,76,38,utRho28
261,cueR,1027948,1027986,1027948,38,0,utRho28
262,curA,3037784,3038054,3037784,270,148,utRho28
263,cusC,1191146,1191200,1191146,54,26,utRho28
264,cusR,1190924,1190924,1190886,38,82,utRho28
265,cutA,8730784,8730784,8730712,72,44,utRho28
266,cutC,3918534,3918534,3917920,614,554,utRho28
267,cvpA,4861600,4861600,4861526,74,2,utRho28
268,cvrA,2484328,2484328,2484142,186,68,utRho28
269,cyaA,7981548,7982306,7981548,758,534,utRho28
270,cyaR,4334228,4334224,4334228,4,14,utRho28
271,cyaY,7988166,7988166,7988118,48,454,utRho28
272,cybB,2981522,2981804,2981522,282,286,utRho28
273,cycA,8859560,8859728,8859560,168,164,utRho28
274,cydA,1542340,1542916,1542340,576,2974,utRho28
275,cydC,1858800,1858800,1858390,410,0,utRho28
276,cydD,1862062,1862062,1861924,138,0,utRho28
277,cydX,1548300,1548392,1548300,92,278,utRho28
278,cynR,717418,717418,717380,38,0,utRho28
279,cynT,1435092,1435196,1435092,104,0,utRho28
280,cyoA,903306,903306,903220,86,366,utRho28
281,cyoE,895540,895540,895410,130,194,utRho28
282,cysB,2667576,2667710,2667576,134,156,utRho28
283,cysC,5748056,5748056,5747984,72,182,utRho28
284,cysD,5752736,5752736,5752658,78,56,utRho28
285,cysE,7565362,7565362,7565124,238,816,utRho28
286,cysG,6995508,6995656,6995508,148,3256,utRho28
287,cysJ,5783928,5783928,5783796,132,904,utRho28
288,cysK,5064688,5064818,5064688,130,0,utRho28
289,cysP,5087114,5087114,5087056,58,102,utRho28
290,cysS,1109154,1109222,1109154,68,70,utRho28
291,cysT,3984100,3984100,3983974,126,110,utRho28
292,cysZ,5062766,5062926,5062766,160,252,utRho28
293,cytR,8249018,8249018,8248912,106,166,utRho28
294,dacA,1328002,1328002,1327926,76,0,utRho28
295,dacB,6657714,6657926,6657714,212,52,utRho28
296,dacC,1761306,1761454,1761306,148,826,utRho28
297,dadA,2475018,2475142,2475018,124,218,utRho28
298,dam,7032504,7032504,7031826,678,282,utRho28
299,damX,7035200,7035200,7034612,588,1618,utRho28
300,dapA,5199568,5199568,5199520,48,26,utRho28
301,dapB,56576,56748,56576,172,868,utRho28
302,dapD,371954,371954,371894,60,236,utRho28
303,dapE,5183120,5183214,5183120,94,372,utRho28
304,dcp,3254844,3254844,3254760,84,0,utRho28
305,dcrB,7219534,7219910,7219534,376,294,utRho28
306,dctA,7366996,7366996,7366894,102,308,utRho28
307,dcuA,8733686,8733686,8733546,140,1374,utRho28
308,dcuB,8698182,8698182,8697488,694,1480,utRho28
309,dcuC,1312166,1312166,1311936,230,602,utRho28
310,dcuD,6749166,6749738,6749166,572,684,utRho28
311,dcuR,8701130,8701130,8700068,1062,1072,utRho28
312,dcuS,8703370,8703370,8703324,46,474,utRho28
313,dcyD,3999016,3999016,3998960,56,0,utRho28
314,ddpX,3126498,3126498,3126152,346,70,utRho28
315,deaD,6615818,6615818,6615720,98,238,utRho28
316,dedA,4869880,4869880,4869482,398,748,utRho28
317,dedD,4863750,4863750,4863368,382,16,utRho28
318,def,6867300,6867380,6867300,80,250,utRho28
319,degP,361690,361768,361690,78,40,utRho28
320,degQ,6761308,6761486,6761308,178,432,utRho28
321,deoB,9239134,9239206,9239134,72,76,utRho28
322,deoC,9233358,9234646,9233358,1288,732,utRho28
323,dfp,7625406,7625462,7625406,56,0,utRho28
324,dgcZ,3247758,3247758,3247700,58,54,utRho28
325,dgkA,8512914,8513274,8512914,360,226,utRho28
326,dgt,358392,358474,358392,82,236,utRho28
327,dhaK,2501888,2501888,2501676,212,150,utRho28
328,dhaR,2502006,2502132,2502006,126,116,utRho28
329,dicB,3299194,3299218,3299194,24,40,utRho28
330,dicC,3295752,3295752,3295700,52,0,utRho28
331,dinB,501760,501796,501760,36,0,utRho28
332,dinD,7635398,7635520,7635398,122,68,utRho28
333,dinG,1666146,1666140,1666146,6,0,utRho28
334,dinI,2243018,2243018,2242974,44,122,utRho28
335,dinJ,493230,493230,493004,226,146,utRho28
336,dinQ,7295964,7295964,7295576,388,64,utRho28
337,djlA,114536,114728,114536,192,110,utRho28
338,dkgA,6313142,6313246,6313142,104,62,utRho28
339,dkgB,458196,458334,458196,138,20,utRho28
340,dksA,321502,321502,321208,294,830,utRho28
341,dld,4444164,4444370,4444164,206,40,utRho28
342,dmlA,3763424,3763824,3763424,400,126,utRho28
343,dmlR,3763710,3763710,3763618,92,0,utRho28
344,dmsA,1881646,1881918,1881646,272,32,utRho28
345,dnaA,7767922,7767922,7767458,464,356,utRho28
346,dnaB,8528566,8528628,8528566,62,222,utRho28
347,dnaK,24096,24326,24096,230,4550,utRho28
348,dnaN,7765466,7765466,7764642,824,256,utRho28
349,dnaQ,471868,472134,471868,266,2196,utRho28
350,dnaT,18406460,18406460,18406068,392,104,utRho28
351,dnaX,984112,984184,984112,72,24,utRho28
352,dosP,3131486,3131486,3131466,20,30,utRho28
353,dpiB,1303968,1304470,1303968,502,144,utRho28
354,dppA,7415740,7415740,7415410,330,1168,utRho28
355,dps,1697900,1697900,1697822,78,196,utRho28
356,dsbA,8086754,8086836,8086754,82,384,utRho28
357,dsbB,2466294,2466294,2466060,234,58,utRho28
358,dsbC,6079266,6079266,6077644,1622,1330,utRho28
359,dsbG,1277600,1277600,1277146,454,428,utRho28
360,dsdA,4958242,4958404,4958242,162,174,utRho28
361,dsdC,4955492,4955492,4955258,234,182,utRho28
362,dsdX,4955642,4955694,4955642,52,786,utRho28
363,dsrA,4050626,4050626,4050626,0,0,utRho28
364,dsrB,4049686,4049686,4049646,40,352,utRho28
365,dtpD,1485340,1485340,1485112,228,354,utRho28
366,dusA,8523200,8523338,8523200,138,1030,utRho28
367,dusB,6820492,6820560,6820492,68,60,utRho28
368,dusC,4460790,4460790,4460770,20,0,utRho28
369,dut,7627704,7627864,7627704,160,874,utRho28
370,dxr,386670,387042,386670,372,236,utRho28
371,ebgA,6445102,6445266,6445102,164,0,utRho28
372,ebgR,6442874,6442932,6442874,58,16,utRho28
373,ecnB,8753018,8753106,8753018,88,76,utRho28
374,eco,4607594,4607810,4607594,216,72,utRho28
375,ecpA,621594,621594,621342,252,70,utRho28
376,ecpB,620238,620238,620052,186,106,utRho28
377,ecpR,622964,622964,622672,292,0,utRho28
378,eda,3866218,3866218,3865512,706,86,utRho28
379,edd,3869426,3869426,3869208,218,0,utRho28
380,efeO,2164308,2164486,2164308,178,22,utRho28
381,efeU_1,2162614,2162712,2162614,98,400,utRho28
382,efp,8751134,8751398,8751134,264,934,utRho28
383,elaA,4763372,4763372,4763086,286,126,utRho28
384,elaD,4765308,4765426,4765308,118,128,utRho28
385,elfA,1995530,1995736,1995530,206,0,utRho28
386,elfD,1996642,1996980,1996642,338,108,utRho28
387,emrD,7707690,7707844,7707690,154,102,utRho28
388,emrK,4966896,4966896,4966678,218,68,utRho28
389,emrY,4964668,4964668,4964352,316,426,utRho28
390,emtA,2486250,2486360,2486250,110,2,utRho28
391,endA,12361100,12361388,12361100,288,0,utRho28
392,eno,5817692,5817692,5815882,1810,680,utRho28
393,entC,1249662,1249770,1249662,108,0,utRho28
394,entD,1220508,1220508,1220158,350,162,utRho28
395,entH,1258584,1258600,1258584,16,0,utRho28
396,entS,1244506,1244600,1244506,94,0,utRho28
397,envR,6827266,6827266,6826930,336,140,utRho28
398,epd,12295292,12295292,12294764,528,268,utRho28
399,epmA,8765236,8765286,8765236,50,148,utRho28
400,epmB,8751406,8751406,8751314,92,544,utRho28
401,eptB,7421162,7421162,7420950,212,0,utRho28
402,eptC,8300622,8300622,8300530,92,174,utRho28
403,erfK,4126708,4126708,4126646,62,0,utRho28
404,erpA,353122,353220,353122,98,32,utRho28
405,esrE,8039956,8039956,8039956,0,0,utRho28
406,essD,1153746,1154796,1153746,1050,212,utRho28
407,etk,2088606,2088606,2088420,186,10,utRho28
408,evgA,4967262,4967510,4967262,248,120,utRho28
409,exbB,6304028,6304028,6303968,60,156,utRho28
410,exbD,6302780,6302780,6302486,294,128,utRho28
411,exuR,6493016,6493304,6493016,288,0,utRho28
412,exuT,6490004,6490208,6490004,204,76,utRho28
413,fabA,2032996,2032996,2032940,56,40,utRho28
414,fabB,4883282,4883282,4883210,72,16,utRho28
415,fabH,2297032,2297518,2297032,486,84,utRho28
416,fabI,2702236,2702236,2702078,158,44,utRho28
417,fadB,8062026,8062026,8061942,84,6,utRho28
418,fadD,3779614,3779614,3779492,122,240,utRho28
419,fadE,486812,486812,486606,206,6,utRho28
420,fadH,6463248,6463330,6463248,82,100,utRho28
421,fadI,4921022,4921022,4920938,84,344,utRho28
422,fadL,4922410,4922600,4922410,190,182,utRho28
423,fadM,928720,928804,928720,84,10,utRho28
424,fadR,2469810,2469876,2469810,66,0,utRho28
425,fbaB,4357334,4357334,4357128,206,0,utRho28
426,fdhE,8162722,8162722,8162456,266,166,utRho28
427,fdhF,8598814,8598814,8598732,82,84,utRho28
428,fdnG,3094744,3094802,3094744,58,0,utRho28
429,fdrA,1093012,1093360,1093012,348,74,utRho28
430,feaB,2894994,2895038,2894994,44,0,utRho28
431,feaR,2894734,2894734,2894566,168,0,utRho28
432,fecA,9033454,9033454,9033354,100,98,utRho28
433,fecE,9023288,9023288,9022914,374,2840,utRho28
434,fecI,9036564,9036564,9036470,94,60,utRho28
435,feoA,7080114,7080326,7080114,212,362,utRho28
436,fepA,1225334,1225334,1224988,346,286,utRho28
437,fepB,1249454,1249454,1249020,434,92,utRho28
438,fepD,1244468,1244468,1244378,90,0,utRho28
439,fes,1225374,1225630,1225374,256,332,utRho28
440,ffh,5495706,5495706,5495590,116,616,utRho28
441,ffs,952576,952848,952576,272,492,utRho28
442,fhuA,334884,334968,334884,84,126,utRho28
443,fhuE,2323294,2323294,2323102,192,242,utRho28
444,fhuF,9211504,9211504,9211326,178,556,utRho28
445,fic,6983296,6983296,6982926,370,114,utRho28
446,fieF,8212864,8212938,8212864,74,146,utRho28
447,fimA,9085388,9086230,9085388,842,740,utRho28
448,fimB,9081334,9081914,9081334,580,2356,utRho28
449,fimE,9083742,9084074,9083742,332,980,utRho28
450,fimZ,1129214,1129214,1128960,254,142,utRho28
451,fiu,1683296,1683296,1683062,234,152,utRho28
452,fixA,84650,84806,84650,156,112,utRho28
453,fkpA,6955050,6955050,6954838,212,6840,utRho28
454,fldA,2846084,2846084,2845860,224,1072,utRho28
455,fldB,6079644,6079710,6079644,66,160,utRho28
456,flgA,2261770,2261770,2261726,44,360,utRho28
457,flgB,2261986,2262036,2261986,50,72,utRho28
458,flgK,2276702,2276756,2276702,54,54,utRho28
459,flgM,2260330,2260330,2260256,74,58,utRho28
460,flgN,2259828,2259828,2259660,168,34,utRho28
461,flhB,3932432,3932432,3932382,50,36,utRho28
462,flhC,3955864,3955864,3955688,176,0,utRho28
463,flhD,3957154,3957154,3956394,760,714,utRho28
464,fliA,4003638,4003638,4003578,60,70,utRho28
465,fliC,4007352,4007352,4007212,140,116,utRho28
466,fliD,4007634,4007744,4007634,110,120,utRho28
467,fliE,4026186,4026186,4026028,158,364,utRho28
468,fliF,4026292,4026458,4026292,166,22,utRho28
469,fliL,4039168,4039236,4039168,68,86,utRho28
470,flk,4875824,4875900,4875824,76,0,utRho28
471,flu,4142634,4143078,4142634,444,206,utRho28
472,flxA,3292776,3292810,3292776,34,288,utRho28
473,fnr,2799104,2799104,2799052,52,0,utRho28
474,fnrS,2818258,2818258,2818258,0,0,utRho28
475,focA,1909628,1909628,1908932,696,504,utRho28
476,folA,99598,99646,99598,48,260,utRho28
477,folB,6409296,6409296,6409178,118,892,utRho28
478,folD,1115562,1115562,1115482,80,220,utRho28
479,folE,4487696,4487696,4487304,392,72,utRho28
480,fpr,8228998,8228998,8228944,54,0,utRho28
481,frc,4986878,4986878,4986508,370,224,utRho28
482,frdA,8764824,8764824,8764636,188,84,utRho28
483,frdD,8758948,8758948,8758732,216,414,utRho28
484,fre,8052886,8053054,8052886,168,206,utRho28
485,frlA,6999518,6999820,6999518,302,150,utRho28
486,frr,385624,385744,385624,120,120,utRho28
487,frsA,513004,513054,513004,50,124,utRho28
488,fruB,4527194,4527194,4526990,204,0,utRho28
489,frvR,8179804,8179804,8179710,94,0,utRho28
490,fryA,5008986,5008986,5008970,16,48,utRho28
491,fsaA,1727060,1727284,1727060,224,284,utRho28
492,fsr,1009710,1009710,1009392,318,424,utRho28
493,ftnA,3977364,3977432,3977364,68,20,utRho28
494,ftnB,3973550,3973850,3973550,300,166,utRho28
495,ftsA,207122,207964,207122,842,1082,utRho28
496,ftsB,5745802,5745802,5745640,162,116,utRho28
497,ftsH,6654204,6654204,6653870,334,1656,utRho28
498,ftsK,1865858,1866448,1865858,590,1114,utRho28
499,ftsL,181376,182064,181376,688,570,utRho28
500,ftsP,6325732,6325732,6325338,394,56,utRho28
501,ftsQ,205484,206310,205484,826,1190,utRho28
502,ftsX,7204512,7204512,7204172,340,392,utRho28
503,ftsZ,209272,210610,209272,1338,328,utRho28
504,fucA,5867708,5867708,5867376,332,1730,utRho28
505,fucP,5868238,5868470,5868238,232,180,utRho28
506,fumA,6753760,6753760,6753508,252,1148,utRho28
507,fumB,8694696,8694696,8694652,44,0,utRho28
508,fumC,3373418,3373418,3373176,242,0,utRho28
509,fur,2842892,2842892,2842584,308,668,utRho28
510,fusA,6947370,6947370,6947028,342,5210,utRho28
511,fxsA,8737206,8737328,8737206,122,966,utRho28
512,gabD,5581824,5582546,5581824,722,1830,utRho28
513,gadA,7335214,7335214,7335160,54,0,utRho28
514,gadB,3144144,3144144,3144090,54,0,utRho28
515,gadC,3141168,3141168,3140978,190,902,utRho28
516,gadE,7315600,7316732,7315600,1132,464,utRho28
517,gadW,7329562,7329562,7329236,326,126,utRho28
518,gadX,14663356,14663356,14663240,116,76,utRho28
519,gadY,7329728,7329728,7329728,0,0,utRho28
520,galE,1584354,1584354,1584110,244,40,utRho28
521,galF,4228702,4228702,4228654,48,314,utRho28
522,galM,1577796,1577796,1577674,122,180,utRho28
523,galP,6176510,6176568,6176510,58,110,utRho28
524,galR,5953138,5953198,5953138,60,48,utRho28
525,galS,4483420,4483420,4483336,84,0,utRho28
526,galU,2582810,2582914,2582810,104,182,utRho28
527,gapA,3724480,3725542,3724480,1062,1218,utRho28
528,garP,6549868,6549868,6549814,54,296,utRho28
529,gatY,4354468,4354468,4354408,60,0,utRho28
530,gatZ,4352864,4352864,4352642,222,182,utRho28
531,gcd,282558,282558,282450,108,6,utRho28
532,gcl,1067814,1067832,1067814,18,6,utRho28
533,gcvA,5885278,5885278,5885134,144,64,utRho28
534,gcvB,5885392,5885392,5885392,0,0,utRho28
535,gcvR,5199758,5199812,5199758,54,24,utRho28
536,gcvT,6101544,6101544,6101334,210,498,utRho28
537,gdhA,3684616,3684742,3684616,126,0,utRho28
538,gfcA,2099668,2099668,2099488,180,272,utRho28
539,gfcD,2096236,2096236,2095890,346,288,utRho28
540,ghrA,2195648,2195772,2195648,124,120,utRho28
541,ghrB,7434378,7434620,7434378,242,606,utRho28
542,glcA,6242728,6242728,6242558,170,268,utRho28
543,glcC,6256412,6256544,6256412,132,0,utRho28
544,glcD,6256152,6256152,6256042,110,144,utRho28
545,gldA,8278092,8278092,8278070,22,44,utRho28
546,glgA,7136784,7136784,7136066,718,386,utRho28
547,glgB,7147314,7147314,7147004,310,132,utRho28
548,glgC,7139142,7139142,7138656,486,4,utRho28
549,glgP,7133546,7133546,7133162,384,244,utRho28
550,glgS,6384024,6384024,6383878,146,254,utRho28
551,glgX,7142838,7142838,7142638,200,0,utRho28
552,glk,5018922,5018922,5018852,70,30,utRho28
553,glmS,7827622,7827622,7827336,286,368,utRho28
554,glmU,7830652,7830652,7830400,252,90,utRho28
555,glmY,10765360,10765360,10765360,0,0,utRho28
556,glmZ,7972864,7972864,7972864,0,0,utRho28
557,glnA,16232888,16232888,16232136,752,112,utRho28
558,glnB,5375052,5375052,5374816,236,128,utRho28
559,glnD,377310,377310,377300,10,668,utRho28
560,glnE,6399602,6399602,6399282,320,76,utRho28
561,glnH,1696396,1696396,1696008,388,820,utRho28
562,glnK,945112,945196,945112,84,50,utRho28
563,glnL,8112742,8112742,8112678,64,0,utRho28
564,glnQ,1693262,1693262,1692926,336,262,utRho28
565,glnS,1411998,1412186,1411998,188,1618,utRho28
566,gloA,3455602,3455674,3455602,72,216,utRho28
567,gloB,469852,469852,469564,288,584,utRho28
568,glpA,4705166,4705294,4705166,128,128,utRho28
569,glpD,7123942,7124026,7123942,84,102,utRho28
570,glpE,7123698,7123698,7123646,52,74,utRho28
571,glpF,8236322,8236322,8236180,142,1554,utRho28
572,glpG,7122960,7122960,7122904,56,32,utRho28
573,glpR,7121782,7121782,7121210,572,2998,utRho28
574,glpT,4704902,4704902,4704748,154,300,utRho28
575,glpX,8231212,8231212,8231158,54,246,utRho28
576,glrK,5382246,5382246,5382196,50,20,utRho28
577,gltA,1509534,1509534,1508936,598,918,utRho28
578,gltB,6709018,6709264,6709018,246,116,utRho28
579,gltI,1375792,1375792,1375494,298,480,utRho28
580,gltP,8588536,8588962,8588536,426,578,utRho28
581,gltS,7657382,7657382,7657330,52,742,utRho28
582,gltX,5041568,5041568,5041344,224,152,utRho28
583,gluQ,320286,320286,320224,62,174,utRho28
584,glyA,5371148,5371148,5371014,134,164,utRho28
585,glyQ,7450708,7450708,7450636,72,0,utRho28
586,glyS,7448990,7448990,7448794,196,736,utRho28
587,glyU,5998128,5998128,5998114,14,0,utRho28
588,glyV,8784626,8784720,8784626,94,156,utRho28
589,glyW,3984360,3984360,3984234,126,12,utRho28
590,gmhB,445612,445666,445612,54,0,utRho28
591,gmk,7642776,7642856,7642776,80,0,utRho28
592,gmr,2693686,2693686,2693484,202,52,utRho28
593,gnd,4202648,4202648,4202536,112,422,utRho28
594,gnsB,3275692,3275692,3275564,128,0,utRho28
595,gntK,14310580,14310580,14310368,212,916,utRho28
596,gntP,9102668,9102668,9102592,76,866,utRho28
597,gntR,7157760,7157760,7157452,308,282,utRho28
598,gntT,7092810,7093118,7092810,308,338,utRho28
599,gntU,7154170,7154170,7154122,48,36,utRho28
600,gntX,7089334,7089764,7089334,430,310,utRho28
601,gor,7292224,7292598,7292224,374,276,utRho28
602,gpmA,1575340,1575340,1575190,150,0,utRho28
603,gpmM,7570374,7570520,7570374,146,172,utRho28
604,gpsA,7567620,7567620,7567322,298,2964,utRho28
605,gpt,511828,511954,511828,126,400,utRho28
606,grcA,5433046,5433046,5432898,148,582,utRho28
607,greA,6657728,6657728,6657430,298,814,utRho28
608,greB,7073488,7073624,7073488,136,64,utRho28
609,groL,8741566,8742050,8741566,484,10754,utRho28
610,groS,8741232,8741376,8741232,144,11278,utRho28
611,grpE,5501494,5501494,5501416,78,626,utRho28
612,grxA,1781552,1781552,1781506,46,0,utRho28
613,grxB,2248206,2248206,2248108,98,576,utRho28
614,grxC,7569152,7569152,7568884,268,1234,utRho28
615,grxD,3468324,3468324,3468202,122,3058,utRho28
616,gspA,6911268,6911268,6910796,472,584,utRho28
617,gspC,6910964,6911156,6910964,192,318,utRho28
618,gss,6277220,6277220,6277044,176,160,utRho28
619,gstA,3428654,3428754,3428654,100,0,utRho28
620,gstB,1761038,1761038,1760960,78,206,utRho28
621,guaB,5268214,5268214,5268140,74,212,utRho28
622,gudD,5839026,5839026,5838770,256,56,utRho28
623,gyrA,4678914,4678914,4678840,74,208,utRho28
624,gyrB,7760300,7760300,7760238,62,128,utRho28
625,hcaE,5337964,5338064,5337964,100,512,utRho28
626,hcaR,5337928,5337928,5337792,136,494,utRho28
627,hcaT,5336106,5336106,5335692,414,132,utRho28
628,hchA,4071260,4071670,4071260,410,30,utRho28
629,hcp,1828258,1828258,1827628,630,796,utRho28
630,hcr,1824400,1824400,1824300,100,0,utRho28
631,hdeA,7313582,7313582,7313480,102,14,utRho28
632,hdeD,7313920,7313990,7313920,70,1468,utRho28
633,hdfR,7896320,7896320,7895934,386,170,utRho28
634,hdhA,3396244,3396244,3396080,164,66,utRho28
635,helD,2048876,2048942,2048876,66,24,utRho28
636,hemA,2527166,2527428,2527166,262,220,utRho28
637,hemB,779722,779722,779454,268,206,utRho28
638,hemF,5106410,5106450,5106410,40,12,utRho28
639,hemH,996062,996110,996062,48,36,utRho28
640,hemL,349882,349882,349764,118,80,utRho28
641,hemN,8103886,8104090,8103886,204,12,utRho28
642,hepA,127176,127176,126528,648,7898,utRho28
643,hflD,2385372,2385372,2385262,110,88,utRho28
644,hfq,8799602,8800576,8799602,974,3920,utRho28
645,hha,961006,961006,960616,390,0,utRho28
646,hicA,3018442,3018572,3018442,130,114,utRho28
647,higA,6468682,6468682,6468288,394,1122,utRho28
648,higB,6468960,6468960,6468910,50,84,utRho28
649,hinT,2323642,2323770,2323642,128,0,utRho28
650,hipB,3184964,3184964,3184884,80,52,utRho28
651,hisB,4186720,4186936,4186720,216,346,utRho28
652,hisJ,4853674,4853674,4853576,98,0,utRho28
653,hisL,8359856,8359984,8359856,128,856,utRho28
654,hisS,5281284,5281284,5281150,134,28,utRho28
655,hlpA,400910,400964,400910,54,146,utRho28
656,hlyE,2460932,2460932,2460788,144,266,utRho28
657,hmp,5371594,5371670,5371594,76,0,utRho28
658,hns,2585916,2585916,2585844,72,3800,utRho28
659,hofM,7045856,7045856,7045502,354,210,utRho28
660,hokA,7441620,7441620,7441200,420,520,utRho28
661,hokC,33902,33902,33806,96,302,utRho28
662,hokE,1215462,1215672,1215462,210,138,utRho28
663,holC,8968546,8968546,8968560,14,68,utRho28
664,holD,9215562,9215606,9215562,44,84,utRho28
665,holE,3850040,3850216,3850040,176,72,utRho28
666,hpt,282720,282862,282720,142,254,utRho28
667,hrpB,324150,324210,324150,60,56,utRho28
668,hscB,5319048,5319048,5318934,114,208,utRho28
669,hscC,1367188,1367188,1366786,402,538,utRho28
670,hsdS,9163004,9163004,9162924,80,982,utRho28
671,hslJ,2883560,2883560,2883486,74,384,utRho28
672,hslO,7059344,7059548,7059344,204,44818,utRho28
673,hslR,7058220,7058696,7058220,476,4268,utRho28
674,hslV,8244708,8244708,8244574,134,150,utRho28
675,hsrA,7881412,7881412,7881224,188,44,utRho28
676,htgA,21286,21660,21286,374,492,utRho28
677,htpG,989634,990240,989634,606,708,utRho28
678,htpX,3825236,3825236,3825152,84,32,utRho28
679,htrE,311036,311036,310852,184,470,utRho28
680,htrL,7587668,7587668,7587366,302,292,utRho28
681,hupA,8400352,8400562,8400352,210,20,utRho28
682,hupB,1845220,1845804,1845220,584,208,utRho28
683,hyaA,2063968,2064278,2063968,310,30,utRho28
684,hybO,6292726,6292726,6292522,204,432,utRho28
685,hycA,5700922,5700922,5700870,52,30,utRho28
686,hycI,5686204,5686204,5686086,118,640,utRho28
687,hydN,5676264,5676264,5676210,54,50,utRho28
688,hyfA,5202342,5202402,5202342,60,4,utRho28
689,hypA,11402508,11402588,11402508,80,536,utRho28
690,hypB,11403356,11404004,11403356,648,352,utRho28
691,hypF,5676210,5676210,5674850,1360,3750,utRho28
692,hypT,9116634,9116634,9116578,56,0,utRho28
693,hyuA,6019660,6020056,6019660,396,226,utRho28
694,iaaA,1733074,1733136,1733074,62,0,utRho28
695,iadA,9119074,9119074,9119052,22,126,utRho28
696,iap,5753072,5753162,5753072,90,90,utRho28
697,ibaG,6673966,6673966,6673606,360,68,utRho28
698,ibpA,7735036,7735036,7734844,192,5792,utRho28
699,ibpB,7733962,7733962,7733794,168,40700,utRho28
700,icd,2389922,2390246,2389922,324,30,utRho28
701,iclR,8447304,8447304,8447256,48,34,utRho28
702,idi,6065876,6066130,6065876,254,0,utRho28
703,idnD,8988870,8988870,8988812,58,60,utRho28
704,idnK,8989194,8989246,8989194,52,230,utRho28
705,ihfA,3591442,3591442,3591104,338,724,utRho28
706,ihfB,1927498,1927656,1927498,158,92,utRho28
707,ileS,43666,44782,43666,1116,1058,utRho28
708,ileX,6431194,6431196,6431194,2,26,utRho28
709,ilvA,15820940,15821324,15820940,384,740,utRho28
710,ilvC,7915824,7915940,7915824,116,204,utRho28
711,ilvE,15809552,15809936,15809552,384,232,utRho28
712,ilvI,170840,171260,170840,420,194,utRho28
713,ilvL,23701308,23701932,23701308,624,324,utRho28
714,ilvY,7915734,7915734,7915640,94,144,utRho28
715,inaA,4698998,4698998,4698944,54,110,utRho28
716,infA,1853370,1853370,1852886,484,370,utRho28
717,infC,3602692,3602692,3601276,1416,1700,utRho28
718,insA-5,3958452,3958452,3958430,22,18,utRho28
719,insA-7,9036758,9037054,9036758,296,478,utRho28
720,insC-5,6372080,6372284,6372080,204,242,utRho28
721,insEF-2,785238,785238,785820,582,376,utRho28
722,insEF-4,2190310,2190310,2190892,582,268,utRho28
723,insG,9007098,9007098,9006862,236,32,utRho28
724,insH-1,550596,550596,550234,362,602,utRho28
725,insH-11,7306538,7306538,7306396,142,240,utRho28
726,insH-2,1151548,1151548,1151506,42,304,utRho28
727,insH-3,1378444,1378444,1378026,418,196,utRho28
728,insH-4,2791942,2792152,2791942,210,12,utRho28
729,insH-5,2857852,2857852,2857452,400,132,utRho28
730,insH-6,4135022,4135022,4134642,380,478,utRho28
731,insH-7,4206186,4206186,4205822,364,4096,utRho28
732,insH-9,6260050,6260356,6260050,306,278,utRho28
733,insI-3,9017372,9017372,9017234,138,44,utRho28
734,insJ,7441188,7441360,7441188,172,62,utRho28
735,insK,7442130,7442308,7442130,178,20,utRho28
736,insL-1,30760,30890,30760,130,10130,utRho28
737,insL-2,1216112,1216130,1216112,18,230,utRho28
738,insL-3,5028644,5028662,5028644,18,198,utRho28
739,insN-1,540452,540484,540452,32,0,utRho28
740,intD,1132202,1132202,1131956,246,510,utRho28
741,intR,2826520,2826520,2826470,50,48,utRho28
742,intS,4933026,4933090,4933026,64,2,utRho28
743,intZ,5117386,5117542,5117386,156,262,utRho28
744,iraD,9113152,9113986,9113152,834,192,utRho28
745,iraM,2424246,2424246,2424006,240,116,utRho28
746,iraP,802638,802772,802638,134,0,utRho28
747,iscA,5319924,5319924,5319772,152,348,utRho28
748,iscR,5324398,5324398,5324262,136,3066,utRho28
749,iscX,5313834,5313834,5313472,362,372,utRho28
750,ispF,5743968,5743968,5743560,408,132,utRho28
751,ispG,5283908,5283908,5283608,300,0,utRho28
752,ispU,389568,389806,389568,238,132,utRho28
753,isrA,2811502,2811502,2811618,116,14,utRho28
754,istr-1,7706384,7706384,7706384,0,0,utRho28
755,istr-2,7706514,7706514,7706514,0,0,utRho28
756,ivbL,15412092,15412092,15411952,140,284,utRho28
757,ivy,480638,480686,480638,48,0,utRho28
758,katE,3627628,3627734,3627628,106,90,utRho28
759,katG,8267624,8267670,8267624,46,126,utRho28
760,kbaZ,6557732,6557828,6557732,96,24,utRho28
761,kbl,7585154,7585154,7585102,52,560,utRho28
762,kch,2621046,2621046,2620538,508,304,utRho28
763,kdgR,3820506,3820506,3820198,308,4,utRho28
764,kdpE,1443788,1443788,1443466,322,194,utRho28
765,kdpF,1457698,1457698,1457642,56,112,utRho28
766,kdsA,2535708,2536330,2535708,622,498,utRho28
767,kdsC,6683438,6684546,6683438,1108,3094,utRho28
768,kduI,5968388,5968388,5968248,140,256,utRho28
769,kefF,94160,94492,94160,332,2560,utRho28
770,kgtP,5451624,5451624,5451492,132,340,utRho28
771,kup,7862206,7862632,7862206,426,3150,utRho28
772,lacI,735076,735076,735020,56,92,utRho28
773,lacZ,1465508,1465508,1465220,288,500,utRho28
774,ldcA,2486394,2486394,2486160,234,352,utRho28
775,ldhA,2885830,2885830,2885686,144,114,utRho28
776,ldrA,2538954,2538954,2538550,404,990,utRho28
777,ldrB,2540024,2540024,2539620,404,220,utRho28
778,ldrC,2541092,2541092,2540690,402,278,utRho28
779,ldrD,7400544,7400544,7400174,370,346,utRho28
780,lepA,5414392,5414392,5414248,144,678,utRho28
781,lepB,5410928,5410928,5410618,310,2234,utRho28
782,leuD,159188,159188,158906,282,102,utRho28
783,leuE,3761600,3761600,3761518,82,142,utRho28
784,leuL,168048,168048,167416,632,120,utRho28
785,leuO,168308,168736,168308,428,94,utRho28
786,leuQ,9212864,9212864,9212802,62,2,utRho28
787,leuU,6644556,6644556,6644316,240,1904,utRho28
788,leuV,9212546,9212546,9212330,216,762,utRho28
789,leuX,8992772,8992810,8992772,38,144,utRho28
790,lexA,8514174,8514230,8514174,56,422,utRho28
791,lhr,3456706,3458174,3456706,1468,706,utRho28
792,ligA,5060402,5060402,5060352,50,0,utRho28
793,ligB,7642576,7642576,7642340,236,76,utRho28
794,lipA,1320602,1320602,1320432,170,256,utRho28
795,lipB,1324802,1324802,1324556,246,5252,utRho28
796,lit,2397032,2397390,2397032,358,320,utRho28
797,livJ,7199524,7199524,7199316,208,2186,utRho28
798,livK,7195510,7195510,7195120,390,1026,utRho28
799,lldP,7554578,7554798,7554578,220,198,utRho28
800,lnt,1381968,1381968,1381762,206,534,utRho28
801,loiP,6163784,6163826,6163784,42,0,utRho28
802,lolA,1874656,1874738,1874656,82,54,utRho28
803,lolB,2527112,2527112,2527000,112,132,utRho28
804,lolC,2350748,2350854,2350748,106,0,utRho28
805,lon,917630,917776,917630,146,500,utRho28
806,lpcA,486936,487086,486936,150,0,utRho28
807,lpd,255434,255824,255434,390,628,utRho28
808,lplA,9248476,9248476,9248234,242,346,utRho28
809,lplT,5947878,5947878,5947724,154,20,utRho28
810,lpoA,6586422,6586800,6586422,378,462,utRho28
811,lpp,3514592,3514842,3514592,250,172,utRho28
812,lptA,6686598,6686760,6686598,162,88,utRho28
813,lptB,6686792,6687888,6686792,1096,1024,utRho28
814,lptD,114672,114672,114218,454,216,utRho28
815,lptF,8972244,8972436,8972244,192,118,utRho28
816,lpxC,213016,213114,213016,98,1442,utRho28
817,lpxD,401920,401942,401920,22,0,utRho28
818,lpxL,2233418,2233418,2233164,254,78,utRho28
819,lpxM,3880456,3880456,3880386,70,74,utRho28
820,lpxP,4991156,4991290,4991156,134,180,utRho28
821,lrhA,4813312,4813312,4813282,30,4,utRho28
822,lrp,1864656,1865190,1864656,534,278,utRho28
823,lspA,50028,50414,50028,386,352,utRho28
824,lsrA,3202920,3202980,3202920,60,28,utRho28
825,lsrR,3202514,3202514,3202482,32,178,utRho28
826,ltaE,1818640,1818640,1818588,52,0,utRho28
827,luxS,5630130,5630130,5629466,664,612,utRho28
828,lysA,5957902,5957902,5957798,104,94,utRho28
829,lysC,8467232,8467232,8466466,766,276,utRho28
830,lysP,4497120,4497120,4497064,56,308,utRho28
831,lysR,5957900,5958042,5957900,142,0,utRho28
832,lysT,1561028,1561108,1561028,80,150,utRho28
833,lysU,8709610,8709610,8709434,176,176,utRho28
834,macB,1840188,1840694,1840188,506,370,utRho28
835,maeA,3111484,3111484,3111338,146,346,utRho28
836,mak,820236,820288,820236,52,200,utRho28
837,malE,8492928,8492928,8492838,90,42,utRho28
838,malI,3398456,3398456,3398360,96,46,utRho28
839,malK,8493472,8493568,8493472,96,170,utRho28
840,malP,7105020,7105020,7104946,74,380,utRho28
841,malQ,7100798,7100798,7100140,658,90,utRho28
842,malS,14949880,14949988,14949880,108,212,utRho28
843,malT,7106048,7106170,7106048,122,16,utRho28
844,malX,3398626,3398710,3398626,84,8,utRho28
845,malZ,1689980,1690072,1689980,92,48,utRho28
846,manA,3377102,3377152,3377102,50,102,utRho28
847,manX,3803866,3804096,3803866,230,188,utRho28
848,marC,3237882,3237882,3237816,66,190,utRho28
849,marR,3238186,3238240,3238186,54,82,utRho28
850,matP,2036918,2036970,2036918,52,0,utRho28
851,mazE,5822736,5822736,5822678,58,58,utRho28
852,mazG,5821720,5821720,5821370,350,1226,utRho28
853,mcbA,1684306,1684306,1684112,194,212,utRho28
854,mcbR,3040192,3040524,3040192,332,24,utRho28
855,mcrA,2420278,2420692,2420278,414,172,utRho28
856,mcrC,9156124,9156124,9155916,208,696,utRho28
857,mdaB,6344814,6345060,6344814,246,66,utRho28
858,mdfA,1767138,1767346,1767138,208,462,utRho28
859,mdh,6768940,6768940,6768536,404,120,utRho28
860,mdoB,9198988,9198988,9198882,106,514,utRho28
861,mdoD,2993290,2993712,2993290,422,26,utRho28
862,mdoG,2218514,2218670,2218514,156,150,utRho28
863,mdtA,4307958,4308032,4307958,74,24,utRho28
864,mdtE,7318168,7318464,7318168,296,1652,utRho28
865,mdtK,3486538,3486914,3486538,376,360,utRho28
866,mdtP,8602472,8602472,8602060,412,798,utRho28
867,melA,8683774,8683822,8683774,48,0,utRho28
868,melR,8683300,8683300,8683256,44,242,utRho28
869,menA,8240812,8240812,8240698,114,122,utRho28
870,menB,4753774,4753774,4753638,136,0,utRho28
871,mepH,3468714,3468870,3468714,156,0,utRho28
872,mepM,3883666,3883666,3883270,396,144,utRho28
873,mepS,4539840,4539958,4539840,118,128,utRho28
874,metA,8428318,8428560,8428318,242,16,utRho28
875,metB,8257272,8257344,8257272,72,368,utRho28
876,metC,6304150,6304472,6304150,322,370,utRho28
877,metE,8025768,8026106,8025768,338,64,utRho28
878,metF,8265092,8265232,8265092,140,14,utRho28
879,metG,4388538,4388600,4388538,62,58,utRho28
880,metH,8447010,8447656,8447010,646,1240,utRho28
881,metJ,8257116,8257116,8256790,326,160,utRho28
882,metK,6173154,6173412,6173154,258,232,utRho28
883,metN,445428,445428,445290,138,8,utRho28
884,metR,8025710,8025710,8025632,78,0,utRho28
885,metT,1394326,1394326,1394266,60,38,utRho28
886,metY,19910250,19910250,19909734,516,1350,utRho28
887,metZ,11789528,11789548,11789528,20,76,utRho28
888,mfd,2348056,2348056,2347928,128,36,utRho28
889,mglA,4478782,4478782,4478578,204,152,utRho28
890,mglB,4481132,4481132,4480696,436,7290,utRho28
891,mglC,4475918,4475918,4475506,412,150,utRho28
892,mgrB,3817584,3817584,3817532,52,30,utRho28
893,mgrR,3245828,3245828,3245828,0,0,utRho28
894,mgsA,2054082,2054082,2054030,52,170,utRho28
895,mgtL,8934560,8934862,8934560,302,194,utRho28
896,mhpA,737038,737222,737038,184,250,utRho28
897,mhpR,737072,737072,736840,232,164,utRho28
898,mhpT,750772,750918,750772,146,0,utRho28
899,miaA,8797964,8798504,8797964,540,202,utRho28
900,micA,5629604,5629604,5629604,0,0,utRho28
901,micC,2874242,2874238,2874242,4,0,utRho28
902,micF,4626168,4626168,4626168,0,0,utRho28
903,micM,1014408,1014408,1014408,0,0,utRho28
904,minE,2449422,2449422,2449090,332,62,utRho28
905,mioC,7852950,7852950,7852910,40,0,utRho28
906,mipA,3733012,3733012,3732944,68,594,utRho28
907,mlaA,4930270,4930270,4930014,256,54,utRho28
908,mlc,3337206,3337206,3337128,78,134,utRho28
909,mlrA,4429498,4429732,4429498,234,64,utRho28
910,mltA,5894546,5894546,5894356,190,58,utRho28
911,mltD,468050,468050,467910,140,144,utRho28
912,mltF,5391534,5391602,5391534,68,88,utRho28
913,mmuP,550238,550650,550238,412,656,utRho28
914,mngA,1531622,1531968,1531622,346,0,utRho28
915,mngR,1531852,1531852,1531750,102,0,utRho28
916,mnmG,7851348,7851348,7851266,82,342,utRho28
917,mntH,5025470,5025470,5025412,58,84,utRho28
918,mntP,3810918,3811376,3810918,458,208,utRho28
919,mntR,1706160,1706366,1706160,206,0,utRho28
920,mntS,1706128,1706128,1705994,134,0,utRho28
921,moaA,1633654,1634088,1633654,434,178,utRho28
922,moaB,1635954,1636110,1635954,156,192,utRho28
923,mobA,8084242,8084242,8083998,244,0,utRho28
924,mocA,6030112,6030320,6030112,208,74,utRho28
925,modA,1589990,1590178,1589990,188,88,utRho28
926,moeA,1732788,1732788,1732728,60,16,utRho28
927,mokB,2984610,2984610,2984258,352,50,utRho28
928,molR_1,4392888,4392948,4392888,60,10,utRho28
929,motA,3954604,3954604,3954278,326,48,utRho28
930,mpaA,2781278,2781278,2781196,82,412,utRho28
931,mpl,8911456,8911570,8911456,114,102,utRho28
932,mppA,2786108,2786454,2786108,346,20,utRho28
933,mprA,5621494,5621540,5621494,46,86,utRho28
934,mqo,4613848,4613848,4613508,340,0,utRho28
935,mqsA,6336742,6336742,6336492,250,412,utRho28
936,mqsR,6337306,6337306,6337088,218,1028,utRho28
937,mraZ,179192,179268,179192,76,392,utRho28
938,mrcA,7045652,7045742,7045652,90,74,utRho28
939,mrcB,329442,329460,329442,18,0,utRho28
940,mreB,13605424,13605424,13604348,1076,1028,utRho28
941,mreD,6798166,6798166,6797750,416,86,utRho28
942,mrp,4388360,4388360,4388336,24,2,utRho28
943,mscK,972984,973072,972984,88,182,utRho28
944,mscL,6876002,6876048,6876002,46,552,utRho28
945,mscS,6139742,6139742,6139614,128,76,utRho28
946,msrA,8884522,8884522,8884352,170,1494,utRho28
947,msrB,3725168,3725168,3724858,310,76,utRho28
948,msyB,2228426,2228426,2228362,64,252,utRho28
949,mtfA,4087236,4087302,4087236,66,10,utRho28
950,mtgA,6699662,6699662,6699618,44,608,utRho28
951,mtlA,30177504,30178248,30177504,744,7496,utRho28
952,mtn,358366,358366,358306,60,232,utRho28
953,mtr,6611864,6611864,6611634,230,84,utRho28
954,mug,6430992,6430992,6430946,46,2024,utRho28
955,murQ,5091466,5091546,5091466,80,176,utRho28
956,murR,5091586,5091586,5091218,368,498,utRho28
957,mutH,5939164,5939324,5939164,160,506,utRho28
958,mutL,8794092,8794824,8794092,732,442,utRho28
959,mutM,7622554,7622554,7622304,250,300,utRho28
960,mutS,5714038,5714186,5714038,148,974,utRho28
961,mutY,18617466,18618078,18617466,612,192,utRho28
962,nac,4123956,4123956,4123866,90,0,utRho28
963,nadA,1564122,1564170,1564122,48,0,utRho28
964,nadB,5420714,5420840,5420714,126,0,utRho28
965,nadC,237326,237326,237290,36,92,utRho28
966,nadE,3644604,3644916,3644604,312,110,utRho28
967,nadK,5501526,5501662,5501526,136,90,utRho28
968,nagA,1406350,1406350,1405502,848,854,utRho28
969,nagB,1407416,1407416,1407222,194,0,utRho28
970,nagC,1404016,1404016,1403188,828,16,utRho28
971,nagE,1407680,1407888,1407680,208,376,utRho28
972,nagK,2357080,2357186,2357080,106,94,utRho28
973,nanA,6747240,6747240,6747152,88,268,utRho28
974,nanC,9079856,9079856,9079002,854,612,utRho28
975,nanR,6749406,6749406,6748978,428,1158,utRho28
976,nanS,9075406,9075406,9075188,218,94,utRho28
977,napF,4607390,4607390,4606994,396,84,utRho28
978,narG,2559614,2559728,2559614,114,248,utRho28
979,narK,2555642,2555914,2555642,272,526,utRho28
980,narP,4580844,4581000,4580844,156,88,utRho28
981,narQ,5171154,5171462,5171154,308,440,utRho28
982,narU,3088326,3088326,3088120,206,548,utRho28
983,narW,3077374,3077374,3074618,2756,1188,utRho28
984,narX,2555554,2555554,2555236,318,470,utRho28
985,narZ,3085380,3085380,3085180,200,0,utRho28
986,ndh,2331984,2332170,2331984,186,960,utRho28
987,ndk,5289920,5289920,5289728,192,80,utRho28
988,nemR,6904084,6904092,6904084,8,392,utRho28
989,nepI,7683542,7683542,7683478,64,104,utRho28
990,nfo,4501612,4501680,4501612,68,74,utRho28
991,nfsB,1210906,1210906,1210848,58,0,utRho28
992,nfuA,7090916,7091248,7090916,332,692,utRho28
993,nhaA,34634,34978,34634,344,316,utRho28
994,nhaB,2469534,2469534,2469434,100,0,utRho28
995,nhoA,3067926,3068048,3067926,122,8,utRho28
996,nikA,7226878,7227334,7226878,456,670,utRho28
997,nikR,7237074,7237176,7237074,102,46,utRho28
998,nirB,6987974,6988022,6987974,48,2,utRho28
999,nlpA,7680034,7680034,7679986,48,68,utRho28
1000,nlpC,3585654,3585654,3585462,192,38,utRho28
1001,nlpD,5737658,5737658,5737506,152,52,utRho28
1002,nlpI,6618080,6618080,6617848,232,182,utRho28
1003,nmpC,1153740,1153740,1153650,90,136,utRho28
1004,nohA,3273206,3273206,3272734,472,330,utRho28
1005,norR,5664614,5664614,5664578,36,116,utRho28
1006,norV,5664878,5664952,5664878,74,16,utRho28
1007,nrdA,4689510,4689730,4689510,220,8548,utRho28
1008,nrdD,8925676,8925676,8925320,356,244,utRho28
1009,nrdH,5601312,5601446,5601312,134,528,utRho28
1010,nrdR,865954,866004,865954,50,20,utRho28
1011,nrfA,8575342,8575528,8575342,186,74,utRho28
1012,nsrR,8812088,8812380,8812088,292,144,utRho28
1013,nudB,3897348,3897348,3897264,84,0,utRho28
1014,nudC,8393428,8393806,8393428,378,2,utRho28
1015,nudE,7052658,7052658,7052298,360,18,utRho28
1016,nudG,3682876,3682980,3682876,104,0,utRho28
1017,nudI,4729050,4729108,4729050,58,46,utRho28
1018,nudJ,2388874,2388874,2388576,298,122,utRho28
1019,nuoA,4810670,4810670,4810144,526,5662,utRho28
1020,nuoN,4783434,4783434,4783010,424,414,utRho28
1021,nupC,5026018,5026084,5026018,66,2,utRho28
1022,nupG,6211302,6211428,6211302,126,64,utRho28
1023,ogrK,4335096,4335096,4335040,56,0,utRho28
1024,ogt,2800568,2800568,2800472,96,262,utRho28
1025,ohsC,5401036,5401040,5401036,4,60,utRho28
1026,ompA,2040382,2040382,2040106,276,5130,utRho28
1027,ompC,4625774,4625774,4625498,276,244,utRho28
1028,ompF,1974184,1974184,1973964,220,140,utRho28
1029,ompL,8128958,8128958,8128590,368,276,utRho28
1030,ompN,2874158,2874158,2873786,372,34,utRho28
1031,ompR,7073510,7073510,7073168,342,0,utRho28
1032,ompT,1171330,1171330,1171266,64,78,utRho28
1033,ompW,2627982,2628040,2627982,58,150,utRho28
1034,ompX,1700418,1700900,1700418,482,1282,utRho28
1035,omrA,5952378,5952378,5952378,0,0,utRho28
1036,omrB,5952770,5952770,5952770,0,0,utRho28
1037,oppA,2602170,2602364,2602170,194,426,utRho28
1038,orn,8783168,8783208,8783168,40,102,utRho28
1039,osmB,2686952,2686952,2686656,296,440,utRho28
1040,osmC,3113192,3113250,3113192,58,292,utRho28
1041,osmE,3644566,3644566,3644512,54,90,utRho28
1042,osmF,4439046,4439046,4438962,84,92,utRho28
1043,osmY,9222306,9222792,9222306,486,34,utRho28
1044,otsA,3963302,3963302,3963224,78,38,utRho28
1045,otsB,3964930,3964930,3964774,156,322,utRho28
1046,oxc,4984288,4984288,4983900,388,518,utRho28
1047,oxyR,8316914,8316980,8316914,66,84,utRho28
1048,oxyS,8316788,8316788,8316788,0,0,utRho28
1049,paaA,2907730,2907854,2907730,124,0,utRho28
1050,paaX,2927018,2927078,2927018,60,32,utRho28
1051,paaZ,2907340,2907340,2907284,56,22,utRho28
1052,pabA,6981702,6981702,6981658,44,166,utRho28
1053,pabB,3789256,3789610,3789256,354,190,utRho28
1054,pabC,2306186,2306600,2306186,414,310,utRho28
1055,pagP,1313052,1313114,1313052,62,38,utRho28
1056,panB,299260,299260,299202,58,1430,utRho28
1057,panC,297840,297840,297590,250,200,utRho28
1058,panD,293490,293490,293388,102,136,utRho28
1059,panZ,7195656,7195968,7195656,312,284,utRho28
1060,parC,6332060,6332060,6331946,114,34,utRho28
1061,patA,6438916,6438988,6438916,72,280,utRho28
1062,patD,3030830,3031156,3030830,326,154,utRho28
1063,pbpC,5294986,5294986,5294650,336,88,utRho28
1064,pbpG,4450132,4450132,4449740,392,0,utRho28
1065,pck,7065358,7065636,7065358,278,2484,utRho28
1066,pcnB,318782,318782,318252,530,286,utRho28
1067,pdhR,244068,244184,244068,116,22,utRho28
1068,pdxB,4875768,4875768,4875702,66,76,utRho28
1069,pdxH,3436068,3436068,3436014,54,2,utRho28
1070,pdxJ,5403626,5403626,5403458,168,444,utRho28
1071,pdxK,5074638,5074638,5074474,164,0,utRho28
1072,pepA,8972278,8972278,8971902,376,222,utRho28
1073,pepD,511618,511618,511432,186,322,utRho28
1074,pepN,1981182,1981244,1981182,62,1052,utRho28
1075,pepQ,8062294,8062322,8062294,28,6,utRho28
1076,pepT,2371646,2371688,2371646,42,2,utRho28
1077,pfkA,8214948,8215104,8214948,156,138,utRho28
1078,pfkB,3612646,3612740,3612646,94,8,utRho28
1079,pflA,1902456,1902456,1902160,296,6,utRho28
1080,pflB,1907850,1907850,1907108,742,322,utRho28
1081,pflD,8287716,8287990,8287716,274,0,utRho28
1082,pgaA,2185046,2185046,2184578,468,454,utRho28
1083,pgi,8467444,8467516,8467444,72,44,utRho28
1084,pgk,12291428,12291428,12290488,940,2548,utRho28
1085,pgl,1597078,1597172,1597078,94,0,utRho28
1086,pgpB,2678324,2678660,2678324,336,258,utRho28
1087,pgpC,5397276,5397276,5397100,176,60,utRho28
1088,pgrR,2783744,2783982,2783744,238,256,utRho28
1089,pheL,5475158,5475198,5475158,40,0,utRho28
1090,pheM,7197204,7197204,7197080,124,12,utRho28
1091,pheP,1203858,1203918,1203858,60,0,utRho28
1092,pheU,8725254,8725254,8725252,2,6,utRho28
1093,pheV,6220730,6220732,6220730,2,12,utRho28
1094,phnC,8650412,8650412,8650330,82,146,utRho28
1095,phoA,803414,803494,803414,80,44,utRho28
1096,phoB,834202,834284,834202,82,176,utRho28
1097,phoE,520316,520316,520200,116,26,utRho28
1098,phoH,2169730,2169984,2169730,254,0,utRho28
1099,phoP,2381016,2381016,2380894,122,364,utRho28
1100,phoQ,2379880,2379880,2379552,328,236,utRho28
1101,phoU,7815330,7815330,7815156,174,188,utRho28
1102,phr,1478842,1479014,1478842,172,108,utRho28
1103,pinE,2419054,2419370,2419054,316,112,utRho28
1104,pinQ,3267168,3267244,3267168,76,16,utRho28
1105,pinR,2867424,2867424,2867348,76,16,utRho28
1106,pitA,7275224,7275284,7275224,60,20,utRho28
1107,pitB,6272806,6272806,6272742,64,156,utRho28
1108,pka,5439862,5439906,5439862,44,16,utRho28
1109,plaP,4174476,4174476,4174124,352,168,utRho28
1110,pldA,8009628,8009724,8009628,96,822,utRho28
1111,pldB,8018028,8018340,8018028,312,620,utRho28
1112,plsB,8513196,8513196,8512932,264,146,utRho28
1113,pmbA,8915890,8915918,8915890,28,0,utRho28
1114,pmrD,4747148,4747148,4747076,72,0,utRho28
1115,pncB,1980828,1980828,1980712,116,360,utRho28
1116,pncC,5648788,5648788,5648692,96,44,utRho28
1117,pnp,6622652,6622652,6622336,316,66,utRho28
1118,pntA,3355950,3355950,3355806,144,50,utRho28
1119,pntB,3353096,3353096,3352720,376,668,utRho28
1120,polA,8093880,8093932,8093880,52,40,utRho28
1121,polB,131606,131606,131560,46,0,utRho28
1122,potD,2365700,2365700,2365658,42,56,utRho28
1123,potE,1436688,1436688,1436530,158,66,utRho28
1124,potF,1787268,1787568,1787268,300,64,utRho28
1125,poxB,1822152,1822152,1822098,54,12,utRho28
1126,ppa,8899372,8899372,8899304,68,86,utRho28
1127,ppc,8306380,8306380,8306196,184,1228,utRho28
1128,ppdA,5928440,5928440,5928354,86,0,utRho28
1129,ppdD,235410,235410,235098,312,100,utRho28
1130,pphA,3846770,3846770,3845938,832,826,utRho28
1131,pphB,5719474,5719520,5719474,46,0,utRho28
1132,ppiA,6984898,6984898,6984594,304,44,utRho28
1133,ppiC,7919682,7919682,7919626,56,60,utRho28
1134,ppiD,923638,923830,923638,192,104,utRho28
1135,ppk,5245748,5246088,5245748,340,342,utRho28
1136,pppA,6228958,6228958,6228704,254,30,utRho28
1137,ppsA,3574322,3574322,3574224,98,0,utRho28
1138,ppsR,3574678,3574890,3574678,212,4,utRho28
1139,pptA,3065716,3066104,3065716,388,106,utRho28
1140,pqiA,2023318,2024002,2023318,684,156,utRho28
1141,prc,3830054,3830054,3829632,422,1598,utRho28
1142,preT,4467978,4468066,4467978,88,134,utRho28
1143,prfC,9218688,9218828,9218688,140,92,utRho28
1144,prkB,6968622,6968980,6968622,358,252,utRho28
1145,prlC,7290476,7290476,7290364,112,548,utRho28
1146,prlF,6553944,6554004,6553944,60,474,utRho28
1147,proB,520432,520776,520432,344,4,utRho28
1148,proC,811372,811372,811288,84,14,utRho28
1149,proK,7417388,7417388,7417384,4,24,utRho28
1150,proL,4572414,4572422,4572414,8,34,utRho28
1151,proP,8660640,8661004,8660640,364,404,utRho28
1152,proS,437674,437674,437550,124,94,utRho28
1153,proV,5609126,5609630,5609126,504,454,utRho28
1154,prpB,697292,697364,697292,72,0,utRho28
1155,prpR,696942,696942,696886,56,0,utRho28
1156,prs,2524354,2524354,2523750,604,4040,utRho28
1157,psd,8781276,8781276,8780720,556,966,utRho28
1158,psiE,8480600,8480650,8480600,50,0,utRho28
1159,pspA,2736076,2736158,2736076,82,26,utRho28
1160,pspF,2736080,2736080,2735824,256,0,utRho28
1161,pspG,8525632,8525680,8525632,48,0,utRho28
1162,pssA,5445156,5445454,5445156,298,816,utRho28
1163,pstB,7817112,7817112,7816732,380,58,utRho28
1164,pstC,7821084,7821084,7820796,288,68,utRho28
1165,pstS,23469408,23469408,23469150,258,180,utRho28
1166,psuG,4517114,4517114,4516734,380,2226,utRho28
1167,psuT,4514992,4514992,4514670,322,124,utRho28
1168,pth,2517084,2517084,2517026,58,0,utRho28
1169,ptrA,5918022,5918022,5917768,254,60,utRho28
1170,ptrB,3857730,3857730,3857678,52,92,utRho28
1171,ptsG,2315252,2315738,2315252,486,300,utRho28
1172,ptsH,5066996,5067528,5066996,532,596,utRho28
1173,purA,8809328,8809374,8809328,46,370,utRho28
1174,purC,5195562,5195562,5195236,326,0,utRho28
1175,purD,8411972,8411972,8411862,110,46,utRho28
1176,purE,1106284,1106284,1106200,84,0,utRho28
1177,purH,8415254,8415254,8415064,190,62,utRho28
1178,purL,5391178,5391178,5391086,92,880,utRho28
1179,purM,5242306,5242394,5242306,88,146,utRho28
1180,purR,3475378,3475688,3475378,310,142,utRho28
1181,purT,3861438,3861762,3861438,324,60,utRho28
1182,purU,2577512,2577512,2577248,264,0,utRho28
1183,putA,2157850,2157850,2157764,86,8,utRho28
1184,putP,2158336,2158610,2158336,274,188,utRho28
1185,puuA,2721936,2721936,2721816,120,0,utRho28
1186,puuC,2725456,2725486,2725456,30,0,utRho28
1187,puuD,2722104,2722240,2722104,136,0,utRho28
1188,puuP,2718746,2718746,2718374,372,390,utRho28
1189,pykA,3874988,3875298,3874988,310,74,utRho28
1190,pykF,3510934,3511396,3510934,462,152,utRho28
1191,pyrC,2245286,2245286,2245214,72,98,utRho28
1192,pyrD,2009464,2009536,2009464,72,388,utRho28
1193,pyrE,7631970,7631970,7631536,434,74,utRho28
1194,pyrF,2683740,2683842,2683740,102,504,utRho28
1195,pyrG,5819594,5819594,5819332,262,394,utRho28
1196,pyrH,383624,383710,383624,86,518,utRho28
1197,pyrL,8945490,8945490,8945066,424,306,utRho28
1198,qmcA,1031646,1031646,1031546,100,228,utRho28
1199,qor,8528608,8528608,8528462,146,130,utRho28
1200,qseB,6339502,6339656,6339502,154,84,utRho28
1201,queA,849970,850022,849970,52,50,utRho28
1202,queE,5811212,5811212,5810836,376,88,utRho28
1203,queF,5850642,5850696,5850642,54,194,utRho28
1204,queG,8788184,8788184,8788134,50,888,utRho28
1205,racC,2835630,2835630,2835526,104,0,utRho28
1206,racR,2840898,2840898,2840482,416,242,utRho28
1207,raiA,5474208,5474308,5474208,100,90,utRho28
1208,rarD,8008594,8008594,8008356,238,654,utRho28
1209,ravA,7862256,7862256,7862186,70,646,utRho28
1210,rayT,495088,495274,495088,186,96,utRho28
1211,rbn,4763162,4763216,4763162,54,0,utRho28
1212,rbsD,7866644,7866702,7866644,58,116,utRho28
1213,rcnA,4371654,4371834,4371654,180,196,utRho28
1214,rcnB,4373768,4373920,4373768,152,54,utRho28
1215,rcnR,4371806,4371806,4371592,214,436,utRho28
1216,rcsA,4047672,4047936,4047672,264,262,utRho28
1217,rcsB,4631390,4632354,4631390,964,264,utRho28
1218,rcsC,4640162,4640162,4639656,506,26,utRho28
1219,rcsD,4626904,4626976,4626904,72,62,utRho28
1220,rdgB,6193240,6193362,6193240,122,116,utRho28
1221,rdlA,2538646,2538646,2538646,0,0,utRho28
1222,rdlB,2539712,2539716,2539712,4,0,utRho28
1223,rdlC,2540782,2540786,2540782,4,0,utRho28
1224,rdlD,7400272,7400272,7400272,0,0,utRho28
1225,rdoA,8084782,8084830,8084782,48,22,utRho28
1226,recA,11295276,11295276,11295076,200,416,utRho28
1227,recC,5925014,5925014,5924856,158,16,utRho28
1228,recF,7763722,7763722,7762442,1280,1210,utRho28
1229,recN,5503518,5503590,5503518,72,0,utRho28
1230,recQ,8011666,8011728,8011666,62,108,utRho28
1231,relA,5828554,5828554,5827302,1252,342,utRho28
1232,relB,3291806,3291806,3291744,62,46,utRho28
1233,rem,3289950,3289950,3289804,146,20,utRho28
1234,rep,7921294,7921354,7921294,60,8,utRho28
1235,rfaD,7587730,7587974,7587730,244,1148,utRho28
1236,rfaE,6393852,6393852,6393506,346,62,utRho28
1237,rfaH,8049930,8049930,8049642,288,798,utRho28
1238,rfbX,4219436,4219436,4219168,268,1076,utRho28
1239,rfe,7935600,7935832,7935600,232,622,utRho28
1240,rhaB,8194944,8194944,8194896,48,46,utRho28
1241,rhaD,8188770,8188770,8188544,226,0,utRho28
1242,rhaS,8195422,8195472,8195422,50,0,utRho28
1243,rhaT,8201132,8201132,8201050,82,500,utRho28
1244,rhlE,1661566,1661744,1661566,178,40,utRho28
1245,rhoL,47593944,47594772,47593944,828,2040,utRho28
1246,rhsB,7238006,7238384,7238006,378,0,utRho28
1247,rhsC,1458758,1459166,1458758,408,4,utRho28
1248,rhsD,1046132,1046522,1046132,390,346,utRho28
1249,rhtA,1700608,1700608,1700194,414,1498,utRho28
1250,rhtC,8015478,8015514,8015478,36,172,utRho28
1251,ribA,2678468,2678468,2678320,148,130,utRho28
1252,ribC,3486916,3486916,3486484,432,564,utRho28
1253,ribE,869008,869294,869008,286,3140,utRho28
1254,ribF,42766,42814,42766,48,120,utRho28
1255,ridA,8941892,8941892,8941826,66,52,utRho28
1256,rihA,1369204,1369204,1368824,380,392,utRho28
1257,rihB,4510504,4510504,4510372,132,110,utRho28
1258,rimJ,2251044,2251124,2251044,80,82,utRho28
1259,rimK,1783752,1783934,1783752,182,60,utRho28
1260,rimL,2997486,2997876,2997486,390,0,utRho28
1261,rimO,1756140,1756140,1756070,70,66,utRho28
1262,rimP,6636350,6636350,6636012,338,526,utRho28
1263,rlmA,3814172,3814172,3814120,52,0,utRho28
1264,rlmD,5830086,5830086,5830000,86,60,utRho28
1265,rlmE,6655520,6655520,6655328,192,626,utRho28
1266,rlmF,1684384,1684664,1684384,280,394,utRho28
1267,rlmG,6471784,6471784,6471750,34,86,utRho28
1268,rlmI,2060002,2060002,2059938,64,336,utRho28
1269,rlmJ,7290700,7290770,7290700,70,128,utRho28
1270,rlmL,2015344,2015688,2015344,344,482,utRho28
1271,rlpA,1330444,1330444,1330380,64,70,utRho28
1272,rluA,120900,120900,120692,208,278,utRho28
1273,rluF,8460324,8460708,8460324,384,0,utRho28
1274,rmf,2031006,2031430,2031006,424,68,utRho28
1275,rna,1290068,1290068,1290006,62,0,utRho28
1276,rnb,2698258,2698258,2697824,434,446,utRho28
1277,rnc,10816892,10816892,10816252,640,49580,utRho28
1278,rnd,3776122,3776122,3775982,140,0,utRho28
1279,rne,2289746,2289746,2288734,1012,1944,utRho28
1280,rnhA,472082,472082,472004,78,740,utRho28
1281,rnk,1288360,1288360,1287934,426,142,utRho28
1282,rnlA,5531788,5531836,5531788,48,300,utRho28
1283,rnlB,5533414,5533968,5533414,554,1068,utRho28
1284,rnpB,19623552,19623552,19623552,0,0,utRho28
1285,rob,9270706,9270706,9270620,86,8,utRho28
1286,rodZ,5285868,5285868,5285688,180,78,utRho28
1287,rpe,7030306,7030306,7030118,188,94,utRho28
1288,rph,15266320,15266320,15266196,124,200,utRho28
1289,rpiA,6118706,6118706,6118650,56,22,utRho28
1290,rpiB,8626514,8626700,8626514,186,454,utRho28
1291,rpiR,8626274,8626274,8625982,292,36,utRho28
1292,rplJ,8359246,8359992,8359246,746,4402,utRho28
1293,rplK,8356708,8356894,8356708,186,216,utRho28
1294,rplM,6757344,6757344,6757302,42,1910,utRho28
1295,rplN,6896444,6896444,6896298,146,878,utRho28
1296,rplS,5489284,5489284,5489060,224,9346,utRho28
1297,rplT,7199052,7199052,7198996,56,740,utRho28
1298,rplU,6667036,6667036,6666902,134,46,utRho28
1299,rplY,4564866,4565034,4564866,168,84,utRho28
1300,rpmA,6666450,6666450,6666238,212,704,utRho28
1301,rpmB,15247980,15247980,15246696,1284,35636,utRho28
1302,rpmE,8253816,8254026,8253816,210,574,utRho28
1303,rpmF,2294676,2294734,2294676,58,8680,utRho28
1304,rpmH,7768130,7768672,7768130,542,1506,utRho28
1305,rpmI,3600854,3600854,3599998,856,4470,utRho28
1306,rpoB,8362126,8362490,8362126,364,68,utRho28
1307,rpoD,6424946,6426094,6424946,1148,28932,utRho28
1308,rpoE,5420372,5420372,5420024,348,10,utRho28
1309,rpoH,7202006,7202006,7201566,440,1882,utRho28
1310,rpoN,6689324,6689434,6689324,110,12,utRho28
1311,rpoS,5736236,5736236,5735102,1134,1354,utRho28
1312,rpoZ,7644154,7644212,7644154,58,62,utRho28
1313,rppH,5937986,5937986,5937954,32,286,utRho28
1314,rprA,3540744,3540744,3540744,0,0,utRho28
1315,rpsA,1923434,1923990,1923434,556,23156,utRho28
1316,rpsF,8850050,8850236,8850050,186,7028,utRho28
1317,rpsI,6756580,6756580,6756414,166,4548,utRho28
1318,rpsJ,6906884,6906884,6906540,344,1486,utRho28
1319,rpsL,6949242,6949242,6949104,138,772,utRho28
1320,rpsM,6885130,6885130,6884942,188,640,utRho28
1321,rpsO,13247144,13247144,13246736,408,160,utRho28
1322,rpsP,5492508,5492508,5492370,138,114,utRho28
1323,rpsT,42420,42420,42156,264,158,utRho28
1324,rpsU,12842584,12843124,12842584,540,5232,utRho28
1325,rraA,8238716,8238716,8238660,56,280,utRho28
1326,rraB,8956768,8956946,8956768,178,120,utRho28
1327,rrsA,8070478,8071062,8070478,584,1408,utRho28
1328,rrsB,16665468,16666636,16665468,1168,2588,utRho28
1329,rrsC,7883032,7883616,7883032,584,802,utRho28
1330,rrsD,6858094,6858094,6857524,570,772,utRho28
1331,rrsE,8415726,8416294,8415726,568,832,utRho28
1332,rrsG,5462896,5462896,5462314,582,834,utRho28
1333,rrsH,446970,447542,446970,572,756,utRho28
1334,rsd,8393908,8393908,8393616,292,102,utRho28
1335,rseA,5419264,5419264,5418808,456,652,utRho28
1336,rseP,392940,393092,392940,152,34,utRho28
1337,rseX,4067298,4067298,4067298,0,0,utRho28
1338,rsfS,1338144,1338144,1338072,72,188,utRho28
1339,rsgA,8783132,8783132,8783018,114,2,utRho28
1340,rsmA,105176,105176,104860,316,470,utRho28
1341,rsmB,6869982,6870414,6869982,432,350,utRho28
1342,rsmC,9215736,9215736,9215400,336,170,utRho28
1343,rsmD,7208594,7208786,7208594,192,0,utRho28
1344,rsmE,6182036,6182268,6182036,232,52,utRho28
1345,rsmG,7847512,7847512,7847360,152,190,utRho28
1346,rsmH,180020,180188,180020,168,54,utRho28
1347,rsmI,6587106,6587106,6586670,436,786,utRho28
1348,rssA,2578212,2578412,2578212,200,92,utRho28
1349,rssB,2580440,2580484,2580440,44,74,utRho28
1350,rstA,3364276,3364300,3364276,24,0,utRho28
1351,rsuA,4561096,4561096,4560966,130,128,utRho28
1352,rsxA,3411510,3411534,3411510,24,118,utRho28
1353,rtcA,7114004,7114004,7113698,306,730,utRho28
1354,rtcB,7116214,7116214,7116158,56,66,utRho28
1355,rtn,4541356,4541452,4541356,96,0,utRho28
1356,rutA,2148052,2148052,2148022,30,0,utRho28
1357,rutG,2140090,2140090,2139678,412,70,utRho28
1358,rutR,2148226,2148484,2148226,258,184,utRho28
1359,ruvA,7784096,7784096,7783904,192,0,utRho28
1360,ruvB,7782176,7782176,7781424,752,40,utRho28
1361,ruvC,3894878,3894878,3894752,126,52,utRho28
1362,rybB,1776114,1776114,1776114,0,0,utRho28
1363,rydB,3529860,3529860,3529322,538,110,utRho28
1364,rydC,2983012,2983012,2983012,0,0,utRho28
1365,ryfA,5307398,5307710,5307398,312,50,utRho28
1366,ryfD,5468590,5468590,5468590,0,0,utRho28
1367,ryhB,7162032,7162032,7162032,0,0,utRho28
1368,ryjA,8556132,8556132,8556132,0,0,utRho28
1369,ryjB,9055954,9055954,9055954,0,0,utRho28
1370,sad,3229598,3229598,3229406,192,194,utRho28
1371,safA,3168056,3168056,3167918,138,52,utRho28
1372,sanA,4465368,4465756,4465368,388,10,utRho28
1373,sapF,2705314,2705314,2705268,46,0,utRho28
1374,sbcB,4165456,4165512,4165456,56,0,utRho28
1375,sbcC,831694,831694,831506,188,0,utRho28
1376,sbcD,833954,833954,833904,50,74,utRho28
1377,sbmA,793106,793278,793106,172,936,utRho28
1378,sbmC,4162650,4162650,4162524,126,0,utRho28
1379,sdaA,3793618,3793864,3793618,246,460,utRho28
1380,sdaC,5856070,5856458,5856070,388,16824,utRho28
1381,sdhC,1509916,1510354,1509916,438,5774,utRho28
1382,sdhD,1510808,1511120,1510808,312,442,utRho28
1383,sdiA,3993834,3993834,3993664,170,168,utRho28
1384,secE,8354354,8354716,8354354,362,458,utRho28
1385,secG,6645180,6645180,6645010,170,214,utRho28
1386,selA,7522594,7522594,7522498,96,166,utRho28
1387,selB,7519850,7519850,7519722,128,190,utRho28
1388,selC,7672396,7672444,7672396,48,114,utRho28
1389,selD,3696058,3696058,3696016,42,278,utRho28
1390,seqA,1425884,1425974,1425884,90,0,utRho28
1391,serA,6117098,6117098,6116820,278,70,utRho28
1392,serB,9249712,9249790,9249712,78,0,utRho28
1393,serC,3830380,3830612,3830380,232,272,utRho28
1394,serS,1878730,1878856,1878730,126,660,utRho28
1395,serT,2063438,2063438,2063424,14,4,utRho28
1396,serU,4087124,4087124,4087114,10,0,utRho28
1397,serV,5637394,5637394,5637290,104,50,utRho28
1398,serW,1852014,1852014,1851942,72,294,utRho28
1399,serX,2195352,2195352,2195304,48,24,utRho28
1400,setB,4527426,4527726,4527426,300,4,utRho28
1401,setC,7673488,7673906,7673488,418,330,utRho28
1402,sfmA,1116124,1116424,1116124,300,254,utRho28
1403,sfmC,1117606,1117948,1117606,342,254,utRho28
1404,sfsA,323030,323030,322972,58,70,utRho28
1405,sfsB,6669592,6669818,6669592,226,26,utRho28
1406,sgrR,154676,154676,154598,78,358,utRho28
1407,sgrS,154734,154734,154734,0,0,utRho28
1408,shiA,4107068,4107286,4107068,218,62,utRho28
1409,sibA,4306622,4306622,4306622,0,0,utRho28
1410,sibB,4307292,4307292,4307292,0,0,utRho28
1411,sibC,6113702,6113702,6113702,0,0,utRho28
1412,sibD,6389730,6389730,6389730,0,0,utRho28
1413,sibE,6390480,6390480,6390480,0,0,utRho28
1414,sixA,4913998,4913998,4913624,374,132,utRho28
1415,slp,7307872,7307922,7307872,50,0,utRho28
1416,slt,9261400,9261466,9261400,66,34,utRho28
1417,slyA,3442028,3442028,3441648,380,10,utRho28
1418,slyB,3439496,3439752,3439496,256,114,utRho28
1419,slyD,6957398,6957398,6956994,404,356,utRho28
1420,slyX,6954862,6955280,6954862,418,6838,utRho28
1421,smf,6867372,6867372,6867120,252,472,utRho28
1422,smpB,5509534,5509792,5509534,258,1002,utRho28
1423,smrA,2811872,2811958,2811872,86,312,utRho28
1424,smrB,4896872,4897212,4896872,340,184,utRho28
1425,smtA,1946808,1947074,1946808,266,72,utRho28
1426,sodA,8201518,8201620,8201518,102,792,utRho28
1427,sodB,3470646,3470756,3470646,110,116,utRho28
1428,sodC,3449358,3449358,3449310,48,0,utRho28
1429,sohB,2658568,2658664,2658568,96,182,utRho28
1430,sokB,2984232,2984238,2984232,6,24,utRho28
1431,solA,2241218,2241218,2241172,46,10,utRho28
1432,soxR,8554894,8554938,8554894,44,40,utRho28
1433,soxS,8554846,8554846,8554766,80,0,utRho28
1434,speA,6172096,6172096,6171822,274,966,utRho28
1435,speB,6167892,6167892,6167594,298,34,utRho28
1436,speC,6218350,6218350,6218310,40,0,utRho28
1437,spf,8099798,8099798,8099798,0,0,utRho28
1438,sppA,3697422,3697674,3697422,252,150,utRho28
1439,spy,3651376,3651376,3651250,126,28,utRho28
1440,sra,3112092,3112092,3111926,166,10,utRho28
1441,sraB,2293178,2293178,2293178,0,0,utRho28
1442,sraC,3846132,3846132,3846132,0,0,utRho28
1443,srlA,5651582,5651664,5651582,82,658,utRho28
1444,srlR,5657720,5658094,5657720,374,1342,utRho28
1445,srmB,5425752,5425792,5425752,40,140,utRho28
1446,sroA,151216,151216,151216,0,0,utRho28
1447,sroG,6369436,6369436,6369436,0,0,utRho28
1448,sroH,8380974,8380974,8380974,0,0,utRho28
1449,ssb,8548022,8548250,8548022,228,26,utRho28
1450,sseA,5304782,5304988,5304782,206,1898,utRho28
1451,sspA,6755138,6755138,6754840,298,154,utRho28
1452,ssrA,5511014,5511186,5511014,172,346,utRho28
1453,ssrS,12223036,12223932,12223036,896,3548,utRho28
1454,sstT,6479726,6479888,6479726,162,56,utRho28
1455,ssuB,1988282,1988282,1988088,194,584,utRho28
1456,ssuE,1995126,1995126,1995024,102,262,utRho28
1457,sthA,8321604,8321604,8321580,24,150,utRho28
1458,stpA,5597156,5597156,5596990,166,48,utRho28
1459,sucA,3034344,3034824,3034344,480,132,utRho28
1460,sufA,3528836,3528836,3528772,64,0,utRho28
1461,sufE,3518962,3518962,3518580,382,218,utRho28
1462,sugE,8753588,8753750,8753588,162,80,utRho28
1463,sulA,2041894,2041894,2041838,56,8506,utRho28
1464,syd,5850738,5850738,5850560,178,398,utRho28
1465,symE,9159834,9159834,9159680,154,2,utRho28
1466,symR,9159670,9159670,9159670,0,0,utRho28
1467,tabA,8949566,8949724,8949566,158,24,utRho28
1468,talA,5157140,5157332,5157140,192,0,utRho28
1469,talB,16382,16476,16382,94,3134,utRho28
1470,tam,3214442,3214692,3214442,250,918,utRho28
1471,tamA,8884540,8884764,8884540,224,1592,utRho28
1472,tar,3945432,3945432,3945382,50,0,utRho28
1473,tas,5943138,5943194,5943138,56,68,utRho28
1474,tatA,16087636,16087780,16087636,144,216,utRho28
1475,tatE,1317742,1317894,1317742,152,24,utRho28
1476,tauA,770410,770464,770410,54,66,utRho28
1477,tdcA,6534186,6534186,6534130,56,132,utRho28
1478,tdcG,6519652,6519652,6519298,354,416,utRho28
1479,tdcR,6534380,6534760,6534380,380,302,utRho28
1480,tdk,2586986,2587054,2586986,68,128,utRho28
1481,tehA,3001072,3001146,3001072,74,38,utRho28
1482,tesA,1039898,1039898,1039530,368,578,utRho28
1483,tesB,950402,950402,950322,80,0,utRho28
1484,tfaE,2418532,2418532,2418238,294,354,utRho28
1485,tfaQ,3269912,3269912,3269770,142,110,utRho28
1486,tff,379424,379256,379424,168,492,utRho28
1487,tgt,852110,852274,852110,164,18,utRho28
1488,thiD,4369346,4369346,4369032,314,148,utRho28
1489,thiI,882936,883098,882936,162,2,utRho28
1490,thiM,4370902,4370902,4370602,300,376,utRho28
1491,thiQ,146170,146170,145854,316,3200,utRho28
1492,thrL,592,760,592,168,256,utRho28
1493,thrS,7210932,7210932,7210280,652,748,utRho28
1494,thrU,8350762,8350776,8350762,14,516,utRho28
1495,thrV,6847414,6847414,6847310,104,180010,utRho28
1496,thrW,525682,525742,525682,60,172,utRho28
1497,thyA,5930696,5930696,5930310,386,674,utRho28
1498,tig,909986,910266,909986,280,448,utRho28
1499,tisB,7706674,7707106,7706674,432,804,utRho28
1500,tktA,6163414,6163414,6163270,144,244,utRho28
1501,tktB,5158616,5159272,5158616,656,532,utRho28
1502,tldD,6784368,6784368,6784056,312,0,utRho28
1503,tmcA,5191876,5191876,5191718,158,244,utRho28
1504,tnaC,15553644,15553740,15553644,96,180,utRho28
1505,tolB,1555074,1555480,1555074,406,274,utRho28
1506,tolC,6356008,6356230,6356008,222,62,utRho28
1507,tomB,961588,961588,961416,172,72,utRho28
1508,tonB,2622108,2622178,2622108,70,4,utRho28
1509,topA,2661578,2662096,2661578,518,352,utRho28
1510,torC,2116112,2116168,2116112,56,160,utRho28
1511,torR,2115968,2115968,2115908,60,234,utRho28
1512,torS,2112364,2112364,2112356,8,0,utRho28
1513,torT,2112414,2112522,2112414,108,0,utRho28
1514,tpiA,8223138,8223138,8223014,124,46,utRho28
1515,tppB,3425342,3425538,3425342,196,396,utRho28
1516,tpr,2574376,2574376,2574376,0,0,utRho28
1517,tpx,2777688,2777688,2777622,66,562,utRho28
1518,tqsA,3347780,3347826,3347780,46,66,utRho28
1519,treA,2494850,2494850,2494752,98,106,utRho28
1520,treB,8932420,8932420,8932360,60,158,utRho28
1521,treF,7339102,7339184,7339102,82,30,utRho28
1522,treR,8934694,8934694,8934492,202,130,utRho28
1523,trg,2984878,2984940,2984878,62,4,utRho28
1524,trkG,2847342,2847564,2847342,222,732,utRho28
1525,trmA,8326590,8326590,8326540,50,16,utRho28
1526,trpA,2634678,2634678,2634444,234,248,utRho28
1527,trpC,2639888,2639888,2639570,318,0,utRho28
1528,trpL,5292432,5292432,5292328,104,0,utRho28
1529,trpR,9265408,9265520,9265408,112,18,utRho28
1530,trpS,7027394,7027394,7027276,118,78,utRho28
1531,trpT,7893560,7893914,7893560,354,97558,utRho28
1532,trxA,7931294,7931522,7931294,228,1168,utRho28
1533,trxB,1864156,1864156,1864100,56,40,utRho28
1534,trxC,5437350,5437470,5437350,120,126,utRho28
1535,tsaD,6421256,6421256,6421086,170,2510,utRho28
1536,tsgA,6985038,6985136,6985038,98,104,utRho28
1537,tsr,9182824,9183314,9182824,490,820,utRho28
1538,tsx,864490,864490,864026,464,236,utRho28
1539,ttcA,2823970,2823970,2823896,74,1560,utRho28
1540,ttdA,6412848,6412926,6412848,78,0,utRho28
1541,ttdR,6412760,6412760,6412512,248,812,utRho28
1542,tufA,6943448,6943448,6942658,790,27704,utRho28
1543,tus,3368346,3368518,3368346,172,70,utRho28
1544,tusA,7218040,7218040,7217992,48,236,utRho28
1545,tusB,6950218,6950218,6949930,288,202,utRho28
1546,tynA,2902996,2902996,2902698,298,0,utRho28
1547,typA,8116460,8116814,8116460,354,558,utRho28
1548,tyrB,8534164,8534228,8534164,64,156,utRho28
1549,tyrP,3979004,3979362,3979004,358,110,utRho28
1550,tyrR,2773384,2773440,2773384,56,70,utRho28
1551,tyrS,3434566,3434566,3434444,122,0,utRho28
1552,tyrT,2575330,2575330,2575244,86,12,utRho28
1553,uacT,6062378,6062734,6062378,356,490,utRho28
1554,ubiC,8504886,8505012,8504886,126,92,utRho28
1555,ubiD,8049618,8049976,8049618,358,902,utRho28
1556,ubiE,8037494,8037710,8037494,216,48,utRho28
1557,ubiG,4679078,4679134,4679078,56,0,utRho28
1558,ucpA,5089342,5089342,5089246,96,270,utRho28
1559,udp,8032782,8032862,8032782,80,142,utRho28
1560,ugd,4199470,4199470,4199226,244,0,utRho28
1561,ugpB,7184852,7184852,7184650,202,1560,utRho28
1562,ugpQ,7176600,7176600,7176226,374,134,utRho28
1563,uhpT,7694396,7694396,7694334,62,26,utRho28
1564,uidA,3392304,3392304,3392142,162,0,utRho28
1565,uidC,3386012,3386012,3385702,310,0,utRho28
1566,uidR,3394150,3394150,3394104,46,0,utRho28
1567,ulaA,8839854,8839960,8839854,106,162,utRho28
1568,ulaG,8839350,8839350,8839250,100,40,utRho28
1569,ulaR,8837124,8837124,8836906,218,46,utRho28
1570,umpG,5741372,5741372,5740548,824,92,utRho28
1571,umpH,1400704,1400704,1400652,52,12,utRho28
1572,umuD,2461476,2461534,2461476,58,0,utRho28
1573,ung,5433476,5433508,5433476,32,22,utRho28
1574,uof,2843316,2843316,2842900,416,740,utRho28
1575,upp,5241818,5241818,5241744,74,98,utRho28
1576,usg,4873780,4873780,4873298,482,404,utRho28
1577,ushA,1009772,1009828,1009772,56,120,utRho28
1578,uspA,7279966,7280222,7279966,256,484,utRho28
1579,uspB,7279696,7279696,7279440,256,84,utRho28
1580,uspC,3959172,3959506,3959172,334,104,utRho28
1581,uspE,2797318,2797318,2797244,74,0,utRho28
1582,uspF,2871282,2871282,2871238,44,290,utRho28
1583,uspG,1283806,1283806,1283734,72,184,utRho28
1584,uvrA,8547872,8547872,8547742,130,224,utRho28
1585,uvrB,1626304,1627052,1626304,748,120,utRho28
1586,uvrC,3989758,3989758,3989412,346,0,utRho28
1587,uvrD,7995814,7995966,7995814,152,52,utRho28
1588,uvrY,3990812,3990812,3990718,94,156,utRho28
1589,uxaB,3221474,3221474,3221360,114,0,utRho28
1590,uxaC,6489714,6489714,6489482,232,0,utRho28
1591,uxuA,9103036,9103272,9103036,236,282,utRho28
1592,uxuR,9108916,9109152,9108916,236,70,utRho28
1593,valS,8967854,8967854,8967674,180,350,utRho28
1594,valU,5041848,5041862,5041848,14,0,utRho28
1595,valV,3492830,3492870,3492830,40,28,utRho28
1596,ves,3649968,3649968,3649874,94,6,utRho28
1597,waaA,7616512,7617080,7616512,568,856,utRho28
1598,waaH,7580298,7580298,7580162,136,58,utRho28
1599,waaQ,7616476,7616476,7616196,280,736,utRho28
1600,waaU,7598996,7598996,7598624,372,138,utRho28
1601,waaY,7602272,7602272,7601930,342,9234,utRho28
1602,wbbH,4214888,4214888,4214452,436,2770,utRho28
1603,wbbK,4209212,4209212,4209018,194,402,utRho28
1604,wcaM,4231868,4231868,4231792,76,0,utRho28
1605,wrbA,2135516,2135516,2135416,100,6,utRho28
1606,wza,4275166,4275166,4274486,680,180,utRho28
1607,wzxC,4240674,4240674,4240316,358,56,utRho28
1608,wzzB,4196950,4196950,4196602,348,146,utRho28
1609,xanP,7657642,7657890,7657642,248,124,utRho28
1610,xanQ,6048520,6048702,6048520,182,98,utRho28
1611,xapA,5049820,5049820,5049756,64,0,utRho28
1612,xapR,10090252,10090252,10089908,344,12,utRho28
1613,xdhA,6000514,6000690,6000514,176,570,utRho28
1614,xerD,6079702,6079702,6079486,216,384,utRho28
1615,xseA,5268394,5268464,5268394,70,146,utRho28
1616,xseB,882746,882746,882686,60,0,utRho28
1617,xthA,3664798,3664856,3664798,58,0,utRho28
1618,xylA,7461614,7461614,7461530,84,2124,utRho28
1619,xylE,8484540,8484540,8484508,32,0,utRho28
1620,xylF,7462138,7462262,7462138,124,592,utRho28
1621,xylR,7469812,7469958,7469812,146,0,utRho28
1622,yaaA,13230,13230,12918,312,36,utRho28
1623,yaaI,23876,23876,23572,304,148,utRho28
1624,yaaJ,16034,16034,15918,116,32,utRho28
1625,yaaU,91184,91614,91184,430,896,utRho28
1626,yaaW,23084,23084,22712,372,226,utRho28
1627,yaaX,10060,10468,10060,408,42,utRho28
1628,yabI,142542,142702,142542,160,0,utRho28
1629,yacC,273880,273880,273834,46,118,utRho28
1630,yacH,262932,262932,262520,412,80,utRho28
1631,yacL,268678,268776,268678,98,164,utRho28
1632,yadD,293796,293936,293796,140,0,utRho28
1633,yadE,289930,290162,289930,232,246,utRho28
1634,yadN,314110,314110,313766,344,28,utRho28
1635,yadS,355572,355572,355248,324,492,utRho28
1636,yadV,312470,312470,312402,68,492,utRho28
1637,yaeF,434270,434270,434006,264,8,utRho28
1638,yaeP,428374,428374,428250,124,110,utRho28
1639,yaeQ,428176,428582,428176,406,188,utRho28
1640,yaeR,423716,423754,423716,38,18,utRho28
1641,yafC,462166,462166,461762,404,218,utRho28
1642,yafD,462128,462244,462128,116,232,utRho28
1643,yafK,491986,491986,491610,376,280,utRho28
1644,yafL,493282,493424,493282,142,166,utRho28
1645,yafN,503938,504010,503938,72,78,utRho28
1646,yafS,469568,469632,469568,64,268,utRho28
1647,yafT,474470,474670,474470,200,222,utRho28
1648,yafV,480432,480432,480378,54,150,utRho28
1649,yafZ,536052,536052,536010,42,0,utRho28
1650,yagE,564446,564556,564446,110,0,utRho28
1651,yagG,570414,570790,570414,376,56,utRho28
1652,yagI,578384,578384,578324,60,16,utRho28
1653,yagK,586236,586236,585896,340,408,utRho28
1654,yagL,588062,588062,587836,226,234,utRho28
1655,yagN,591342,591342,591158,184,18,utRho28
1656,yahA,663746,664742,663746,996,3422,utRho28
1657,yahC,670136,670136,670044,92,348,utRho28
1658,yahE,671478,671850,671478,372,776,utRho28
1659,yahM,690504,690808,690504,304,534,utRho28
1660,yahN,692872,692872,692674,198,1026,utRho28
1661,yahO,692864,692968,692864,104,756,utRho28
1662,yaiE,816296,816354,816296,58,118,utRho28
1663,yaiI,811396,811528,811396,132,14,utRho28
1664,yaiO,761946,761946,761684,262,346,utRho28
1665,yaiP,767970,767970,767870,100,0,utRho28
1666,yaiS,769660,769660,769232,428,68,utRho28
1667,yaiV,788922,788922,788922,0,0,utRho28
1668,yaiY,799094,799094,798666,428,82,utRho28
1669,yaiZ,798888,799186,798888,298,242,utRho28
1670,yajC,854410,854574,854410,164,200,utRho28
1671,yajD,860938,861210,860938,272,56,utRho28
1672,yajI,866068,866068,865702,366,72,utRho28
1673,yajL,887496,887496,887282,214,292,utRho28
1674,yajQ,889316,889366,889316,50,116,utRho28
1675,yajR,893374,893374,893332,42,56,utRho28
1676,ybaB,987418,988152,987418,734,420,utRho28
1677,ybaL,1006590,1006590,1006476,114,46,utRho28
1678,ybaM,980648,980648,980542,106,186,utRho28
1679,ybaN,981436,981764,981436,328,330,utRho28
1680,ybaO,936704,936766,936704,62,0,utRho28
1681,ybaP,1016568,1016568,1016160,408,336,utRho28
1682,ybaQ,1016348,1016436,1016348,88,96,utRho28
1683,ybaS,1023146,1023282,1023146,136,714,utRho28
1684,ybaV,927504,927874,927504,370,40,utRho28
1685,ybaY,950490,950758,950490,268,14,utRho28
1686,ybbB,1062724,1062724,1062452,272,214,utRho28
1687,ybbJ,1030154,1030154,1029718,436,444,utRho28
1688,ybbL,1031784,1031838,1031784,54,12,utRho28
1689,ybbN,1037136,1037136,1036558,578,652,utRho28
1690,ybbO,1038658,1038658,1038298,360,532,utRho28
1691,ybbY,1080718,1081130,1080718,412,116,utRho28
1692,ybcH,1176140,1176140,1175962,178,94,utRho28
1693,ybcI,1113264,1113264,1113106,158,406,utRho28
1694,ybcJ,1114050,1114050,1113746,304,148,utRho28
1695,ybcK,1137502,1137804,1137502,302,0,utRho28
1696,ybcL,1141690,1141786,1141690,96,0,utRho28
1697,ybcN,1144628,1144932,1144628,304,0,utRho28
1698,ybcQ,1147548,1147912,1147548,364,76,utRho28
1699,ybcW,1159610,1159760,1159610,150,0,utRho28
1700,ybdD,1263982,1264364,1263982,382,342,utRho28
1701,ybdF,1212106,1212106,1211772,334,0,utRho28
1702,ybdH,1267048,1267048,1266954,94,42,utRho28
1703,ybdJ,1212822,1212822,1212398,424,58,utRho28
1704,ybdK,1215122,1215122,1214766,356,362,utRho28
1705,ybdL,1267114,1267172,1267114,58,52,utRho28
1706,ybdM,1271110,1271110,1270752,358,150,utRho28
1707,ybdN,1273372,1273372,1273138,234,36,utRho28
1708,ybdR,1283844,1284176,1283844,332,314,utRho28
1709,ybeD,1325412,1325412,1325284,128,526,utRho28
1710,ybeF,1323090,1323090,1322756,334,1066,utRho28
1711,ybeL,1349986,1350036,1349986,50,86,utRho28
1712,ybeQ,1353412,1353412,1353094,318,72,utRho28
1713,ybeR,1353120,1353422,1353120,302,72,utRho28
1714,ybeT,1358832,1358832,1358812,20,0,utRho28
1715,ybeU,1358924,1359016,1358924,92,148,utRho28
1716,ybeZ,1386938,1386938,1386834,104,308,utRho28
1717,ybfA,1458074,1458268,1458074,194,388,utRho28
1718,ybfE,1423878,1423878,1423796,82,148,utRho28
1719,ybfF,1425692,1425692,1425604,88,180,utRho28
1720,ybfH,1433282,1433282,1433194,88,106,utRho28
1721,ybgA,1477840,1478002,1477840,162,70,utRho28
1722,ybgC,1549288,1549504,1549288,216,78,utRho28
1723,ybgD,1505916,1505916,1505590,326,3754,utRho28
1724,ybgI,1485238,1485654,1485238,416,10,utRho28
1725,ybgO,1498370,1498370,1497964,406,118,utRho28
1726,ybgS,1570992,1570992,1570634,358,70,utRho28
1727,ybhA,1597184,1597184,1596862,322,74,utRho28
1728,ybhB,1616070,1616070,1615818,252,108,utRho28
1729,ybhC,1614642,1614642,1614562,80,28,utRho28
1730,ybhD,1601418,1601418,1601276,142,48,utRho28
1731,ybhH,1601104,1601518,1601104,414,126,utRho28
1732,ybhK,1633384,1633384,1633294,90,0,utRho28
1733,ybhM,1641556,1641586,1641556,30,50,utRho28
1734,ybhN,1645296,1645296,1644996,300,24,utRho28
1735,ybhQ,1649202,1649260,1649202,58,136,utRho28
1736,ybiA,1665920,1665920,1665900,20,0,utRho28
1737,ybiI,1676968,1676968,1676912,56,238,utRho28
1738,ybiO,1691328,1691328,1690960,368,100,utRho28
1739,ybiP,1705252,1705252,1705194,58,0,utRho28
1740,ybiS,1711572,1711572,1711488,84,30,utRho28
1741,ybiT,1711894,1711926,1711894,32,0,utRho28
1742,ybiU,1718212,1718212,1718122,90,0,utRho28
1743,ybiV,1720176,1720176,1720056,120,4,utRho28
1744,ybiW,1725566,1725566,1725212,354,3584,utRho28
1745,ybiX,1678548,1678548,1678414,134,784,utRho28
1746,ybjC,1781784,1781826,1781784,42,0,utRho28
1747,ybjE,1830154,1830154,1829714,440,460,utRho28
1748,ybjG,1767016,1767016,1766776,240,676,utRho28
1749,ybjL,1779882,1779882,1779638,244,48,utRho28
1750,ybjM,1779770,1780178,1779770,408,158,utRho28
1751,ybjO,1795704,1795978,1795704,274,0,utRho28
1752,ybjP,1809046,1809046,1808934,112,0,utRho28
1753,ybjQ,1809034,1809186,1809034,152,32,utRho28
1754,ybjS,1813796,1813796,1813506,290,242,utRho28
1755,ybjX,1838206,1838206,1838168,38,0,utRho28
1756,ycaD,1891438,1891742,1891438,304,62,utRho28
1757,ycaI,1928210,1928640,1928210,430,180,utRho28
1758,ycaK,1899094,1899336,1899094,242,50,utRho28
1759,ycaL,1920264,1920528,1920264,264,78,utRho28
1760,ycaM,1894240,1894458,1894240,218,50,utRho28
1761,ycaR,1941284,1941346,1941284,62,182,utRho28
1762,ycbB,1961862,1962094,1961862,232,378,utRho28
1763,ycbJ,1943344,1943504,1943344,160,138,utRho28
1764,ycbK,1966046,1966150,1966046,104,46,utRho28
1765,ycbZ,2036920,2036920,2036598,322,4,utRho28
1766,yccA,2062886,2062886,2062836,50,268,utRho28
1767,yccF,2048730,2048730,2048696,34,128,utRho28
1768,yccS,2047988,2047988,2047766,222,744,utRho28
1769,yccT,2055674,2055674,2055546,128,152,utRho28
1770,yccX,2059960,2060128,2059960,168,362,utRho28
1771,ycdT,2185682,2185752,2185682,70,30,utRho28
1772,ycdU,2191266,2191686,2191266,420,374,utRho28
1773,ycdZ,2200504,2200592,2200504,88,110,utRho28
1774,yceA,2233544,2233614,2233544,70,0,utRho28
1775,yceD,2293298,2293588,2293298,290,1328,utRho28
1776,yceF,2293522,2293522,2293190,332,818,utRho28
1777,yceH,2252154,2252314,2252154,160,386,utRho28
1778,yceI,2237282,2237282,2236952,330,140,utRho28
1779,yceJ,2238142,2238142,2238092,50,246,utRho28
1780,yceM,2253208,2253612,2253208,404,124,utRho28
1781,yceO,2239264,2239264,2238894,370,374,utRho28
1782,yceQ,2288760,2289004,2288760,244,1762,utRho28
1783,ycfD,2376540,2376540,2376480,60,54,utRho28
1784,ycfJ,2334814,2335198,2334814,384,32,utRho28
1785,ycfS,2340834,2340834,2340748,86,0,utRho28
1786,ycfT,2350658,2350658,2350330,328,204,utRho28
1787,ycfZ,2362760,2362760,2362534,226,270,utRho28
1788,ycgB,2474570,2474570,2474482,88,0,utRho28
1789,ycgG,2434614,2434656,2434614,42,226,utRho28
1790,ycgJ,2452956,2453200,2452956,244,140,utRho28
1791,ycgL,2455218,2455362,2455218,144,44,utRho28
1792,ycgN,2457366,2457660,2457366,294,70,utRho28
1793,ycgR,2489112,2489112,2489054,58,0,utRho28
1794,ycgV,2512222,2512222,2511904,318,186,utRho28
1795,ycgX,2426568,2426568,2426214,354,1316,utRho28
1796,ycgY,2490166,2490320,2490166,154,480,utRho28
1797,ycgZ,2431504,2431578,2431504,74,92,utRho28
1798,ychE,2596904,2597196,2596904,292,70,utRho28
1799,ychF,2515764,2515764,2515624,140,0,utRho28
1800,ychH,2517476,2517582,2517476,106,406,utRho28
1801,ychJ,2578354,2578354,2578264,90,30,utRho28
1802,ychN,2547310,2547310,2547198,112,0,utRho28
1803,ychO,2547520,2547850,2547520,330,548,utRho28
1804,ychQ,2533798,2533848,2533798,50,0,utRho28
1805,yciA,2624828,2624828,2624492,336,0,utRho28
1806,yciB,2626110,2626110,2625780,330,332,utRho28
1807,yciC,2627396,2627396,2627326,70,12,utRho28
1808,yciE,2630794,2630794,2630448,346,0,utRho28
1809,yciG,5264368,5264368,5264140,228,0,utRho28
1810,yciI,2621784,2621784,2621730,54,96,utRho28
1811,yciN,2661606,2661606,2661336,270,136,utRho28
1812,yciS,2680270,2680486,2680270,216,0,utRho28
1813,yciT,2689088,2689088,2688692,396,348,utRho28
1814,yciU,2614718,2614718,2614300,418,48,utRho28
1815,yciV,2646376,2646440,2646376,64,0,utRho28
1816,yciW,2700472,2700472,2700214,258,52,utRho28
1817,yciZ,2689276,2689276,2689218,58,172,utRho28
1818,ycjD,2703792,2703792,2703520,272,96,utRho28
1819,ycjG,2777748,2777860,2777748,112,330,utRho28
1820,ycjM,2740006,2740432,2740006,426,166,utRho28
1821,ycjW,2767982,2767982,2767922,60,74,utRho28
1822,ycjX,2768138,2768234,2768138,96,108,utRho28
1823,ycjY,5568288,5568288,5567460,828,516,utRho28
1824,ydaE,2836438,2836438,2836016,422,166,utRho28
1825,ydaN,2816048,2816100,2816048,52,92,utRho28
1826,ydaS,2840340,2840730,2840340,390,386,utRho28
1827,ydbC,2948376,2948442,2948376,66,130,utRho28
1828,ydbD,2950132,2950288,2950132,156,0,utRho28
1829,ydbH,2885800,2886102,2885800,302,1780,utRho28
1830,ydbJ,2881712,2882116,2881712,404,560,utRho28
1831,ydbK,2881692,2881692,2881568,124,120,utRho28
1832,ydcA,2983294,2983354,2983294,60,18,utRho28
1833,ydcF,2974404,2974470,2974404,66,0,utRho28
1834,ydcI,2990268,2990268,2990142,126,12,utRho28
1835,ydcJ,2990266,2990576,2990266,310,18,utRho28
1836,ydcK,3001280,3001280,3000898,382,430,utRho28
1837,ydcL,3004646,3004914,3004646,268,0,utRho28
1838,ydcN,3012308,3012344,3012308,36,58,utRho28
1839,ydcP,3013508,3013562,3013508,54,0,utRho28
1840,ydcR,3019956,3020006,3019956,50,0,utRho28
1841,ydcS,3022906,3023308,3022906,402,0,utRho28
1842,ydcX,3034442,3034778,3034442,336,120,utRho28
1843,ydcY,3035220,3035296,3035220,76,56,utRho28
1844,ydcZ,3036750,3036750,3036662,88,232,utRho28
1845,yddB,3155332,3155332,3155238,94,94,utRho28
1846,yddE,3071738,3071738,3071716,22,0,utRho28
1847,yddG,3094410,3094410,3094338,72,24,utRho28
1848,yddJ,3089732,3089732,3089438,294,356,utRho28
1849,yddW,3137704,3137704,3137646,58,56,utRho28
1850,ydeA,3233910,3234056,3233910,146,2102,utRho28
1851,ydeE,3242528,3242664,3242528,136,202,utRho28
1852,ydeI,3249118,3249118,3248994,124,0,utRho28
1853,ydeJ,3249376,3249546,3249376,170,0,utRho28
1854,ydeN,3165458,3165458,3165048,410,10,utRho28
1855,ydeP,3173328,3173328,3172972,356,8,utRho28
1856,ydeR,3176596,3176596,3176592,4,0,utRho28
1857,ydfA,3296872,3297016,3296872,144,82,utRho28
1858,ydfG,3254982,3255034,3254982,52,0,utRho28
1859,ydfH,3256652,3256704,3256652,52,0,utRho28
1860,ydfK,3265446,3266144,3265446,698,930,utRho28
1861,ydgA,3379588,3379704,3379588,116,0,utRho28
1862,ydgC,3364124,3364124,3364060,64,24,utRho28
1863,ydgD,3343906,3343920,3343906,14,88,utRho28
1864,ydgH,3356754,3356854,3356754,100,60,utRho28
1865,ydgJ,3408798,3408798,3408616,182,264,utRho28
1866,ydgK,3410414,3410500,3410414,86,578,utRho28
1867,ydhB,3479618,3479618,3479596,22,0,utRho28
1868,ydhC,3479698,3479822,3479698,124,0,utRho28
1869,ydhF,3451310,3451310,3451264,46,0,utRho28
1870,ydhI,3441996,3442050,3441996,54,0,utRho28
1871,ydhL,3451864,3451864,3451840,24,198,utRho28
1872,ydhQ,3492404,3492404,3492254,150,0,utRho28
1873,ydhS,3494136,3494262,3494136,126,26,utRho28
1874,ydhT,3499138,3499138,3499118,20,0,utRho28
1875,ydhY,3509284,3509284,3508954,330,184,utRho28
1876,ydhZ,3510418,3510418,3510282,136,0,utRho28
1877,ydiE,3579206,3579226,3579206,20,0,utRho28
1878,ydiH,3530582,3530582,3530406,176,14,utRho28
1879,ydiM,3541852,3542142,3541852,290,0,utRho28
1880,ydiN,3544818,3545024,3544818,206,0,utRho28
1881,ydiP,3558656,3558656,3558602,54,136,utRho28
1882,ydiU,3582508,3582508,3582488,20,0,utRho28
1883,ydiV,3584174,3584174,3584040,134,92,utRho28
1884,ydiY,3612500,3612500,3612166,334,702,utRho28
1885,ydjA,3697400,3697400,3697352,48,0,utRho28
1886,ydjE,3708082,3708082,3707958,124,0,utRho28
1887,ydjF,3709848,3709848,3709708,140,0,utRho28
1888,ydjM,3620340,3620422,3620340,82,0,utRho28
1889,ydjO,3626696,3626696,3626288,408,0,utRho28
1890,ydjX,3666434,3666802,3666434,368,360,utRho28
1891,yeaE,3731448,3731448,3731272,176,232,utRho28
1892,yeaG,3733530,3733816,3733530,286,44,utRho28
1893,yeaI,3740486,3740770,3740486,284,162,utRho28
1894,yeaJ,3743874,3744082,3743874,208,240,utRho28
1895,yeaL,3748646,3748704,3748646,58,302,utRho28
1896,yeaM,3751296,3751296,3751152,144,0,utRho28
1897,yeaN,3750926,3751346,3750926,420,56,utRho28
1898,yeaO,3753554,3753818,3753554,264,20,utRho28
1899,yeaP,3755314,3755430,3755314,116,40,utRho28
1900,yeaQ,3758780,3758780,3758510,270,54,utRho28
1901,yeaR,3759988,3759988,3759896,92,174,utRho28
1902,yeaY,3781122,3781122,3781064,58,0,utRho28
1903,yebB,3892220,3892502,3892220,282,588,utRho28
1904,yebC,3896370,3896370,3896302,68,28,utRho28
1905,yebE,3859464,3859464,3859414,50,128,utRho28
1906,yebG,3861530,3861530,3861494,36,0,utRho28
1907,yebK,3873180,3873304,3873180,124,0,utRho28
1908,yebQ,3820314,3820552,3820314,238,4,utRho28
1909,yebS,3832238,3832516,3832238,278,138,utRho28
1910,yebV,3843430,3843560,3843430,130,0,utRho28
1911,yebW,3843914,3844242,3843914,328,568,utRho28
1912,yecC,3995646,3995646,3995628,18,0,utRho28
1913,yecD,3901272,3901664,3901272,392,64,utRho28
1914,yecF,3991434,3991636,3991434,202,300,utRho28
1915,yecH,3979304,3979304,3978980,324,110,utRho28
1916,yecJ,3975604,3975604,3975516,88,0,utRho28
1917,yecM,3919968,3919968,3919692,276,400,utRho28
1918,yecR,3976400,3976444,3976400,44,34,utRho28
1919,yecT,3923862,3923944,3923862,82,96,utRho28
1920,yedD,4016522,4016522,4016180,342,76,utRho28
1921,yedE,4016310,4016554,4016310,244,76,utRho28
1922,yedI,4058922,4058922,4058732,190,388,utRho28
1923,yedJ,4066446,4066446,4066158,288,146,utRho28
1924,yedV,4076404,4076404,4076304,100,104,utRho28
1925,yedX,4077680,4077912,4077680,232,48,utRho28
1926,yedY,4078572,4078956,4078572,384,40,utRho28
1927,yeeA,4161322,4161322,4161182,140,64,utRho28
1928,yeeE,4171104,4171104,4171050,54,710,utRho28
1929,yeeJ,4089526,4089822,4089526,296,96,utRho28
1930,yeeN,4113508,4113716,4113508,208,250,utRho28
1931,yeeO,4119444,4119444,4119692,248,212,utRho28
1932,yeeX,4158834,4158834,4158722,112,146,utRho28
1933,yeeZ,4178422,4178422,4178256,166,108,utRho28
1934,yefM,4179466,4179466,4179426,40,0,utRho28
1935,yegD,4295288,4295348,4295288,60,34,utRho28
1936,yegH,4275726,4275804,4275726,78,46,utRho28
1937,yegI,4302154,4302154,4301970,184,18,utRho28
1938,yegJ,4302032,4302370,4302032,338,170,utRho28
1939,yegQ,4331182,4331336,4331182,154,236,utRho28
1940,yegR,4336698,4336698,4336612,86,374,utRho28
1941,yegS,4337086,4337424,4337086,338,148,utRho28
1942,yegT,4357562,4357642,4357562,80,214,utRho28
1943,yegX,4367640,4367640,4367302,338,148,utRho28
1944,yehA,4376944,4376944,4376828,116,118,utRho28
1945,yehE,4385818,4385818,4385592,226,0,utRho28
1946,yehK,4407568,4407944,4407568,376,188,utRho28
1947,yehL,4408804,4409192,4408804,388,110,utRho28
1948,yeiB,4486146,4486146,4485934,212,58,utRho28
1949,yeiE,4499422,4499422,4499236,186,40,utRho28
1950,yeiG,4487776,4487820,4487776,44,40,utRho28
1951,yeiH,4499332,4499434,4499332,102,28,utRho28
1952,yeiI,4503306,4503400,4503306,94,44,utRho28
1953,yeiL,4510580,4510710,4510580,130,10,utRho28
1954,yeiP,4530834,4530900,4530834,66,220,utRho28
1955,yeiQ,4532328,4532490,4532328,162,2,utRho28
1956,yeiR,4535484,4535658,4535484,174,56,utRho28
1957,yeiW,4530840,4530840,4530590,250,320,utRho28
1958,yejA,4544624,4544728,4544624,104,0,utRho28
1959,yejG,4556892,4556892,4556474,418,1158,utRho28
1960,yejH,4561244,4561264,4561244,20,60,utRho28
1961,yejK,4568218,4568218,4567894,324,6,utRho28
1962,yejO,4578352,4578352,4577800,552,154,utRho28
1963,yfaD,4713380,4713808,4713380,428,66,utRho28
1964,yfaE,4696676,4697028,4696676,352,142,utRho28
1965,yfaL,4688568,4688568,4688338,230,106,utRho28
1966,yfaP,4656398,4656398,4656286,112,0,utRho28
1967,yfaU,4717892,4717892,4717690,202,16,utRho28
1968,yfaY,4727310,4727310,4727266,44,1158,utRho28
1969,yfaZ,4728744,4728744,4728550,194,410,utRho28
1970,yfbK,4771810,4771810,4771444,366,686,utRho28
1971,yfbL,4771500,4771720,4771500,220,614,utRho28
1972,yfbN,4777174,4777174,4776852,322,600,utRho28
1973,yfbO,4776916,4777162,4776916,246,582,utRho28
1974,yfbP,4777990,4778232,4777990,242,1020,utRho28
1975,yfbR,4817662,4817724,4817662,62,24,utRho28
1976,yfcI,4847424,4847424,4847078,346,406,utRho28
1977,yfcJ,4880482,4880482,4880240,242,80,utRho28
1978,yfcL,4888502,4888502,4888338,164,0,utRho28
1979,yfcV,4911642,4911642,4911292,350,294,utRho28
1980,yfcZ,4921958,4921958,4921868,90,0,utRho28
1981,yfdF,4925604,4926024,4925604,420,2364,utRho28
1982,yfdG,4935474,4935710,4935474,236,10,utRho28
1983,yfdP,4946844,4947040,4946844,196,140,utRho28
1984,yfdX,4988866,4988866,4988804,62,132,utRho28
1985,yfdY,4990672,4990672,4990584,88,358,utRho28
1986,yfeA,5035784,5035784,5035664,120,290,utRho28
1987,yfeC,5036668,5036934,5036668,266,0,utRho28
1988,yfeH,5053818,5053892,5053818,74,0,utRho28
1989,yfeK,5074630,5074684,5074630,54,0,utRho28
1990,yfeO,5018906,5019260,5018906,354,264,utRho28
1991,yfeR,5054078,5054078,5053712,366,62,utRho28
1992,yfeX,5101356,5101356,5101090,266,28,utRho28
1993,yfeY,5102486,5102486,5102432,54,0,utRho28
1994,yfeZ,5103842,5103842,5103452,390,732,utRho28
1995,yffO,5123804,5124222,5123804,418,708,utRho28
1996,yffQ,5126778,5127154,5126778,376,650,utRho28
1997,yffS,5128800,5128986,5128800,186,122,utRho28
1998,yfgC,5232052,5232188,5232052,136,0,utRho28
1999,yfgF,5258062,5258062,5257876,186,754,utRho28
2000,yfgG,5258170,5258580,5258170,410,826,utRho28
2001,yfgH,5259344,5259584,5259344,240,0,utRho28
2002,yfgM,5278866,5278866,5278566,300,126,utRho28
2003,yfhH,5397414,5397518,5397414,104,372,utRho28
2004,yfhM,5304648,5304648,5304574,74,32,utRho28
2005,yfhR,5328408,5328726,5328408,318,94,utRho28
2006,yfiC,5425610,5425610,5425528,82,0,utRho28
2007,yfiE,5430688,5430688,5430640,48,396,utRho28
2008,yfiL,5482630,5482720,5482630,90,46,utRho28
2009,yfiM,5448066,5448358,5448066,292,978,utRho28
2010,yfiR,5483354,5483750,5483354,396,262,utRho28
2011,yfjH,5517326,5517326,5517200,126,30,utRho28
2012,yfjI,5517710,5517970,5517710,260,32,utRho28
2013,yfjJ,5521014,5521094,5521014,80,48,utRho28
2014,yfjM,5531970,5531970,5531552,418,2246,utRho28
2015,yfjP,5535080,5535420,5535080,340,3378,utRho28
2016,yfjW,5546570,5546636,5546570,66,0,utRho28
2017,yfjX,5551776,5551838,5551776,62,0,utRho28
2018,ygaC,5601180,5601180,5599988,1192,4550,utRho28
2019,ygaM,5600242,5600292,5600242,50,1130,utRho28
2020,ygaU,5593628,5593628,5593572,56,112,utRho28
2021,ygaZ,5619190,5619234,5619190,44,64,utRho28
2022,ygbA,5713656,5713656,5713612,44,72,utRho28
2023,ygbE,5746784,5746784,5746674,110,90,utRho28
2024,ygbI,5722882,5722882,5722528,354,170,utRho28
2025,ygbK,5724394,5724670,5724394,276,188,utRho28
2026,ygbL,5727074,5727186,5727074,112,14,utRho28
2027,ygbN,5729814,5730202,5729814,388,326,utRho28
2028,ygcG,5811210,5811422,5811210,212,174,utRho28
2029,ygcN,5785144,5785314,5785144,170,122,utRho28
2030,ygcU,5799214,5799214,5798836,378,418,utRho28
2031,ygcW,5800942,5800942,5800546,396,36,utRho28
2032,ygdD,5883442,5883442,5883262,180,762,utRho28
2033,ygdG,5861746,5861930,5861746,184,256,utRho28
2034,ygdI,5886526,5886526,5886290,236,0,utRho28
2035,ygdQ,5940784,5940840,5940784,56,108,utRho28
2036,ygdR,5942494,5942542,5942494,48,0,utRho28
2037,ygeA,5961606,5961606,5961270,336,6,utRho28
2038,ygeH,5983758,5984188,5983758,430,28,utRho28
2039,ygeI,5987162,5987276,5987162,114,372,utRho28
2040,ygeR,6000078,6000078,5999782,296,496,utRho28
2041,ygeV,6011694,6011694,6011572,122,0,utRho28
2042,ygeW,6012234,6012524,6012234,290,720,utRho28
2043,ygfB,6110946,6110946,6110888,58,0,utRho28
2044,ygfK,6031984,6032120,6031984,136,2,utRho28
2045,ygfS,6058328,6058328,6058024,304,0,utRho28
2046,ygfZ,6082564,6082626,6082564,62,40,utRho28
2047,yggC,6149512,6149512,6149378,134,0,utRho28
2048,yggE,6136370,6136370,6136160,210,214,utRho28
2049,yggI,6179176,6179510,6179176,334,48,utRho28
2050,yggL,6204508,6204508,6204266,242,114,utRho28
2051,yggM,6199514,6199514,6199130,384,292,utRho28
2052,yggN,6203596,6203596,6203246,350,92,utRho28
2053,yggX,18623958,18624558,18623958,600,84,utRho28
2054,yghA,6298966,6299324,6298966,358,74,utRho28
2055,yghB,6307058,6307126,6307058,68,138,utRho28
2056,yghD,6222614,6222614,6222252,362,134,utRho28
2057,yghF,6225798,6225798,6225840,42,0,utRho28
2058,yghJ,6238640,6238640,6238224,416,234,utRho28
2059,yghQ,6265186,6265186,6264816,370,228,utRho28
2060,yghT,6267830,6268262,6267830,432,430,utRho28
2061,yghU,6277400,6277454,6277400,54,56,utRho28
2062,yghW,6293506,6293506,6293474,32,16,utRho28
2063,yghZ,6295562,6295794,6295562,232,96,utRho28
2064,ygiD,6365122,6365122,6364868,254,250,utRho28
2065,ygiH,6409066,6409388,6409066,322,2398,utRho28
2066,ygiL,6370622,6370828,6370622,206,2,utRho28
2067,ygiM,6402084,6402414,6402084,330,318,utRho28
2068,ygiN,6346156,6346284,6346156,128,174,utRho28
2069,ygiQ,6322620,6322620,6322292,328,212,utRho28
2070,ygiS,6335462,6335462,6335436,26,0,utRho28
2071,ygiV,6338582,6338582,6338462,120,20,utRho28
2072,ygiW,6339774,6339774,6339352,422,284,utRho28
2073,ygiZ,6344506,6344506,6344422,84,78,utRho28
2074,ygjH,6442528,6442528,6442494,34,0,utRho28
2075,ygjI,6452140,6452468,6452140,328,12,utRho28
2076,ygjQ,6472730,6473080,6472730,350,736,utRho28
2077,ygjR,6474564,6474586,6474564,22,134,utRho28
2078,ygjV,6483638,6483638,6483488,150,0,utRho28
2079,yhaB,6535632,6535708,6535632,76,160,utRho28
2080,yhaH,6504498,6504608,6504498,110,214,utRho28
2081,yhaI,6505400,6505822,6505400,422,190,utRho28
2082,yhaJ,6508560,6508560,6508428,132,22,utRho28
2083,yhaK,6508538,6508638,6508538,100,22,utRho28
2084,yhbQ,6599878,6599932,6599878,54,164,utRho28
2085,yhbT,6602736,6602736,6602552,184,510,utRho28
2086,yhbU,6602558,6602970,6602558,412,590,utRho28
2087,yhbX,6643302,6643302,6643226,76,48,utRho28
2088,yhbY,6655518,6655580,6655518,62,448,utRho28
2089,yhcA,6723956,6724224,6723956,268,104,utRho28
2090,yhcB,6760364,6760382,6760364,18,60,utRho28
2091,yhcC,6708470,6708470,6708100,370,286,utRho28
2092,yhcF,6733440,6733852,6733440,412,508,utRho28
2093,yhcH,6739124,6739124,6738956,168,396,utRho28
2094,yhcM,6760312,6760312,6759994,318,34,utRho28
2095,yhcN,6770812,6771076,6770812,264,402,utRho28
2096,yhcO,6772606,6772606,6772258,348,0,utRho28
2097,yhdH,6806560,6806968,6806560,408,316,utRho28
2098,yhdJ,6823234,6823306,6823234,72,0,utRho28
2099,yhdN,6879092,6879092,6879018,74,426,utRho28
2100,yhdT,6814702,6814750,6814702,48,40,utRho28
2101,yhdU,6824994,6825242,6824994,248,260,utRho28
2102,yhdV,6836392,6836780,6836392,388,236,utRho28
2103,yhdW,6837944,6838298,6837944,354,32,utRho28
2104,yheO,6953082,6953082,6952880,202,0,utRho28
2105,yheV,6957970,6957970,6957584,386,0,utRho28
2106,yhfA,6971902,6971902,6971636,266,792,utRho28
2107,yhfG,6983294,6983294,6983240,54,64,utRho28
2108,yhfL,6998622,6998896,6998622,274,374,utRho28
2109,yhfY,7023244,7023244,7022844,400,16,utRho28
2110,yhgA,7086294,7086334,7086294,40,0,utRho28
2111,yhgE,7065176,7065176,7064878,298,694,utRho28
2112,yhgF,7074352,7074770,7074352,418,1508,utRho28
2113,yhhA,7173458,7173886,7173458,428,634,utRho28
2114,yhhI,7248346,7248756,7248346,410,112,utRho28
2115,yhhJ,7253696,7253696,7253606,90,226,utRho28
2116,yhhM,7211588,7211588,7211220,368,994,utRho28
2117,yhhN,7211150,7211502,7211150,352,556,utRho28
2118,yhhQ,7218238,7218434,7218238,196,252,utRho28
2119,yhhT,7223682,7223730,7223682,48,0,utRho28
2120,yhhX,7162032,7162032,7161610,422,164,utRho28
2121,yhhY,7162222,7162276,7162222,54,84,utRho28
2122,yhhZ,7163516,7163726,7163516,210,374,utRho28
2123,yhiD,7312220,7312220,7311804,416,4666,utRho28
2124,yhiJ,7265190,7265190,7265180,10,44,utRho28
2125,yhiM,7269270,7269682,7269270,412,2460,utRho28
2126,yhiN,7275000,7275000,7274820,180,496,utRho28
2127,yhjA,7338522,7338522,7338376,146,224,utRho28
2128,yhjB,7344090,7344090,7343788,302,780,utRho28
2129,yhjC,7344272,7344684,7344272,412,214,utRho28
2130,yhjD,7346660,7346724,7346660,64,64,utRho28
2131,yhjE,7349274,7349572,7349274,298,824,utRho28
2132,yhjG,7356824,7356824,7356730,94,2,utRho28
2133,yhjH,7358458,7358458,7358374,84,248,utRho28
2134,yhjJ,7364032,7364032,7363880,152,282,utRho28
2135,yhjK,7371296,7371296,7371158,138,160,utRho28
2136,yhjR,7392750,7392750,7392370,380,10,utRho28
2137,yhjV,7400796,7401126,7400796,330,496,utRho28
2138,yhjX,7424194,7424194,7424014,180,78,utRho28
2139,yhjY,7425966,7425966,7425868,98,24,utRho28
2140,yiaB,7455654,7455654,7455496,158,266,utRho28
2141,yiaD,7432712,7433094,7432712,382,220,utRho28
2142,yiaF,7438194,7438194,7438088,106,350,utRho28
2143,yiaG,7438862,7438956,7438862,94,338,utRho28
2144,yiaJ,7485236,7485236,7485064,172,476,utRho28
2145,yiaK,7485348,7485466,7485348,118,88,utRho28
2146,yiaT,7503924,7503924,7503736,188,28,utRho28
2147,yiaU,7503792,7503984,7503792,192,48,utRho28
2148,yiaY,7515856,7515856,7515654,202,370,utRho28
2149,yibF,7523950,7523950,7523910,40,56,utRho28
2150,yibG,7536128,7536354,7536128,226,1022,utRho28
2151,yibL,7553194,7553330,7553194,136,296,utRho28
2152,yibN,7570112,7570112,7570030,82,174,utRho28
2153,yibT,7552848,7552848,7552760,88,1446,utRho28
2154,yicC,7633290,7633352,7633290,62,80,utRho28
2155,yicH,7660862,7660914,7660862,52,6,utRho28
2156,yicJ,7673328,7673328,7671858,1470,8414,utRho28
2157,yicN,7685018,7685018,7684804,214,1234,utRho28
2158,yicO,7687914,7687914,7687578,336,8,utRho28
2159,yicR,15250308,15250308,15250236,72,0,utRho28
2160,yidB,7755230,7755230,7754930,300,1138,utRho28
2161,yidE,7732780,7732780,7732546,234,0,utRho28
2162,yidF,7711580,7711580,7711222,358,72,utRho28
2163,yidQ,7735088,7735456,7735088,368,1572,utRho28
2164,yidR,7738824,7738824,7738618,206,160,utRho28
2165,yieE,7787658,7787738,7787658,80,374,utRho28
2166,yieH,7793314,7793548,7793314,234,130,utRho28
2167,yieK,7798928,7798928,7798786,142,22,utRho28
2168,yifB,7900350,7900350,7899998,352,138,utRho28
2169,yifL,7988984,7989044,7988984,60,224,utRho28
2170,yigF,8005750,8005750,8005598,152,1738,utRho28
2171,yigI,8009448,8009448,8009394,54,28,utRho28
2172,yigM,8022100,8022152,8022100,52,610,utRho28
2173,yihA,8101970,8101970,8101458,512,0,utRho28
2174,yihD,8084098,8084138,8084098,40,0,utRho28
2175,yihF,8088110,8088398,8088110,288,326,utRho28
2176,yihG,8093304,8093304,8093204,100,92,utRho28
2177,yihI,8102616,8102694,8102616,78,0,utRho28
2178,yihL,8120506,8120894,8120506,388,1092,utRho28
2179,yihN,8124332,8124494,8124332,162,1322,utRho28
2180,yihO,8131942,8131942,8131532,410,148,utRho28
2181,yihQ,8138892,8138892,8138552,340,138,utRho28
2182,yihV,8147064,8147478,8147064,414,150,utRho28
2183,yihX,8151096,8151106,8151096,10,116,utRho28
2184,yiiE,8158192,8158582,8158192,390,522,utRho28
2185,yiiF,8159124,8159502,8159124,378,102,utRho28
2186,yiiG,8173762,8174004,8173762,242,0,utRho28
2187,yiiM,8205506,8205644,8205506,138,610,utRho28
2188,yiiQ,8224624,8224624,8224428,196,132,utRho28
2189,yiiS,8225738,8225934,8225738,196,2,utRho28
2190,yijE,8272178,8272216,8272178,38,0,utRho28
2191,yijF,8275728,8275728,8275314,414,450,utRho28
2192,yijO,8296858,8296858,8296634,224,66,utRho28
2193,yjaA,8426240,8426468,8426240,228,92302,utRho28
2194,yjaB,8428312,8428312,8428246,66,16,utRho28
2195,yjaG,8398746,8399008,8398746,262,600,utRho28
2196,yjaH,8401022,8401132,8401022,110,14,utRho28
2197,yjaZ,8379506,8379572,8379506,66,0,utRho28
2198,yjbB,8455204,8455462,8455204,258,72,utRho28
2199,yjbE,16943432,16943624,16943432,192,472,utRho28
2200,yjbL,8520318,8520642,8520318,324,180,utRho28
2201,yjbQ,8540428,8540476,8540428,48,2,utRho28
2202,yjcB,8550328,8550328,8550082,246,208,utRho28
2203,yjcC,8550836,8550942,8550836,106,242,utRho28
2204,yjcD,8556628,8556958,8556628,330,460,utRho28
2205,yjcE,8559658,8559960,8559658,302,606,utRho28
2206,yjcF,8566212,8566212,8566150,62,0,utRho28
2207,yjcO,8594660,8594660,8594250,410,512,utRho28
2208,yjdA,8654128,8654270,8654128,142,0,utRho28
2209,yjdC,8726660,8726660,8726616,44,80,utRho28
2210,yjdK,8704780,8705168,8704780,388,1392,utRho28
2211,yjdL,8713034,8713034,8712822,212,18,utRho28
2212,yjdM,8653672,8653672,8653468,204,1844,utRho28
2213,yjeF,8787354,8788132,8787354,778,1816,utRho28
2214,yjeI,8745522,8745618,8745522,96,130,utRho28
2215,yjeJ,8748806,8748806,8748468,338,630,utRho28
2216,yjeV,8785472,8785784,8785472,312,2,utRho28
2217,yjfP,8833512,8833904,8833512,392,108,utRho28
2218,yjfY,8849656,8849656,8849582,74,92,utRho28
2219,yjfZ,8855052,8855052,8854844,208,242,utRho28
2220,yjgA,8916162,8916162,8915730,432,66,utRho28
2221,yjgL,8950802,8950874,8950802,72,180,utRho28
2222,yjgM,8959342,8959342,8959074,268,42,utRho28
2223,yjgN,8959132,8959460,8959132,328,22,utRho28
2224,yjgR,8980170,8980170,8980126,44,188,utRho28
2225,yjgZ,9002116,9002520,9002116,404,1060,utRho28
2226,yjhB,9007764,9008116,9007764,352,1122,utRho28
2227,yjhG,9048452,9048452,9048188,264,1288,utRho28
2228,yjhU,9041080,9041080,9040648,432,2214,utRho28
2229,yjiA,9178096,9178096,9177730,366,234,utRho28
2230,yjiJ,9125364,9125364,9125350,14,32,utRho28
2231,yjiK,9127270,9127270,9127422,152,190,utRho28
2232,yjiL,9129604,9129604,9129378,226,58,utRho28
2233,yjiS,9143410,9143502,9143410,92,126,utRho28
2234,yjiY,9182734,9182734,9182558,176,384,utRho28
2235,yjjA,9200674,9200674,9200378,296,382,utRho28
2236,yjjB,18408708,18408708,18407800,908,964,utRho28
2237,yjjJ,9243314,9243538,9243314,224,0,utRho28
2238,yjjK,9261132,9261132,9261044,88,130,utRho28
2239,yjjL,9189764,9189764,9189444,320,130,utRho28
2240,yjjM,9191894,9191894,9191702,192,762,utRho28
2241,yjjP,9206068,9206068,9205716,352,778,utRho28
2242,yjjQ,9206638,9206954,9206638,316,178,utRho28
2243,yjjX,9267798,9267798,9267490,308,230,utRho28
2244,yjjY,9280716,9280804,9280716,88,112,utRho28
2245,yjjZ,9211554,9211608,9211554,54,332,utRho28
2246,yjtD,9281676,9281884,9281676,208,476,utRho28
2247,ykfB,532454,532454,532174,280,158,utRho28
2248,ykfI,527636,527636,527338,298,398,utRho28
2249,ykgB,637050,637050,636638,412,122,utRho28
2250,ykgC,640430,640430,640002,428,396,utRho28
2251,ykgD,640232,640454,640232,222,310,utRho28
2252,ykgE,642962,643216,642962,254,2330,utRho28
2253,ykgJ,608524,608524,608364,160,286,utRho28
2254,ykgL,623878,624224,623878,346,324,utRho28
2255,ykgM,625610,625610,625554,56,50,utRho28
2256,ykgR,626570,626570,626484,86,64,utRho28
2257,ylaC,958576,958576,958502,74,316,utRho28
2258,yliE,1745938,1745958,1745938,20,0,utRho28
2259,ymcE,2103660,2103694,2103660,34,26,utRho28
2260,ymdA,2210450,2210828,2210450,378,72,utRho28
2261,ymdB,2211428,2211640,2211428,212,0,utRho28
2262,ymfD,2395322,2395322,2395064,258,444,utRho28
2263,ymfI,2402880,2402994,2402880,114,186,utRho28
2264,ymfJ,2404518,2404518,2404168,350,88,utRho28
2265,ymfK,2406176,2406176,2405866,310,48,utRho28
2266,ymfT,2405766,2406048,2405766,282,100,utRho28
2267,ymgE,2489110,2489456,2489110,346,504,utRho28
2268,ymgF,2437628,2437966,2437628,338,152,utRho28
2269,ymiA,2670112,2670320,2670112,208,118,utRho28
2270,ymjA,2715620,2715620,2715336,284,134,utRho28
2271,ynaI,2791946,2791946,2791844,102,0,utRho28
2272,ynaK,2850438,2850754,2850438,316,134,utRho28
2273,ynbA,2954924,2955242,2954924,318,278,utRho28
2274,yncD,3046552,3046552,3046130,422,64,utRho28
2275,yncE,3046454,3046614,3046454,160,34,utRho28
2276,yncG,3052456,3052494,3052456,38,442,utRho28
2277,yncL,3034492,3034492,3034388,104,166,utRho28
2278,yneE,3218364,3218364,3218044,320,128,utRho28
2279,yneF,3223748,3223748,3223708,40,644,utRho28
2280,yneJ,3229560,3229608,3229560,48,58,utRho28
2281,yneK,3231100,3231526,3231100,426,388,utRho28
2282,yneM,3245176,3245292,3245176,116,70,utRho28
2283,ynfA,3311398,3311398,3311346,52,18,utRho28
2284,ynfB,3311418,3311616,3311418,198,202,utRho28
2285,ynfC,3315094,3315094,3314914,180,0,utRho28
2286,ynfD,3314828,3315130,3314828,302,0,utRho28
2287,ynfE,3316006,3316138,3316006,132,12,utRho28
2288,ynfK,3334670,3334670,3334438,232,2,utRho28
2289,ynfL,3339304,3339304,3339184,120,0,utRho28
2290,ynfM,3339260,3339398,3339260,138,0,utRho28
2291,ynfN,3276598,3276598,3276218,380,44,utRho28
2292,ynfO,3273454,3273512,3273454,58,4,utRho28
2293,ynhG,3517890,3517890,3517450,440,200,utRho28
2294,yniA,3615158,3615592,3615158,434,310,utRho28
2295,yniB,3618526,3618526,3618466,60,78,utRho28
2296,yniC,3618652,3618760,3618652,108,58,utRho28
2297,yniD,3610202,3610330,3610202,128,60,utRho28
2298,ynjE,3678880,3678934,3678880,54,26,utRho28
2299,ynjF,3683222,3683222,3682806,416,130,utRho28
2300,ynjH,3684376,3684376,3684270,106,96,utRho28
2301,ynjI,3690022,3690022,3689742,280,474,utRho28
2302,yoaB,3786642,3786734,3786642,92,154,utRho28
2303,yoaC,3787932,3788146,3787932,214,266,utRho28
2304,yoaE,3803544,3803544,3803170,374,302,utRho28
2305,yoaF,3755444,3755444,3755064,380,62,utRho28
2306,yoaH,3789866,3789866,3789462,404,602,utRho28
2307,yobB,3850418,3850880,3850418,462,12,utRho28
2308,yobF,3815586,3815586,3815182,404,334,utRho28
2309,yobH,3817800,3817850,3817800,50,0,utRho28
2310,yodB,4084352,4084736,4084352,384,366,utRho28
2311,yodC,4057008,4057008,4056740,268,180,utRho28
2312,yohC,4451358,4451358,4451262,96,34,utRho28
2313,yohD,4451526,4451602,4451526,76,22,utRho28
2314,yohJ,4460986,4461248,4460986,262,818,utRho28
2315,yohO,4431172,4431314,4431172,142,52,utRho28
2316,yojI,4617282,4617282,4617230,52,152,utRho28
2317,ypdI,4988988,4989396,4988988,408,196,utRho28
2318,ypfG,5165786,5165786,5165554,232,48,utRho28
2319,ypfM,5182140,5182140,5181732,408,888,utRho28
2320,yphB,5349590,5349590,5349376,214,0,utRho28
2321,ypjA,5565644,5565644,5565452,192,634,utRho28
2322,ypjB,5569636,5569636,5568858,778,50,utRho28
2323,ypjD,5495860,5495774,5495860,86,42,utRho28
2324,yqaE,5594170,5594170,5594056,114,156,utRho28
2325,yqcA,5846100,5846100,5845968,132,142,utRho28
2326,yqcE,5800944,5801184,5800944,240,14,utRho28
2327,yqeC,6030468,6030468,6030114,354,126,utRho28
2328,yqeF,5971618,5971618,5971184,434,598,utRho28
2329,yqeG,5971438,5971694,5971438,256,594,utRho28
2330,yqeH,5975016,5975072,5975016,56,942,utRho28
2331,yqeI,5976688,5977004,5976688,316,130,utRho28
2332,yqeK,5981140,5981140,5980720,420,1590,utRho28
2333,yqfA,6086728,6086728,6086296,432,294,utRho28
2334,yqgA,6219042,6219106,6219042,64,6,utRho28
2335,yqgB,6172500,6172500,6172102,398,560,utRho28
2336,yqgE,6185768,6185874,6185768,106,2,utRho28
2337,yqhA,6299150,6299150,6298942,208,64,utRho28
2338,yqhC,6310768,6310768,6310436,332,208,utRho28
2339,yqhD,6310604,6310710,6310604,106,6,utRho28
2340,yqhH,6316842,6317254,6316842,412,532,utRho28
2341,yqiC,6369662,6369680,6369662,18,138,utRho28
2342,yqiJ,6384108,6384416,6384108,308,568,utRho28
2343,yqjA,6495096,6495546,6495096,450,112,utRho28
2344,yqjF,6500932,6501124,6500932,192,170,utRho28
2345,yqjG,6501948,6502048,6501948,100,12,utRho28
2346,yqjH,6433078,6433078,6432982,96,0,utRho28
2347,yqjI,6433506,6433558,6433506,52,54,utRho28
2348,yraH,6574552,6574852,6574552,300,106,utRho28
2349,yraP,6592144,6592818,6592144,674,196,utRho28
2350,yraQ,6596414,6596414,6596276,138,0,utRho28
2351,yraR,6598024,6598024,6597692,332,492,utRho28
2352,yrbG,13360844,13361100,13360844,256,168,utRho28
2353,yrbL,6696842,6696904,6696842,62,714,utRho28
2354,yrbN,6616172,6616172,6615866,306,348,utRho28
2355,yrdB,6860176,6860176,6860046,130,190,utRho28
2356,yrfF,7052548,7052938,7052548,390,96,utRho28
2357,yrhB,7169440,7169518,7169440,78,6,utRho28
2358,ysaB,7451804,7451804,7451424,380,224,utRho28
2359,ysgA,8032686,8032686,8032338,348,154,utRho28
2360,ytfB,8857638,8857638,8857434,204,306,utRho28
2361,ytfE,8864018,8864018,8863966,52,32,utRho28
2362,ytfF,8866296,8866296,8866130,166,574,utRho28
2363,ytfH,8868164,8868226,8868164,62,256,utRho28
2364,ytfI,8875234,8875414,8875234,180,158,utRho28
2365,ytfJ,8878572,8878572,8878524,48,66,utRho28
2366,ytfK,8879022,8879174,8879022,152,372,utRho28
2367,ytfL,8882642,8882642,8882430,212,114,utRho28
2368,ytfQ,8899634,8899924,8899634,290,70,utRho28
2369,ytjB,9249598,9249598,9249578,20,0,utRho28
2370,yzfA,8896588,8896588,8896490,98,0,utRho28
2371,zapA,6111102,6111224,6111102,122,286,utRho28
2372,zapB,8236772,8237030,8236772,258,190,utRho28
2373,zapC,2011700,2011904,2011700,204,60,utRho28
2374,zinT,4082692,4082750,4082692,58,0,utRho28
2375,zipA,5062814,5062814,5062466,348,0,utRho28
2376,zitB,1569716,1569716,1569646,70,0,utRho28
2377,zntA,7212844,7212902,7212844,58,16,utRho28
2378,zntR,6878336,6878336,6878260,76,32,utRho28
2379,znuA,3885322,3885322,3885166,156,32,utRho28
2380,znuC,3885268,3885324,3885268,56,32,utRho28
2381,zraP,8403424,8403424,8403376,48,0,utRho28
2382,zraS,8403810,8403852,8403810,42,0,utRho28
2383,zupT,6364866,6365100,6364866,234,250,utRho28
2384,zur,8520282,8520282,8520006,276,520,utRho28
2385,zwf,3872752,3872752,3872628,124,0,utRho28
0,C0343,2818676,2818728,2818676,52,0,utRho29
1,aaeB,6776526,6776526,6776376,150,14,utRho29
2,aaeR,6778762,6779040,6778762,278,250,utRho29
3,aaeX,6778860,6778860,6778674,186,186,utRho29
4,aat,1854920,1854920,1854864,56,0,utRho29
5,accA,416822,417242,416822,420,282,utRho29
6,accB,6810280,6810872,6810280,592,1368,utRho29
7,accD,4868030,4868030,4867852,178,120,utRho29
8,aceB,8430804,8430956,8430804,152,454,utRho29
9,aceE,245938,246034,245938,96,38,utRho29
10,ackA,4826918,4826940,4826918,22,194,utRho29
11,acnA,2670848,2671662,2670848,814,518,utRho29
12,acnB,263038,263230,263038,192,586,utRho29
13,acpP,2303148,2303230,2303148,82,310,utRho29
14,acpS,5402324,5402324,5401996,328,780,utRho29
15,acrA,971396,971396,971238,158,84,utRho29
16,acrB,969370,969370,968806,564,486,utRho29
17,acrD,5174950,5175190,5174950,240,130,utRho29
18,acrE,6827404,6827728,6827404,324,108,utRho29
19,acrR,971398,971522,971398,124,0,utRho29
20,acrZ,1589502,1589546,1589502,44,36,utRho29
21,acs,8575190,8575190,8574742,448,1792,utRho29
22,actP,8569870,8569870,8569804,66,130,utRho29
23,ada,4620854,4620854,4620810,44,10,utRho29
24,add,3404404,3404466,3404404,62,8,utRho29
25,ade,7687802,7687928,7687802,126,16,utRho29
26,adhE,2596826,2596826,2596242,584,22,utRho29
27,adhP,3107988,3107988,3107676,312,388,utRho29
28,adiA,8681112,8681112,8681042,70,52,utRho29
29,adiC,8674404,8674404,8674062,342,212,utRho29
30,adiY,8676084,8676084,8675858,226,18,utRho29
31,adk,994278,994350,994278,72,978,utRho29
32,adrA,807374,807406,807374,32,48,utRho29
33,aer,6438240,6438240,6438152,88,0,utRho29
34,aes,1000102,1000102,999946,156,56,utRho29
35,agaR,6557406,6557406,6557330,76,78,utRho29
36,agaS,6563778,6563952,6563778,174,8,utRho29
37,agp,2131118,2131170,2131118,52,0,utRho29
38,agrA,7296126,7296126,7296126,0,0,utRho29
39,agrB,7296588,7296588,7296588,0,0,utRho29
40,ahpC,1277386,1277890,1277386,504,782,utRho29
41,ahpF,1278004,1279506,1278004,1502,28258,utRho29
42,ahr,8992698,8992698,8992418,280,408,utRho29
43,aidB,8828494,8828550,8828494,56,0,utRho29
44,ais,4731512,4731512,4731240,272,142,utRho29
45,alaA,4814816,4815122,4814816,306,96,utRho29
46,alaC,4996798,4996798,4996590,208,0,utRho29
47,alaE,5598140,5598328,5598140,188,260,utRho29
48,alaS,5644180,5644180,5644022,158,458,utRho29
49,alaW,5036612,5036612,5036462,150,72,utRho29
50,aldA,2976380,2976464,2976380,84,64,utRho29
51,aldB,7513070,7513070,7513022,48,148,utRho29
52,alkA,4295118,4295118,4295080,38,272,utRho29
53,alkB,4618890,4618890,4618682,208,112,utRho29
54,allA,1064780,1064902,1064780,122,58,utRho29
55,allD,1092822,1092822,1092726,96,0,utRho29
56,allE,1088112,1088112,1088092,20,106,utRho29
57,allS,1064600,1064600,1064442,158,216,utRho29
58,alr,8531178,8531564,8531178,386,390,utRho29
59,alsE,8617334,8617334,8616956,378,900,utRho29
60,alsK,8615990,8615990,8615598,392,982,utRho29
61,alx,6476740,6477160,6476740,420,58,utRho29
62,amiA,5104482,5104704,5104482,222,96,utRho29
63,amiC,5898378,5898378,5898020,358,42,utRho29
64,amn,4110062,4110122,4110062,60,22,utRho29
65,ampC,8758006,8758006,8757888,118,2,utRho29
66,ampD,237362,237466,237362,104,120,utRho29
67,ampG,907372,907372,907090,282,70,utRho29
68,ampH,792726,792726,792574,152,36,utRho29
69,amyA,4012230,4012312,4012230,82,4,utRho29
70,anmK,3439346,3439346,3439204,142,40,utRho29
71,ansB,6201580,6201580,6201456,124,266,utRho29
72,ansP,3052040,3052040,3051960,80,64,utRho29
73,apaG,104068,104068,103212,856,364,utRho29
74,apaH,102586,102586,102444,142,562,utRho29
75,apbE,4623188,4623188,4623068,120,0,utRho29
76,appA,2081198,2081234,2081198,36,0,utRho29
77,appC,2075420,2075480,2075420,60,44,utRho29
78,appY,1167134,1167362,1167134,228,0,utRho29
79,apt,982620,982824,982620,204,64,utRho29
80,aqpZ,1832424,1832424,1832094,330,72,utRho29
81,araB,140150,140150,140096,54,12,utRho29
82,araC,140482,140774,140482,292,374,utRho29
83,araE,5964416,5964416,5964364,52,0,utRho29
84,araF,3972476,3972476,3972256,220,0,utRho29
85,araH,3967120,3967120,3967086,34,302,utRho29
86,araJ,825058,825058,824962,96,862,utRho29
87,arcA,9281602,9281602,9280612,990,1342,utRho29
88,arcB,6706098,6706098,6706050,48,36,utRho29
89,arcZ,6701154,6701154,6701154,0,0,utRho29
90,arfA,6877346,6877346,6877298,48,40,utRho29
91,argA,5898312,5898484,5898312,172,40,utRho29
92,argC,8309770,8310002,8309770,232,128,utRho29
93,argD,6980442,6980442,6980360,82,88,utRho29
94,argE,8310156,8310156,8309694,462,184,utRho29
95,argF,580680,580680,580610,70,72,utRho29
96,argG,6637124,6637274,6637124,150,20,utRho29
97,argI,8956688,8956688,8956622,66,78,utRho29
98,argO,6137672,6137672,6137616,56,128,utRho29
99,argP,6119460,6119506,6119460,46,42,utRho29
100,argR,6769204,6769406,6769204,202,64,utRho29
101,argS,3920002,3920124,3920002,122,38,utRho29
102,argT,4855698,4855698,4855582,116,128,utRho29
103,argU,1129406,1129446,1129406,40,0,utRho29
104,argW,4932616,4932618,4932616,2,0,utRho29
105,argX,7964728,7964750,7964728,22,70,utRho29
106,aroF,5482402,5482402,5482300,102,0,utRho29
107,aroG,1571182,1571266,1571182,84,20,utRho29
108,aroH,3576636,3576870,3576636,234,282,utRho29
109,aroK,7038760,7038760,7038128,632,742,utRho29
110,aroL,812560,812810,812560,250,1690,utRho29
111,aroP,243342,243342,243102,240,16,utRho29
112,arpA,8445382,8445382,8444974,408,0,utRho29
113,arrS,7316108,7316108,7316108,0,0,utRho29
114,arsR,7297024,7297056,7297024,32,0,utRho29
115,artJ,1801252,1801252,1801150,102,0,utRho29
116,artP,1807686,1807686,1807468,218,1010,utRho29
117,ascF,5678858,5679048,5678858,190,48,utRho29
118,ascG,5678574,5678574,5678528,46,146,utRho29
119,aslB,7965562,7965916,7965562,354,68,utRho29
120,asnA,7854258,7854310,7854258,52,792,utRho29
121,asnB,1398444,1398444,1398354,90,228,utRho29
122,asnC,23562186,23562186,23562018,168,1164,utRho29
123,asnS,1978088,1978088,1977970,118,1140,utRho29
124,asnT,4089082,4089098,4089082,16,22,utRho29
125,asnU,4119690,4119702,4119690,12,4,utRho29
126,asnV,4124504,4124520,4124504,16,22,utRho29
127,aspA,17473728,17473728,17473308,420,116,utRho29
128,aspC,1971486,1971486,1971418,68,62,utRho29
129,aspS,3901402,3901402,3901044,358,246,utRho29
130,aspT,7893560,7893744,7893560,184,55674,utRho29
131,aspV,473826,473862,473826,36,344,utRho29
132,asr,3342654,3342752,3342654,98,70,utRho29
133,astC,3664088,3664088,3663964,124,90,utRho29
134,astE,3654138,3654138,3653846,292,188,utRho29
135,atoD,4646824,4646894,4646824,70,286,utRho29
136,atpB,7844540,7844540,7844102,438,684,utRho29
137,atpC,7832118,7832118,7831944,174,396,utRho29
138,atpI,7845050,7845050,7844880,170,1114,utRho29
139,avtA,7479348,7479410,7479348,62,636,utRho29
140,azoR,2965982,2965982,2965720,262,104,utRho29
141,azuC,3976002,3976002,3975918,84,60,utRho29
142,bacA,6408350,6408350,6408262,88,11198,utRho29
143,bamA,394052,395856,394052,1804,1986,utRho29
144,bamB,5277950,5277950,5277304,646,892,utRho29
145,bamC,5198028,5198028,5197730,298,518,utRho29
146,bamD,5471922,5472292,5471922,370,204,utRho29
147,bamE,5506972,5507210,5506972,238,866,utRho29
148,basS,8666954,8666954,8666544,410,568,utRho29
149,bax,7474468,7474468,7474354,114,272,utRho29
150,bcp,5200874,5200956,5200874,82,120,utRho29
151,bcsB,7385346,7385346,7385214,132,66,utRho29
152,bcsE,7392644,7392916,7392644,272,194,utRho29
153,bdcA,8948128,8948128,8948106,22,250,utRho29
154,bdcR,8948192,8948248,8948192,56,290,utRho29
155,bdm,3112680,3112680,3112560,120,82,utRho29
156,betA,654522,654522,654494,28,0,utRho29
157,betI,658722,658722,658668,54,138,utRho29
158,betT,658842,658926,658842,84,196,utRho29
159,bfr,6933498,6933498,6933450,48,34,utRho29
160,bglG,23440182,23440182,23439402,780,1992,utRho29
161,bglX,4444240,4444240,4443978,262,0,utRho29
162,bhsA,2337962,2338146,2337962,184,64,utRho29
163,bioA,1618584,1618584,1618514,70,0,utRho29
164,bioB,1618604,1618688,1618604,84,0,utRho29
165,bioH,7089716,7089716,7089688,28,0,utRho29
166,bisC,7433026,7433026,7432788,238,70,utRho29
167,blc,8755490,8755490,8755444,46,0,utRho29
168,blr,3409024,3409102,3409024,78,472,utRho29
169,bluF,2431226,2431226,2430950,276,110,utRho29
170,bluR,2428226,2428226,2428118,108,2,utRho29
171,bolA,908698,908944,908698,246,80,utRho29
172,borD,1157842,1157842,1157786,56,4,utRho29
173,brnQ,838976,839182,838976,206,680,utRho29
174,bssR,1756492,1756496,1756492,4,2,utRho29
175,bssS,2242116,2242116,2241910,206,632,utRho29
176,btuB,8326798,8327278,8326798,480,568,utRho29
177,cadB,8720212,8720212,8720062,150,806,utRho29
178,cadC,8723926,8723926,8723868,58,0,utRho29
179,caiE,70998,70998,70742,256,68,utRho29
180,caiF,68436,68600,68436,164,348,utRho29
181,caiT,84074,84074,83862,212,92,utRho29
182,can,285406,285406,285340,66,194,utRho29
183,carA,59102,59302,59102,200,738,utRho29
184,carB,61550,61634,61550,84,66,utRho29
185,cas2,5757830,5757830,5757706,124,188,utRho29
186,casA,5768638,5768638,5768276,362,144,utRho29
187,cbl,4121882,4121882,4121828,54,72,utRho29
188,cbpA,2128074,2128074,2127550,524,96,utRho29
189,cbrA,7738628,7738754,7738628,126,8,utRho29
190,cbrB,7794958,7795012,7794958,54,24,utRho29
191,ccmH,4585242,4585242,4584820,422,4,utRho29
192,cdaR,364894,364926,364894,32,120,utRho29
193,cdd,4463638,4463688,4463638,50,24,utRho29
194,cdh,8219814,8219860,8219814,46,138,utRho29
195,cdsA,391110,391354,391110,244,488,utRho29
196,cedA,3627484,3627484,3627326,158,184,utRho29
197,cfa,3482402,3482826,3482402,424,92,utRho29
198,chaC,2544844,2544972,2544844,128,268,utRho29
199,chbB,3643452,3643452,3643238,214,28,utRho29
200,chbG,3634624,3634624,3634270,354,24,utRho29
201,cheW,3946924,3946924,3946678,246,168,utRho29
202,chiA,6939792,6939792,6939706,86,548,utRho29
203,chiP,1416472,1416668,1416472,196,22,utRho29
204,cho,3646984,3647030,3646984,46,0,utRho29
205,chpS,8896804,8896894,8896804,90,32,utRho29
206,cirA,4493884,4493884,4493538,346,272,utRho29
207,citC,1304078,1304078,1303712,366,614,utRho29
208,citT,1293264,1293264,1293160,104,0,utRho29
209,clcA,350104,350214,350104,110,0,utRho29
210,clpA,1846160,1846528,1846160,368,100,utRho29
211,clpB,5468410,5468410,5468346,64,410,utRho29
212,clpP,913154,913354,913154,200,802,utRho29
213,clpS,1845500,1845826,1845500,326,32,utRho29
214,clpX,914404,914852,914404,448,1380,utRho29
215,clsA,2617346,2617346,2617290,56,220,utRho29
216,clsC,2212584,2212710,2212584,126,16,utRho29
217,cmk,1922330,1922402,1922330,72,2,utRho29
218,cnu,3409522,3409898,3409522,376,862,utRho29
219,coaA,8350214,8350214,8350052,162,1364,utRho29
220,cobC,1340092,1340092,1339814,278,314,utRho29
221,cobT,4129202,4129202,4128934,268,80,utRho29
222,cobU,4131944,4131944,4131528,416,156,utRho29
223,codB,709768,709844,709768,76,90,utRho29
224,comR,2337726,2337726,2337664,62,0,utRho29
225,copA,1022822,1022822,1022758,64,64,utRho29
226,corA,8002388,8002852,8002388,464,21926,utRho29
227,cpdB,8873258,8873258,8873130,128,244,utRho29
228,cptB,6082198,6082198,6082140,58,10,utRho29
229,cpxA,8210202,8210202,8209950,252,62,utRho29
230,cpxP,8211570,8211640,8211570,70,116,utRho29
231,cpxR,8211372,8211372,8211340,32,0,utRho29
232,cra,175894,176056,175894,162,300,utRho29
233,crcB,1316016,1316016,1315876,140,0,utRho29
234,creA,9270486,9271042,9270486,556,482,utRho29
235,creD,9276320,9276356,9276320,36,66,utRho29
236,crl,515620,515658,515620,38,1088,utRho29
237,crp,6971906,6972240,6971906,334,380,utRho29
238,crr,5070960,5071668,5070960,708,1484,utRho29
239,csdA,5886414,5886674,5886414,260,0,utRho29
240,csgB,2207718,2207902,2207718,184,0,utRho29
241,csgD,2206688,2206688,2206392,296,544,utRho29
242,csgG,2203510,2203510,2203368,142,204,utRho29
243,csiD,5577854,5577970,5577854,116,220,utRho29
244,csiE,5330802,5330870,5330802,68,100,utRho29
245,csiR,5590942,5591348,5590942,406,46,utRho29
246,cspA,7439778,7440098,7439778,320,744,utRho29
247,cspB,3283430,3283430,3283108,322,14,utRho29
248,cspC,3815018,3815018,3814870,148,126,utRho29
249,cspD,1845352,1845352,1845180,172,4564,utRho29
250,cspE,1314294,1314584,1314294,290,404,utRho29
251,cspF,3283380,3283710,3283380,330,888,utRho29
252,cspG,2102610,2102922,2102610,312,406,utRho29
253,cspH,2102746,2102746,2102350,396,120,utRho29
254,cspI,3277624,3277624,3277334,290,0,utRho29
255,csrA,5638746,5638746,5638292,454,2110,utRho29
256,csrB,5849048,5849048,5849048,0,0,utRho29
257,csrC,8102072,8102072,8102072,0,0,utRho29
258,csrD,6806850,6806850,6806664,186,134,utRho29
259,cstA,1259710,1259788,1259710,78,96,utRho29
260,cueO,274090,274166,274090,76,0,utRho29
261,cueR,1027948,1027986,1027948,38,0,utRho29
262,curA,3037784,3038054,3037784,270,214,utRho29
263,cusC,1191146,1191200,1191146,54,100,utRho29
264,cusR,1190924,1190924,1190886,38,126,utRho29
265,cutA,8730784,8730784,8730712,72,0,utRho29
266,cutC,3918534,3918534,3917920,614,716,utRho29
267,cvpA,4861600,4861600,4861526,74,220,utRho29
268,cvrA,2484328,2484328,2484142,186,64,utRho29
269,cyaA,7981548,7982306,7981548,758,1118,utRho29
270,cyaR,4334228,4334224,4334228,4,12,utRho29
271,cyaY,7988166,7988166,7988118,48,198,utRho29
272,cybB,2981522,2981804,2981522,282,238,utRho29
273,cycA,8859560,8859728,8859560,168,372,utRho29
274,cydA,1542340,1542916,1542340,576,2958,utRho29
275,cydC,1858800,1858800,1858390,410,84,utRho29
276,cydD,1862062,1862062,1861924,138,0,utRho29
277,cydX,1548300,1548392,1548300,92,36,utRho29
278,cynR,717418,717418,717380,38,38,utRho29
279,cynT,1435092,1435196,1435092,104,72,utRho29
280,cyoA,903306,903306,903220,86,280,utRho29
281,cyoE,895540,895540,895410,130,108,utRho29
282,cysB,2667576,2667710,2667576,134,114,utRho29
283,cysC,5748056,5748056,5747984,72,94,utRho29
284,cysD,5752736,5752736,5752658,78,110,utRho29
285,cysE,7565362,7565362,7565124,238,480,utRho29
286,cysG,6995508,6995656,6995508,148,2766,utRho29
287,cysJ,5783928,5783928,5783796,132,1040,utRho29
288,cysK,5064688,5064818,5064688,130,0,utRho29
289,cysP,5087114,5087114,5087056,58,54,utRho29
290,cysS,1109154,1109222,1109154,68,76,utRho29
291,cysT,3984100,3984100,3983974,126,22,utRho29
292,cysZ,5062766,5062926,5062766,160,330,utRho29
293,cytR,8249018,8249018,8248912,106,694,utRho29
294,dacA,1328002,1328002,1327926,76,0,utRho29
295,dacB,6657714,6657926,6657714,212,0,utRho29
296,dacC,1761306,1761454,1761306,148,904,utRho29
297,dadA,2475018,2475142,2475018,124,50,utRho29
298,dam,7032504,7032504,7031826,678,58,utRho29
299,damX,7035200,7035200,7034612,588,2262,utRho29
300,dapA,5199568,5199568,5199520,48,54,utRho29
301,dapB,56576,56748,56576,172,722,utRho29
302,dapD,371954,371954,371894,60,318,utRho29
303,dapE,5183120,5183214,5183120,94,532,utRho29
304,dcp,3254844,3254844,3254760,84,0,utRho29
305,dcrB,7219534,7219910,7219534,376,262,utRho29
306,dctA,7366996,7366996,7366894,102,404,utRho29
307,dcuA,8733686,8733686,8733546,140,918,utRho29
308,dcuB,8698182,8698182,8697488,694,1050,utRho29
309,dcuC,1312166,1312166,1311936,230,1070,utRho29
310,dcuD,6749166,6749738,6749166,572,344,utRho29
311,dcuR,8701130,8701130,8700068,1062,752,utRho29
312,dcuS,8703370,8703370,8703324,46,260,utRho29
313,dcyD,3999016,3999016,3998960,56,0,utRho29
314,ddpX,3126498,3126498,3126152,346,72,utRho29
315,deaD,6615818,6615818,6615720,98,172,utRho29
316,dedA,4869880,4869880,4869482,398,336,utRho29
317,dedD,4863750,4863750,4863368,382,90,utRho29
318,def,6867300,6867380,6867300,80,0,utRho29
319,degP,361690,361768,361690,78,0,utRho29
320,degQ,6761308,6761486,6761308,178,512,utRho29
321,deoB,9239134,9239206,9239134,72,44,utRho29
322,deoC,9233358,9234646,9233358,1288,834,utRho29
323,dfp,7625406,7625462,7625406,56,72,utRho29
324,dgcZ,3247758,3247758,3247700,58,0,utRho29
325,dgkA,8512914,8513274,8512914,360,344,utRho29
326,dgt,358392,358474,358392,82,28,utRho29
327,dhaK,2501888,2501888,2501676,212,66,utRho29
328,dhaR,2502006,2502132,2502006,126,234,utRho29
329,dicB,3299194,3299218,3299194,24,0,utRho29
330,dicC,3295752,3295752,3295700,52,0,utRho29
331,dinB,501760,501796,501760,36,100,utRho29
332,dinD,7635398,7635520,7635398,122,138,utRho29
333,dinG,1666146,1666140,1666146,6,0,utRho29
334,dinI,2243018,2243018,2242974,44,144,utRho29
335,dinJ,493230,493230,493004,226,102,utRho29
336,dinQ,7295964,7295964,7295576,388,256,utRho29
337,djlA,114536,114728,114536,192,60,utRho29
338,dkgA,6313142,6313246,6313142,104,28,utRho29
339,dkgB,458196,458334,458196,138,26,utRho29
340,dksA,321502,321502,321208,294,830,utRho29
341,dld,4444164,4444370,4444164,206,0,utRho29
342,dmlA,3763424,3763824,3763424,400,190,utRho29
343,dmlR,3763710,3763710,3763618,92,22,utRho29
344,dmsA,1881646,1881918,1881646,272,48,utRho29
345,dnaA,7767922,7767922,7767458,464,122,utRho29
346,dnaB,8528566,8528628,8528566,62,240,utRho29
347,dnaK,24096,24326,24096,230,3536,utRho29
348,dnaN,7765466,7765466,7764642,824,368,utRho29
349,dnaQ,471868,472134,471868,266,906,utRho29
350,dnaT,18406460,18406460,18406068,392,0,utRho29
351,dnaX,984112,984184,984112,72,204,utRho29
352,dosP,3131486,3131486,3131466,20,0,utRho29
353,dpiB,1303968,1304470,1303968,502,220,utRho29
354,dppA,7415740,7415740,7415410,330,1568,utRho29
355,dps,1697900,1697900,1697822,78,202,utRho29
356,dsbA,8086754,8086836,8086754,82,452,utRho29
357,dsbB,2466294,2466294,2466060,234,182,utRho29
358,dsbC,6079266,6079266,6077644,1622,1108,utRho29
359,dsbG,1277600,1277600,1277146,454,360,utRho29
360,dsdA,4958242,4958404,4958242,162,214,utRho29
361,dsdC,4955492,4955492,4955258,234,132,utRho29
362,dsdX,4955642,4955694,4955642,52,1232,utRho29
363,dsrA,4050626,4050626,4050626,0,0,utRho29
364,dsrB,4049686,4049686,4049646,40,248,utRho29
365,dtpD,1485340,1485340,1485112,228,412,utRho29
366,dusA,8523200,8523338,8523200,138,1046,utRho29
367,dusB,6820492,6820560,6820492,68,0,utRho29
368,dusC,4460790,4460790,4460770,20,0,utRho29
369,dut,7627704,7627864,7627704,160,994,utRho29
370,dxr,386670,387042,386670,372,418,utRho29
371,ebgA,6445102,6445266,6445102,164,136,utRho29
372,ebgR,6442874,6442932,6442874,58,0,utRho29
373,ecnB,8753018,8753106,8753018,88,40,utRho29
374,eco,4607594,4607810,4607594,216,0,utRho29
375,ecpA,621594,621594,621342,252,82,utRho29
376,ecpB,620238,620238,620052,186,20,utRho29
377,ecpR,622964,622964,622672,292,0,utRho29
378,eda,3866218,3866218,3865512,706,2,utRho29
379,edd,3869426,3869426,3869208,218,0,utRho29
380,efeO,2164308,2164486,2164308,178,24,utRho29
381,efeU_1,2162614,2162712,2162614,98,184,utRho29
382,efp,8751134,8751398,8751134,264,946,utRho29
383,elaA,4763372,4763372,4763086,286,304,utRho29
384,elaD,4765308,4765426,4765308,118,156,utRho29
385,elfA,1995530,1995736,1995530,206,12,utRho29
386,elfD,1996642,1996980,1996642,338,236,utRho29
387,emrD,7707690,7707844,7707690,154,110,utRho29
388,emrK,4966896,4966896,4966678,218,166,utRho29
389,emrY,4964668,4964668,4964352,316,570,utRho29
390,emtA,2486250,2486360,2486250,110,64,utRho29
391,endA,12361100,12361388,12361100,288,92,utRho29
392,eno,5817692,5817692,5815882,1810,770,utRho29
393,entC,1249662,1249770,1249662,108,0,utRho29
394,entD,1220508,1220508,1220158,350,316,utRho29
395,entH,1258584,1258600,1258584,16,0,utRho29
396,entS,1244506,1244600,1244506,94,64,utRho29
397,envR,6827266,6827266,6826930,336,28,utRho29
398,epd,12295292,12295292,12294764,528,840,utRho29
399,epmA,8765236,8765286,8765236,50,80,utRho29
400,epmB,8751406,8751406,8751314,92,546,utRho29
401,eptB,7421162,7421162,7420950,212,44,utRho29
402,eptC,8300622,8300622,8300530,92,212,utRho29
403,erfK,4126708,4126708,4126646,62,34,utRho29
404,erpA,353122,353220,353122,98,4,utRho29
405,esrE,8039956,8039956,8039956,0,0,utRho29
406,essD,1153746,1154796,1153746,1050,138,utRho29
407,etk,2088606,2088606,2088420,186,104,utRho29
408,evgA,4967262,4967510,4967262,248,226,utRho29
409,exbB,6304028,6304028,6303968,60,320,utRho29
410,exbD,6302780,6302780,6302486,294,194,utRho29
411,exuR,6493016,6493304,6493016,288,190,utRho29
412,exuT,6490004,6490208,6490004,204,0,utRho29
413,fabA,2032996,2032996,2032940,56,74,utRho29
414,fabB,4883282,4883282,4883210,72,2,utRho29
415,fabH,2297032,2297518,2297032,486,178,utRho29
416,fabI,2702236,2702236,2702078,158,4,utRho29
417,fadB,8062026,8062026,8061942,84,10,utRho29
418,fadD,3779614,3779614,3779492,122,76,utRho29
419,fadE,486812,486812,486606,206,88,utRho29
420,fadH,6463248,6463330,6463248,82,22,utRho29
421,fadI,4921022,4921022,4920938,84,324,utRho29
422,fadL,4922410,4922600,4922410,190,158,utRho29
423,fadM,928720,928804,928720,84,0,utRho29
424,fadR,2469810,2469876,2469810,66,12,utRho29
425,fbaB,4357334,4357334,4357128,206,2,utRho29
426,fdhE,8162722,8162722,8162456,266,282,utRho29
427,fdhF,8598814,8598814,8598732,82,72,utRho29
428,fdnG,3094744,3094802,3094744,58,0,utRho29
429,fdrA,1093012,1093360,1093012,348,64,utRho29
430,feaB,2894994,2895038,2894994,44,0,utRho29
431,feaR,2894734,2894734,2894566,168,0,utRho29
432,fecA,9033454,9033454,9033354,100,50,utRho29
433,fecE,9023288,9023288,9022914,374,2520,utRho29
434,fecI,9036564,9036564,9036470,94,0,utRho29
435,feoA,7080114,7080326,7080114,212,106,utRho29
436,fepA,1225334,1225334,1224988,346,596,utRho29
437,fepB,1249454,1249454,1249020,434,68,utRho29
438,fepD,1244468,1244468,1244378,90,0,utRho29
439,fes,1225374,1225630,1225374,256,452,utRho29
440,ffh,5495706,5495706,5495590,116,318,utRho29
441,ffs,952576,952848,952576,272,206,utRho29
442,fhuA,334884,334968,334884,84,138,utRho29
443,fhuE,2323294,2323294,2323102,192,238,utRho29
444,fhuF,9211504,9211504,9211326,178,840,utRho29
445,fic,6983296,6983296,6982926,370,4,utRho29
446,fieF,8212864,8212938,8212864,74,138,utRho29
447,fimA,9085388,9086230,9085388,842,1158,utRho29
448,fimB,9081334,9081914,9081334,580,2370,utRho29
449,fimE,9083742,9084074,9083742,332,788,utRho29
450,fimZ,1129214,1129214,1128960,254,194,utRho29
451,fiu,1683296,1683296,1683062,234,224,utRho29
452,fixA,84650,84806,84650,156,180,utRho29
453,fkpA,6955050,6955050,6954838,212,5668,utRho29
454,fldA,2846084,2846084,2845860,224,428,utRho29
455,fldB,6079644,6079710,6079644,66,0,utRho29
456,flgA,2261770,2261770,2261726,44,356,utRho29
457,flgB,2261986,2262036,2261986,50,76,utRho29
458,flgK,2276702,2276756,2276702,54,76,utRho29
459,flgM,2260330,2260330,2260256,74,198,utRho29
460,flgN,2259828,2259828,2259660,168,0,utRho29
461,flhB,3932432,3932432,3932382,50,264,utRho29
462,flhC,3955864,3955864,3955688,176,2,utRho29
463,flhD,3957154,3957154,3956394,760,790,utRho29
464,fliA,4003638,4003638,4003578,60,54,utRho29
465,fliC,4007352,4007352,4007212,140,40,utRho29
466,fliD,4007634,4007744,4007634,110,148,utRho29
467,fliE,4026186,4026186,4026028,158,142,utRho29
468,fliF,4026292,4026458,4026292,166,242,utRho29
469,fliL,4039168,4039236,4039168,68,12,utRho29
470,flk,4875824,4875900,4875824,76,12,utRho29
471,flu,4142634,4143078,4142634,444,400,utRho29
472,flxA,3292776,3292810,3292776,34,60,utRho29
473,fnr,2799104,2799104,2799052,52,32,utRho29
474,fnrS,2818258,2818258,2818258,0,0,utRho29
475,focA,1909628,1909628,1908932,696,116,utRho29
476,folA,99598,99646,99598,48,116,utRho29
477,folB,6409296,6409296,6409178,118,794,utRho29
478,folD,1115562,1115562,1115482,80,230,utRho29
479,folE,4487696,4487696,4487304,392,150,utRho29
480,fpr,8228998,8228998,8228944,54,86,utRho29
481,frc,4986878,4986878,4986508,370,566,utRho29
482,frdA,8764824,8764824,8764636,188,0,utRho29
483,frdD,8758948,8758948,8758732,216,366,utRho29
484,fre,8052886,8053054,8052886,168,90,utRho29
485,frlA,6999518,6999820,6999518,302,132,utRho29
486,frr,385624,385744,385624,120,340,utRho29
487,frsA,513004,513054,513004,50,54,utRho29
488,fruB,4527194,4527194,4526990,204,0,utRho29
489,frvR,8179804,8179804,8179710,94,0,utRho29
490,fryA,5008986,5008986,5008970,16,0,utRho29
491,fsaA,1727060,1727284,1727060,224,348,utRho29
492,fsr,1009710,1009710,1009392,318,848,utRho29
493,ftnA,3977364,3977432,3977364,68,0,utRho29
494,ftnB,3973550,3973850,3973550,300,220,utRho29
495,ftsA,207122,207964,207122,842,1320,utRho29
496,ftsB,5745802,5745802,5745640,162,78,utRho29
497,ftsH,6654204,6654204,6653870,334,1430,utRho29
498,ftsK,1865858,1866448,1865858,590,908,utRho29
499,ftsL,181376,182064,181376,688,440,utRho29
500,ftsP,6325732,6325732,6325338,394,52,utRho29
501,ftsQ,205484,206310,205484,826,750,utRho29
502,ftsX,7204512,7204512,7204172,340,626,utRho29
503,ftsZ,209272,210610,209272,1338,338,utRho29
504,fucA,5867708,5867708,5867376,332,1634,utRho29
505,fucP,5868238,5868470,5868238,232,314,utRho29
506,fumA,6753760,6753760,6753508,252,1376,utRho29
507,fumB,8694696,8694696,8694652,44,2,utRho29
508,fumC,3373418,3373418,3373176,242,0,utRho29
509,fur,2842892,2842892,2842584,308,424,utRho29
510,fusA,6947370,6947370,6947028,342,5468,utRho29
511,fxsA,8737206,8737328,8737206,122,938,utRho29
512,gabD,5581824,5582546,5581824,722,1088,utRho29
513,gadA,7335214,7335214,7335160,54,18,utRho29
514,gadB,3144144,3144144,3144090,54,50,utRho29
515,gadC,3141168,3141168,3140978,190,738,utRho29
516,gadE,7315600,7316732,7315600,1132,784,utRho29
517,gadW,7329562,7329562,7329236,326,16,utRho29
518,gadX,14663356,14663356,14663240,116,172,utRho29
519,gadY,7329728,7329728,7329728,0,0,utRho29
520,galE,1584354,1584354,1584110,244,46,utRho29
521,galF,4228702,4228702,4228654,48,156,utRho29
522,galM,1577796,1577796,1577674,122,256,utRho29
523,galP,6176510,6176568,6176510,58,64,utRho29
524,galR,5953138,5953198,5953138,60,0,utRho29
525,galS,4483420,4483420,4483336,84,82,utRho29
526,galU,2582810,2582914,2582810,104,124,utRho29
527,gapA,3724480,3725542,3724480,1062,1418,utRho29
528,garP,6549868,6549868,6549814,54,582,utRho29
529,gatY,4354468,4354468,4354408,60,0,utRho29
530,gatZ,4352864,4352864,4352642,222,426,utRho29
531,gcd,282558,282558,282450,108,56,utRho29
532,gcl,1067814,1067832,1067814,18,20,utRho29
533,gcvA,5885278,5885278,5885134,144,0,utRho29
534,gcvB,5885392,5885392,5885392,0,0,utRho29
535,gcvR,5199758,5199812,5199758,54,72,utRho29
536,gcvT,6101544,6101544,6101334,210,192,utRho29
537,gdhA,3684616,3684742,3684616,126,0,utRho29
538,gfcA,2099668,2099668,2099488,180,228,utRho29
539,gfcD,2096236,2096236,2095890,346,162,utRho29
540,ghrA,2195648,2195772,2195648,124,178,utRho29
541,ghrB,7434378,7434620,7434378,242,1348,utRho29
542,glcA,6242728,6242728,6242558,170,252,utRho29
543,glcC,6256412,6256544,6256412,132,16,utRho29
544,glcD,6256152,6256152,6256042,110,72,utRho29
545,gldA,8278092,8278092,8278070,22,80,utRho29
546,glgA,7136784,7136784,7136066,718,686,utRho29
547,glgB,7147314,7147314,7147004,310,200,utRho29
548,glgC,7139142,7139142,7138656,486,68,utRho29
549,glgP,7133546,7133546,7133162,384,308,utRho29
550,glgS,6384024,6384024,6383878,146,500,utRho29
551,glgX,7142838,7142838,7142638,200,0,utRho29
552,glk,5018922,5018922,5018852,70,0,utRho29
553,glmS,7827622,7827622,7827336,286,610,utRho29
554,glmU,7830652,7830652,7830400,252,204,utRho29
555,glmY,10765360,10765360,10765360,0,0,utRho29
556,glmZ,7972864,7972864,7972864,0,0,utRho29
557,glnA,16232888,16232888,16232136,752,104,utRho29
558,glnB,5375052,5375052,5374816,236,40,utRho29
559,glnD,377310,377310,377300,10,244,utRho29
560,glnE,6399602,6399602,6399282,320,104,utRho29
561,glnH,1696396,1696396,1696008,388,400,utRho29
562,glnK,945112,945196,945112,84,172,utRho29
563,glnL,8112742,8112742,8112678,64,0,utRho29
564,glnQ,1693262,1693262,1692926,336,362,utRho29
565,glnS,1411998,1412186,1411998,188,1348,utRho29
566,gloA,3455602,3455674,3455602,72,0,utRho29
567,gloB,469852,469852,469564,288,540,utRho29
568,glpA,4705166,4705294,4705166,128,34,utRho29
569,glpD,7123942,7124026,7123942,84,0,utRho29
570,glpE,7123698,7123698,7123646,52,10,utRho29
571,glpF,8236322,8236322,8236180,142,1652,utRho29
572,glpG,7122960,7122960,7122904,56,70,utRho29
573,glpR,7121782,7121782,7121210,572,3112,utRho29
574,glpT,4704902,4704902,4704748,154,264,utRho29
575,glpX,8231212,8231212,8231158,54,244,utRho29
576,glrK,5382246,5382246,5382196,50,0,utRho29
577,gltA,1509534,1509534,1508936,598,1574,utRho29
578,gltB,6709018,6709264,6709018,246,140,utRho29
579,gltI,1375792,1375792,1375494,298,656,utRho29
580,gltP,8588536,8588962,8588536,426,402,utRho29
581,gltS,7657382,7657382,7657330,52,804,utRho29
582,gltX,5041568,5041568,5041344,224,116,utRho29
583,gluQ,320286,320286,320224,62,4,utRho29
584,glyA,5371148,5371148,5371014,134,72,utRho29
585,glyQ,7450708,7450708,7450636,72,6,utRho29
586,glyS,7448990,7448990,7448794,196,510,utRho29
587,glyU,5998128,5998128,5998114,14,0,utRho29
588,glyV,8784626,8784720,8784626,94,158,utRho29
589,glyW,3984360,3984360,3984234,126,0,utRho29
590,gmhB,445612,445666,445612,54,0,utRho29
591,gmk,7642776,7642856,7642776,80,0,utRho29
592,gmr,2693686,2693686,2693484,202,132,utRho29
593,gnd,4202648,4202648,4202536,112,480,utRho29
594,gnsB,3275692,3275692,3275564,128,0,utRho29
595,gntK,14310580,14310580,14310368,212,768,utRho29
596,gntP,9102668,9102668,9102592,76,906,utRho29
597,gntR,7157760,7157760,7157452,308,164,utRho29
598,gntT,7092810,7093118,7092810,308,386,utRho29
599,gntU,7154170,7154170,7154122,48,302,utRho29
600,gntX,7089334,7089764,7089334,430,304,utRho29
601,gor,7292224,7292598,7292224,374,140,utRho29
602,gpmA,1575340,1575340,1575190,150,0,utRho29
603,gpmM,7570374,7570520,7570374,146,26,utRho29
604,gpsA,7567620,7567620,7567322,298,3064,utRho29
605,gpt,511828,511954,511828,126,284,utRho29
606,grcA,5433046,5433046,5432898,148,534,utRho29
607,greA,6657728,6657728,6657430,298,920,utRho29
608,greB,7073488,7073624,7073488,136,26,utRho29
609,groL,8741566,8742050,8741566,484,11870,utRho29
610,groS,8741232,8741376,8741232,144,8484,utRho29
611,grpE,5501494,5501494,5501416,78,432,utRho29
612,grxA,1781552,1781552,1781506,46,0,utRho29
613,grxB,2248206,2248206,2248108,98,666,utRho29
614,grxC,7569152,7569152,7568884,268,1128,utRho29
615,grxD,3468324,3468324,3468202,122,1794,utRho29
616,gspA,6911268,6911268,6910796,472,734,utRho29
617,gspC,6910964,6911156,6910964,192,470,utRho29
618,gss,6277220,6277220,6277044,176,106,utRho29
619,gstA,3428654,3428754,3428654,100,0,utRho29
620,gstB,1761038,1761038,1760960,78,378,utRho29
621,guaB,5268214,5268214,5268140,74,84,utRho29
622,gudD,5839026,5839026,5838770,256,52,utRho29
623,gyrA,4678914,4678914,4678840,74,92,utRho29
624,gyrB,7760300,7760300,7760238,62,218,utRho29
625,hcaE,5337964,5338064,5337964,100,166,utRho29
626,hcaR,5337928,5337928,5337792,136,260,utRho29
627,hcaT,5336106,5336106,5335692,414,212,utRho29
628,hchA,4071260,4071670,4071260,410,0,utRho29
629,hcp,1828258,1828258,1827628,630,198,utRho29
630,hcr,1824400,1824400,1824300,100,0,utRho29
631,hdeA,7313582,7313582,7313480,102,0,utRho29
632,hdeD,7313920,7313990,7313920,70,1696,utRho29
633,hdfR,7896320,7896320,7895934,386,96,utRho29
634,hdhA,3396244,3396244,3396080,164,152,utRho29
635,helD,2048876,2048942,2048876,66,48,utRho29
636,hemA,2527166,2527428,2527166,262,258,utRho29
637,hemB,779722,779722,779454,268,184,utRho29
638,hemF,5106410,5106450,5106410,40,46,utRho29
639,hemH,996062,996110,996062,48,0,utRho29
640,hemL,349882,349882,349764,118,48,utRho29
641,hemN,8103886,8104090,8103886,204,0,utRho29
642,hepA,127176,127176,126528,648,7880,utRho29
643,hflD,2385372,2385372,2385262,110,104,utRho29
644,hfq,8799602,8800576,8799602,974,2896,utRho29
645,hha,961006,961006,960616,390,0,utRho29
646,hicA,3018442,3018572,3018442,130,10,utRho29
647,higA,6468682,6468682,6468288,394,1280,utRho29
648,higB,6468960,6468960,6468910,50,182,utRho29
649,hinT,2323642,2323770,2323642,128,34,utRho29
650,hipB,3184964,3184964,3184884,80,52,utRho29
651,hisB,4186720,4186936,4186720,216,306,utRho29
652,hisJ,4853674,4853674,4853576,98,0,utRho29
653,hisL,8359856,8359984,8359856,128,272,utRho29
654,hisS,5281284,5281284,5281150,134,30,utRho29
655,hlpA,400910,400964,400910,54,84,utRho29
656,hlyE,2460932,2460932,2460788,144,564,utRho29
657,hmp,5371594,5371670,5371594,76,6,utRho29
658,hns,2585916,2585916,2585844,72,3504,utRho29
659,hofM,7045856,7045856,7045502,354,176,utRho29
660,hokA,7441620,7441620,7441200,420,372,utRho29
661,hokC,33902,33902,33806,96,168,utRho29
662,hokE,1215462,1215672,1215462,210,26,utRho29
663,holC,8968546,8968546,8968560,14,110,utRho29
664,holD,9215562,9215606,9215562,44,24,utRho29
665,holE,3850040,3850216,3850040,176,60,utRho29
666,hpt,282720,282862,282720,142,228,utRho29
667,hrpB,324150,324210,324150,60,36,utRho29
668,hscB,5319048,5319048,5318934,114,112,utRho29
669,hscC,1367188,1367188,1366786,402,114,utRho29
670,hsdS,9163004,9163004,9162924,80,536,utRho29
671,hslJ,2883560,2883560,2883486,74,374,utRho29
672,hslO,7059344,7059548,7059344,204,41920,utRho29
673,hslR,7058220,7058696,7058220,476,4804,utRho29
674,hslV,8244708,8244708,8244574,134,100,utRho29
675,hsrA,7881412,7881412,7881224,188,48,utRho29
676,htgA,21286,21660,21286,374,532,utRho29
677,htpG,989634,990240,989634,606,810,utRho29
678,htpX,3825236,3825236,3825152,84,12,utRho29
679,htrE,311036,311036,310852,184,510,utRho29
680,htrL,7587668,7587668,7587366,302,574,utRho29
681,hupA,8400352,8400562,8400352,210,18,utRho29
682,hupB,1845220,1845804,1845220,584,808,utRho29
683,hyaA,2063968,2064278,2063968,310,38,utRho29
684,hybO,6292726,6292726,6292522,204,444,utRho29
685,hycA,5700922,5700922,5700870,52,0,utRho29
686,hycI,5686204,5686204,5686086,118,1064,utRho29
687,hydN,5676264,5676264,5676210,54,18,utRho29
688,hyfA,5202342,5202402,5202342,60,0,utRho29
689,hypA,11402508,11402588,11402508,80,140,utRho29
690,hypB,11403356,11404004,11403356,648,472,utRho29
691,hypF,5676210,5676210,5674850,1360,3360,utRho29
692,hypT,9116634,9116634,9116578,56,0,utRho29
693,hyuA,6019660,6020056,6019660,396,96,utRho29
694,iaaA,1733074,1733136,1733074,62,14,utRho29
695,iadA,9119074,9119074,9119052,22,90,utRho29
696,iap,5753072,5753162,5753072,90,64,utRho29
697,ibaG,6673966,6673966,6673606,360,26,utRho29
698,ibpA,7735036,7735036,7734844,192,4954,utRho29
699,ibpB,7733962,7733962,7733794,168,41552,utRho29
700,icd,2389922,2390246,2389922,324,348,utRho29
701,iclR,8447304,8447304,8447256,48,64,utRho29
702,idi,6065876,6066130,6065876,254,38,utRho29
703,idnD,8988870,8988870,8988812,58,54,utRho29
704,idnK,8989194,8989246,8989194,52,290,utRho29
705,ihfA,3591442,3591442,3591104,338,602,utRho29
706,ihfB,1927498,1927656,1927498,158,558,utRho29
707,ileS,43666,44782,43666,1116,762,utRho29
708,ileX,6431194,6431196,6431194,2,0,utRho29
709,ilvA,15820940,15821324,15820940,384,232,utRho29
710,ilvC,7915824,7915940,7915824,116,116,utRho29
711,ilvE,15809552,15809936,15809552,384,220,utRho29
712,ilvI,170840,171260,170840,420,236,utRho29
713,ilvL,23701308,23701932,23701308,624,534,utRho29
714,ilvY,7915734,7915734,7915640,94,232,utRho29
715,inaA,4698998,4698998,4698944,54,336,utRho29
716,infA,1853370,1853370,1852886,484,240,utRho29
717,infC,3602692,3602692,3601276,1416,1360,utRho29
718,insA-5,3958452,3958452,3958430,22,64,utRho29
719,insA-7,9036758,9037054,9036758,296,420,utRho29
720,insC-5,6372080,6372284,6372080,204,464,utRho29
721,insEF-2,785238,785238,785820,582,216,utRho29
722,insEF-4,2190310,2190310,2190892,582,220,utRho29
723,insG,9007098,9007098,9006862,236,88,utRho29
724,insH-1,550596,550596,550234,362,428,utRho29
725,insH-11,7306538,7306538,7306396,142,670,utRho29
726,insH-2,1151548,1151548,1151506,42,302,utRho29
727,insH-3,1378444,1378444,1378026,418,136,utRho29
728,insH-4,2791942,2792152,2791942,210,148,utRho29
729,insH-5,2857852,2857852,2857452,400,110,utRho29
730,insH-6,4135022,4135022,4134642,380,246,utRho29
731,insH-7,4206186,4206186,4205822,364,4118,utRho29
732,insH-9,6260050,6260356,6260050,306,216,utRho29
733,insI-3,9017372,9017372,9017234,138,118,utRho29
734,insJ,7441188,7441360,7441188,172,124,utRho29
735,insK,7442130,7442308,7442130,178,0,utRho29
736,insL-1,30760,30890,30760,130,6664,utRho29
737,insL-2,1216112,1216130,1216112,18,102,utRho29
738,insL-3,5028644,5028662,5028644,18,162,utRho29
739,insN-1,540452,540484,540452,32,46,utRho29
740,intD,1132202,1132202,1131956,246,528,utRho29
741,intR,2826520,2826520,2826470,50,152,utRho29
742,intS,4933026,4933090,4933026,64,2,utRho29
743,intZ,5117386,5117542,5117386,156,118,utRho29
744,iraD,9113152,9113986,9113152,834,656,utRho29
745,iraM,2424246,2424246,2424006,240,204,utRho29
746,iraP,802638,802772,802638,134,0,utRho29
747,iscA,5319924,5319924,5319772,152,530,utRho29
748,iscR,5324398,5324398,5324262,136,1852,utRho29
749,iscX,5313834,5313834,5313472,362,278,utRho29
750,ispF,5743968,5743968,5743560,408,90,utRho29
751,ispG,5283908,5283908,5283608,300,48,utRho29
752,ispU,389568,389806,389568,238,6,utRho29
753,isrA,2811502,2811502,2811618,116,38,utRho29
754,istr-1,7706384,7706384,7706384,0,0,utRho29
755,istr-2,7706514,7706514,7706514,0,0,utRho29
756,ivbL,15412092,15412092,15411952,140,64,utRho29
757,ivy,480638,480686,480638,48,0,utRho29
758,katE,3627628,3627734,3627628,106,122,utRho29
759,katG,8267624,8267670,8267624,46,148,utRho29
760,kbaZ,6557732,6557828,6557732,96,32,utRho29
761,kbl,7585154,7585154,7585102,52,342,utRho29
762,kch,2621046,2621046,2620538,508,124,utRho29
763,kdgR,3820506,3820506,3820198,308,52,utRho29
764,kdpE,1443788,1443788,1443466,322,250,utRho29
765,kdpF,1457698,1457698,1457642,56,0,utRho29
766,kdsA,2535708,2536330,2535708,622,490,utRho29
767,kdsC,6683438,6684546,6683438,1108,3682,utRho29
768,kduI,5968388,5968388,5968248,140,632,utRho29
769,kefF,94160,94492,94160,332,1670,utRho29
770,kgtP,5451624,5451624,5451492,132,610,utRho29
771,kup,7862206,7862632,7862206,426,3040,utRho29
772,lacI,735076,735076,735020,56,24,utRho29
773,lacZ,1465508,1465508,1465220,288,1280,utRho29
774,ldcA,2486394,2486394,2486160,234,112,utRho29
775,ldhA,2885830,2885830,2885686,144,114,utRho29
776,ldrA,2538954,2538954,2538550,404,338,utRho29
777,ldrB,2540024,2540024,2539620,404,76,utRho29
778,ldrC,2541092,2541092,2540690,402,158,utRho29
779,ldrD,7400544,7400544,7400174,370,444,utRho29
780,lepA,5414392,5414392,5414248,144,602,utRho29
781,lepB,5410928,5410928,5410618,310,1682,utRho29
782,leuD,159188,159188,158906,282,104,utRho29
783,leuE,3761600,3761600,3761518,82,124,utRho29
784,leuL,168048,168048,167416,632,124,utRho29
785,leuO,168308,168736,168308,428,132,utRho29
786,leuQ,9212864,9212864,9212802,62,2,utRho29
787,leuU,6644556,6644556,6644316,240,1680,utRho29
788,leuV,9212546,9212546,9212330,216,282,utRho29
789,leuX,8992772,8992810,8992772,38,0,utRho29
790,lexA,8514174,8514230,8514174,56,122,utRho29
791,lhr,3456706,3458174,3456706,1468,220,utRho29
792,ligA,5060402,5060402,5060352,50,0,utRho29
793,ligB,7642576,7642576,7642340,236,88,utRho29
794,lipA,1320602,1320602,1320432,170,206,utRho29
795,lipB,1324802,1324802,1324556,246,4882,utRho29
796,lit,2397032,2397390,2397032,358,364,utRho29
797,livJ,7199524,7199524,7199316,208,2924,utRho29
798,livK,7195510,7195510,7195120,390,1506,utRho29
799,lldP,7554578,7554798,7554578,220,362,utRho29
800,lnt,1381968,1381968,1381762,206,256,utRho29
801,loiP,6163784,6163826,6163784,42,10,utRho29
802,lolA,1874656,1874738,1874656,82,78,utRho29
803,lolB,2527112,2527112,2527000,112,14,utRho29
804,lolC,2350748,2350854,2350748,106,0,utRho29
805,lon,917630,917776,917630,146,170,utRho29
806,lpcA,486936,487086,486936,150,0,utRho29
807,lpd,255434,255824,255434,390,580,utRho29
808,lplA,9248476,9248476,9248234,242,772,utRho29
809,lplT,5947878,5947878,5947724,154,72,utRho29
810,lpoA,6586422,6586800,6586422,378,198,utRho29
811,lpp,3514592,3514842,3514592,250,258,utRho29
812,lptA,6686598,6686760,6686598,162,90,utRho29
813,lptB,6686792,6687888,6686792,1096,1350,utRho29
814,lptD,114672,114672,114218,454,276,utRho29
815,lptF,8972244,8972436,8972244,192,0,utRho29
816,lpxC,213016,213114,213016,98,1152,utRho29
817,lpxD,401920,401942,401920,22,0,utRho29
818,lpxL,2233418,2233418,2233164,254,174,utRho29
819,lpxM,3880456,3880456,3880386,70,0,utRho29
820,lpxP,4991156,4991290,4991156,134,142,utRho29
821,lrhA,4813312,4813312,4813282,30,40,utRho29
822,lrp,1864656,1865190,1864656,534,744,utRho29
823,lspA,50028,50414,50028,386,506,utRho29
824,lsrA,3202920,3202980,3202920,60,46,utRho29
825,lsrR,3202514,3202514,3202482,32,368,utRho29
826,ltaE,1818640,1818640,1818588,52,0,utRho29
827,luxS,5630130,5630130,5629466,664,1172,utRho29
828,lysA,5957902,5957902,5957798,104,16,utRho29
829,lysC,8467232,8467232,8466466,766,460,utRho29
830,lysP,4497120,4497120,4497064,56,140,utRho29
831,lysR,5957900,5958042,5957900,142,0,utRho29
832,lysT,1561028,1561108,1561028,80,4,utRho29
833,lysU,8709610,8709610,8709434,176,70,utRho29
834,macB,1840188,1840694,1840188,506,660,utRho29
835,maeA,3111484,3111484,3111338,146,404,utRho29
836,mak,820236,820288,820236,52,0,utRho29
837,malE,8492928,8492928,8492838,90,14,utRho29
838,malI,3398456,3398456,3398360,96,0,utRho29
839,malK,8493472,8493568,8493472,96,66,utRho29
840,malP,7105020,7105020,7104946,74,616,utRho29
841,malQ,7100798,7100798,7100140,658,562,utRho29
842,malS,14949880,14949988,14949880,108,12,utRho29
843,malT,7106048,7106170,7106048,122,172,utRho29
844,malX,3398626,3398710,3398626,84,2,utRho29
845,malZ,1689980,1690072,1689980,92,0,utRho29
846,manA,3377102,3377152,3377102,50,0,utRho29
847,manX,3803866,3804096,3803866,230,36,utRho29
848,marC,3237882,3237882,3237816,66,140,utRho29
849,marR,3238186,3238240,3238186,54,0,utRho29
850,matP,2036918,2036970,2036918,52,0,utRho29
851,mazE,5822736,5822736,5822678,58,70,utRho29
852,mazG,5821720,5821720,5821370,350,1760,utRho29
853,mcbA,1684306,1684306,1684112,194,22,utRho29
854,mcbR,3040192,3040524,3040192,332,0,utRho29
855,mcrA,2420278,2420692,2420278,414,168,utRho29
856,mcrC,9156124,9156124,9155916,208,364,utRho29
857,mdaB,6344814,6345060,6344814,246,22,utRho29
858,mdfA,1767138,1767346,1767138,208,266,utRho29
859,mdh,6768940,6768940,6768536,404,92,utRho29
860,mdoB,9198988,9198988,9198882,106,156,utRho29
861,mdoD,2993290,2993712,2993290,422,0,utRho29
862,mdoG,2218514,2218670,2218514,156,140,utRho29
863,mdtA,4307958,4308032,4307958,74,0,utRho29
864,mdtE,7318168,7318464,7318168,296,1572,utRho29
865,mdtK,3486538,3486914,3486538,376,542,utRho29
866,mdtP,8602472,8602472,8602060,412,830,utRho29
867,melA,8683774,8683822,8683774,48,0,utRho29
868,melR,8683300,8683300,8683256,44,458,utRho29
869,menA,8240812,8240812,8240698,114,12,utRho29
870,menB,4753774,4753774,4753638,136,24,utRho29
871,mepH,3468714,3468870,3468714,156,0,utRho29
872,mepM,3883666,3883666,3883270,396,96,utRho29
873,mepS,4539840,4539958,4539840,118,14,utRho29
874,metA,8428318,8428560,8428318,242,36,utRho29
875,metB,8257272,8257344,8257272,72,468,utRho29
876,metC,6304150,6304472,6304150,322,338,utRho29
877,metE,8025768,8026106,8025768,338,4,utRho29
878,metF,8265092,8265232,8265092,140,54,utRho29
879,metG,4388538,4388600,4388538,62,48,utRho29
880,metH,8447010,8447656,8447010,646,592,utRho29
881,metJ,8257116,8257116,8256790,326,246,utRho29
882,metK,6173154,6173412,6173154,258,302,utRho29
883,metN,445428,445428,445290,138,42,utRho29
884,metR,8025710,8025710,8025632,78,0,utRho29
885,metT,1394326,1394326,1394266,60,10,utRho29
886,metY,19910250,19910250,19909734,516,618,utRho29
887,metZ,11789528,11789548,11789528,20,116,utRho29
888,mfd,2348056,2348056,2347928,128,50,utRho29
889,mglA,4478782,4478782,4478578,204,26,utRho29
890,mglB,4481132,4481132,4480696,436,8048,utRho29
891,mglC,4475918,4475918,4475506,412,92,utRho29
892,mgrB,3817584,3817584,3817532,52,54,utRho29
893,mgrR,3245828,3245828,3245828,0,0,utRho29
894,mgsA,2054082,2054082,2054030,52,78,utRho29
895,mgtL,8934560,8934862,8934560,302,128,utRho29
896,mhpA,737038,737222,737038,184,188,utRho29
897,mhpR,737072,737072,736840,232,112,utRho29
898,mhpT,750772,750918,750772,146,0,utRho29
899,miaA,8797964,8798504,8797964,540,344,utRho29
900,micA,5629604,5629604,5629604,0,0,utRho29
901,micC,2874242,2874238,2874242,4,0,utRho29
902,micF,4626168,4626168,4626168,0,0,utRho29
903,micM,1014408,1014408,1014408,0,0,utRho29
904,minE,2449422,2449422,2449090,332,436,utRho29
905,mioC,7852950,7852950,7852910,40,30,utRho29
906,mipA,3733012,3733012,3732944,68,722,utRho29
907,mlaA,4930270,4930270,4930014,256,188,utRho29
908,mlc,3337206,3337206,3337128,78,94,utRho29
909,mlrA,4429498,4429732,4429498,234,182,utRho29
910,mltA,5894546,5894546,5894356,190,72,utRho29
911,mltD,468050,468050,467910,140,164,utRho29
912,mltF,5391534,5391602,5391534,68,58,utRho29
913,mmuP,550238,550650,550238,412,450,utRho29
914,mngA,1531622,1531968,1531622,346,60,utRho29
915,mngR,1531852,1531852,1531750,102,58,utRho29
916,mnmG,7851348,7851348,7851266,82,368,utRho29
917,mntH,5025470,5025470,5025412,58,0,utRho29
918,mntP,3810918,3811376,3810918,458,196,utRho29
919,mntR,1706160,1706366,1706160,206,0,utRho29
920,mntS,1706128,1706128,1705994,134,0,utRho29
921,moaA,1633654,1634088,1633654,434,142,utRho29
922,moaB,1635954,1636110,1635954,156,6,utRho29
923,mobA,8084242,8084242,8083998,244,102,utRho29
924,mocA,6030112,6030320,6030112,208,50,utRho29
925,modA,1589990,1590178,1589990,188,88,utRho29
926,moeA,1732788,1732788,1732728,60,38,utRho29
927,mokB,2984610,2984610,2984258,352,48,utRho29
928,molR_1,4392888,4392948,4392888,60,10,utRho29
929,motA,3954604,3954604,3954278,326,96,utRho29
930,mpaA,2781278,2781278,2781196,82,132,utRho29
931,mpl,8911456,8911570,8911456,114,110,utRho29
932,mppA,2786108,2786454,2786108,346,8,utRho29
933,mprA,5621494,5621540,5621494,46,36,utRho29
934,mqo,4613848,4613848,4613508,340,0,utRho29
935,mqsA,6336742,6336742,6336492,250,736,utRho29
936,mqsR,6337306,6337306,6337088,218,798,utRho29
937,mraZ,179192,179268,179192,76,752,utRho29
938,mrcA,7045652,7045742,7045652,90,40,utRho29
939,mrcB,329442,329460,329442,18,0,utRho29
940,mreB,13605424,13605424,13604348,1076,884,utRho29
941,mreD,6798166,6798166,6797750,416,292,utRho29
942,mrp,4388360,4388360,4388336,24,54,utRho29
943,mscK,972984,973072,972984,88,124,utRho29
944,mscL,6876002,6876048,6876002,46,576,utRho29
945,mscS,6139742,6139742,6139614,128,182,utRho29
946,msrA,8884522,8884522,8884352,170,1860,utRho29
947,msrB,3725168,3725168,3724858,310,72,utRho29
948,msyB,2228426,2228426,2228362,64,26,utRho29
949,mtfA,4087236,4087302,4087236,66,238,utRho29
950,mtgA,6699662,6699662,6699618,44,888,utRho29
951,mtlA,30177504,30178248,30177504,744,9176,utRho29
952,mtn,358366,358366,358306,60,340,utRho29
953,mtr,6611864,6611864,6611634,230,102,utRho29
954,mug,6430992,6430992,6430946,46,1432,utRho29
955,murQ,5091466,5091546,5091466,80,346,utRho29
956,murR,5091586,5091586,5091218,368,844,utRho29
957,mutH,5939164,5939324,5939164,160,348,utRho29
958,mutL,8794092,8794824,8794092,732,350,utRho29
959,mutM,7622554,7622554,7622304,250,272,utRho29
960,mutS,5714038,5714186,5714038,148,658,utRho29
961,mutY,18617466,18618078,18617466,612,0,utRho29
962,nac,4123956,4123956,4123866,90,82,utRho29
963,nadA,1564122,1564170,1564122,48,0,utRho29
964,nadB,5420714,5420840,5420714,126,90,utRho29
965,nadC,237326,237326,237290,36,158,utRho29
966,nadE,3644604,3644916,3644604,312,0,utRho29
967,nadK,5501526,5501662,5501526,136,44,utRho29
968,nagA,1406350,1406350,1405502,848,1468,utRho29
969,nagB,1407416,1407416,1407222,194,164,utRho29
970,nagC,1404016,1404016,1403188,828,128,utRho29
971,nagE,1407680,1407888,1407680,208,862,utRho29
972,nagK,2357080,2357186,2357080,106,70,utRho29
973,nanA,6747240,6747240,6747152,88,366,utRho29
974,nanC,9079856,9079856,9079002,854,514,utRho29
975,nanR,6749406,6749406,6748978,428,696,utRho29
976,nanS,9075406,9075406,9075188,218,2,utRho29
977,napF,4607390,4607390,4606994,396,12,utRho29
978,narG,2559614,2559728,2559614,114,224,utRho29
979,narK,2555642,2555914,2555642,272,276,utRho29
980,narP,4580844,4581000,4580844,156,92,utRho29
981,narQ,5171154,5171462,5171154,308,228,utRho29
982,narU,3088326,3088326,3088120,206,176,utRho29
983,narW,3077374,3077374,3074618,2756,760,utRho29
984,narX,2555554,2555554,2555236,318,280,utRho29
985,narZ,3085380,3085380,3085180,200,0,utRho29
986,ndh,2331984,2332170,2331984,186,674,utRho29
987,ndk,5289920,5289920,5289728,192,206,utRho29
988,nemR,6904084,6904092,6904084,8,152,utRho29
989,nepI,7683542,7683542,7683478,64,72,utRho29
990,nfo,4501612,4501680,4501612,68,0,utRho29
991,nfsB,1210906,1210906,1210848,58,0,utRho29
992,nfuA,7090916,7091248,7090916,332,618,utRho29
993,nhaA,34634,34978,34634,344,424,utRho29
994,nhaB,2469534,2469534,2469434,100,122,utRho29
995,nhoA,3067926,3068048,3067926,122,0,utRho29
996,nikA,7226878,7227334,7226878,456,538,utRho29
997,nikR,7237074,7237176,7237074,102,102,utRho29
998,nirB,6987974,6988022,6987974,48,28,utRho29
999,nlpA,7680034,7680034,7679986,48,0,utRho29
1000,nlpC,3585654,3585654,3585462,192,40,utRho29
1001,nlpD,5737658,5737658,5737506,152,148,utRho29
1002,nlpI,6618080,6618080,6617848,232,62,utRho29
1003,nmpC,1153740,1153740,1153650,90,0,utRho29
1004,nohA,3273206,3273206,3272734,472,316,utRho29
1005,norR,5664614,5664614,5664578,36,338,utRho29
1006,norV,5664878,5664952,5664878,74,406,utRho29
1007,nrdA,4689510,4689730,4689510,220,8408,utRho29
1008,nrdD,8925676,8925676,8925320,356,200,utRho29
1009,nrdH,5601312,5601446,5601312,134,570,utRho29
1010,nrdR,865954,866004,865954,50,0,utRho29
1011,nrfA,8575342,8575528,8575342,186,96,utRho29
1012,nsrR,8812088,8812380,8812088,292,182,utRho29
1013,nudB,3897348,3897348,3897264,84,0,utRho29
1014,nudC,8393428,8393806,8393428,378,70,utRho29
1015,nudE,7052658,7052658,7052298,360,128,utRho29
1016,nudG,3682876,3682980,3682876,104,0,utRho29
1017,nudI,4729050,4729108,4729050,58,0,utRho29
1018,nudJ,2388874,2388874,2388576,298,70,utRho29
1019,nuoA,4810670,4810670,4810144,526,5518,utRho29
1020,nuoN,4783434,4783434,4783010,424,236,utRho29
1021,nupC,5026018,5026084,5026018,66,2,utRho29
1022,nupG,6211302,6211428,6211302,126,22,utRho29
1023,ogrK,4335096,4335096,4335040,56,0,utRho29
1024,ogt,2800568,2800568,2800472,96,216,utRho29
1025,ohsC,5401036,5401040,5401036,4,382,utRho29
1026,ompA,2040382,2040382,2040106,276,5368,utRho29
1027,ompC,4625774,4625774,4625498,276,348,utRho29
1028,ompF,1974184,1974184,1973964,220,2,utRho29
1029,ompL,8128958,8128958,8128590,368,600,utRho29
1030,ompN,2874158,2874158,2873786,372,0,utRho29
1031,ompR,7073510,7073510,7073168,342,166,utRho29
1032,ompT,1171330,1171330,1171266,64,0,utRho29
1033,ompW,2627982,2628040,2627982,58,122,utRho29
1034,ompX,1700418,1700900,1700418,482,828,utRho29
1035,omrA,5952378,5952378,5952378,0,0,utRho29
1036,omrB,5952770,5952770,5952770,0,0,utRho29
1037,oppA,2602170,2602364,2602170,194,278,utRho29
1038,orn,8783168,8783208,8783168,40,168,utRho29
1039,osmB,2686952,2686952,2686656,296,540,utRho29
1040,osmC,3113192,3113250,3113192,58,278,utRho29
1041,osmE,3644566,3644566,3644512,54,0,utRho29
1042,osmF,4439046,4439046,4438962,84,104,utRho29
1043,osmY,9222306,9222792,9222306,486,72,utRho29
1044,otsA,3963302,3963302,3963224,78,0,utRho29
1045,otsB,3964930,3964930,3964774,156,496,utRho29
1046,oxc,4984288,4984288,4983900,388,376,utRho29
1047,oxyR,8316914,8316980,8316914,66,246,utRho29
1048,oxyS,8316788,8316788,8316788,0,0,utRho29
1049,paaA,2907730,2907854,2907730,124,2,utRho29
1050,paaX,2927018,2927078,2927018,60,0,utRho29
1051,paaZ,2907340,2907340,2907284,56,0,utRho29
1052,pabA,6981702,6981702,6981658,44,60,utRho29
1053,pabB,3789256,3789610,3789256,354,242,utRho29
1054,pabC,2306186,2306600,2306186,414,162,utRho29
1055,pagP,1313052,1313114,1313052,62,52,utRho29
1056,panB,299260,299260,299202,58,1050,utRho29
1057,panC,297840,297840,297590,250,50,utRho29
1058,panD,293490,293490,293388,102,106,utRho29
1059,panZ,7195656,7195968,7195656,312,178,utRho29
1060,parC,6332060,6332060,6331946,114,300,utRho29
1061,patA,6438916,6438988,6438916,72,172,utRho29
1062,patD,3030830,3031156,3030830,326,40,utRho29
1063,pbpC,5294986,5294986,5294650,336,0,utRho29
1064,pbpG,4450132,4450132,4449740,392,96,utRho29
1065,pck,7065358,7065636,7065358,278,1374,utRho29
1066,pcnB,318782,318782,318252,530,126,utRho29
1067,pdhR,244068,244184,244068,116,4,utRho29
1068,pdxB,4875768,4875768,4875702,66,0,utRho29
1069,pdxH,3436068,3436068,3436014,54,2,utRho29
1070,pdxJ,5403626,5403626,5403458,168,370,utRho29
1071,pdxK,5074638,5074638,5074474,164,68,utRho29
1072,pepA,8972278,8972278,8971902,376,18,utRho29
1073,pepD,511618,511618,511432,186,626,utRho29
1074,pepN,1981182,1981244,1981182,62,1530,utRho29
1075,pepQ,8062294,8062322,8062294,28,48,utRho29
1076,pepT,2371646,2371688,2371646,42,26,utRho29
1077,pfkA,8214948,8215104,8214948,156,134,utRho29
1078,pfkB,3612646,3612740,3612646,94,0,utRho29
1079,pflA,1902456,1902456,1902160,296,24,utRho29
1080,pflB,1907850,1907850,1907108,742,288,utRho29
1081,pflD,8287716,8287990,8287716,274,0,utRho29
1082,pgaA,2185046,2185046,2184578,468,626,utRho29
1083,pgi,8467444,8467516,8467444,72,60,utRho29
1084,pgk,12291428,12291428,12290488,940,1544,utRho29
1085,pgl,1597078,1597172,1597078,94,68,utRho29
1086,pgpB,2678324,2678660,2678324,336,342,utRho29
1087,pgpC,5397276,5397276,5397100,176,32,utRho29
1088,pgrR,2783744,2783982,2783744,238,328,utRho29
1089,pheL,5475158,5475198,5475158,40,0,utRho29
1090,pheM,7197204,7197204,7197080,124,0,utRho29
1091,pheP,1203858,1203918,1203858,60,32,utRho29
1092,pheU,8725254,8725254,8725252,2,4,utRho29
1093,pheV,6220730,6220732,6220730,2,0,utRho29
1094,phnC,8650412,8650412,8650330,82,72,utRho29
1095,phoA,803414,803494,803414,80,226,utRho29
1096,phoB,834202,834284,834202,82,118,utRho29
1097,phoE,520316,520316,520200,116,142,utRho29
1098,phoH,2169730,2169984,2169730,254,20,utRho29
1099,phoP,2381016,2381016,2380894,122,662,utRho29
1100,phoQ,2379880,2379880,2379552,328,82,utRho29
1101,phoU,7815330,7815330,7815156,174,58,utRho29
1102,phr,1478842,1479014,1478842,172,68,utRho29
1103,pinE,2419054,2419370,2419054,316,70,utRho29
1104,pinQ,3267168,3267244,3267168,76,0,utRho29
1105,pinR,2867424,2867424,2867348,76,2,utRho29
1106,pitA,7275224,7275284,7275224,60,20,utRho29
1107,pitB,6272806,6272806,6272742,64,0,utRho29
1108,pka,5439862,5439906,5439862,44,0,utRho29
1109,plaP,4174476,4174476,4174124,352,316,utRho29
1110,pldA,8009628,8009724,8009628,96,640,utRho29
1111,pldB,8018028,8018340,8018028,312,554,utRho29
1112,plsB,8513196,8513196,8512932,264,274,utRho29
1113,pmbA,8915890,8915918,8915890,28,86,utRho29
1114,pmrD,4747148,4747148,4747076,72,0,utRho29
1115,pncB,1980828,1980828,1980712,116,210,utRho29
1116,pncC,5648788,5648788,5648692,96,8,utRho29
1117,pnp,6622652,6622652,6622336,316,186,utRho29
1118,pntA,3355950,3355950,3355806,144,30,utRho29
1119,pntB,3353096,3353096,3352720,376,638,utRho29
1120,polA,8093880,8093932,8093880,52,76,utRho29
1121,polB,131606,131606,131560,46,0,utRho29
1122,potD,2365700,2365700,2365658,42,0,utRho29
1123,potE,1436688,1436688,1436530,158,26,utRho29
1124,potF,1787268,1787568,1787268,300,68,utRho29
1125,poxB,1822152,1822152,1822098,54,38,utRho29
1126,ppa,8899372,8899372,8899304,68,44,utRho29
1127,ppc,8306380,8306380,8306196,184,1122,utRho29
1128,ppdA,5928440,5928440,5928354,86,126,utRho29
1129,ppdD,235410,235410,235098,312,284,utRho29
1130,pphA,3846770,3846770,3845938,832,794,utRho29
1131,pphB,5719474,5719520,5719474,46,32,utRho29
1132,ppiA,6984898,6984898,6984594,304,132,utRho29
1133,ppiC,7919682,7919682,7919626,56,60,utRho29
1134,ppiD,923638,923830,923638,192,46,utRho29
1135,ppk,5245748,5246088,5245748,340,146,utRho29
1136,pppA,6228958,6228958,6228704,254,124,utRho29
1137,ppsA,3574322,3574322,3574224,98,0,utRho29
1138,ppsR,3574678,3574890,3574678,212,0,utRho29
1139,pptA,3065716,3066104,3065716,388,286,utRho29
1140,pqiA,2023318,2024002,2023318,684,102,utRho29
1141,prc,3830054,3830054,3829632,422,1030,utRho29
1142,preT,4467978,4468066,4467978,88,104,utRho29
1143,prfC,9218688,9218828,9218688,140,0,utRho29
1144,prkB,6968622,6968980,6968622,358,236,utRho29
1145,prlC,7290476,7290476,7290364,112,576,utRho29
1146,prlF,6553944,6554004,6553944,60,334,utRho29
1147,proB,520432,520776,520432,344,224,utRho29
1148,proC,811372,811372,811288,84,26,utRho29
1149,proK,7417388,7417388,7417384,4,0,utRho29
1150,proL,4572414,4572422,4572414,8,22,utRho29
1151,proP,8660640,8661004,8660640,364,366,utRho29
1152,proS,437674,437674,437550,124,0,utRho29
1153,proV,5609126,5609630,5609126,504,392,utRho29
1154,prpB,697292,697364,697292,72,26,utRho29
1155,prpR,696942,696942,696886,56,34,utRho29
1156,prs,2524354,2524354,2523750,604,4588,utRho29
1157,psd,8781276,8781276,8780720,556,588,utRho29
1158,psiE,8480600,8480650,8480600,50,0,utRho29
1159,pspA,2736076,2736158,2736076,82,0,utRho29
1160,pspF,2736080,2736080,2735824,256,0,utRho29
1161,pspG,8525632,8525680,8525632,48,28,utRho29
1162,pssA,5445156,5445454,5445156,298,1062,utRho29
1163,pstB,7817112,7817112,7816732,380,38,utRho29
1164,pstC,7821084,7821084,7820796,288,134,utRho29
1165,pstS,23469408,23469408,23469150,258,12,utRho29
1166,psuG,4517114,4517114,4516734,380,1610,utRho29
1167,psuT,4514992,4514992,4514670,322,130,utRho29
1168,pth,2517084,2517084,2517026,58,18,utRho29
1169,ptrA,5918022,5918022,5917768,254,56,utRho29
1170,ptrB,3857730,3857730,3857678,52,148,utRho29
1171,ptsG,2315252,2315738,2315252,486,308,utRho29
1172,ptsH,5066996,5067528,5066996,532,358,utRho29
1173,purA,8809328,8809374,8809328,46,354,utRho29
1174,purC,5195562,5195562,5195236,326,4,utRho29
1175,purD,8411972,8411972,8411862,110,0,utRho29
1176,purE,1106284,1106284,1106200,84,108,utRho29
1177,purH,8415254,8415254,8415064,190,116,utRho29
1178,purL,5391178,5391178,5391086,92,1244,utRho29
1179,purM,5242306,5242394,5242306,88,80,utRho29
1180,purR,3475378,3475688,3475378,310,42,utRho29
1181,purT,3861438,3861762,3861438,324,28,utRho29
1182,purU,2577512,2577512,2577248,264,158,utRho29
1183,putA,2157850,2157850,2157764,86,58,utRho29
1184,putP,2158336,2158610,2158336,274,134,utRho29
1185,puuA,2721936,2721936,2721816,120,0,utRho29
1186,puuC,2725456,2725486,2725456,30,50,utRho29
1187,puuD,2722104,2722240,2722104,136,0,utRho29
1188,puuP,2718746,2718746,2718374,372,122,utRho29
1189,pykA,3874988,3875298,3874988,310,84,utRho29
1190,pykF,3510934,3511396,3510934,462,42,utRho29
1191,pyrC,2245286,2245286,2245214,72,230,utRho29
1192,pyrD,2009464,2009536,2009464,72,324,utRho29
1193,pyrE,7631970,7631970,7631536,434,80,utRho29
1194,pyrF,2683740,2683842,2683740,102,588,utRho29
1195,pyrG,5819594,5819594,5819332,262,638,utRho29
1196,pyrH,383624,383710,383624,86,306,utRho29
1197,pyrL,8945490,8945490,8945066,424,304,utRho29
1198,qmcA,1031646,1031646,1031546,100,486,utRho29
1199,qor,8528608,8528608,8528462,146,266,utRho29
1200,qseB,6339502,6339656,6339502,154,92,utRho29
1201,queA,849970,850022,849970,52,72,utRho29
1202,queE,5811212,5811212,5810836,376,90,utRho29
1203,queF,5850642,5850696,5850642,54,112,utRho29
1204,queG,8788184,8788184,8788134,50,606,utRho29
1205,racC,2835630,2835630,2835526,104,0,utRho29
1206,racR,2840898,2840898,2840482,416,884,utRho29
1207,raiA,5474208,5474308,5474208,100,72,utRho29
1208,rarD,8008594,8008594,8008356,238,576,utRho29
1209,ravA,7862256,7862256,7862186,70,538,utRho29
1210,rayT,495088,495274,495088,186,244,utRho29
1211,rbn,4763162,4763216,4763162,54,160,utRho29
1212,rbsD,7866644,7866702,7866644,58,0,utRho29
1213,rcnA,4371654,4371834,4371654,180,94,utRho29
1214,rcnB,4373768,4373920,4373768,152,264,utRho29
1215,rcnR,4371806,4371806,4371592,214,168,utRho29
1216,rcsA,4047672,4047936,4047672,264,134,utRho29
1217,rcsB,4631390,4632354,4631390,964,338,utRho29
1218,rcsC,4640162,4640162,4639656,506,60,utRho29
1219,rcsD,4626904,4626976,4626904,72,64,utRho29
1220,rdgB,6193240,6193362,6193240,122,104,utRho29
1221,rdlA,2538646,2538646,2538646,0,0,utRho29
1222,rdlB,2539712,2539716,2539712,4,0,utRho29
1223,rdlC,2540782,2540786,2540782,4,0,utRho29
1224,rdlD,7400272,7400272,7400272,0,0,utRho29
1225,rdoA,8084782,8084830,8084782,48,28,utRho29
1226,recA,11295276,11295276,11295076,200,788,utRho29
1227,recC,5925014,5925014,5924856,158,36,utRho29
1228,recF,7763722,7763722,7762442,1280,1700,utRho29
1229,recN,5503518,5503590,5503518,72,0,utRho29
1230,recQ,8011666,8011728,8011666,62,146,utRho29
1231,relA,5828554,5828554,5827302,1252,268,utRho29
1232,relB,3291806,3291806,3291744,62,0,utRho29
1233,rem,3289950,3289950,3289804,146,138,utRho29
1234,rep,7921294,7921354,7921294,60,124,utRho29
1235,rfaD,7587730,7587974,7587730,244,748,utRho29
1236,rfaE,6393852,6393852,6393506,346,56,utRho29
1237,rfaH,8049930,8049930,8049642,288,796,utRho29
1238,rfbX,4219436,4219436,4219168,268,824,utRho29
1239,rfe,7935600,7935832,7935600,232,744,utRho29
1240,rhaB,8194944,8194944,8194896,48,182,utRho29
1241,rhaD,8188770,8188770,8188544,226,28,utRho29
1242,rhaS,8195422,8195472,8195422,50,0,utRho29
1243,rhaT,8201132,8201132,8201050,82,496,utRho29
1244,rhlE,1661566,1661744,1661566,178,196,utRho29
1245,rhoL,47593944,47594772,47593944,828,2412,utRho29
1246,rhsB,7238006,7238384,7238006,378,24,utRho29
1247,rhsC,1458758,1459166,1458758,408,78,utRho29
1248,rhsD,1046132,1046522,1046132,390,238,utRho29
1249,rhtA,1700608,1700608,1700194,414,1324,utRho29
1250,rhtC,8015478,8015514,8015478,36,22,utRho29
1251,ribA,2678468,2678468,2678320,148,228,utRho29
1252,ribC,3486916,3486916,3486484,432,992,utRho29
1253,ribE,869008,869294,869008,286,2942,utRho29
1254,ribF,42766,42814,42766,48,152,utRho29
1255,ridA,8941892,8941892,8941826,66,10,utRho29
1256,rihA,1369204,1369204,1368824,380,442,utRho29
1257,rihB,4510504,4510504,4510372,132,130,utRho29
1258,rimJ,2251044,2251124,2251044,80,110,utRho29
1259,rimK,1783752,1783934,1783752,182,30,utRho29
1260,rimL,2997486,2997876,2997486,390,108,utRho29
1261,rimO,1756140,1756140,1756070,70,80,utRho29
1262,rimP,6636350,6636350,6636012,338,500,utRho29
1263,rlmA,3814172,3814172,3814120,52,0,utRho29
1264,rlmD,5830086,5830086,5830000,86,0,utRho29
1265,rlmE,6655520,6655520,6655328,192,396,utRho29
1266,rlmF,1684384,1684664,1684384,280,220,utRho29
1267,rlmG,6471784,6471784,6471750,34,52,utRho29
1268,rlmI,2060002,2060002,2059938,64,254,utRho29
1269,rlmJ,7290700,7290770,7290700,70,24,utRho29
1270,rlmL,2015344,2015688,2015344,344,590,utRho29
1271,rlpA,1330444,1330444,1330380,64,106,utRho29
1272,rluA,120900,120900,120692,208,12,utRho29
1273,rluF,8460324,8460708,8460324,384,28,utRho29
1274,rmf,2031006,2031430,2031006,424,626,utRho29
1275,rna,1290068,1290068,1290006,62,0,utRho29
1276,rnb,2698258,2698258,2697824,434,714,utRho29
1277,rnc,10816892,10816892,10816252,640,52580,utRho29
1278,rnd,3776122,3776122,3775982,140,0,utRho29
1279,rne,2289746,2289746,2288734,1012,2540,utRho29
1280,rnhA,472082,472082,472004,78,404,utRho29
1281,rnk,1288360,1288360,1287934,426,44,utRho29
1282,rnlA,5531788,5531836,5531788,48,82,utRho29
1283,rnlB,5533414,5533968,5533414,554,706,utRho29
1284,rnpB,19623552,19623552,19623552,0,0,utRho29
1285,rob,9270706,9270706,9270620,86,116,utRho29
1286,rodZ,5285868,5285868,5285688,180,62,utRho29
1287,rpe,7030306,7030306,7030118,188,52,utRho29
1288,rph,15266320,15266320,15266196,124,480,utRho29
1289,rpiA,6118706,6118706,6118650,56,4,utRho29
1290,rpiB,8626514,8626700,8626514,186,498,utRho29
1291,rpiR,8626274,8626274,8625982,292,22,utRho29
1292,rplJ,8359246,8359992,8359246,746,5258,utRho29
1293,rplK,8356708,8356894,8356708,186,204,utRho29
1294,rplM,6757344,6757344,6757302,42,2276,utRho29
1295,rplN,6896444,6896444,6896298,146,696,utRho29
1296,rplS,5489284,5489284,5489060,224,7328,utRho29
1297,rplT,7199052,7199052,7198996,56,188,utRho29
1298,rplU,6667036,6667036,6666902,134,108,utRho29
1299,rplY,4564866,4565034,4564866,168,108,utRho29
1300,rpmA,6666450,6666450,6666238,212,346,utRho29
1301,rpmB,15247980,15247980,15246696,1284,42464,utRho29
1302,rpmE,8253816,8254026,8253816,210,290,utRho29
1303,rpmF,2294676,2294734,2294676,58,9156,utRho29
1304,rpmH,7768130,7768672,7768130,542,2082,utRho29
1305,rpmI,3600854,3600854,3599998,856,4900,utRho29
1306,rpoB,8362126,8362490,8362126,364,144,utRho29
1307,rpoD,6424946,6426094,6424946,1148,27336,utRho29
1308,rpoE,5420372,5420372,5420024,348,16,utRho29
1309,rpoH,7202006,7202006,7201566,440,1994,utRho29
1310,rpoN,6689324,6689434,6689324,110,166,utRho29
1311,rpoS,5736236,5736236,5735102,1134,1810,utRho29
1312,rpoZ,7644154,7644212,7644154,58,102,utRho29
1313,rppH,5937986,5937986,5937954,32,268,utRho29
1314,rprA,3540744,3540744,3540744,0,0,utRho29
1315,rpsA,1923434,1923990,1923434,556,23026,utRho29
1316,rpsF,8850050,8850236,8850050,186,6268,utRho29
1317,rpsI,6756580,6756580,6756414,166,5100,utRho29
1318,rpsJ,6906884,6906884,6906540,344,1580,utRho29
1319,rpsL,6949242,6949242,6949104,138,934,utRho29
1320,rpsM,6885130,6885130,6884942,188,306,utRho29
1321,rpsO,13247144,13247144,13246736,408,84,utRho29
1322,rpsP,5492508,5492508,5492370,138,0,utRho29
1323,rpsT,42420,42420,42156,264,168,utRho29
1324,rpsU,12842584,12843124,12842584,540,2940,utRho29
1325,rraA,8238716,8238716,8238660,56,216,utRho29
1326,rraB,8956768,8956946,8956768,178,70,utRho29
1327,rrsA,8070478,8071062,8070478,584,1306,utRho29
1328,rrsB,16665468,16666636,16665468,1168,2592,utRho29
1329,rrsC,7883032,7883616,7883032,584,626,utRho29
1330,rrsD,6858094,6858094,6857524,570,378,utRho29
1331,rrsE,8415726,8416294,8415726,568,504,utRho29
1332,rrsG,5462896,5462896,5462314,582,1278,utRho29
1333,rrsH,446970,447542,446970,572,472,utRho29
1334,rsd,8393908,8393908,8393616,292,140,utRho29
1335,rseA,5419264,5419264,5418808,456,598,utRho29
1336,rseP,392940,393092,392940,152,246,utRho29
1337,rseX,4067298,4067298,4067298,0,0,utRho29
1338,rsfS,1338144,1338144,1338072,72,66,utRho29
1339,rsgA,8783132,8783132,8783018,114,72,utRho29
1340,rsmA,105176,105176,104860,316,128,utRho29
1341,rsmB,6869982,6870414,6869982,432,138,utRho29
1342,rsmC,9215736,9215736,9215400,336,84,utRho29
1343,rsmD,7208594,7208786,7208594,192,118,utRho29
1344,rsmE,6182036,6182268,6182036,232,136,utRho29
1345,rsmG,7847512,7847512,7847360,152,96,utRho29
1346,rsmH,180020,180188,180020,168,0,utRho29
1347,rsmI,6587106,6587106,6586670,436,382,utRho29
1348,rssA,2578212,2578412,2578212,200,0,utRho29
1349,rssB,2580440,2580484,2580440,44,106,utRho29
1350,rstA,3364276,3364300,3364276,24,0,utRho29
1351,rsuA,4561096,4561096,4560966,130,40,utRho29
1352,rsxA,3411510,3411534,3411510,24,228,utRho29
1353,rtcA,7114004,7114004,7113698,306,644,utRho29
1354,rtcB,7116214,7116214,7116158,56,8,utRho29
1355,rtn,4541356,4541452,4541356,96,0,utRho29
1356,rutA,2148052,2148052,2148022,30,66,utRho29
1357,rutG,2140090,2140090,2139678,412,68,utRho29
1358,rutR,2148226,2148484,2148226,258,282,utRho29
1359,ruvA,7784096,7784096,7783904,192,0,utRho29
1360,ruvB,7782176,7782176,7781424,752,320,utRho29
1361,ruvC,3894878,3894878,3894752,126,42,utRho29
1362,rybB,1776114,1776114,1776114,0,0,utRho29
1363,rydB,3529860,3529860,3529322,538,394,utRho29
1364,rydC,2983012,2983012,2983012,0,0,utRho29
1365,ryfA,5307398,5307710,5307398,312,0,utRho29
1366,ryfD,5468590,5468590,5468590,0,0,utRho29
1367,ryhB,7162032,7162032,7162032,0,0,utRho29
1368,ryjA,8556132,8556132,8556132,0,0,utRho29
1369,ryjB,9055954,9055954,9055954,0,0,utRho29
1370,sad,3229598,3229598,3229406,192,64,utRho29
1371,safA,3168056,3168056,3167918,138,98,utRho29
1372,sanA,4465368,4465756,4465368,388,0,utRho29
1373,sapF,2705314,2705314,2705268,46,0,utRho29
1374,sbcB,4165456,4165512,4165456,56,20,utRho29
1375,sbcC,831694,831694,831506,188,0,utRho29
1376,sbcD,833954,833954,833904,50,156,utRho29
1377,sbmA,793106,793278,793106,172,950,utRho29
1378,sbmC,4162650,4162650,4162524,126,0,utRho29
1379,sdaA,3793618,3793864,3793618,246,450,utRho29
1380,sdaC,5856070,5856458,5856070,388,16308,utRho29
1381,sdhC,1509916,1510354,1509916,438,8770,utRho29
1382,sdhD,1510808,1511120,1510808,312,196,utRho29
1383,sdiA,3993834,3993834,3993664,170,142,utRho29
1384,secE,8354354,8354716,8354354,362,746,utRho29
1385,secG,6645180,6645180,6645010,170,288,utRho29
1386,selA,7522594,7522594,7522498,96,30,utRho29
1387,selB,7519850,7519850,7519722,128,64,utRho29
1388,selC,7672396,7672444,7672396,48,46,utRho29
1389,selD,3696058,3696058,3696016,42,1078,utRho29
1390,seqA,1425884,1425974,1425884,90,16,utRho29
1391,serA,6117098,6117098,6116820,278,0,utRho29
1392,serB,9249712,9249790,9249712,78,72,utRho29
1393,serC,3830380,3830612,3830380,232,144,utRho29
1394,serS,1878730,1878856,1878730,126,422,utRho29
1395,serT,2063438,2063438,2063424,14,0,utRho29
1396,serU,4087124,4087124,4087114,10,52,utRho29
1397,serV,5637394,5637394,5637290,104,36,utRho29
1398,serW,1852014,1852014,1851942,72,100,utRho29
1399,serX,2195352,2195352,2195304,48,0,utRho29
1400,setB,4527426,4527726,4527426,300,32,utRho29
1401,setC,7673488,7673906,7673488,418,598,utRho29
1402,sfmA,1116124,1116424,1116124,300,170,utRho29
1403,sfmC,1117606,1117948,1117606,342,22,utRho29
1404,sfsA,323030,323030,322972,58,68,utRho29
1405,sfsB,6669592,6669818,6669592,226,58,utRho29
1406,sgrR,154676,154676,154598,78,128,utRho29
1407,sgrS,154734,154734,154734,0,0,utRho29
1408,shiA,4107068,4107286,4107068,218,0,utRho29
1409,sibA,4306622,4306622,4306622,0,0,utRho29
1410,sibB,4307292,4307292,4307292,0,0,utRho29
1411,sibC,6113702,6113702,6113702,0,0,utRho29
1412,sibD,6389730,6389730,6389730,0,0,utRho29
1413,sibE,6390480,6390480,6390480,0,0,utRho29
1414,sixA,4913998,4913998,4913624,374,4,utRho29
1415,slp,7307872,7307922,7307872,50,156,utRho29
1416,slt,9261400,9261466,9261400,66,0,utRho29
1417,slyA,3442028,3442028,3441648,380,26,utRho29
1418,slyB,3439496,3439752,3439496,256,108,utRho29
1419,slyD,6957398,6957398,6956994,404,226,utRho29
1420,slyX,6954862,6955280,6954862,418,5642,utRho29
1421,smf,6867372,6867372,6867120,252,150,utRho29
1422,smpB,5509534,5509792,5509534,258,1204,utRho29
1423,smrA,2811872,2811958,2811872,86,432,utRho29
1424,smrB,4896872,4897212,4896872,340,260,utRho29
1425,smtA,1946808,1947074,1946808,266,54,utRho29
1426,sodA,8201518,8201620,8201518,102,1188,utRho29
1427,sodB,3470646,3470756,3470646,110,0,utRho29
1428,sodC,3449358,3449358,3449310,48,0,utRho29
1429,sohB,2658568,2658664,2658568,96,164,utRho29
1430,sokB,2984232,2984238,2984232,6,86,utRho29
1431,solA,2241218,2241218,2241172,46,180,utRho29
1432,soxR,8554894,8554938,8554894,44,2,utRho29
1433,soxS,8554846,8554846,8554766,80,56,utRho29
1434,speA,6172096,6172096,6171822,274,644,utRho29
1435,speB,6167892,6167892,6167594,298,158,utRho29
1436,speC,6218350,6218350,6218310,40,12,utRho29
1437,spf,8099798,8099798,8099798,0,0,utRho29
1438,sppA,3697422,3697674,3697422,252,476,utRho29
1439,spy,3651376,3651376,3651250,126,12,utRho29
1440,sra,3112092,3112092,3111926,166,0,utRho29
1441,sraB,2293178,2293178,2293178,0,0,utRho29
1442,sraC,3846132,3846132,3846132,0,0,utRho29
1443,srlA,5651582,5651664,5651582,82,526,utRho29
1444,srlR,5657720,5658094,5657720,374,2332,utRho29
1445,srmB,5425752,5425792,5425752,40,192,utRho29
1446,sroA,151216,151216,151216,0,0,utRho29
1447,sroG,6369436,6369436,6369436,0,0,utRho29
1448,sroH,8380974,8380974,8380974,0,0,utRho29
1449,ssb,8548022,8548250,8548022,228,282,utRho29
1450,sseA,5304782,5304988,5304782,206,2012,utRho29
1451,sspA,6755138,6755138,6754840,298,26,utRho29
1452,ssrA,5511014,5511186,5511014,172,836,utRho29
1453,ssrS,12223036,12223932,12223036,896,1708,utRho29
1454,sstT,6479726,6479888,6479726,162,62,utRho29
1455,ssuB,1988282,1988282,1988088,194,620,utRho29
1456,ssuE,1995126,1995126,1995024,102,194,utRho29
1457,sthA,8321604,8321604,8321580,24,76,utRho29
1458,stpA,5597156,5597156,5596990,166,52,utRho29
1459,sucA,3034344,3034824,3034344,480,76,utRho29
1460,sufA,3528836,3528836,3528772,64,2,utRho29
1461,sufE,3518962,3518962,3518580,382,110,utRho29
1462,sugE,8753588,8753750,8753588,162,86,utRho29
1463,sulA,2041894,2041894,2041838,56,6060,utRho29
1464,syd,5850738,5850738,5850560,178,194,utRho29
1465,symE,9159834,9159834,9159680,154,26,utRho29
1466,symR,9159670,9159670,9159670,0,0,utRho29
1467,tabA,8949566,8949724,8949566,158,0,utRho29
1468,talA,5157140,5157332,5157140,192,66,utRho29
1469,talB,16382,16476,16382,94,3682,utRho29
1470,tam,3214442,3214692,3214442,250,1422,utRho29
1471,tamA,8884540,8884764,8884540,224,1832,utRho29
1472,tar,3945432,3945432,3945382,50,10,utRho29
1473,tas,5943138,5943194,5943138,56,42,utRho29
1474,tatA,16087636,16087780,16087636,144,228,utRho29
1475,tatE,1317742,1317894,1317742,152,118,utRho29
1476,tauA,770410,770464,770410,54,84,utRho29
1477,tdcA,6534186,6534186,6534130,56,26,utRho29
1478,tdcG,6519652,6519652,6519298,354,198,utRho29
1479,tdcR,6534380,6534760,6534380,380,180,utRho29
1480,tdk,2586986,2587054,2586986,68,148,utRho29
1481,tehA,3001072,3001146,3001072,74,38,utRho29
1482,tesA,1039898,1039898,1039530,368,566,utRho29
1483,tesB,950402,950402,950322,80,0,utRho29
1484,tfaE,2418532,2418532,2418238,294,176,utRho29
1485,tfaQ,3269912,3269912,3269770,142,138,utRho29
1486,tff,379424,379256,379424,168,292,utRho29
1487,tgt,852110,852274,852110,164,38,utRho29
1488,thiD,4369346,4369346,4369032,314,94,utRho29
1489,thiI,882936,883098,882936,162,42,utRho29
1490,thiM,4370902,4370902,4370602,300,574,utRho29
1491,thiQ,146170,146170,145854,316,5266,utRho29
1492,thrL,592,760,592,168,384,utRho29
1493,thrS,7210932,7210932,7210280,652,1024,utRho29
1494,thrU,8350762,8350776,8350762,14,380,utRho29
1495,thrV,6847414,6847414,6847310,104,139626,utRho29
1496,thrW,525682,525742,525682,60,80,utRho29
1497,thyA,5930696,5930696,5930310,386,702,utRho29
1498,tig,909986,910266,909986,280,400,utRho29
1499,tisB,7706674,7707106,7706674,432,608,utRho29
1500,tktA,6163414,6163414,6163270,144,70,utRho29
1501,tktB,5158616,5159272,5158616,656,1034,utRho29
1502,tldD,6784368,6784368,6784056,312,24,utRho29
1503,tmcA,5191876,5191876,5191718,158,214,utRho29
1504,tnaC,15553644,15553740,15553644,96,84,utRho29
1505,tolB,1555074,1555480,1555074,406,530,utRho29
1506,tolC,6356008,6356230,6356008,222,78,utRho29
1507,tomB,961588,961588,961416,172,182,utRho29
1508,tonB,2622108,2622178,2622108,70,168,utRho29
1509,topA,2661578,2662096,2661578,518,356,utRho29
1510,torC,2116112,2116168,2116112,56,202,utRho29
1511,torR,2115968,2115968,2115908,60,232,utRho29
1512,torS,2112364,2112364,2112356,8,0,utRho29
1513,torT,2112414,2112522,2112414,108,0,utRho29
1514,tpiA,8223138,8223138,8223014,124,2,utRho29
1515,tppB,3425342,3425538,3425342,196,276,utRho29
1516,tpr,2574376,2574376,2574376,0,0,utRho29
1517,tpx,2777688,2777688,2777622,66,710,utRho29
1518,tqsA,3347780,3347826,3347780,46,28,utRho29
1519,treA,2494850,2494850,2494752,98,84,utRho29
1520,treB,8932420,8932420,8932360,60,154,utRho29
1521,treF,7339102,7339184,7339102,82,108,utRho29
1522,treR,8934694,8934694,8934492,202,40,utRho29
1523,trg,2984878,2984940,2984878,62,0,utRho29
1524,trkG,2847342,2847564,2847342,222,666,utRho29
1525,trmA,8326590,8326590,8326540,50,56,utRho29
1526,trpA,2634678,2634678,2634444,234,194,utRho29
1527,trpC,2639888,2639888,2639570,318,44,utRho29
1528,trpL,5292432,5292432,5292328,104,0,utRho29
1529,trpR,9265408,9265520,9265408,112,220,utRho29
1530,trpS,7027394,7027394,7027276,118,64,utRho29
1531,trpT,7893560,7893914,7893560,354,56408,utRho29
1532,trxA,7931294,7931522,7931294,228,1168,utRho29
1533,trxB,1864156,1864156,1864100,56,72,utRho29
1534,trxC,5437350,5437470,5437350,120,502,utRho29
1535,tsaD,6421256,6421256,6421086,170,1324,utRho29
1536,tsgA,6985038,6985136,6985038,98,80,utRho29
1537,tsr,9182824,9183314,9182824,490,944,utRho29
1538,tsx,864490,864490,864026,464,426,utRho29
1539,ttcA,2823970,2823970,2823896,74,1048,utRho29
1540,ttdA,6412848,6412926,6412848,78,18,utRho29
1541,ttdR,6412760,6412760,6412512,248,420,utRho29
1542,tufA,6943448,6943448,6942658,790,24042,utRho29
1543,tus,3368346,3368518,3368346,172,40,utRho29
1544,tusA,7218040,7218040,7217992,48,98,utRho29
1545,tusB,6950218,6950218,6949930,288,230,utRho29
1546,tynA,2902996,2902996,2902698,298,104,utRho29
1547,typA,8116460,8116814,8116460,354,380,utRho29
1548,tyrB,8534164,8534228,8534164,64,114,utRho29
1549,tyrP,3979004,3979362,3979004,358,54,utRho29
1550,tyrR,2773384,2773440,2773384,56,70,utRho29
1551,tyrS,3434566,3434566,3434444,122,0,utRho29
1552,tyrT,2575330,2575330,2575244,86,2,utRho29
1553,uacT,6062378,6062734,6062378,356,578,utRho29
1554,ubiC,8504886,8505012,8504886,126,196,utRho29
1555,ubiD,8049618,8049976,8049618,358,850,utRho29
1556,ubiE,8037494,8037710,8037494,216,206,utRho29
1557,ubiG,4679078,4679134,4679078,56,72,utRho29
1558,ucpA,5089342,5089342,5089246,96,302,utRho29
1559,udp,8032782,8032862,8032782,80,252,utRho29
1560,ugd,4199470,4199470,4199226,244,102,utRho29
1561,ugpB,7184852,7184852,7184650,202,1440,utRho29
1562,ugpQ,7176600,7176600,7176226,374,234,utRho29
1563,uhpT,7694396,7694396,7694334,62,176,utRho29
1564,uidA,3392304,3392304,3392142,162,0,utRho29
1565,uidC,3386012,3386012,3385702,310,0,utRho29
1566,uidR,3394150,3394150,3394104,46,0,utRho29
1567,ulaA,8839854,8839960,8839854,106,98,utRho29
1568,ulaG,8839350,8839350,8839250,100,80,utRho29
1569,ulaR,8837124,8837124,8836906,218,6,utRho29
1570,umpG,5741372,5741372,5740548,824,124,utRho29
1571,umpH,1400704,1400704,1400652,52,44,utRho29
1572,umuD,2461476,2461534,2461476,58,0,utRho29
1573,ung,5433476,5433508,5433476,32,160,utRho29
1574,uof,2843316,2843316,2842900,416,552,utRho29
1575,upp,5241818,5241818,5241744,74,284,utRho29
1576,usg,4873780,4873780,4873298,482,298,utRho29
1577,ushA,1009772,1009828,1009772,56,272,utRho29
1578,uspA,7279966,7280222,7279966,256,518,utRho29
1579,uspB,7279696,7279696,7279440,256,202,utRho29
1580,uspC,3959172,3959506,3959172,334,168,utRho29
1581,uspE,2797318,2797318,2797244,74,0,utRho29
1582,uspF,2871282,2871282,2871238,44,128,utRho29
1583,uspG,1283806,1283806,1283734,72,230,utRho29
1584,uvrA,8547872,8547872,8547742,130,276,utRho29
1585,uvrB,1626304,1627052,1626304,748,270,utRho29
1586,uvrC,3989758,3989758,3989412,346,0,utRho29
1587,uvrD,7995814,7995966,7995814,152,0,utRho29
1588,uvrY,3990812,3990812,3990718,94,34,utRho29
1589,uxaB,3221474,3221474,3221360,114,244,utRho29
1590,uxaC,6489714,6489714,6489482,232,0,utRho29
1591,uxuA,9103036,9103272,9103036,236,718,utRho29
1592,uxuR,9108916,9109152,9108916,236,28,utRho29
1593,valS,8967854,8967854,8967674,180,138,utRho29
1594,valU,5041848,5041862,5041848,14,2,utRho29
1595,valV,3492830,3492870,3492830,40,8,utRho29
1596,ves,3649968,3649968,3649874,94,0,utRho29
1597,waaA,7616512,7617080,7616512,568,972,utRho29
1598,waaH,7580298,7580298,7580162,136,58,utRho29
1599,waaQ,7616476,7616476,7616196,280,714,utRho29
1600,waaU,7598996,7598996,7598624,372,212,utRho29
1601,waaY,7602272,7602272,7601930,342,7642,utRho29
1602,wbbH,4214888,4214888,4214452,436,2404,utRho29
1603,wbbK,4209212,4209212,4209018,194,294,utRho29
1604,wcaM,4231868,4231868,4231792,76,38,utRho29
1605,wrbA,2135516,2135516,2135416,100,78,utRho29
1606,wza,4275166,4275166,4274486,680,152,utRho29
1607,wzxC,4240674,4240674,4240316,358,52,utRho29
1608,wzzB,4196950,4196950,4196602,348,40,utRho29
1609,xanP,7657642,7657890,7657642,248,236,utRho29
1610,xanQ,6048520,6048702,6048520,182,12,utRho29
1611,xapA,5049820,5049820,5049756,64,0,utRho29
1612,xapR,10090252,10090252,10089908,344,232,utRho29
1613,xdhA,6000514,6000690,6000514,176,348,utRho29
1614,xerD,6079702,6079702,6079486,216,84,utRho29
1615,xseA,5268394,5268464,5268394,70,198,utRho29
1616,xseB,882746,882746,882686,60,58,utRho29
1617,xthA,3664798,3664856,3664798,58,0,utRho29
1618,xylA,7461614,7461614,7461530,84,1634,utRho29
1619,xylE,8484540,8484540,8484508,32,0,utRho29
1620,xylF,7462138,7462262,7462138,124,1130,utRho29
1621,xylR,7469812,7469958,7469812,146,0,utRho29
1622,yaaA,13230,13230,12918,312,224,utRho29
1623,yaaI,23876,23876,23572,304,98,utRho29
1624,yaaJ,16034,16034,15918,116,72,utRho29
1625,yaaU,91184,91614,91184,430,746,utRho29
1626,yaaW,23084,23084,22712,372,328,utRho29
1627,yaaX,10060,10468,10060,408,0,utRho29
1628,yabI,142542,142702,142542,160,134,utRho29
1629,yacC,273880,273880,273834,46,48,utRho29
1630,yacH,262932,262932,262520,412,34,utRho29
1631,yacL,268678,268776,268678,98,178,utRho29
1632,yadD,293796,293936,293796,140,62,utRho29
1633,yadE,289930,290162,289930,232,340,utRho29
1634,yadN,314110,314110,313766,344,48,utRho29
1635,yadS,355572,355572,355248,324,560,utRho29
1636,yadV,312470,312470,312402,68,532,utRho29
1637,yaeF,434270,434270,434006,264,78,utRho29
1638,yaeP,428374,428374,428250,124,120,utRho29
1639,yaeQ,428176,428582,428176,406,156,utRho29
1640,yaeR,423716,423754,423716,38,14,utRho29
1641,yafC,462166,462166,461762,404,334,utRho29
1642,yafD,462128,462244,462128,116,348,utRho29
1643,yafK,491986,491986,491610,376,162,utRho29
1644,yafL,493282,493424,493282,142,94,utRho29
1645,yafN,503938,504010,503938,72,44,utRho29
1646,yafS,469568,469632,469568,64,202,utRho29
1647,yafT,474470,474670,474470,200,140,utRho29
1648,yafV,480432,480432,480378,54,0,utRho29
1649,yafZ,536052,536052,536010,42,10,utRho29
1650,yagE,564446,564556,564446,110,0,utRho29
1651,yagG,570414,570790,570414,376,0,utRho29
1652,yagI,578384,578384,578324,60,0,utRho29
1653,yagK,586236,586236,585896,340,788,utRho29
1654,yagL,588062,588062,587836,226,154,utRho29
1655,yagN,591342,591342,591158,184,48,utRho29
1656,yahA,663746,664742,663746,996,3346,utRho29
1657,yahC,670136,670136,670044,92,414,utRho29
1658,yahE,671478,671850,671478,372,606,utRho29
1659,yahM,690504,690808,690504,304,482,utRho29
1660,yahN,692872,692872,692674,198,464,utRho29
1661,yahO,692864,692968,692864,104,532,utRho29
1662,yaiE,816296,816354,816296,58,72,utRho29
1663,yaiI,811396,811528,811396,132,26,utRho29
1664,yaiO,761946,761946,761684,262,140,utRho29
1665,yaiP,767970,767970,767870,100,52,utRho29
1666,yaiS,769660,769660,769232,428,224,utRho29
1667,yaiV,788922,788922,788922,0,0,utRho29
1668,yaiY,799094,799094,798666,428,298,utRho29
1669,yaiZ,798888,799186,798888,298,110,utRho29
1670,yajC,854410,854574,854410,164,88,utRho29
1671,yajD,860938,861210,860938,272,80,utRho29
1672,yajI,866068,866068,865702,366,108,utRho29
1673,yajL,887496,887496,887282,214,152,utRho29
1674,yajQ,889316,889366,889316,50,64,utRho29
1675,yajR,893374,893374,893332,42,46,utRho29
1676,ybaB,987418,988152,987418,734,282,utRho29
1677,ybaL,1006590,1006590,1006476,114,20,utRho29
1678,ybaM,980648,980648,980542,106,476,utRho29
1679,ybaN,981436,981764,981436,328,636,utRho29
1680,ybaO,936704,936766,936704,62,0,utRho29
1681,ybaP,1016568,1016568,1016160,408,326,utRho29
1682,ybaQ,1016348,1016436,1016348,88,54,utRho29
1683,ybaS,1023146,1023282,1023146,136,708,utRho29
1684,ybaV,927504,927874,927504,370,10,utRho29
1685,ybaY,950490,950758,950490,268,198,utRho29
1686,ybbB,1062724,1062724,1062452,272,246,utRho29
1687,ybbJ,1030154,1030154,1029718,436,344,utRho29
1688,ybbL,1031784,1031838,1031784,54,16,utRho29
1689,ybbN,1037136,1037136,1036558,578,396,utRho29
1690,ybbO,1038658,1038658,1038298,360,240,utRho29
1691,ybbY,1080718,1081130,1080718,412,204,utRho29
1692,ybcH,1176140,1176140,1175962,178,48,utRho29
1693,ybcI,1113264,1113264,1113106,158,292,utRho29
1694,ybcJ,1114050,1114050,1113746,304,20,utRho29
1695,ybcK,1137502,1137804,1137502,302,188,utRho29
1696,ybcL,1141690,1141786,1141690,96,12,utRho29
1697,ybcN,1144628,1144932,1144628,304,236,utRho29
1698,ybcQ,1147548,1147912,1147548,364,176,utRho29
1699,ybcW,1159610,1159760,1159610,150,36,utRho29
1700,ybdD,1263982,1264364,1263982,382,338,utRho29
1701,ybdF,1212106,1212106,1211772,334,0,utRho29
1702,ybdH,1267048,1267048,1266954,94,0,utRho29
1703,ybdJ,1212822,1212822,1212398,424,0,utRho29
1704,ybdK,1215122,1215122,1214766,356,276,utRho29
1705,ybdL,1267114,1267172,1267114,58,0,utRho29
1706,ybdM,1271110,1271110,1270752,358,222,utRho29
1707,ybdN,1273372,1273372,1273138,234,84,utRho29
1708,ybdR,1283844,1284176,1283844,332,360,utRho29
1709,ybeD,1325412,1325412,1325284,128,480,utRho29
1710,ybeF,1323090,1323090,1322756,334,820,utRho29
1711,ybeL,1349986,1350036,1349986,50,56,utRho29
1712,ybeQ,1353412,1353412,1353094,318,38,utRho29
1713,ybeR,1353120,1353422,1353120,302,38,utRho29
1714,ybeT,1358832,1358832,1358812,20,0,utRho29
1715,ybeU,1358924,1359016,1358924,92,52,utRho29
1716,ybeZ,1386938,1386938,1386834,104,74,utRho29
1717,ybfA,1458074,1458268,1458074,194,460,utRho29
1718,ybfE,1423878,1423878,1423796,82,156,utRho29
1719,ybfF,1425692,1425692,1425604,88,120,utRho29
1720,ybfH,1433282,1433282,1433194,88,118,utRho29
1721,ybgA,1477840,1478002,1477840,162,22,utRho29
1722,ybgC,1549288,1549504,1549288,216,0,utRho29
1723,ybgD,1505916,1505916,1505590,326,2598,utRho29
1724,ybgI,1485238,1485654,1485238,416,0,utRho29
1725,ybgO,1498370,1498370,1497964,406,0,utRho29
1726,ybgS,1570992,1570992,1570634,358,26,utRho29
1727,ybhA,1597184,1597184,1596862,322,154,utRho29
1728,ybhB,1616070,1616070,1615818,252,138,utRho29
1729,ybhC,1614642,1614642,1614562,80,106,utRho29
1730,ybhD,1601418,1601418,1601276,142,138,utRho29
1731,ybhH,1601104,1601518,1601104,414,180,utRho29
1732,ybhK,1633384,1633384,1633294,90,50,utRho29
1733,ybhM,1641556,1641586,1641556,30,0,utRho29
1734,ybhN,1645296,1645296,1644996,300,164,utRho29
1735,ybhQ,1649202,1649260,1649202,58,174,utRho29
1736,ybiA,1665920,1665920,1665900,20,0,utRho29
1737,ybiI,1676968,1676968,1676912,56,132,utRho29
1738,ybiO,1691328,1691328,1690960,368,406,utRho29
1739,ybiP,1705252,1705252,1705194,58,22,utRho29
1740,ybiS,1711572,1711572,1711488,84,122,utRho29
1741,ybiT,1711894,1711926,1711894,32,0,utRho29
1742,ybiU,1718212,1718212,1718122,90,2,utRho29
1743,ybiV,1720176,1720176,1720056,120,0,utRho29
1744,ybiW,1725566,1725566,1725212,354,3052,utRho29
1745,ybiX,1678548,1678548,1678414,134,620,utRho29
1746,ybjC,1781784,1781826,1781784,42,0,utRho29
1747,ybjE,1830154,1830154,1829714,440,834,utRho29
1748,ybjG,1767016,1767016,1766776,240,1002,utRho29
1749,ybjL,1779882,1779882,1779638,244,24,utRho29
1750,ybjM,1779770,1780178,1779770,408,102,utRho29
1751,ybjO,1795704,1795978,1795704,274,0,utRho29
1752,ybjP,1809046,1809046,1808934,112,0,utRho29
1753,ybjQ,1809034,1809186,1809034,152,38,utRho29
1754,ybjS,1813796,1813796,1813506,290,134,utRho29
1755,ybjX,1838206,1838206,1838168,38,0,utRho29
1756,ycaD,1891438,1891742,1891438,304,0,utRho29
1757,ycaI,1928210,1928640,1928210,430,78,utRho29
1758,ycaK,1899094,1899336,1899094,242,266,utRho29
1759,ycaL,1920264,1920528,1920264,264,46,utRho29
1760,ycaM,1894240,1894458,1894240,218,46,utRho29
1761,ycaR,1941284,1941346,1941284,62,110,utRho29
1762,ycbB,1961862,1962094,1961862,232,380,utRho29
1763,ycbJ,1943344,1943504,1943344,160,76,utRho29
1764,ycbK,1966046,1966150,1966046,104,50,utRho29
1765,ycbZ,2036920,2036920,2036598,322,138,utRho29
1766,yccA,2062886,2062886,2062836,50,302,utRho29
1767,yccF,2048730,2048730,2048696,34,24,utRho29
1768,yccS,2047988,2047988,2047766,222,656,utRho29
1769,yccT,2055674,2055674,2055546,128,28,utRho29
1770,yccX,2059960,2060128,2059960,168,352,utRho29
1771,ycdT,2185682,2185752,2185682,70,6,utRho29
1772,ycdU,2191266,2191686,2191266,420,184,utRho29
1773,ycdZ,2200504,2200592,2200504,88,66,utRho29
1774,yceA,2233544,2233614,2233544,70,90,utRho29
1775,yceD,2293298,2293588,2293298,290,938,utRho29
1776,yceF,2293522,2293522,2293190,332,488,utRho29
1777,yceH,2252154,2252314,2252154,160,74,utRho29
1778,yceI,2237282,2237282,2236952,330,0,utRho29
1779,yceJ,2238142,2238142,2238092,50,188,utRho29
1780,yceM,2253208,2253612,2253208,404,338,utRho29
1781,yceO,2239264,2239264,2238894,370,550,utRho29
1782,yceQ,2288760,2289004,2288760,244,2476,utRho29
1783,ycfD,2376540,2376540,2376480,60,126,utRho29
1784,ycfJ,2334814,2335198,2334814,384,2,utRho29
1785,ycfS,2340834,2340834,2340748,86,0,utRho29
1786,ycfT,2350658,2350658,2350330,328,108,utRho29
1787,ycfZ,2362760,2362760,2362534,226,518,utRho29
1788,ycgB,2474570,2474570,2474482,88,48,utRho29
1789,ycgG,2434614,2434656,2434614,42,206,utRho29
1790,ycgJ,2452956,2453200,2452956,244,24,utRho29
1791,ycgL,2455218,2455362,2455218,144,20,utRho29
1792,ycgN,2457366,2457660,2457366,294,132,utRho29
1793,ycgR,2489112,2489112,2489054,58,2,utRho29
1794,ycgV,2512222,2512222,2511904,318,328,utRho29
1795,ycgX,2426568,2426568,2426214,354,2006,utRho29
1796,ycgY,2490166,2490320,2490166,154,624,utRho29
1797,ycgZ,2431504,2431578,2431504,74,64,utRho29
1798,ychE,2596904,2597196,2596904,292,36,utRho29
1799,ychF,2515764,2515764,2515624,140,6,utRho29
1800,ychH,2517476,2517582,2517476,106,446,utRho29
1801,ychJ,2578354,2578354,2578264,90,0,utRho29
1802,ychN,2547310,2547310,2547198,112,68,utRho29
1803,ychO,2547520,2547850,2547520,330,164,utRho29
1804,ychQ,2533798,2533848,2533798,50,0,utRho29
1805,yciA,2624828,2624828,2624492,336,112,utRho29
1806,yciB,2626110,2626110,2625780,330,478,utRho29
1807,yciC,2627396,2627396,2627326,70,0,utRho29
1808,yciE,2630794,2630794,2630448,346,146,utRho29
1809,yciG,5264368,5264368,5264140,228,0,utRho29
1810,yciI,2621784,2621784,2621730,54,152,utRho29
1811,yciN,2661606,2661606,2661336,270,62,utRho29
1812,yciS,2680270,2680486,2680270,216,0,utRho29
1813,yciT,2689088,2689088,2688692,396,142,utRho29
1814,yciU,2614718,2614718,2614300,418,74,utRho29
1815,yciV,2646376,2646440,2646376,64,0,utRho29
1816,yciW,2700472,2700472,2700214,258,160,utRho29
1817,yciZ,2689276,2689276,2689218,58,126,utRho29
1818,ycjD,2703792,2703792,2703520,272,26,utRho29
1819,ycjG,2777748,2777860,2777748,112,58,utRho29
1820,ycjM,2740006,2740432,2740006,426,282,utRho29
1821,ycjW,2767982,2767982,2767922,60,32,utRho29
1822,ycjX,2768138,2768234,2768138,96,58,utRho29
1823,ycjY,5568288,5568288,5567460,828,1056,utRho29
1824,ydaE,2836438,2836438,2836016,422,42,utRho29
1825,ydaN,2816048,2816100,2816048,52,48,utRho29
1826,ydaS,2840340,2840730,2840340,390,744,utRho29
1827,ydbC,2948376,2948442,2948376,66,64,utRho29
1828,ydbD,2950132,2950288,2950132,156,0,utRho29
1829,ydbH,2885800,2886102,2885800,302,1740,utRho29
1830,ydbJ,2881712,2882116,2881712,404,318,utRho29
1831,ydbK,2881692,2881692,2881568,124,52,utRho29
1832,ydcA,2983294,2983354,2983294,60,142,utRho29
1833,ydcF,2974404,2974470,2974404,66,0,utRho29
1834,ydcI,2990268,2990268,2990142,126,60,utRho29
1835,ydcJ,2990266,2990576,2990266,310,0,utRho29
1836,ydcK,3001280,3001280,3000898,382,84,utRho29
1837,ydcL,3004646,3004914,3004646,268,76,utRho29
1838,ydcN,3012308,3012344,3012308,36,76,utRho29
1839,ydcP,3013508,3013562,3013508,54,0,utRho29
1840,ydcR,3019956,3020006,3019956,50,0,utRho29
1841,ydcS,3022906,3023308,3022906,402,184,utRho29
1842,ydcX,3034442,3034778,3034442,336,220,utRho29
1843,ydcY,3035220,3035296,3035220,76,0,utRho29
1844,ydcZ,3036750,3036750,3036662,88,112,utRho29
1845,yddB,3155332,3155332,3155238,94,182,utRho29
1846,yddE,3071738,3071738,3071716,22,26,utRho29
1847,yddG,3094410,3094410,3094338,72,72,utRho29
1848,yddJ,3089732,3089732,3089438,294,928,utRho29
1849,yddW,3137704,3137704,3137646,58,0,utRho29
1850,ydeA,3233910,3234056,3233910,146,3184,utRho29
1851,ydeE,3242528,3242664,3242528,136,528,utRho29
1852,ydeI,3249118,3249118,3248994,124,0,utRho29
1853,ydeJ,3249376,3249546,3249376,170,0,utRho29
1854,ydeN,3165458,3165458,3165048,410,10,utRho29
1855,ydeP,3173328,3173328,3172972,356,132,utRho29
1856,ydeR,3176596,3176596,3176592,4,52,utRho29
1857,ydfA,3296872,3297016,3296872,144,0,utRho29
1858,ydfG,3254982,3255034,3254982,52,20,utRho29
1859,ydfH,3256652,3256704,3256652,52,54,utRho29
1860,ydfK,3265446,3266144,3265446,698,778,utRho29
1861,ydgA,3379588,3379704,3379588,116,4,utRho29
1862,ydgC,3364124,3364124,3364060,64,0,utRho29
1863,ydgD,3343906,3343920,3343906,14,0,utRho29
1864,ydgH,3356754,3356854,3356754,100,80,utRho29
1865,ydgJ,3408798,3408798,3408616,182,104,utRho29
1866,ydgK,3410414,3410500,3410414,86,410,utRho29
1867,ydhB,3479618,3479618,3479596,22,18,utRho29
1868,ydhC,3479698,3479822,3479698,124,66,utRho29
1869,ydhF,3451310,3451310,3451264,46,0,utRho29
1870,ydhI,3441996,3442050,3441996,54,0,utRho29
1871,ydhL,3451864,3451864,3451840,24,148,utRho29
1872,ydhQ,3492404,3492404,3492254,150,0,utRho29
1873,ydhS,3494136,3494262,3494136,126,0,utRho29
1874,ydhT,3499138,3499138,3499118,20,0,utRho29
1875,ydhY,3509284,3509284,3508954,330,4,utRho29
1876,ydhZ,3510418,3510418,3510282,136,0,utRho29
1877,ydiE,3579206,3579226,3579206,20,0,utRho29
1878,ydiH,3530582,3530582,3530406,176,12,utRho29
1879,ydiM,3541852,3542142,3541852,290,6,utRho29
1880,ydiN,3544818,3545024,3544818,206,108,utRho29
1881,ydiP,3558656,3558656,3558602,54,72,utRho29
1882,ydiU,3582508,3582508,3582488,20,4,utRho29
1883,ydiV,3584174,3584174,3584040,134,20,utRho29
1884,ydiY,3612500,3612500,3612166,334,286,utRho29
1885,ydjA,3697400,3697400,3697352,48,190,utRho29
1886,ydjE,3708082,3708082,3707958,124,0,utRho29
1887,ydjF,3709848,3709848,3709708,140,196,utRho29
1888,ydjM,3620340,3620422,3620340,82,0,utRho29
1889,ydjO,3626696,3626696,3626288,408,0,utRho29
1890,ydjX,3666434,3666802,3666434,368,200,utRho29
1891,yeaE,3731448,3731448,3731272,176,22,utRho29
1892,yeaG,3733530,3733816,3733530,286,62,utRho29
1893,yeaI,3740486,3740770,3740486,284,52,utRho29
1894,yeaJ,3743874,3744082,3743874,208,34,utRho29
1895,yeaL,3748646,3748704,3748646,58,312,utRho29
1896,yeaM,3751296,3751296,3751152,144,0,utRho29
1897,yeaN,3750926,3751346,3750926,420,22,utRho29
1898,yeaO,3753554,3753818,3753554,264,0,utRho29
1899,yeaP,3755314,3755430,3755314,116,12,utRho29
1900,yeaQ,3758780,3758780,3758510,270,132,utRho29
1901,yeaR,3759988,3759988,3759896,92,142,utRho29
1902,yeaY,3781122,3781122,3781064,58,0,utRho29
1903,yebB,3892220,3892502,3892220,282,190,utRho29
1904,yebC,3896370,3896370,3896302,68,68,utRho29
1905,yebE,3859464,3859464,3859414,50,180,utRho29
1906,yebG,3861530,3861530,3861494,36,0,utRho29
1907,yebK,3873180,3873304,3873180,124,2,utRho29
1908,yebQ,3820314,3820552,3820314,238,32,utRho29
1909,yebS,3832238,3832516,3832238,278,176,utRho29
1910,yebV,3843430,3843560,3843430,130,0,utRho29
1911,yebW,3843914,3844242,3843914,328,1036,utRho29
1912,yecC,3995646,3995646,3995628,18,0,utRho29
1913,yecD,3901272,3901664,3901272,392,100,utRho29
1914,yecF,3991434,3991636,3991434,202,194,utRho29
1915,yecH,3979304,3979304,3978980,324,108,utRho29
1916,yecJ,3975604,3975604,3975516,88,0,utRho29
1917,yecM,3919968,3919968,3919692,276,682,utRho29
1918,yecR,3976400,3976444,3976400,44,38,utRho29
1919,yecT,3923862,3923944,3923862,82,0,utRho29
1920,yedD,4016522,4016522,4016180,342,4,utRho29
1921,yedE,4016310,4016554,4016310,244,34,utRho29
1922,yedI,4058922,4058922,4058732,190,266,utRho29
1923,yedJ,4066446,4066446,4066158,288,392,utRho29
1924,yedV,4076404,4076404,4076304,100,126,utRho29
1925,yedX,4077680,4077912,4077680,232,94,utRho29
1926,yedY,4078572,4078956,4078572,384,46,utRho29
1927,yeeA,4161322,4161322,4161182,140,84,utRho29
1928,yeeE,4171104,4171104,4171050,54,272,utRho29
1929,yeeJ,4089526,4089822,4089526,296,44,utRho29
1930,yeeN,4113508,4113716,4113508,208,76,utRho29
1931,yeeO,4119444,4119444,4119692,248,280,utRho29
1932,yeeX,4158834,4158834,4158722,112,50,utRho29
1933,yeeZ,4178422,4178422,4178256,166,188,utRho29
1934,yefM,4179466,4179466,4179426,40,6,utRho29
1935,yegD,4295288,4295348,4295288,60,278,utRho29
1936,yegH,4275726,4275804,4275726,78,198,utRho29
1937,yegI,4302154,4302154,4301970,184,0,utRho29
1938,yegJ,4302032,4302370,4302032,338,142,utRho29
1939,yegQ,4331182,4331336,4331182,154,0,utRho29
1940,yegR,4336698,4336698,4336612,86,576,utRho29
1941,yegS,4337086,4337424,4337086,338,282,utRho29
1942,yegT,4357562,4357642,4357562,80,176,utRho29
1943,yegX,4367640,4367640,4367302,338,0,utRho29
1944,yehA,4376944,4376944,4376828,116,154,utRho29
1945,yehE,4385818,4385818,4385592,226,24,utRho29
1946,yehK,4407568,4407944,4407568,376,62,utRho29
1947,yehL,4408804,4409192,4408804,388,0,utRho29
1948,yeiB,4486146,4486146,4485934,212,0,utRho29
1949,yeiE,4499422,4499422,4499236,186,66,utRho29
1950,yeiG,4487776,4487820,4487776,44,30,utRho29
1951,yeiH,4499332,4499434,4499332,102,80,utRho29
1952,yeiI,4503306,4503400,4503306,94,46,utRho29
1953,yeiL,4510580,4510710,4510580,130,82,utRho29
1954,yeiP,4530834,4530900,4530834,66,182,utRho29
1955,yeiQ,4532328,4532490,4532328,162,0,utRho29
1956,yeiR,4535484,4535658,4535484,174,108,utRho29
1957,yeiW,4530840,4530840,4530590,250,530,utRho29
1958,yejA,4544624,4544728,4544624,104,0,utRho29
1959,yejG,4556892,4556892,4556474,418,1016,utRho29
1960,yejH,4561244,4561264,4561244,20,62,utRho29
1961,yejK,4568218,4568218,4567894,324,0,utRho29
1962,yejO,4578352,4578352,4577800,552,174,utRho29
1963,yfaD,4713380,4713808,4713380,428,156,utRho29
1964,yfaE,4696676,4697028,4696676,352,430,utRho29
1965,yfaL,4688568,4688568,4688338,230,20,utRho29
1966,yfaP,4656398,4656398,4656286,112,22,utRho29
1967,yfaU,4717892,4717892,4717690,202,0,utRho29
1968,yfaY,4727310,4727310,4727266,44,818,utRho29
1969,yfaZ,4728744,4728744,4728550,194,418,utRho29
1970,yfbK,4771810,4771810,4771444,366,1058,utRho29
1971,yfbL,4771500,4771720,4771500,220,1006,utRho29
1972,yfbN,4777174,4777174,4776852,322,1038,utRho29
1973,yfbO,4776916,4777162,4776916,246,940,utRho29
1974,yfbP,4777990,4778232,4777990,242,890,utRho29
1975,yfbR,4817662,4817724,4817662,62,0,utRho29
1976,yfcI,4847424,4847424,4847078,346,270,utRho29
1977,yfcJ,4880482,4880482,4880240,242,62,utRho29
1978,yfcL,4888502,4888502,4888338,164,0,utRho29
1979,yfcV,4911642,4911642,4911292,350,112,utRho29
1980,yfcZ,4921958,4921958,4921868,90,92,utRho29
1981,yfdF,4925604,4926024,4925604,420,3136,utRho29
1982,yfdG,4935474,4935710,4935474,236,64,utRho29
1983,yfdP,4946844,4947040,4946844,196,214,utRho29
1984,yfdX,4988866,4988866,4988804,62,150,utRho29
1985,yfdY,4990672,4990672,4990584,88,680,utRho29
1986,yfeA,5035784,5035784,5035664,120,248,utRho29
1987,yfeC,5036668,5036934,5036668,266,46,utRho29
1988,yfeH,5053818,5053892,5053818,74,0,utRho29
1989,yfeK,5074630,5074684,5074630,54,34,utRho29
1990,yfeO,5018906,5019260,5018906,354,2,utRho29
1991,yfeR,5054078,5054078,5053712,366,0,utRho29
1992,yfeX,5101356,5101356,5101090,266,0,utRho29
1993,yfeY,5102486,5102486,5102432,54,146,utRho29
1994,yfeZ,5103842,5103842,5103452,390,404,utRho29
1995,yffO,5123804,5124222,5123804,418,224,utRho29
1996,yffQ,5126778,5127154,5126778,376,474,utRho29
1997,yffS,5128800,5128986,5128800,186,52,utRho29
1998,yfgC,5232052,5232188,5232052,136,0,utRho29
1999,yfgF,5258062,5258062,5257876,186,1056,utRho29
2000,yfgG,5258170,5258580,5258170,410,1414,utRho29
2001,yfgH,5259344,5259584,5259344,240,0,utRho29
2002,yfgM,5278866,5278866,5278566,300,496,utRho29
2003,yfhH,5397414,5397518,5397414,104,234,utRho29
2004,yfhM,5304648,5304648,5304574,74,62,utRho29
2005,yfhR,5328408,5328726,5328408,318,134,utRho29
2006,yfiC,5425610,5425610,5425528,82,276,utRho29
2007,yfiE,5430688,5430688,5430640,48,628,utRho29
2008,yfiL,5482630,5482720,5482630,90,44,utRho29
2009,yfiM,5448066,5448358,5448066,292,1376,utRho29
2010,yfiR,5483354,5483750,5483354,396,376,utRho29
2011,yfjH,5517326,5517326,5517200,126,20,utRho29
2012,yfjI,5517710,5517970,5517710,260,186,utRho29
2013,yfjJ,5521014,5521094,5521014,80,114,utRho29
2014,yfjM,5531970,5531970,5531552,418,1474,utRho29
2015,yfjP,5535080,5535420,5535080,340,3810,utRho29
2016,yfjW,5546570,5546636,5546570,66,0,utRho29
2017,yfjX,5551776,5551838,5551776,62,52,utRho29
2018,ygaC,5601180,5601180,5599988,1192,5152,utRho29
2019,ygaM,5600242,5600292,5600242,50,1844,utRho29
2020,ygaU,5593628,5593628,5593572,56,52,utRho29
2021,ygaZ,5619190,5619234,5619190,44,62,utRho29
2022,ygbA,5713656,5713656,5713612,44,112,utRho29
2023,ygbE,5746784,5746784,5746674,110,72,utRho29
2024,ygbI,5722882,5722882,5722528,354,518,utRho29
2025,ygbK,5724394,5724670,5724394,276,106,utRho29
2026,ygbL,5727074,5727186,5727074,112,116,utRho29
2027,ygbN,5729814,5730202,5729814,388,118,utRho29
2028,ygcG,5811210,5811422,5811210,212,108,utRho29
2029,ygcN,5785144,5785314,5785144,170,146,utRho29
2030,ygcU,5799214,5799214,5798836,378,366,utRho29
2031,ygcW,5800942,5800942,5800546,396,36,utRho29
2032,ygdD,5883442,5883442,5883262,180,442,utRho29
2033,ygdG,5861746,5861930,5861746,184,206,utRho29
2034,ygdI,5886526,5886526,5886290,236,0,utRho29
2035,ygdQ,5940784,5940840,5940784,56,26,utRho29
2036,ygdR,5942494,5942542,5942494,48,38,utRho29
2037,ygeA,5961606,5961606,5961270,336,132,utRho29
2038,ygeH,5983758,5984188,5983758,430,8,utRho29
2039,ygeI,5987162,5987276,5987162,114,364,utRho29
2040,ygeR,6000078,6000078,5999782,296,982,utRho29
2041,ygeV,6011694,6011694,6011572,122,18,utRho29
2042,ygeW,6012234,6012524,6012234,290,1726,utRho29
2043,ygfB,6110946,6110946,6110888,58,12,utRho29
2044,ygfK,6031984,6032120,6031984,136,8,utRho29
2045,ygfS,6058328,6058328,6058024,304,0,utRho29
2046,ygfZ,6082564,6082626,6082564,62,72,utRho29
2047,yggC,6149512,6149512,6149378,134,112,utRho29
2048,yggE,6136370,6136370,6136160,210,344,utRho29
2049,yggI,6179176,6179510,6179176,334,104,utRho29
2050,yggL,6204508,6204508,6204266,242,88,utRho29
2051,yggM,6199514,6199514,6199130,384,36,utRho29
2052,yggN,6203596,6203596,6203246,350,248,utRho29
2053,yggX,18623958,18624558,18623958,600,216,utRho29
2054,yghA,6298966,6299324,6298966,358,128,utRho29
2055,yghB,6307058,6307126,6307058,68,152,utRho29
2056,yghD,6222614,6222614,6222252,362,118,utRho29
2057,yghF,6225798,6225798,6225840,42,0,utRho29
2058,yghJ,6238640,6238640,6238224,416,286,utRho29
2059,yghQ,6265186,6265186,6264816,370,134,utRho29
2060,yghT,6267830,6268262,6267830,432,484,utRho29
2061,yghU,6277400,6277454,6277400,54,128,utRho29
2062,yghW,6293506,6293506,6293474,32,104,utRho29
2063,yghZ,6295562,6295794,6295562,232,0,utRho29
2064,ygiD,6365122,6365122,6364868,254,144,utRho29
2065,ygiH,6409066,6409388,6409066,322,2834,utRho29
2066,ygiL,6370622,6370828,6370622,206,28,utRho29
2067,ygiM,6402084,6402414,6402084,330,278,utRho29
2068,ygiN,6346156,6346284,6346156,128,440,utRho29
2069,ygiQ,6322620,6322620,6322292,328,38,utRho29
2070,ygiS,6335462,6335462,6335436,26,0,utRho29
2071,ygiV,6338582,6338582,6338462,120,16,utRho29
2072,ygiW,6339774,6339774,6339352,422,204,utRho29
2073,ygiZ,6344506,6344506,6344422,84,36,utRho29
2074,ygjH,6442528,6442528,6442494,34,42,utRho29
2075,ygjI,6452140,6452468,6452140,328,0,utRho29
2076,ygjQ,6472730,6473080,6472730,350,344,utRho29
2077,ygjR,6474564,6474586,6474564,22,64,utRho29
2078,ygjV,6483638,6483638,6483488,150,0,utRho29
2079,yhaB,6535632,6535708,6535632,76,116,utRho29
2080,yhaH,6504498,6504608,6504498,110,290,utRho29
2081,yhaI,6505400,6505822,6505400,422,156,utRho29
2082,yhaJ,6508560,6508560,6508428,132,18,utRho29
2083,yhaK,6508538,6508638,6508538,100,76,utRho29
2084,yhbQ,6599878,6599932,6599878,54,206,utRho29
2085,yhbT,6602736,6602736,6602552,184,948,utRho29
2086,yhbU,6602558,6602970,6602558,412,1136,utRho29
2087,yhbX,6643302,6643302,6643226,76,124,utRho29
2088,yhbY,6655518,6655580,6655518,62,166,utRho29
2089,yhcA,6723956,6724224,6723956,268,14,utRho29
2090,yhcB,6760364,6760382,6760364,18,0,utRho29
2091,yhcC,6708470,6708470,6708100,370,238,utRho29
2092,yhcF,6733440,6733852,6733440,412,142,utRho29
2093,yhcH,6739124,6739124,6738956,168,558,utRho29
2094,yhcM,6760312,6760312,6759994,318,208,utRho29
2095,yhcN,6770812,6771076,6770812,264,164,utRho29
2096,yhcO,6772606,6772606,6772258,348,0,utRho29
2097,yhdH,6806560,6806968,6806560,408,272,utRho29
2098,yhdJ,6823234,6823306,6823234,72,2,utRho29
2099,yhdN,6879092,6879092,6879018,74,330,utRho29
2100,yhdT,6814702,6814750,6814702,48,28,utRho29
2101,yhdU,6824994,6825242,6824994,248,152,utRho29
2102,yhdV,6836392,6836780,6836392,388,94,utRho29
2103,yhdW,6837944,6838298,6837944,354,0,utRho29
2104,yheO,6953082,6953082,6952880,202,152,utRho29
2105,yheV,6957970,6957970,6957584,386,148,utRho29
2106,yhfA,6971902,6971902,6971636,266,494,utRho29
2107,yhfG,6983294,6983294,6983240,54,2,utRho29
2108,yhfL,6998622,6998896,6998622,274,492,utRho29
2109,yhfY,7023244,7023244,7022844,400,266,utRho29
2110,yhgA,7086294,7086334,7086294,40,0,utRho29
2111,yhgE,7065176,7065176,7064878,298,754,utRho29
2112,yhgF,7074352,7074770,7074352,418,1436,utRho29
2113,yhhA,7173458,7173886,7173458,428,564,utRho29
2114,yhhI,7248346,7248756,7248346,410,0,utRho29
2115,yhhJ,7253696,7253696,7253606,90,102,utRho29
2116,yhhM,7211588,7211588,7211220,368,2446,utRho29
2117,yhhN,7211150,7211502,7211150,352,1260,utRho29
2118,yhhQ,7218238,7218434,7218238,196,384,utRho29
2119,yhhT,7223682,7223730,7223682,48,0,utRho29
2120,yhhX,7162032,7162032,7161610,422,72,utRho29
2121,yhhY,7162222,7162276,7162222,54,36,utRho29
2122,yhhZ,7163516,7163726,7163516,210,546,utRho29
2123,yhiD,7312220,7312220,7311804,416,3656,utRho29
2124,yhiJ,7265190,7265190,7265180,10,126,utRho29
2125,yhiM,7269270,7269682,7269270,412,2064,utRho29
2126,yhiN,7275000,7275000,7274820,180,296,utRho29
2127,yhjA,7338522,7338522,7338376,146,130,utRho29
2128,yhjB,7344090,7344090,7343788,302,746,utRho29
2129,yhjC,7344272,7344684,7344272,412,468,utRho29
2130,yhjD,7346660,7346724,7346660,64,8,utRho29
2131,yhjE,7349274,7349572,7349274,298,1058,utRho29
2132,yhjG,7356824,7356824,7356730,94,48,utRho29
2133,yhjH,7358458,7358458,7358374,84,294,utRho29
2134,yhjJ,7364032,7364032,7363880,152,196,utRho29
2135,yhjK,7371296,7371296,7371158,138,272,utRho29
2136,yhjR,7392750,7392750,7392370,380,96,utRho29
2137,yhjV,7400796,7401126,7400796,330,706,utRho29
2138,yhjX,7424194,7424194,7424014,180,180,utRho29
2139,yhjY,7425966,7425966,7425868,98,36,utRho29
2140,yiaB,7455654,7455654,7455496,158,364,utRho29
2141,yiaD,7432712,7433094,7432712,382,102,utRho29
2142,yiaF,7438194,7438194,7438088,106,196,utRho29
2143,yiaG,7438862,7438956,7438862,94,426,utRho29
2144,yiaJ,7485236,7485236,7485064,172,30,utRho29
2145,yiaK,7485348,7485466,7485348,118,44,utRho29
2146,yiaT,7503924,7503924,7503736,188,0,utRho29
2147,yiaU,7503792,7503984,7503792,192,0,utRho29
2148,yiaY,7515856,7515856,7515654,202,124,utRho29
2149,yibF,7523950,7523950,7523910,40,68,utRho29
2150,yibG,7536128,7536354,7536128,226,854,utRho29
2151,yibL,7553194,7553330,7553194,136,400,utRho29
2152,yibN,7570112,7570112,7570030,82,294,utRho29
2153,yibT,7552848,7552848,7552760,88,746,utRho29
2154,yicC,7633290,7633352,7633290,62,80,utRho29
2155,yicH,7660862,7660914,7660862,52,0,utRho29
2156,yicJ,7673328,7673328,7671858,1470,8440,utRho29
2157,yicN,7685018,7685018,7684804,214,1204,utRho29
2158,yicO,7687914,7687914,7687578,336,110,utRho29
2159,yicR,15250308,15250308,15250236,72,120,utRho29
2160,yidB,7755230,7755230,7754930,300,1274,utRho29
2161,yidE,7732780,7732780,7732546,234,0,utRho29
2162,yidF,7711580,7711580,7711222,358,62,utRho29
2163,yidQ,7735088,7735456,7735088,368,966,utRho29
2164,yidR,7738824,7738824,7738618,206,8,utRho29
2165,yieE,7787658,7787738,7787658,80,140,utRho29
2166,yieH,7793314,7793548,7793314,234,46,utRho29
2167,yieK,7798928,7798928,7798786,142,104,utRho29
2168,yifB,7900350,7900350,7899998,352,212,utRho29
2169,yifL,7988984,7989044,7988984,60,212,utRho29
2170,yigF,8005750,8005750,8005598,152,1666,utRho29
2171,yigI,8009448,8009448,8009394,54,286,utRho29
2172,yigM,8022100,8022152,8022100,52,592,utRho29
2173,yihA,8101970,8101970,8101458,512,60,utRho29
2174,yihD,8084098,8084138,8084098,40,84,utRho29
2175,yihF,8088110,8088398,8088110,288,304,utRho29
2176,yihG,8093304,8093304,8093204,100,60,utRho29
2177,yihI,8102616,8102694,8102616,78,0,utRho29
2178,yihL,8120506,8120894,8120506,388,996,utRho29
2179,yihN,8124332,8124494,8124332,162,1150,utRho29
2180,yihO,8131942,8131942,8131532,410,104,utRho29
2181,yihQ,8138892,8138892,8138552,340,32,utRho29
2182,yihV,8147064,8147478,8147064,414,80,utRho29
2183,yihX,8151096,8151106,8151096,10,0,utRho29
2184,yiiE,8158192,8158582,8158192,390,608,utRho29
2185,yiiF,8159124,8159502,8159124,378,274,utRho29
2186,yiiG,8173762,8174004,8173762,242,182,utRho29
2187,yiiM,8205506,8205644,8205506,138,816,utRho29
2188,yiiQ,8224624,8224624,8224428,196,0,utRho29
2189,yiiS,8225738,8225934,8225738,196,40,utRho29
2190,yijE,8272178,8272216,8272178,38,32,utRho29
2191,yijF,8275728,8275728,8275314,414,936,utRho29
2192,yijO,8296858,8296858,8296634,224,0,utRho29
2193,yjaA,8426240,8426468,8426240,228,53646,utRho29
2194,yjaB,8428312,8428312,8428246,66,38,utRho29
2195,yjaG,8398746,8399008,8398746,262,0,utRho29
2196,yjaH,8401022,8401132,8401022,110,60,utRho29
2197,yjaZ,8379506,8379572,8379506,66,12,utRho29
2198,yjbB,8455204,8455462,8455204,258,10,utRho29
2199,yjbE,16943432,16943624,16943432,192,160,utRho29
2200,yjbL,8520318,8520642,8520318,324,80,utRho29
2201,yjbQ,8540428,8540476,8540428,48,6,utRho29
2202,yjcB,8550328,8550328,8550082,246,402,utRho29
2203,yjcC,8550836,8550942,8550836,106,136,utRho29
2204,yjcD,8556628,8556958,8556628,330,592,utRho29
2205,yjcE,8559658,8559960,8559658,302,382,utRho29
2206,yjcF,8566212,8566212,8566150,62,0,utRho29
2207,yjcO,8594660,8594660,8594250,410,262,utRho29
2208,yjdA,8654128,8654270,8654128,142,0,utRho29
2209,yjdC,8726660,8726660,8726616,44,114,utRho29
2210,yjdK,8704780,8705168,8704780,388,866,utRho29
2211,yjdL,8713034,8713034,8712822,212,28,utRho29
2212,yjdM,8653672,8653672,8653468,204,1626,utRho29
2213,yjeF,8787354,8788132,8787354,778,2158,utRho29
2214,yjeI,8745522,8745618,8745522,96,78,utRho29
2215,yjeJ,8748806,8748806,8748468,338,600,utRho29
2216,yjeV,8785472,8785784,8785472,312,102,utRho29
2217,yjfP,8833512,8833904,8833512,392,120,utRho29
2218,yjfY,8849656,8849656,8849582,74,0,utRho29
2219,yjfZ,8855052,8855052,8854844,208,236,utRho29
2220,yjgA,8916162,8916162,8915730,432,188,utRho29
2221,yjgL,8950802,8950874,8950802,72,16,utRho29
2222,yjgM,8959342,8959342,8959074,268,26,utRho29
2223,yjgN,8959132,8959460,8959132,328,34,utRho29
2224,yjgR,8980170,8980170,8980126,44,204,utRho29
2225,yjgZ,9002116,9002520,9002116,404,740,utRho29
2226,yjhB,9007764,9008116,9007764,352,826,utRho29
2227,yjhG,9048452,9048452,9048188,264,1454,utRho29
2228,yjhU,9041080,9041080,9040648,432,1290,utRho29
2229,yjiA,9178096,9178096,9177730,366,374,utRho29
2230,yjiJ,9125364,9125364,9125350,14,48,utRho29
2231,yjiK,9127270,9127270,9127422,152,142,utRho29
2232,yjiL,9129604,9129604,9129378,226,28,utRho29
2233,yjiS,9143410,9143502,9143410,92,0,utRho29
2234,yjiY,9182734,9182734,9182558,176,34,utRho29
2235,yjjA,9200674,9200674,9200378,296,64,utRho29
2236,yjjB,18408708,18408708,18407800,908,688,utRho29
2237,yjjJ,9243314,9243538,9243314,224,0,utRho29
2238,yjjK,9261132,9261132,9261044,88,164,utRho29
2239,yjjL,9189764,9189764,9189444,320,270,utRho29
2240,yjjM,9191894,9191894,9191702,192,272,utRho29
2241,yjjP,9206068,9206068,9205716,352,644,utRho29
2242,yjjQ,9206638,9206954,9206638,316,944,utRho29
2243,yjjX,9267798,9267798,9267490,308,486,utRho29
2244,yjjY,9280716,9280804,9280716,88,186,utRho29
2245,yjjZ,9211554,9211608,9211554,54,754,utRho29
2246,yjtD,9281676,9281884,9281676,208,364,utRho29
2247,ykfB,532454,532454,532174,280,174,utRho29
2248,ykfI,527636,527636,527338,298,730,utRho29
2249,ykgB,637050,637050,636638,412,72,utRho29
2250,ykgC,640430,640430,640002,428,182,utRho29
2251,ykgD,640232,640454,640232,222,214,utRho29
2252,ykgE,642962,643216,642962,254,956,utRho29
2253,ykgJ,608524,608524,608364,160,286,utRho29
2254,ykgL,623878,624224,623878,346,302,utRho29
2255,ykgM,625610,625610,625554,56,66,utRho29
2256,ykgR,626570,626570,626484,86,24,utRho29
2257,ylaC,958576,958576,958502,74,178,utRho29
2258,yliE,1745938,1745958,1745938,20,0,utRho29
2259,ymcE,2103660,2103694,2103660,34,0,utRho29
2260,ymdA,2210450,2210828,2210450,378,0,utRho29
2261,ymdB,2211428,2211640,2211428,212,0,utRho29
2262,ymfD,2395322,2395322,2395064,258,158,utRho29
2263,ymfI,2402880,2402994,2402880,114,0,utRho29
2264,ymfJ,2404518,2404518,2404168,350,120,utRho29
2265,ymfK,2406176,2406176,2405866,310,258,utRho29
2266,ymfT,2405766,2406048,2405766,282,258,utRho29
2267,ymgE,2489110,2489456,2489110,346,870,utRho29
2268,ymgF,2437628,2437966,2437628,338,210,utRho29
2269,ymiA,2670112,2670320,2670112,208,232,utRho29
2270,ymjA,2715620,2715620,2715336,284,148,utRho29
2271,ynaI,2791946,2791946,2791844,102,44,utRho29
2272,ynaK,2850438,2850754,2850438,316,160,utRho29
2273,ynbA,2954924,2955242,2954924,318,150,utRho29
2274,yncD,3046552,3046552,3046130,422,260,utRho29
2275,yncE,3046454,3046614,3046454,160,126,utRho29
2276,yncG,3052456,3052494,3052456,38,156,utRho29
2277,yncL,3034492,3034492,3034388,104,170,utRho29
2278,yneE,3218364,3218364,3218044,320,90,utRho29
2279,yneF,3223748,3223748,3223708,40,502,utRho29
2280,yneJ,3229560,3229608,3229560,48,26,utRho29
2281,yneK,3231100,3231526,3231100,426,88,utRho29
2282,yneM,3245176,3245292,3245176,116,50,utRho29
2283,ynfA,3311398,3311398,3311346,52,0,utRho29
2284,ynfB,3311418,3311616,3311418,198,56,utRho29
2285,ynfC,3315094,3315094,3314914,180,10,utRho29
2286,ynfD,3314828,3315130,3314828,302,10,utRho29
2287,ynfE,3316006,3316138,3316006,132,102,utRho29
2288,ynfK,3334670,3334670,3334438,232,0,utRho29
2289,ynfL,3339304,3339304,3339184,120,0,utRho29
2290,ynfM,3339260,3339398,3339260,138,20,utRho29
2291,ynfN,3276598,3276598,3276218,380,82,utRho29
2292,ynfO,3273454,3273512,3273454,58,52,utRho29
2293,ynhG,3517890,3517890,3517450,440,182,utRho29
2294,yniA,3615158,3615592,3615158,434,292,utRho29
2295,yniB,3618526,3618526,3618466,60,142,utRho29
2296,yniC,3618652,3618760,3618652,108,102,utRho29
2297,yniD,3610202,3610330,3610202,128,56,utRho29
2298,ynjE,3678880,3678934,3678880,54,32,utRho29
2299,ynjF,3683222,3683222,3682806,416,210,utRho29
2300,ynjH,3684376,3684376,3684270,106,58,utRho29
2301,ynjI,3690022,3690022,3689742,280,270,utRho29
2302,yoaB,3786642,3786734,3786642,92,126,utRho29
2303,yoaC,3787932,3788146,3787932,214,196,utRho29
2304,yoaE,3803544,3803544,3803170,374,410,utRho29
2305,yoaF,3755444,3755444,3755064,380,12,utRho29
2306,yoaH,3789866,3789866,3789462,404,402,utRho29
2307,yobB,3850418,3850880,3850418,462,12,utRho29
2308,yobF,3815586,3815586,3815182,404,52,utRho29
2309,yobH,3817800,3817850,3817800,50,74,utRho29
2310,yodB,4084352,4084736,4084352,384,676,utRho29
2311,yodC,4057008,4057008,4056740,268,116,utRho29
2312,yohC,4451358,4451358,4451262,96,0,utRho29
2313,yohD,4451526,4451602,4451526,76,0,utRho29
2314,yohJ,4460986,4461248,4460986,262,206,utRho29
2315,yohO,4431172,4431314,4431172,142,68,utRho29
2316,yojI,4617282,4617282,4617230,52,188,utRho29
2317,ypdI,4988988,4989396,4988988,408,264,utRho29
2318,ypfG,5165786,5165786,5165554,232,78,utRho29
2319,ypfM,5182140,5182140,5181732,408,718,utRho29
2320,yphB,5349590,5349590,5349376,214,0,utRho29
2321,ypjA,5565644,5565644,5565452,192,812,utRho29
2322,ypjB,5569636,5569636,5568858,778,248,utRho29
2323,ypjD,5495860,5495774,5495860,86,0,utRho29
2324,yqaE,5594170,5594170,5594056,114,234,utRho29
2325,yqcA,5846100,5846100,5845968,132,64,utRho29
2326,yqcE,5800944,5801184,5800944,240,8,utRho29
2327,yqeC,6030468,6030468,6030114,354,74,utRho29
2328,yqeF,5971618,5971618,5971184,434,796,utRho29
2329,yqeG,5971438,5971694,5971438,256,928,utRho29
2330,yqeH,5975016,5975072,5975016,56,732,utRho29
2331,yqeI,5976688,5977004,5976688,316,336,utRho29
2332,yqeK,5981140,5981140,5980720,420,2824,utRho29
2333,yqfA,6086728,6086728,6086296,432,246,utRho29
2334,yqgA,6219042,6219106,6219042,64,22,utRho29
2335,yqgB,6172500,6172500,6172102,398,438,utRho29
2336,yqgE,6185768,6185874,6185768,106,6,utRho29
2337,yqhA,6299150,6299150,6298942,208,70,utRho29
2338,yqhC,6310768,6310768,6310436,332,110,utRho29
2339,yqhD,6310604,6310710,6310604,106,6,utRho29
2340,yqhH,6316842,6317254,6316842,412,222,utRho29
2341,yqiC,6369662,6369680,6369662,18,32,utRho29
2342,yqiJ,6384108,6384416,6384108,308,916,utRho29
2343,yqjA,6495096,6495546,6495096,450,328,utRho29
2344,yqjF,6500932,6501124,6500932,192,460,utRho29
2345,yqjG,6501948,6502048,6501948,100,0,utRho29
2346,yqjH,6433078,6433078,6432982,96,0,utRho29
2347,yqjI,6433506,6433558,6433506,52,0,utRho29
2348,yraH,6574552,6574852,6574552,300,26,utRho29
2349,yraP,6592144,6592818,6592144,674,196,utRho29
2350,yraQ,6596414,6596414,6596276,138,32,utRho29
2351,yraR,6598024,6598024,6597692,332,464,utRho29
2352,yrbG,13360844,13361100,13360844,256,56,utRho29
2353,yrbL,6696842,6696904,6696842,62,662,utRho29
2354,yrbN,6616172,6616172,6615866,306,446,utRho29
2355,yrdB,6860176,6860176,6860046,130,10,utRho29
2356,yrfF,7052548,7052938,7052548,390,116,utRho29
2357,yrhB,7169440,7169518,7169440,78,52,utRho29
2358,ysaB,7451804,7451804,7451424,380,30,utRho29
2359,ysgA,8032686,8032686,8032338,348,302,utRho29
2360,ytfB,8857638,8857638,8857434,204,190,utRho29
2361,ytfE,8864018,8864018,8863966,52,26,utRho29
2362,ytfF,8866296,8866296,8866130,166,322,utRho29
2363,ytfH,8868164,8868226,8868164,62,206,utRho29
2364,ytfI,8875234,8875414,8875234,180,46,utRho29
2365,ytfJ,8878572,8878572,8878524,48,114,utRho29
2366,ytfK,8879022,8879174,8879022,152,358,utRho29
2367,ytfL,8882642,8882642,8882430,212,60,utRho29
2368,ytfQ,8899634,8899924,8899634,290,14,utRho29
2369,ytjB,9249598,9249598,9249578,20,0,utRho29
2370,yzfA,8896588,8896588,8896490,98,0,utRho29
2371,zapA,6111102,6111224,6111102,122,392,utRho29
2372,zapB,8236772,8237030,8236772,258,344,utRho29
2373,zapC,2011700,2011904,2011700,204,92,utRho29
2374,zinT,4082692,4082750,4082692,58,16,utRho29
2375,zipA,5062814,5062814,5062466,348,34,utRho29
2376,zitB,1569716,1569716,1569646,70,10,utRho29
2377,zntA,7212844,7212902,7212844,58,0,utRho29
2378,zntR,6878336,6878336,6878260,76,0,utRho29
2379,znuA,3885322,3885322,3885166,156,92,utRho29
2380,znuC,3885268,3885324,3885268,56,48,utRho29
2381,zraP,8403424,8403424,8403376,48,0,utRho29
2382,zraS,8403810,8403852,8403810,42,68,utRho29
2383,zupT,6364866,6365100,6364866,234,96,utRho29
2384,zur,8520282,8520282,8520006,276,42,utRho29
2385,zwf,3872752,3872752,3872628,124,0,utRho29
0,C0343,2818676,2818728,2818676,52,0,utRho30
1,aaeB,6776526,6776526,6776376,150,86,utRho30
2,aaeR,6778762,6779040,6778762,278,596,utRho30
3,aaeX,6778860,6778860,6778674,186,684,utRho30
4,aat,1854920,1854920,1854864,56,146,utRho30
5,accA,416822,417242,416822,420,552,utRho30
6,accB,6810280,6810872,6810280,592,1544,utRho30
7,accD,4868030,4868030,4867852,178,294,utRho30
8,aceB,8430804,8430956,8430804,152,878,utRho30
9,aceE,245938,246034,245938,96,102,utRho30
10,ackA,4826918,4826940,4826918,22,218,utRho30
11,acnA,2670848,2671662,2670848,814,268,utRho30
12,acnB,263038,263230,263038,192,600,utRho30
13,acpP,2303148,2303230,2303148,82,194,utRho30
14,acpS,5402324,5402324,5401996,328,1010,utRho30
15,acrA,971396,971396,971238,158,294,utRho30
16,acrB,969370,969370,968806,564,512,utRho30
17,acrD,5174950,5175190,5174950,240,216,utRho30
18,acrE,6827404,6827728,6827404,324,356,utRho30
19,acrR,971398,971522,971398,124,160,utRho30
20,acrZ,1589502,1589546,1589502,44,128,utRho30
21,acs,8575190,8575190,8574742,448,3842,utRho30
22,actP,8569870,8569870,8569804,66,136,utRho30
23,ada,4620854,4620854,4620810,44,10,utRho30
24,add,3404404,3404466,3404404,62,70,utRho30
25,ade,7687802,7687928,7687802,126,204,utRho30
26,adhE,2596826,2596826,2596242,584,58,utRho30
27,adhP,3107988,3107988,3107676,312,126,utRho30
28,adiA,8681112,8681112,8681042,70,220,utRho30
29,adiC,8674404,8674404,8674062,342,550,utRho30
30,adiY,8676084,8676084,8675858,226,0,utRho30
31,adk,994278,994350,994278,72,3426,utRho30
32,adrA,807374,807406,807374,32,14,utRho30
33,aer,6438240,6438240,6438152,88,24,utRho30
34,aes,1000102,1000102,999946,156,190,utRho30
35,agaR,6557406,6557406,6557330,76,56,utRho30
36,agaS,6563778,6563952,6563778,174,248,utRho30
37,agp,2131118,2131170,2131118,52,38,utRho30
38,agrA,7296126,7296126,7296126,0,0,utRho30
39,agrB,7296588,7296588,7296588,0,0,utRho30
40,ahpC,1277386,1277890,1277386,504,1008,utRho30
41,ahpF,1278004,1279506,1278004,1502,28530,utRho30
42,ahr,8992698,8992698,8992418,280,528,utRho30
43,aidB,8828494,8828550,8828494,56,0,utRho30
44,ais,4731512,4731512,4731240,272,128,utRho30
45,alaA,4814816,4815122,4814816,306,258,utRho30
46,alaC,4996798,4996798,4996590,208,158,utRho30
47,alaE,5598140,5598328,5598140,188,498,utRho30
48,alaS,5644180,5644180,5644022,158,498,utRho30
49,alaW,5036612,5036612,5036462,150,164,utRho30
50,aldA,2976380,2976464,2976380,84,110,utRho30
51,aldB,7513070,7513070,7513022,48,338,utRho30
52,alkA,4295118,4295118,4295080,38,180,utRho30
53,alkB,4618890,4618890,4618682,208,480,utRho30
54,allA,1064780,1064902,1064780,122,236,utRho30
55,allD,1092822,1092822,1092726,96,18,utRho30
56,allE,1088112,1088112,1088092,20,14,utRho30
57,allS,1064600,1064600,1064442,158,218,utRho30
58,alr,8531178,8531564,8531178,386,536,utRho30
59,alsE,8617334,8617334,8616956,378,1390,utRho30
60,alsK,8615990,8615990,8615598,392,586,utRho30
61,alx,6476740,6477160,6476740,420,152,utRho30
62,amiA,5104482,5104704,5104482,222,18,utRho30
63,amiC,5898378,5898378,5898020,358,190,utRho30
64,amn,4110062,4110122,4110062,60,0,utRho30
65,ampC,8758006,8758006,8757888,118,24,utRho30
66,ampD,237362,237466,237362,104,2,utRho30
67,ampG,907372,907372,907090,282,112,utRho30
68,ampH,792726,792726,792574,152,62,utRho30
69,amyA,4012230,4012312,4012230,82,72,utRho30
70,anmK,3439346,3439346,3439204,142,36,utRho30
71,ansB,6201580,6201580,6201456,124,456,utRho30
72,ansP,3052040,3052040,3051960,80,150,utRho30
73,apaG,104068,104068,103212,856,790,utRho30
74,apaH,102586,102586,102444,142,878,utRho30
75,apbE,4623188,4623188,4623068,120,0,utRho30
76,appA,2081198,2081234,2081198,36,84,utRho30
77,appC,2075420,2075480,2075420,60,104,utRho30
78,appY,1167134,1167362,1167134,228,0,utRho30
79,apt,982620,982824,982620,204,84,utRho30
80,aqpZ,1832424,1832424,1832094,330,368,utRho30
81,araB,140150,140150,140096,54,0,utRho30
82,araC,140482,140774,140482,292,208,utRho30
83,araE,5964416,5964416,5964364,52,0,utRho30
84,araF,3972476,3972476,3972256,220,186,utRho30
85,araH,3967120,3967120,3967086,34,130,utRho30
86,araJ,825058,825058,824962,96,1786,utRho30
87,arcA,9281602,9281602,9280612,990,2850,utRho30
88,arcB,6706098,6706098,6706050,48,266,utRho30
89,arcZ,6701154,6701154,6701154,0,0,utRho30
90,arfA,6877346,6877346,6877298,48,192,utRho30
91,argA,5898312,5898484,5898312,172,112,utRho30
92,argC,8309770,8310002,8309770,232,142,utRho30
93,argD,6980442,6980442,6980360,82,306,utRho30
94,argE,8310156,8310156,8309694,462,644,utRho30
95,argF,580680,580680,580610,70,124,utRho30
96,argG,6637124,6637274,6637124,150,202,utRho30
97,argI,8956688,8956688,8956622,66,182,utRho30
98,argO,6137672,6137672,6137616,56,384,utRho30
99,argP,6119460,6119506,6119460,46,18,utRho30
100,argR,6769204,6769406,6769204,202,54,utRho30
101,argS,3920002,3920124,3920002,122,68,utRho30
102,argT,4855698,4855698,4855582,116,0,utRho30
103,argU,1129406,1129446,1129406,40,4,utRho30
104,argW,4932616,4932618,4932616,2,0,utRho30
105,argX,7964728,7964750,7964728,22,4,utRho30
106,aroF,5482402,5482402,5482300,102,64,utRho30
107,aroG,1571182,1571266,1571182,84,16,utRho30
108,aroH,3576636,3576870,3576636,234,618,utRho30
109,aroK,7038760,7038760,7038128,632,2356,utRho30
110,aroL,812560,812810,812560,250,2736,utRho30
111,aroP,243342,243342,243102,240,0,utRho30
112,arpA,8445382,8445382,8444974,408,150,utRho30
113,arrS,7316108,7316108,7316108,0,0,utRho30
114,arsR,7297024,7297056,7297024,32,0,utRho30
115,artJ,1801252,1801252,1801150,102,0,utRho30
116,artP,1807686,1807686,1807468,218,2322,utRho30
117,ascF,5678858,5679048,5678858,190,88,utRho30
118,ascG,5678574,5678574,5678528,46,226,utRho30
119,aslB,7965562,7965916,7965562,354,126,utRho30
120,asnA,7854258,7854310,7854258,52,996,utRho30
121,asnB,1398444,1398444,1398354,90,612,utRho30
122,asnC,23562186,23562186,23562018,168,894,utRho30
123,asnS,1978088,1978088,1977970,118,822,utRho30
124,asnT,4089082,4089098,4089082,16,32,utRho30
125,asnU,4119690,4119702,4119690,12,6,utRho30
126,asnV,4124504,4124520,4124504,16,26,utRho30
127,aspA,17473728,17473728,17473308,420,624,utRho30
128,aspC,1971486,1971486,1971418,68,2,utRho30
129,aspS,3901402,3901402,3901044,358,466,utRho30
130,aspT,7893560,7893744,7893560,184,50994,utRho30
131,aspV,473826,473862,473826,36,148,utRho30
132,asr,3342654,3342752,3342654,98,30,utRho30
133,astC,3664088,3664088,3663964,124,220,utRho30
134,astE,3654138,3654138,3653846,292,286,utRho30
135,atoD,4646824,4646894,4646824,70,468,utRho30
136,atpB,7844540,7844540,7844102,438,1366,utRho30
137,atpC,7832118,7832118,7831944,174,532,utRho30
138,atpI,7845050,7845050,7844880,170,2358,utRho30
139,avtA,7479348,7479410,7479348,62,1500,utRho30
140,azoR,2965982,2965982,2965720,262,736,utRho30
141,azuC,3976002,3976002,3975918,84,124,utRho30
142,bacA,6408350,6408350,6408262,88,25404,utRho30
143,bamA,394052,395856,394052,1804,2404,utRho30
144,bamB,5277950,5277950,5277304,646,714,utRho30
145,bamC,5198028,5198028,5197730,298,1096,utRho30
146,bamD,5471922,5472292,5471922,370,630,utRho30
147,bamE,5506972,5507210,5506972,238,2062,utRho30
148,basS,8666954,8666954,8666544,410,554,utRho30
149,bax,7474468,7474468,7474354,114,1090,utRho30
150,bcp,5200874,5200956,5200874,82,428,utRho30
151,bcsB,7385346,7385346,7385214,132,20,utRho30
152,bcsE,7392644,7392916,7392644,272,318,utRho30
153,bdcA,8948128,8948128,8948106,22,450,utRho30
154,bdcR,8948192,8948248,8948192,56,308,utRho30
155,bdm,3112680,3112680,3112560,120,258,utRho30
156,betA,654522,654522,654494,28,0,utRho30
157,betI,658722,658722,658668,54,254,utRho30
158,betT,658842,658926,658842,84,588,utRho30
159,bfr,6933498,6933498,6933450,48,180,utRho30
160,bglG,23440182,23440182,23439402,780,2892,utRho30
161,bglX,4444240,4444240,4443978,262,114,utRho30
162,bhsA,2337962,2338146,2337962,184,244,utRho30
163,bioA,1618584,1618584,1618514,70,0,utRho30
164,bioB,1618604,1618688,1618604,84,0,utRho30
165,bioH,7089716,7089716,7089688,28,28,utRho30
166,bisC,7433026,7433026,7432788,238,70,utRho30
167,blc,8755490,8755490,8755444,46,4,utRho30
168,blr,3409024,3409102,3409024,78,586,utRho30
169,bluF,2431226,2431226,2430950,276,624,utRho30
170,bluR,2428226,2428226,2428118,108,12,utRho30
171,bolA,908698,908944,908698,246,212,utRho30
172,borD,1157842,1157842,1157786,56,126,utRho30
173,brnQ,838976,839182,838976,206,2260,utRho30
174,bssR,1756492,1756496,1756492,4,0,utRho30
175,bssS,2242116,2242116,2241910,206,1112,utRho30
176,btuB,8326798,8327278,8326798,480,1508,utRho30
177,cadB,8720212,8720212,8720062,150,828,utRho30
178,cadC,8723926,8723926,8723868,58,74,utRho30
179,caiE,70998,70998,70742,256,74,utRho30
180,caiF,68436,68600,68436,164,596,utRho30
181,caiT,84074,84074,83862,212,350,utRho30
182,can,285406,285406,285340,66,296,utRho30
183,carA,59102,59302,59102,200,1158,utRho30
184,carB,61550,61634,61550,84,304,utRho30
185,cas2,5757830,5757830,5757706,124,362,utRho30
186,casA,5768638,5768638,5768276,362,88,utRho30
187,cbl,4121882,4121882,4121828,54,64,utRho30
188,cbpA,2128074,2128074,2127550,524,200,utRho30
189,cbrA,7738628,7738754,7738628,126,4,utRho30
190,cbrB,7794958,7795012,7794958,54,136,utRho30
191,ccmH,4585242,4585242,4584820,422,206,utRho30
192,cdaR,364894,364926,364894,32,56,utRho30
193,cdd,4463638,4463688,4463638,50,32,utRho30
194,cdh,8219814,8219860,8219814,46,542,utRho30
195,cdsA,391110,391354,391110,244,990,utRho30
196,cedA,3627484,3627484,3627326,158,380,utRho30
197,cfa,3482402,3482826,3482402,424,214,utRho30
198,chaC,2544844,2544972,2544844,128,574,utRho30
199,chbB,3643452,3643452,3643238,214,338,utRho30
200,chbG,3634624,3634624,3634270,354,20,utRho30
201,cheW,3946924,3946924,3946678,246,362,utRho30
202,chiA,6939792,6939792,6939706,86,1600,utRho30
203,chiP,1416472,1416668,1416472,196,80,utRho30
204,cho,3646984,3647030,3646984,46,0,utRho30
205,chpS,8896804,8896894,8896804,90,202,utRho30
206,cirA,4493884,4493884,4493538,346,684,utRho30
207,citC,1304078,1304078,1303712,366,1666,utRho30
208,citT,1293264,1293264,1293160,104,206,utRho30
209,clcA,350104,350214,350104,110,10,utRho30
210,clpA,1846160,1846528,1846160,368,182,utRho30
211,clpB,5468410,5468410,5468346,64,1114,utRho30
212,clpP,913154,913354,913154,200,2882,utRho30
213,clpS,1845500,1845826,1845500,326,844,utRho30
214,clpX,914404,914852,914404,448,5764,utRho30
215,clsA,2617346,2617346,2617290,56,142,utRho30
216,clsC,2212584,2212710,2212584,126,174,utRho30
217,cmk,1922330,1922402,1922330,72,40,utRho30
218,cnu,3409522,3409898,3409522,376,690,utRho30
219,coaA,8350214,8350214,8350052,162,1092,utRho30
220,cobC,1340092,1340092,1339814,278,560,utRho30
221,cobT,4129202,4129202,4128934,268,164,utRho30
222,cobU,4131944,4131944,4131528,416,712,utRho30
223,codB,709768,709844,709768,76,480,utRho30
224,comR,2337726,2337726,2337664,62,0,utRho30
225,copA,1022822,1022822,1022758,64,126,utRho30
226,corA,8002388,8002852,8002388,464,13870,utRho30
227,cpdB,8873258,8873258,8873130,128,150,utRho30
228,cptB,6082198,6082198,6082140,58,0,utRho30
229,cpxA,8210202,8210202,8209950,252,98,utRho30
230,cpxP,8211570,8211640,8211570,70,350,utRho30
231,cpxR,8211372,8211372,8211340,32,0,utRho30
232,cra,175894,176056,175894,162,550,utRho30
233,crcB,1316016,1316016,1315876,140,56,utRho30
234,creA,9270486,9271042,9270486,556,1160,utRho30
235,creD,9276320,9276356,9276320,36,534,utRho30
236,crl,515620,515658,515620,38,912,utRho30
237,crp,6971906,6972240,6971906,334,586,utRho30
238,crr,5070960,5071668,5070960,708,2628,utRho30
239,csdA,5886414,5886674,5886414,260,0,utRho30
240,csgB,2207718,2207902,2207718,184,0,utRho30
241,csgD,2206688,2206688,2206392,296,1640,utRho30
242,csgG,2203510,2203510,2203368,142,888,utRho30
243,csiD,5577854,5577970,5577854,116,260,utRho30
244,csiE,5330802,5330870,5330802,68,0,utRho30
245,csiR,5590942,5591348,5590942,406,418,utRho30
246,cspA,7439778,7440098,7439778,320,1192,utRho30
247,cspB,3283430,3283430,3283108,322,144,utRho30
248,cspC,3815018,3815018,3814870,148,158,utRho30
249,cspD,1845352,1845352,1845180,172,4480,utRho30
250,cspE,1314294,1314584,1314294,290,632,utRho30
251,cspF,3283380,3283710,3283380,330,2054,utRho30
252,cspG,2102610,2102922,2102610,312,740,utRho30
253,cspH,2102746,2102746,2102350,396,330,utRho30
254,cspI,3277624,3277624,3277334,290,48,utRho30
255,csrA,5638746,5638746,5638292,454,2328,utRho30
256,csrB,5849048,5849048,5849048,0,0,utRho30
257,csrC,8102072,8102072,8102072,0,0,utRho30
258,csrD,6806850,6806850,6806664,186,350,utRho30
259,cstA,1259710,1259788,1259710,78,0,utRho30
260,cueO,274090,274166,274090,76,0,utRho30
261,cueR,1027948,1027986,1027948,38,76,utRho30
262,curA,3037784,3038054,3037784,270,488,utRho30
263,cusC,1191146,1191200,1191146,54,14,utRho30
264,cusR,1190924,1190924,1190886,38,260,utRho30
265,cutA,8730784,8730784,8730712,72,156,utRho30
266,cutC,3918534,3918534,3917920,614,750,utRho30
267,cvpA,4861600,4861600,4861526,74,78,utRho30
268,cvrA,2484328,2484328,2484142,186,22,utRho30
269,cyaA,7981548,7982306,7981548,758,926,utRho30
270,cyaR,4334228,4334224,4334228,4,2,utRho30
271,cyaY,7988166,7988166,7988118,48,690,utRho30
272,cybB,2981522,2981804,2981522,282,100,utRho30
273,cycA,8859560,8859728,8859560,168,476,utRho30
274,cydA,1542340,1542916,1542340,576,6714,utRho30
275,cydC,1858800,1858800,1858390,410,324,utRho30
276,cydD,1862062,1862062,1861924,138,0,utRho30
277,cydX,1548300,1548392,1548300,92,202,utRho30
278,cynR,717418,717418,717380,38,68,utRho30
279,cynT,1435092,1435196,1435092,104,40,utRho30
280,cyoA,903306,903306,903220,86,922,utRho30
281,cyoE,895540,895540,895410,130,154,utRho30
282,cysB,2667576,2667710,2667576,134,750,utRho30
283,cysC,5748056,5748056,5747984,72,228,utRho30
284,cysD,5752736,5752736,5752658,78,286,utRho30
285,cysE,7565362,7565362,7565124,238,480,utRho30
286,cysG,6995508,6995656,6995508,148,4748,utRho30
287,cysJ,5783928,5783928,5783796,132,2008,utRho30
288,cysK,5064688,5064818,5064688,130,44,utRho30
289,cysP,5087114,5087114,5087056,58,100,utRho30
290,cysS,1109154,1109222,1109154,68,122,utRho30
291,cysT,3984100,3984100,3983974,126,16,utRho30
292,cysZ,5062766,5062926,5062766,160,576,utRho30
293,cytR,8249018,8249018,8248912,106,406,utRho30
294,dacA,1328002,1328002,1327926,76,110,utRho30
295,dacB,6657714,6657926,6657714,212,170,utRho30
296,dacC,1761306,1761454,1761306,148,1094,utRho30
297,dadA,2475018,2475142,2475018,124,120,utRho30
298,dam,7032504,7032504,7031826,678,526,utRho30
299,damX,7035200,7035200,7034612,588,3756,utRho30
300,dapA,5199568,5199568,5199520,48,0,utRho30
301,dapB,56576,56748,56576,172,908,utRho30
302,dapD,371954,371954,371894,60,456,utRho30
303,dapE,5183120,5183214,5183120,94,876,utRho30
304,dcp,3254844,3254844,3254760,84,50,utRho30
305,dcrB,7219534,7219910,7219534,376,806,utRho30
306,dctA,7366996,7366996,7366894,102,672,utRho30
307,dcuA,8733686,8733686,8733546,140,2392,utRho30
308,dcuB,8698182,8698182,8697488,694,3808,utRho30
309,dcuC,1312166,1312166,1311936,230,1216,utRho30
310,dcuD,6749166,6749738,6749166,572,1420,utRho30
311,dcuR,8701130,8701130,8700068,1062,1384,utRho30
312,dcuS,8703370,8703370,8703324,46,554,utRho30
313,dcyD,3999016,3999016,3998960,56,0,utRho30
314,ddpX,3126498,3126498,3126152,346,58,utRho30
315,deaD,6615818,6615818,6615720,98,28,utRho30
316,dedA,4869880,4869880,4869482,398,512,utRho30
317,dedD,4863750,4863750,4863368,382,90,utRho30
318,def,6867300,6867380,6867300,80,214,utRho30
319,degP,361690,361768,361690,78,76,utRho30
320,degQ,6761308,6761486,6761308,178,938,utRho30
321,deoB,9239134,9239206,9239134,72,78,utRho30
322,deoC,9233358,9234646,9233358,1288,1460,utRho30
323,dfp,7625406,7625462,7625406,56,70,utRho30
324,dgcZ,3247758,3247758,3247700,58,170,utRho30
325,dgkA,8512914,8513274,8512914,360,472,utRho30
326,dgt,358392,358474,358392,82,302,utRho30
327,dhaK,2501888,2501888,2501676,212,116,utRho30
328,dhaR,2502006,2502132,2502006,126,164,utRho30
329,dicB,3299194,3299218,3299194,24,0,utRho30
330,dicC,3295752,3295752,3295700,52,40,utRho30
331,dinB,501760,501796,501760,36,0,utRho30
332,dinD,7635398,7635520,7635398,122,154,utRho30
333,dinG,1666146,1666140,1666146,6,12,utRho30
334,dinI,2243018,2243018,2242974,44,384,utRho30
335,dinJ,493230,493230,493004,226,208,utRho30
336,dinQ,7295964,7295964,7295576,388,240,utRho30
337,djlA,114536,114728,114536,192,130,utRho30
338,dkgA,6313142,6313246,6313142,104,180,utRho30
339,dkgB,458196,458334,458196,138,136,utRho30
340,dksA,321502,321502,321208,294,1086,utRho30
341,dld,4444164,4444370,4444164,206,130,utRho30
342,dmlA,3763424,3763824,3763424,400,978,utRho30
343,dmlR,3763710,3763710,3763618,92,474,utRho30
344,dmsA,1881646,1881918,1881646,272,180,utRho30
345,dnaA,7767922,7767922,7767458,464,122,utRho30
346,dnaB,8528566,8528628,8528566,62,300,utRho30
347,dnaK,24096,24326,24096,230,9838,utRho30
348,dnaN,7765466,7765466,7764642,824,456,utRho30
349,dnaQ,471868,472134,471868,266,3834,utRho30
350,dnaT,18406460,18406460,18406068,392,204,utRho30
351,dnaX,984112,984184,984112,72,46,utRho30
352,dosP,3131486,3131486,3131466,20,66,utRho30
353,dpiB,1303968,1304470,1303968,502,318,utRho30
354,dppA,7415740,7415740,7415410,330,2252,utRho30
355,dps,1697900,1697900,1697822,78,434,utRho30
356,dsbA,8086754,8086836,8086754,82,458,utRho30
357,dsbB,2466294,2466294,2466060,234,64,utRho30
358,dsbC,6079266,6079266,6077644,1622,2354,utRho30
359,dsbG,1277600,1277600,1277146,454,416,utRho30
360,dsdA,4958242,4958404,4958242,162,432,utRho30
361,dsdC,4955492,4955492,4955258,234,318,utRho30
362,dsdX,4955642,4955694,4955642,52,1068,utRho30
363,dsrA,4050626,4050626,4050626,0,0,utRho30
364,dsrB,4049686,4049686,4049646,40,576,utRho30
365,dtpD,1485340,1485340,1485112,228,404,utRho30
366,dusA,8523200,8523338,8523200,138,1052,utRho30
367,dusB,6820492,6820560,6820492,68,64,utRho30
368,dusC,4460790,4460790,4460770,20,0,utRho30
369,dut,7627704,7627864,7627704,160,858,utRho30
370,dxr,386670,387042,386670,372,260,utRho30
371,ebgA,6445102,6445266,6445102,164,76,utRho30
372,ebgR,6442874,6442932,6442874,58,18,utRho30
373,ecnB,8753018,8753106,8753018,88,0,utRho30
374,eco,4607594,4607810,4607594,216,0,utRho30
375,ecpA,621594,621594,621342,252,190,utRho30
376,ecpB,620238,620238,620052,186,32,utRho30
377,ecpR,622964,622964,622672,292,34,utRho30
378,eda,3866218,3866218,3865512,706,180,utRho30
379,edd,3869426,3869426,3869208,218,0,utRho30
380,efeO,2164308,2164486,2164308,178,0,utRho30
381,efeU_1,2162614,2162712,2162614,98,306,utRho30
382,efp,8751134,8751398,8751134,264,2194,utRho30
383,elaA,4763372,4763372,4763086,286,198,utRho30
384,elaD,4765308,4765426,4765308,118,426,utRho30
385,elfA,1995530,1995736,1995530,206,0,utRho30
386,elfD,1996642,1996980,1996642,338,342,utRho30
387,emrD,7707690,7707844,7707690,154,514,utRho30
388,emrK,4966896,4966896,4966678,218,172,utRho30
389,emrY,4964668,4964668,4964352,316,1110,utRho30
390,emtA,2486250,2486360,2486250,110,8,utRho30
391,endA,12361100,12361388,12361100,288,84,utRho30
392,eno,5817692,5817692,5815882,1810,476,utRho30
393,entC,1249662,1249770,1249662,108,48,utRho30
394,entD,1220508,1220508,1220158,350,84,utRho30
395,entH,1258584,1258600,1258584,16,0,utRho30
396,entS,1244506,1244600,1244506,94,62,utRho30
397,envR,6827266,6827266,6826930,336,122,utRho30
398,epd,12295292,12295292,12294764,528,312,utRho30
399,epmA,8765236,8765286,8765236,50,382,utRho30
400,epmB,8751406,8751406,8751314,92,1500,utRho30
401,eptB,7421162,7421162,7420950,212,214,utRho30
402,eptC,8300622,8300622,8300530,92,202,utRho30
403,erfK,4126708,4126708,4126646,62,160,utRho30
404,erpA,353122,353220,353122,98,16,utRho30
405,esrE,8039956,8039956,8039956,0,0,utRho30
406,essD,1153746,1154796,1153746,1050,554,utRho30
407,etk,2088606,2088606,2088420,186,208,utRho30
408,evgA,4967262,4967510,4967262,248,382,utRho30
409,exbB,6304028,6304028,6303968,60,338,utRho30
410,exbD,6302780,6302780,6302486,294,398,utRho30
411,exuR,6493016,6493304,6493016,288,14,utRho30
412,exuT,6490004,6490208,6490004,204,114,utRho30
413,fabA,2032996,2032996,2032940,56,52,utRho30
414,fabB,4883282,4883282,4883210,72,50,utRho30
415,fabH,2297032,2297518,2297032,486,28,utRho30
416,fabI,2702236,2702236,2702078,158,42,utRho30
417,fadB,8062026,8062026,8061942,84,4,utRho30
418,fadD,3779614,3779614,3779492,122,474,utRho30
419,fadE,486812,486812,486606,206,162,utRho30
420,fadH,6463248,6463330,6463248,82,114,utRho30
421,fadI,4921022,4921022,4920938,84,498,utRho30
422,fadL,4922410,4922600,4922410,190,386,utRho30
423,fadM,928720,928804,928720,84,0,utRho30
424,fadR,2469810,2469876,2469810,66,124,utRho30
425,fbaB,4357334,4357334,4357128,206,40,utRho30
426,fdhE,8162722,8162722,8162456,266,372,utRho30
427,fdhF,8598814,8598814,8598732,82,244,utRho30
428,fdnG,3094744,3094802,3094744,58,0,utRho30
429,fdrA,1093012,1093360,1093012,348,28,utRho30
430,feaB,2894994,2895038,2894994,44,0,utRho30
431,feaR,2894734,2894734,2894566,168,60,utRho30
432,fecA,9033454,9033454,9033354,100,0,utRho30
433,fecE,9023288,9023288,9022914,374,1372,utRho30
434,fecI,9036564,9036564,9036470,94,176,utRho30
435,feoA,7080114,7080326,7080114,212,306,utRho30
436,fepA,1225334,1225334,1224988,346,750,utRho30
437,fepB,1249454,1249454,1249020,434,206,utRho30
438,fepD,1244468,1244468,1244378,90,50,utRho30
439,fes,1225374,1225630,1225374,256,784,utRho30
440,ffh,5495706,5495706,5495590,116,1262,utRho30
441,ffs,952576,952848,952576,272,898,utRho30
442,fhuA,334884,334968,334884,84,392,utRho30
443,fhuE,2323294,2323294,2323102,192,546,utRho30
444,fhuF,9211504,9211504,9211326,178,920,utRho30
445,fic,6983296,6983296,6982926,370,282,utRho30
446,fieF,8212864,8212938,8212864,74,334,utRho30
447,fimA,9085388,9086230,9085388,842,3198,utRho30
448,fimB,9081334,9081914,9081334,580,5502,utRho30
449,fimE,9083742,9084074,9083742,332,1622,utRho30
450,fimZ,1129214,1129214,1128960,254,174,utRho30
451,fiu,1683296,1683296,1683062,234,256,utRho30
452,fixA,84650,84806,84650,156,390,utRho30
453,fkpA,6955050,6955050,6954838,212,9786,utRho30
454,fldA,2846084,2846084,2845860,224,1416,utRho30
455,fldB,6079644,6079710,6079644,66,148,utRho30
456,flgA,2261770,2261770,2261726,44,748,utRho30
457,flgB,2261986,2262036,2261986,50,70,utRho30
458,flgK,2276702,2276756,2276702,54,200,utRho30
459,flgM,2260330,2260330,2260256,74,38,utRho30
460,flgN,2259828,2259828,2259660,168,28,utRho30
461,flhB,3932432,3932432,3932382,50,410,utRho30
462,flhC,3955864,3955864,3955688,176,148,utRho30
463,flhD,3957154,3957154,3956394,760,3182,utRho30
464,fliA,4003638,4003638,4003578,60,32,utRho30
465,fliC,4007352,4007352,4007212,140,130,utRho30
466,fliD,4007634,4007744,4007634,110,152,utRho30
467,fliE,4026186,4026186,4026028,158,1420,utRho30
468,fliF,4026292,4026458,4026292,166,1130,utRho30
469,fliL,4039168,4039236,4039168,68,196,utRho30
470,flk,4875824,4875900,4875824,76,42,utRho30
471,flu,4142634,4143078,4142634,444,546,utRho30
472,flxA,3292776,3292810,3292776,34,452,utRho30
473,fnr,2799104,2799104,2799052,52,8,utRho30
474,fnrS,2818258,2818258,2818258,0,0,utRho30
475,focA,1909628,1909628,1908932,696,750,utRho30
476,folA,99598,99646,99598,48,192,utRho30
477,folB,6409296,6409296,6409178,118,1408,utRho30
478,folD,1115562,1115562,1115482,80,88,utRho30
479,folE,4487696,4487696,4487304,392,282,utRho30
480,fpr,8228998,8228998,8228944,54,32,utRho30
481,frc,4986878,4986878,4986508,370,268,utRho30
482,frdA,8764824,8764824,8764636,188,120,utRho30
483,frdD,8758948,8758948,8758732,216,644,utRho30
484,fre,8052886,8053054,8052886,168,150,utRho30
485,frlA,6999518,6999820,6999518,302,134,utRho30
486,frr,385624,385744,385624,120,338,utRho30
487,frsA,513004,513054,513004,50,30,utRho30
488,fruB,4527194,4527194,4526990,204,116,utRho30
489,frvR,8179804,8179804,8179710,94,124,utRho30
490,fryA,5008986,5008986,5008970,16,102,utRho30
491,fsaA,1727060,1727284,1727060,224,310,utRho30
492,fsr,1009710,1009710,1009392,318,1488,utRho30
493,ftnA,3977364,3977432,3977364,68,38,utRho30
494,ftnB,3973550,3973850,3973550,300,398,utRho30
495,ftsA,207122,207964,207122,842,1012,utRho30
496,ftsB,5745802,5745802,5745640,162,250,utRho30
497,ftsH,6654204,6654204,6653870,334,2534,utRho30
498,ftsK,1865858,1866448,1865858,590,458,utRho30
499,ftsL,181376,182064,181376,688,482,utRho30
500,ftsP,6325732,6325732,6325338,394,208,utRho30
501,ftsQ,205484,206310,205484,826,2034,utRho30
502,ftsX,7204512,7204512,7204172,340,680,utRho30
503,ftsZ,209272,210610,209272,1338,762,utRho30
504,fucA,5867708,5867708,5867376,332,7632,utRho30
505,fucP,5868238,5868470,5868238,232,862,utRho30
506,fumA,6753760,6753760,6753508,252,1904,utRho30
507,fumB,8694696,8694696,8694652,44,0,utRho30
508,fumC,3373418,3373418,3373176,242,50,utRho30
509,fur,2842892,2842892,2842584,308,372,utRho30
510,fusA,6947370,6947370,6947028,342,5818,utRho30
511,fxsA,8737206,8737328,8737206,122,2836,utRho30
512,gabD,5581824,5582546,5581824,722,2284,utRho30
513,gadA,7335214,7335214,7335160,54,0,utRho30
514,gadB,3144144,3144144,3144090,54,248,utRho30
515,gadC,3141168,3141168,3140978,190,1812,utRho30
516,gadE,7315600,7316732,7315600,1132,2232,utRho30
517,gadW,7329562,7329562,7329236,326,494,utRho30
518,gadX,14663356,14663356,14663240,116,120,utRho30
519,gadY,7329728,7329728,7329728,0,0,utRho30
520,galE,1584354,1584354,1584110,244,86,utRho30
521,galF,4228702,4228702,4228654,48,476,utRho30
522,galM,1577796,1577796,1577674,122,162,utRho30
523,galP,6176510,6176568,6176510,58,174,utRho30
524,galR,5953138,5953198,5953138,60,112,utRho30
525,galS,4483420,4483420,4483336,84,4,utRho30
526,galU,2582810,2582914,2582810,104,136,utRho30
527,gapA,3724480,3725542,3724480,1062,2120,utRho30
528,garP,6549868,6549868,6549814,54,622,utRho30
529,gatY,4354468,4354468,4354408,60,0,utRho30
530,gatZ,4352864,4352864,4352642,222,428,utRho30
531,gcd,282558,282558,282450,108,130,utRho30
532,gcl,1067814,1067832,1067814,18,0,utRho30
533,gcvA,5885278,5885278,5885134,144,180,utRho30
534,gcvB,5885392,5885392,5885392,0,0,utRho30
535,gcvR,5199758,5199812,5199758,54,66,utRho30
536,gcvT,6101544,6101544,6101334,210,362,utRho30
537,gdhA,3684616,3684742,3684616,126,70,utRho30
538,gfcA,2099668,2099668,2099488,180,312,utRho30
539,gfcD,2096236,2096236,2095890,346,678,utRho30
540,ghrA,2195648,2195772,2195648,124,528,utRho30
541,ghrB,7434378,7434620,7434378,242,896,utRho30
542,glcA,6242728,6242728,6242558,170,816,utRho30
543,glcC,6256412,6256544,6256412,132,76,utRho30
544,glcD,6256152,6256152,6256042,110,234,utRho30
545,gldA,8278092,8278092,8278070,22,206,utRho30
546,glgA,7136784,7136784,7136066,718,956,utRho30
547,glgB,7147314,7147314,7147004,310,572,utRho30
548,glgC,7139142,7139142,7138656,486,346,utRho30
549,glgP,7133546,7133546,7133162,384,688,utRho30
550,glgS,6384024,6384024,6383878,146,842,utRho30
551,glgX,7142838,7142838,7142638,200,6,utRho30
552,glk,5018922,5018922,5018852,70,18,utRho30
553,glmS,7827622,7827622,7827336,286,362,utRho30
554,glmU,7830652,7830652,7830400,252,630,utRho30
555,glmY,10765360,10765360,10765360,0,0,utRho30
556,glmZ,7972864,7972864,7972864,0,0,utRho30
557,glnA,16232888,16232888,16232136,752,412,utRho30
558,glnB,5375052,5375052,5374816,236,168,utRho30
559,glnD,377310,377310,377300,10,546,utRho30
560,glnE,6399602,6399602,6399282,320,0,utRho30
561,glnH,1696396,1696396,1696008,388,534,utRho30
562,glnK,945112,945196,945112,84,458,utRho30
563,glnL,8112742,8112742,8112678,64,0,utRho30
564,glnQ,1693262,1693262,1692926,336,416,utRho30
565,glnS,1411998,1412186,1411998,188,4894,utRho30
566,gloA,3455602,3455674,3455602,72,8,utRho30
567,gloB,469852,469852,469564,288,1404,utRho30
568,glpA,4705166,4705294,4705166,128,156,utRho30
569,glpD,7123942,7124026,7123942,84,176,utRho30
570,glpE,7123698,7123698,7123646,52,60,utRho30
571,glpF,8236322,8236322,8236180,142,2106,utRho30
572,glpG,7122960,7122960,7122904,56,84,utRho30
573,glpR,7121782,7121782,7121210,572,6386,utRho30
574,glpT,4704902,4704902,4704748,154,320,utRho30
575,glpX,8231212,8231212,8231158,54,258,utRho30
576,glrK,5382246,5382246,5382196,50,0,utRho30
577,gltA,1509534,1509534,1508936,598,2034,utRho30
578,gltB,6709018,6709264,6709018,246,426,utRho30
579,gltI,1375792,1375792,1375494,298,2746,utRho30
580,gltP,8588536,8588962,8588536,426,418,utRho30
581,gltS,7657382,7657382,7657330,52,542,utRho30
582,gltX,5041568,5041568,5041344,224,960,utRho30
583,gluQ,320286,320286,320224,62,134,utRho30
584,glyA,5371148,5371148,5371014,134,0,utRho30
585,glyQ,7450708,7450708,7450636,72,132,utRho30
586,glyS,7448990,7448990,7448794,196,144,utRho30
587,glyU,5998128,5998128,5998114,14,0,utRho30
588,glyV,8784626,8784720,8784626,94,80,utRho30
589,glyW,3984360,3984360,3984234,126,2,utRho30
590,gmhB,445612,445666,445612,54,0,utRho30
591,gmk,7642776,7642856,7642776,80,66,utRho30
592,gmr,2693686,2693686,2693484,202,4,utRho30
593,gnd,4202648,4202648,4202536,112,416,utRho30
594,gnsB,3275692,3275692,3275564,128,104,utRho30
595,gntK,14310580,14310580,14310368,212,1056,utRho30
596,gntP,9102668,9102668,9102592,76,1774,utRho30
597,gntR,7157760,7157760,7157452,308,346,utRho30
598,gntT,7092810,7093118,7092810,308,1760,utRho30
599,gntU,7154170,7154170,7154122,48,452,utRho30
600,gntX,7089334,7089764,7089334,430,590,utRho30
601,gor,7292224,7292598,7292224,374,40,utRho30
602,gpmA,1575340,1575340,1575190,150,4,utRho30
603,gpmM,7570374,7570520,7570374,146,174,utRho30
604,gpsA,7567620,7567620,7567322,298,2472,utRho30
605,gpt,511828,511954,511828,126,278,utRho30
606,grcA,5433046,5433046,5432898,148,810,utRho30
607,greA,6657728,6657728,6657430,298,1556,utRho30
608,greB,7073488,7073624,7073488,136,198,utRho30
609,groL,8741566,8742050,8741566,484,33984,utRho30
610,groS,8741232,8741376,8741232,144,27816,utRho30
611,grpE,5501494,5501494,5501416,78,1230,utRho30
612,grxA,1781552,1781552,1781506,46,14,utRho30
613,grxB,2248206,2248206,2248108,98,784,utRho30
614,grxC,7569152,7569152,7568884,268,940,utRho30
615,grxD,3468324,3468324,3468202,122,1316,utRho30
616,gspA,6911268,6911268,6910796,472,1126,utRho30
617,gspC,6910964,6911156,6910964,192,422,utRho30
618,gss,6277220,6277220,6277044,176,530,utRho30
619,gstA,3428654,3428754,3428654,100,4,utRho30
620,gstB,1761038,1761038,1760960,78,442,utRho30
621,guaB,5268214,5268214,5268140,74,216,utRho30
622,gudD,5839026,5839026,5838770,256,124,utRho30
623,gyrA,4678914,4678914,4678840,74,64,utRho30
624,gyrB,7760300,7760300,7760238,62,82,utRho30
625,hcaE,5337964,5338064,5337964,100,332,utRho30
626,hcaR,5337928,5337928,5337792,136,382,utRho30
627,hcaT,5336106,5336106,5335692,414,698,utRho30
628,hchA,4071260,4071670,4071260,410,238,utRho30
629,hcp,1828258,1828258,1827628,630,902,utRho30
630,hcr,1824400,1824400,1824300,100,12,utRho30
631,hdeA,7313582,7313582,7313480,102,136,utRho30
632,hdeD,7313920,7313990,7313920,70,4186,utRho30
633,hdfR,7896320,7896320,7895934,386,318,utRho30
634,hdhA,3396244,3396244,3396080,164,236,utRho30
635,helD,2048876,2048942,2048876,66,208,utRho30
636,hemA,2527166,2527428,2527166,262,210,utRho30
637,hemB,779722,779722,779454,268,500,utRho30
638,hemF,5106410,5106450,5106410,40,54,utRho30
639,hemH,996062,996110,996062,48,0,utRho30
640,hemL,349882,349882,349764,118,36,utRho30
641,hemN,8103886,8104090,8103886,204,166,utRho30
642,hepA,127176,127176,126528,648,35584,utRho30
643,hflD,2385372,2385372,2385262,110,150,utRho30
644,hfq,8799602,8800576,8799602,974,11964,utRho30
645,hha,961006,961006,960616,390,16,utRho30
646,hicA,3018442,3018572,3018442,130,154,utRho30
647,higA,6468682,6468682,6468288,394,1730,utRho30
648,higB,6468960,6468960,6468910,50,540,utRho30
649,hinT,2323642,2323770,2323642,128,88,utRho30
650,hipB,3184964,3184964,3184884,80,108,utRho30
651,hisB,4186720,4186936,4186720,216,322,utRho30
652,hisJ,4853674,4853674,4853576,98,122,utRho30
653,hisL,8359856,8359984,8359856,128,1140,utRho30
654,hisS,5281284,5281284,5281150,134,2,utRho30
655,hlpA,400910,400964,400910,54,68,utRho30
656,hlyE,2460932,2460932,2460788,144,294,utRho30
657,hmp,5371594,5371670,5371594,76,0,utRho30
658,hns,2585916,2585916,2585844,72,4886,utRho30
659,hofM,7045856,7045856,7045502,354,460,utRho30
660,hokA,7441620,7441620,7441200,420,1118,utRho30
661,hokC,33902,33902,33806,96,1216,utRho30
662,hokE,1215462,1215672,1215462,210,102,utRho30
663,holC,8968546,8968546,8968560,14,98,utRho30
664,holD,9215562,9215606,9215562,44,0,utRho30
665,holE,3850040,3850216,3850040,176,158,utRho30
666,hpt,282720,282862,282720,142,562,utRho30
667,hrpB,324150,324210,324150,60,108,utRho30
668,hscB,5319048,5319048,5318934,114,140,utRho30
669,hscC,1367188,1367188,1366786,402,258,utRho30
670,hsdS,9163004,9163004,9162924,80,1788,utRho30
671,hslJ,2883560,2883560,2883486,74,1480,utRho30
672,hslO,7059344,7059548,7059344,204,177112,utRho30
673,hslR,7058220,7058696,7058220,476,15886,utRho30
674,hslV,8244708,8244708,8244574,134,350,utRho30
675,hsrA,7881412,7881412,7881224,188,16,utRho30
676,htgA,21286,21660,21286,374,2470,utRho30
677,htpG,989634,990240,989634,606,1120,utRho30
678,htpX,3825236,3825236,3825152,84,210,utRho30
679,htrE,311036,311036,310852,184,984,utRho30
680,htrL,7587668,7587668,7587366,302,1202,utRho30
681,hupA,8400352,8400562,8400352,210,22,utRho30
682,hupB,1845220,1845804,1845220,584,1056,utRho30
683,hyaA,2063968,2064278,2063968,310,136,utRho30
684,hybO,6292726,6292726,6292522,204,424,utRho30
685,hycA,5700922,5700922,5700870,52,70,utRho30
686,hycI,5686204,5686204,5686086,118,750,utRho30
687,hydN,5676264,5676264,5676210,54,86,utRho30
688,hyfA,5202342,5202402,5202342,60,56,utRho30
689,hypA,11402508,11402588,11402508,80,488,utRho30
690,hypB,11403356,11404004,11403356,648,120,utRho30
691,hypF,5676210,5676210,5674850,1360,4884,utRho30
692,hypT,9116634,9116634,9116578,56,60,utRho30
693,hyuA,6019660,6020056,6019660,396,204,utRho30
694,iaaA,1733074,1733136,1733074,62,98,utRho30
695,iadA,9119074,9119074,9119052,22,482,utRho30
696,iap,5753072,5753162,5753072,90,122,utRho30
697,ibaG,6673966,6673966,6673606,360,202,utRho30
698,ibpA,7735036,7735036,7734844,192,13328,utRho30
699,ibpB,7733962,7733962,7733794,168,153552,utRho30
700,icd,2389922,2390246,2389922,324,136,utRho30
701,iclR,8447304,8447304,8447256,48,284,utRho30
702,idi,6065876,6066130,6065876,254,166,utRho30
703,idnD,8988870,8988870,8988812,58,40,utRho30
704,idnK,8989194,8989246,8989194,52,364,utRho30
705,ihfA,3591442,3591442,3591104,338,176,utRho30
706,ihfB,1927498,1927656,1927498,158,154,utRho30
707,ileS,43666,44782,43666,1116,2632,utRho30
708,ileX,6431194,6431196,6431194,2,54,utRho30
709,ilvA,15820940,15821324,15820940,384,652,utRho30
710,ilvC,7915824,7915940,7915824,116,206,utRho30
711,ilvE,15809552,15809936,15809552,384,204,utRho30
712,ilvI,170840,171260,170840,420,266,utRho30
713,ilvL,23701308,23701932,23701308,624,648,utRho30
714,ilvY,7915734,7915734,7915640,94,360,utRho30
715,inaA,4698998,4698998,4698944,54,280,utRho30
716,infA,1853370,1853370,1852886,484,254,utRho30
717,infC,3602692,3602692,3601276,1416,1154,utRho30
718,insA-5,3958452,3958452,3958430,22,98,utRho30
719,insA-7,9036758,9037054,9036758,296,740,utRho30
720,insC-5,6372080,6372284,6372080,204,1050,utRho30
721,insEF-2,785238,785238,785820,582,822,utRho30
722,insEF-4,2190310,2190310,2190892,582,716,utRho30
723,insG,9007098,9007098,9006862,236,32,utRho30
724,insH-1,550596,550596,550234,362,914,utRho30
725,insH-11,7306538,7306538,7306396,142,646,utRho30
726,insH-2,1151548,1151548,1151506,42,400,utRho30
727,insH-3,1378444,1378444,1378026,418,850,utRho30
728,insH-4,2791942,2792152,2791942,210,360,utRho30
729,insH-5,2857852,2857852,2857452,400,292,utRho30
730,insH-6,4135022,4135022,4134642,380,948,utRho30
731,insH-7,4206186,4206186,4205822,364,2236,utRho30
732,insH-9,6260050,6260356,6260050,306,1196,utRho30
733,insI-3,9017372,9017372,9017234,138,62,utRho30
734,insJ,7441188,7441360,7441188,172,562,utRho30
735,insK,7442130,7442308,7442130,178,82,utRho30
736,insL-1,30760,30890,30760,130,19262,utRho30
737,insL-2,1216112,1216130,1216112,18,434,utRho30
738,insL-3,5028644,5028662,5028644,18,468,utRho30
739,insN-1,540452,540484,540452,32,0,utRho30
740,intD,1132202,1132202,1131956,246,1082,utRho30
741,intR,2826520,2826520,2826470,50,72,utRho30
742,intS,4933026,4933090,4933026,64,98,utRho30
743,intZ,5117386,5117542,5117386,156,726,utRho30
744,iraD,9113152,9113986,9113152,834,872,utRho30
745,iraM,2424246,2424246,2424006,240,134,utRho30
746,iraP,802638,802772,802638,134,58,utRho30
747,iscA,5319924,5319924,5319772,152,942,utRho30
748,iscR,5324398,5324398,5324262,136,2674,utRho30
749,iscX,5313834,5313834,5313472,362,484,utRho30
750,ispF,5743968,5743968,5743560,408,136,utRho30
751,ispG,5283908,5283908,5283608,300,66,utRho30
752,ispU,389568,389806,389568,238,244,utRho30
753,isrA,2811502,2811502,2811618,116,80,utRho30
754,istr-1,7706384,7706384,7706384,0,0,utRho30
755,istr-2,7706514,7706514,7706514,0,0,utRho30
756,ivbL,15412092,15412092,15411952,140,280,utRho30
757,ivy,480638,480686,480638,48,0,utRho30
758,katE,3627628,3627734,3627628,106,446,utRho30
759,katG,8267624,8267670,8267624,46,584,utRho30
760,kbaZ,6557732,6557828,6557732,96,28,utRho30
761,kbl,7585154,7585154,7585102,52,436,utRho30
762,kch,2621046,2621046,2620538,508,392,utRho30
763,kdgR,3820506,3820506,3820198,308,108,utRho30
764,kdpE,1443788,1443788,1443466,322,400,utRho30
765,kdpF,1457698,1457698,1457642,56,286,utRho30
766,kdsA,2535708,2536330,2535708,622,854,utRho30
767,kdsC,6683438,6684546,6683438,1108,7396,utRho30
768,kduI,5968388,5968388,5968248,140,854,utRho30
769,kefF,94160,94492,94160,332,4252,utRho30
770,kgtP,5451624,5451624,5451492,132,688,utRho30
771,kup,7862206,7862632,7862206,426,5928,utRho30
772,lacI,735076,735076,735020,56,190,utRho30
773,lacZ,1465508,1465508,1465220,288,740,utRho30
774,ldcA,2486394,2486394,2486160,234,92,utRho30
775,ldhA,2885830,2885830,2885686,144,952,utRho30
776,ldrA,2538954,2538954,2538550,404,976,utRho30
777,ldrB,2540024,2540024,2539620,404,396,utRho30
778,ldrC,2541092,2541092,2540690,402,218,utRho30
779,ldrD,7400544,7400544,7400174,370,442,utRho30
780,lepA,5414392,5414392,5414248,144,1254,utRho30
781,lepB,5410928,5410928,5410618,310,3828,utRho30
782,leuD,159188,159188,158906,282,256,utRho30
783,leuE,3761600,3761600,3761518,82,240,utRho30
784,leuL,168048,168048,167416,632,246,utRho30
785,leuO,168308,168736,168308,428,200,utRho30
786,leuQ,9212864,9212864,9212802,62,4,utRho30
787,leuU,6644556,6644556,6644316,240,636,utRho30
788,leuV,9212546,9212546,9212330,216,394,utRho30
789,leuX,8992772,8992810,8992772,38,52,utRho30
790,lexA,8514174,8514230,8514174,56,1172,utRho30
791,lhr,3456706,3458174,3456706,1468,756,utRho30
792,ligA,5060402,5060402,5060352,50,0,utRho30
793,ligB,7642576,7642576,7642340,236,246,utRho30
794,lipA,1320602,1320602,1320432,170,556,utRho30
795,lipB,1324802,1324802,1324556,246,14386,utRho30
796,lit,2397032,2397390,2397032,358,892,utRho30
797,livJ,7199524,7199524,7199316,208,4706,utRho30
798,livK,7195510,7195510,7195120,390,2894,utRho30
799,lldP,7554578,7554798,7554578,220,396,utRho30
800,lnt,1381968,1381968,1381762,206,1542,utRho30
801,loiP,6163784,6163826,6163784,42,92,utRho30
802,lolA,1874656,1874738,1874656,82,24,utRho30
803,lolB,2527112,2527112,2527000,112,198,utRho30
804,lolC,2350748,2350854,2350748,106,0,utRho30
805,lon,917630,917776,917630,146,2328,utRho30
806,lpcA,486936,487086,486936,150,10,utRho30
807,lpd,255434,255824,255434,390,514,utRho30
808,lplA,9248476,9248476,9248234,242,1126,utRho30
809,lplT,5947878,5947878,5947724,154,0,utRho30
810,lpoA,6586422,6586800,6586422,378,512,utRho30
811,lpp,3514592,3514842,3514592,250,110,utRho30
812,lptA,6686598,6686760,6686598,162,228,utRho30
813,lptB,6686792,6687888,6686792,1096,1366,utRho30
814,lptD,114672,114672,114218,454,290,utRho30
815,lptF,8972244,8972436,8972244,192,20,utRho30
816,lpxC,213016,213114,213016,98,1146,utRho30
817,lpxD,401920,401942,401920,22,38,utRho30
818,lpxL,2233418,2233418,2233164,254,240,utRho30
819,lpxM,3880456,3880456,3880386,70,54,utRho30
820,lpxP,4991156,4991290,4991156,134,600,utRho30
821,lrhA,4813312,4813312,4813282,30,152,utRho30
822,lrp,1864656,1865190,1864656,534,708,utRho30
823,lspA,50028,50414,50028,386,404,utRho30
824,lsrA,3202920,3202980,3202920,60,68,utRho30
825,lsrR,3202514,3202514,3202482,32,66,utRho30
826,ltaE,1818640,1818640,1818588,52,84,utRho30
827,luxS,5630130,5630130,5629466,664,890,utRho30
828,lysA,5957902,5957902,5957798,104,48,utRho30
829,lysC,8467232,8467232,8466466,766,528,utRho30
830,lysP,4497120,4497120,4497064,56,110,utRho30
831,lysR,5957900,5958042,5957900,142,56,utRho30
832,lysT,1561028,1561108,1561028,80,14,utRho30
833,lysU,8709610,8709610,8709434,176,140,utRho30
834,macB,1840188,1840694,1840188,506,762,utRho30
835,maeA,3111484,3111484,3111338,146,130,utRho30
836,mak,820236,820288,820236,52,80,utRho30
837,malE,8492928,8492928,8492838,90,14,utRho30
838,malI,3398456,3398456,3398360,96,50,utRho30
839,malK,8493472,8493568,8493472,96,190,utRho30
840,malP,7105020,7105020,7104946,74,772,utRho30
841,malQ,7100798,7100798,7100140,658,612,utRho30
842,malS,14949880,14949988,14949880,108,112,utRho30
843,malT,7106048,7106170,7106048,122,214,utRho30
844,malX,3398626,3398710,3398626,84,102,utRho30
845,malZ,1689980,1690072,1689980,92,256,utRho30
846,manA,3377102,3377152,3377102,50,94,utRho30
847,manX,3803866,3804096,3803866,230,70,utRho30
848,marC,3237882,3237882,3237816,66,572,utRho30
849,marR,3238186,3238240,3238186,54,142,utRho30
850,matP,2036918,2036970,2036918,52,26,utRho30
851,mazE,5822736,5822736,5822678,58,90,utRho30
852,mazG,5821720,5821720,5821370,350,1500,utRho30
853,mcbA,1684306,1684306,1684112,194,510,utRho30
854,mcbR,3040192,3040524,3040192,332,110,utRho30
855,mcrA,2420278,2420692,2420278,414,564,utRho30
856,mcrC,9156124,9156124,9155916,208,1084,utRho30
857,mdaB,6344814,6345060,6344814,246,138,utRho30
858,mdfA,1767138,1767346,1767138,208,496,utRho30
859,mdh,6768940,6768940,6768536,404,186,utRho30
860,mdoB,9198988,9198988,9198882,106,722,utRho30
861,mdoD,2993290,2993712,2993290,422,298,utRho30
862,mdoG,2218514,2218670,2218514,156,176,utRho30
863,mdtA,4307958,4308032,4307958,74,98,utRho30
864,mdtE,7318168,7318464,7318168,296,3958,utRho30
865,mdtK,3486538,3486914,3486538,376,868,utRho30
866,mdtP,8602472,8602472,8602060,412,1602,utRho30
867,melA,8683774,8683822,8683774,48,0,utRho30
868,melR,8683300,8683300,8683256,44,924,utRho30
869,menA,8240812,8240812,8240698,114,212,utRho30
870,menB,4753774,4753774,4753638,136,8,utRho30
871,mepH,3468714,3468870,3468714,156,8,utRho30
872,mepM,3883666,3883666,3883270,396,120,utRho30
873,mepS,4539840,4539958,4539840,118,56,utRho30
874,metA,8428318,8428560,8428318,242,78,utRho30
875,metB,8257272,8257344,8257272,72,716,utRho30
876,metC,6304150,6304472,6304150,322,920,utRho30
877,metE,8025768,8026106,8025768,338,604,utRho30
878,metF,8265092,8265232,8265092,140,242,utRho30
879,metG,4388538,4388600,4388538,62,176,utRho30
880,metH,8447010,8447656,8447010,646,2048,utRho30
881,metJ,8257116,8257116,8256790,326,500,utRho30
882,metK,6173154,6173412,6173154,258,246,utRho30
883,metN,445428,445428,445290,138,42,utRho30
884,metR,8025710,8025710,8025632,78,0,utRho30
885,metT,1394326,1394326,1394266,60,72,utRho30
886,metY,19910250,19910250,19909734,516,666,utRho30
887,metZ,11789528,11789548,11789528,20,100,utRho30
888,mfd,2348056,2348056,2347928,128,134,utRho30
889,mglA,4478782,4478782,4478578,204,56,utRho30
890,mglB,4481132,4481132,4480696,436,6318,utRho30
891,mglC,4475918,4475918,4475506,412,152,utRho30
892,mgrB,3817584,3817584,3817532,52,208,utRho30
893,mgrR,3245828,3245828,3245828,0,0,utRho30
894,mgsA,2054082,2054082,2054030,52,246,utRho30
895,mgtL,8934560,8934862,8934560,302,874,utRho30
896,mhpA,737038,737222,737038,184,376,utRho30
897,mhpR,737072,737072,736840,232,296,utRho30
898,mhpT,750772,750918,750772,146,12,utRho30
899,miaA,8797964,8798504,8797964,540,582,utRho30
900,micA,5629604,5629604,5629604,0,0,utRho30
901,micC,2874242,2874238,2874242,4,0,utRho30
902,micF,4626168,4626168,4626168,0,0,utRho30
903,micM,1014408,1014408,1014408,0,0,utRho30
904,minE,2449422,2449422,2449090,332,286,utRho30
905,mioC,7852950,7852950,7852910,40,0,utRho30
906,mipA,3733012,3733012,3732944,68,846,utRho30
907,mlaA,4930270,4930270,4930014,256,94,utRho30
908,mlc,3337206,3337206,3337128,78,98,utRho30
909,mlrA,4429498,4429732,4429498,234,216,utRho30
910,mltA,5894546,5894546,5894356,190,136,utRho30
911,mltD,468050,468050,467910,140,78,utRho30
912,mltF,5391534,5391602,5391534,68,98,utRho30
913,mmuP,550238,550650,550238,412,998,utRho30
914,mngA,1531622,1531968,1531622,346,290,utRho30
915,mngR,1531852,1531852,1531750,102,182,utRho30
916,mnmG,7851348,7851348,7851266,82,476,utRho30
917,mntH,5025470,5025470,5025412,58,0,utRho30
918,mntP,3810918,3811376,3810918,458,292,utRho30
919,mntR,1706160,1706366,1706160,206,50,utRho30
920,mntS,1706128,1706128,1705994,134,74,utRho30
921,moaA,1633654,1634088,1633654,434,312,utRho30
922,moaB,1635954,1636110,1635954,156,90,utRho30
923,mobA,8084242,8084242,8083998,244,222,utRho30
924,mocA,6030112,6030320,6030112,208,68,utRho30
925,modA,1589990,1590178,1589990,188,284,utRho30
926,moeA,1732788,1732788,1732728,60,0,utRho30
927,mokB,2984610,2984610,2984258,352,212,utRho30
928,molR_1,4392888,4392948,4392888,60,16,utRho30
929,motA,3954604,3954604,3954278,326,34,utRho30
930,mpaA,2781278,2781278,2781196,82,292,utRho30
931,mpl,8911456,8911570,8911456,114,86,utRho30
932,mppA,2786108,2786454,2786108,346,180,utRho30
933,mprA,5621494,5621540,5621494,46,186,utRho30
934,mqo,4613848,4613848,4613508,340,274,utRho30
935,mqsA,6336742,6336742,6336492,250,512,utRho30
936,mqsR,6337306,6337306,6337088,218,1286,utRho30
937,mraZ,179192,179268,179192,76,932,utRho30
938,mrcA,7045652,7045742,7045652,90,146,utRho30
939,mrcB,329442,329460,329442,18,0,utRho30
940,mreB,13605424,13605424,13604348,1076,1132,utRho30
941,mreD,6798166,6798166,6797750,416,296,utRho30
942,mrp,4388360,4388360,4388336,24,114,utRho30
943,mscK,972984,973072,972984,88,456,utRho30
944,mscL,6876002,6876048,6876002,46,1488,utRho30
945,mscS,6139742,6139742,6139614,128,66,utRho30
946,msrA,8884522,8884522,8884352,170,2978,utRho30
947,msrB,3725168,3725168,3724858,310,116,utRho30
948,msyB,2228426,2228426,2228362,64,334,utRho30
949,mtfA,4087236,4087302,4087236,66,54,utRho30
950,mtgA,6699662,6699662,6699618,44,1048,utRho30
951,mtlA,30177504,30178248,30177504,744,17784,utRho30
952,mtn,358366,358366,358306,60,540,utRho30
953,mtr,6611864,6611864,6611634,230,8,utRho30
954,mug,6430992,6430992,6430946,46,3848,utRho30
955,murQ,5091466,5091546,5091466,80,608,utRho30
956,murR,5091586,5091586,5091218,368,1628,utRho30
957,mutH,5939164,5939324,5939164,160,314,utRho30
958,mutL,8794092,8794824,8794092,732,844,utRho30
959,mutM,7622554,7622554,7622304,250,160,utRho30
960,mutS,5714038,5714186,5714038,148,1264,utRho30
961,mutY,18617466,18618078,18617466,612,0,utRho30
962,nac,4123956,4123956,4123866,90,24,utRho30
963,nadA,1564122,1564170,1564122,48,64,utRho30
964,nadB,5420714,5420840,5420714,126,80,utRho30
965,nadC,237326,237326,237290,36,2,utRho30
966,nadE,3644604,3644916,3644604,312,378,utRho30
967,nadK,5501526,5501662,5501526,136,318,utRho30
968,nagA,1406350,1406350,1405502,848,1058,utRho30
969,nagB,1407416,1407416,1407222,194,98,utRho30
970,nagC,1404016,1404016,1403188,828,20,utRho30
971,nagE,1407680,1407888,1407680,208,890,utRho30
972,nagK,2357080,2357186,2357080,106,62,utRho30
973,nanA,6747240,6747240,6747152,88,290,utRho30
974,nanC,9079856,9079856,9079002,854,1084,utRho30
975,nanR,6749406,6749406,6748978,428,2288,utRho30
976,nanS,9075406,9075406,9075188,218,152,utRho30
977,napF,4607390,4607390,4606994,396,152,utRho30
978,narG,2559614,2559728,2559614,114,702,utRho30
979,narK,2555642,2555914,2555642,272,362,utRho30
980,narP,4580844,4581000,4580844,156,320,utRho30
981,narQ,5171154,5171462,5171154,308,302,utRho30
982,narU,3088326,3088326,3088120,206,736,utRho30
983,narW,3077374,3077374,3074618,2756,1718,utRho30
984,narX,2555554,2555554,2555236,318,486,utRho30
985,narZ,3085380,3085380,3085180,200,10,utRho30
986,ndh,2331984,2332170,2331984,186,1992,utRho30
987,ndk,5289920,5289920,5289728,192,16,utRho30
988,nemR,6904084,6904092,6904084,8,644,utRho30
989,nepI,7683542,7683542,7683478,64,98,utRho30
990,nfo,4501612,4501680,4501612,68,100,utRho30
991,nfsB,1210906,1210906,1210848,58,0,utRho30
992,nfuA,7090916,7091248,7090916,332,1548,utRho30
993,nhaA,34634,34978,34634,344,1976,utRho30
994,nhaB,2469534,2469534,2469434,100,316,utRho30
995,nhoA,3067926,3068048,3067926,122,146,utRho30
996,nikA,7226878,7227334,7226878,456,870,utRho30
997,nikR,7237074,7237176,7237074,102,94,utRho30
998,nirB,6987974,6988022,6987974,48,204,utRho30
999,nlpA,7680034,7680034,7679986,48,212,utRho30
1000,nlpC,3585654,3585654,3585462,192,376,utRho30
1001,nlpD,5737658,5737658,5737506,152,52,utRho30
1002,nlpI,6618080,6618080,6617848,232,132,utRho30
1003,nmpC,1153740,1153740,1153650,90,14,utRho30
1004,nohA,3273206,3273206,3272734,472,970,utRho30
1005,norR,5664614,5664614,5664578,36,94,utRho30
1006,norV,5664878,5664952,5664878,74,106,utRho30
1007,nrdA,4689510,4689730,4689510,220,6760,utRho30
1008,nrdD,8925676,8925676,8925320,356,536,utRho30
1009,nrdH,5601312,5601446,5601312,134,640,utRho30
1010,nrdR,865954,866004,865954,50,102,utRho30
1011,nrfA,8575342,8575528,8575342,186,0,utRho30
1012,nsrR,8812088,8812380,8812088,292,138,utRho30
1013,nudB,3897348,3897348,3897264,84,4,utRho30
1014,nudC,8393428,8393806,8393428,378,58,utRho30
1015,nudE,7052658,7052658,7052298,360,1098,utRho30
1016,nudG,3682876,3682980,3682876,104,2,utRho30
1017,nudI,4729050,4729108,4729050,58,124,utRho30
1018,nudJ,2388874,2388874,2388576,298,284,utRho30
1019,nuoA,4810670,4810670,4810144,526,13628,utRho30
1020,nuoN,4783434,4783434,4783010,424,904,utRho30
1021,nupC,5026018,5026084,5026018,66,0,utRho30
1022,nupG,6211302,6211428,6211302,126,8,utRho30
1023,ogrK,4335096,4335096,4335040,56,0,utRho30
1024,ogt,2800568,2800568,2800472,96,892,utRho30
1025,ohsC,5401036,5401040,5401036,4,396,utRho30
1026,ompA,2040382,2040382,2040106,276,4576,utRho30
1027,ompC,4625774,4625774,4625498,276,492,utRho30
1028,ompF,1974184,1974184,1973964,220,316,utRho30
1029,ompL,8128958,8128958,8128590,368,992,utRho30
1030,ompN,2874158,2874158,2873786,372,56,utRho30
1031,ompR,7073510,7073510,7073168,342,244,utRho30
1032,ompT,1171330,1171330,1171266,64,164,utRho30
1033,ompW,2627982,2628040,2627982,58,218,utRho30
1034,ompX,1700418,1700900,1700418,482,1824,utRho30
1035,omrA,5952378,5952378,5952378,0,0,utRho30
1036,omrB,5952770,5952770,5952770,0,0,utRho30
1037,oppA,2602170,2602364,2602170,194,772,utRho30
1038,orn,8783168,8783208,8783168,40,54,utRho30
1039,osmB,2686952,2686952,2686656,296,1594,utRho30
1040,osmC,3113192,3113250,3113192,58,212,utRho30
1041,osmE,3644566,3644566,3644512,54,2,utRho30
1042,osmF,4439046,4439046,4438962,84,196,utRho30
1043,osmY,9222306,9222792,9222306,486,188,utRho30
1044,otsA,3963302,3963302,3963224,78,88,utRho30
1045,otsB,3964930,3964930,3964774,156,336,utRho30
1046,oxc,4984288,4984288,4983900,388,1452,utRho30
1047,oxyR,8316914,8316980,8316914,66,460,utRho30
1048,oxyS,8316788,8316788,8316788,0,0,utRho30
1049,paaA,2907730,2907854,2907730,124,78,utRho30
1050,paaX,2927018,2927078,2927018,60,0,utRho30
1051,paaZ,2907340,2907340,2907284,56,0,utRho30
1052,pabA,6981702,6981702,6981658,44,218,utRho30
1053,pabB,3789256,3789610,3789256,354,348,utRho30
1054,pabC,2306186,2306600,2306186,414,78,utRho30
1055,pagP,1313052,1313114,1313052,62,132,utRho30
1056,panB,299260,299260,299202,58,2278,utRho30
1057,panC,297840,297840,297590,250,26,utRho30
1058,panD,293490,293490,293388,102,142,utRho30
1059,panZ,7195656,7195968,7195656,312,484,utRho30
1060,parC,6332060,6332060,6331946,114,244,utRho30
1061,patA,6438916,6438988,6438916,72,84,utRho30
1062,patD,3030830,3031156,3030830,326,52,utRho30
1063,pbpC,5294986,5294986,5294650,336,60,utRho30
1064,pbpG,4450132,4450132,4449740,392,6,utRho30
1065,pck,7065358,7065636,7065358,278,3874,utRho30
1066,pcnB,318782,318782,318252,530,338,utRho30
1067,pdhR,244068,244184,244068,116,180,utRho30
1068,pdxB,4875768,4875768,4875702,66,164,utRho30
1069,pdxH,3436068,3436068,3436014,54,2,utRho30
1070,pdxJ,5403626,5403626,5403458,168,280,utRho30
1071,pdxK,5074638,5074638,5074474,164,80,utRho30
1072,pepA,8972278,8972278,8971902,376,36,utRho30
1073,pepD,511618,511618,511432,186,444,utRho30
1074,pepN,1981182,1981244,1981182,62,2118,utRho30
1075,pepQ,8062294,8062322,8062294,28,46,utRho30
1076,pepT,2371646,2371688,2371646,42,18,utRho30
1077,pfkA,8214948,8215104,8214948,156,208,utRho30
1078,pfkB,3612646,3612740,3612646,94,174,utRho30
1079,pflA,1902456,1902456,1902160,296,0,utRho30
1080,pflB,1907850,1907850,1907108,742,426,utRho30
1081,pflD,8287716,8287990,8287716,274,280,utRho30
1082,pgaA,2185046,2185046,2184578,468,1598,utRho30
1083,pgi,8467444,8467516,8467444,72,226,utRho30
1084,pgk,12291428,12291428,12290488,940,1780,utRho30
1085,pgl,1597078,1597172,1597078,94,182,utRho30
1086,pgpB,2678324,2678660,2678324,336,272,utRho30
1087,pgpC,5397276,5397276,5397100,176,34,utRho30
1088,pgrR,2783744,2783982,2783744,238,760,utRho30
1089,pheL,5475158,5475198,5475158,40,12,utRho30
1090,pheM,7197204,7197204,7197080,124,0,utRho30
1091,pheP,1203858,1203918,1203858,60,94,utRho30
1092,pheU,8725254,8725254,8725252,2,0,utRho30
1093,pheV,6220730,6220732,6220730,2,22,utRho30
1094,phnC,8650412,8650412,8650330,82,322,utRho30
1095,phoA,803414,803494,803414,80,26,utRho30
1096,phoB,834202,834284,834202,82,488,utRho30
1097,phoE,520316,520316,520200,116,8,utRho30
1098,phoH,2169730,2169984,2169730,254,142,utRho30
1099,phoP,2381016,2381016,2380894,122,722,utRho30
1100,phoQ,2379880,2379880,2379552,328,544,utRho30
1101,phoU,7815330,7815330,7815156,174,270,utRho30
1102,phr,1478842,1479014,1478842,172,0,utRho30
1103,pinE,2419054,2419370,2419054,316,346,utRho30
1104,pinQ,3267168,3267244,3267168,76,124,utRho30
1105,pinR,2867424,2867424,2867348,76,38,utRho30
1106,pitA,7275224,7275284,7275224,60,54,utRho30
1107,pitB,6272806,6272806,6272742,64,182,utRho30
1108,pka,5439862,5439906,5439862,44,146,utRho30
1109,plaP,4174476,4174476,4174124,352,274,utRho30
1110,pldA,8009628,8009724,8009628,96,1042,utRho30
1111,pldB,8018028,8018340,8018028,312,680,utRho30
1112,plsB,8513196,8513196,8512932,264,436,utRho30
1113,pmbA,8915890,8915918,8915890,28,80,utRho30
1114,pmrD,4747148,4747148,4747076,72,0,utRho30
1115,pncB,1980828,1980828,1980712,116,222,utRho30
1116,pncC,5648788,5648788,5648692,96,64,utRho30
1117,pnp,6622652,6622652,6622336,316,738,utRho30
1118,pntA,3355950,3355950,3355806,144,258,utRho30
1119,pntB,3353096,3353096,3352720,376,732,utRho30
1120,polA,8093880,8093932,8093880,52,484,utRho30
1121,polB,131606,131606,131560,46,0,utRho30
1122,potD,2365700,2365700,2365658,42,64,utRho30
1123,potE,1436688,1436688,1436530,158,364,utRho30
1124,potF,1787268,1787568,1787268,300,678,utRho30
1125,poxB,1822152,1822152,1822098,54,36,utRho30
1126,ppa,8899372,8899372,8899304,68,138,utRho30
1127,ppc,8306380,8306380,8306196,184,4034,utRho30
1128,ppdA,5928440,5928440,5928354,86,66,utRho30
1129,ppdD,235410,235410,235098,312,302,utRho30
1130,pphA,3846770,3846770,3845938,832,752,utRho30
1131,pphB,5719474,5719520,5719474,46,164,utRho30
1132,ppiA,6984898,6984898,6984594,304,228,utRho30
1133,ppiC,7919682,7919682,7919626,56,14,utRho30
1134,ppiD,923638,923830,923638,192,116,utRho30
1135,ppk,5245748,5246088,5245748,340,664,utRho30
1136,pppA,6228958,6228958,6228704,254,112,utRho30
1137,ppsA,3574322,3574322,3574224,98,46,utRho30
1138,ppsR,3574678,3574890,3574678,212,40,utRho30
1139,pptA,3065716,3066104,3065716,388,744,utRho30
1140,pqiA,2023318,2024002,2023318,684,148,utRho30
1141,prc,3830054,3830054,3829632,422,1358,utRho30
1142,preT,4467978,4468066,4467978,88,248,utRho30
1143,prfC,9218688,9218828,9218688,140,190,utRho30
1144,prkB,6968622,6968980,6968622,358,566,utRho30
1145,prlC,7290476,7290476,7290364,112,1188,utRho30
1146,prlF,6553944,6554004,6553944,60,1070,utRho30
1147,proB,520432,520776,520432,344,36,utRho30
1148,proC,811372,811372,811288,84,162,utRho30
1149,proK,7417388,7417388,7417384,4,26,utRho30
1150,proL,4572414,4572422,4572414,8,38,utRho30
1151,proP,8660640,8661004,8660640,364,660,utRho30
1152,proS,437674,437674,437550,124,20,utRho30
1153,proV,5609126,5609630,5609126,504,1538,utRho30
1154,prpB,697292,697364,697292,72,192,utRho30
1155,prpR,696942,696942,696886,56,112,utRho30
1156,prs,2524354,2524354,2523750,604,2164,utRho30
1157,psd,8781276,8781276,8780720,556,1034,utRho30
1158,psiE,8480600,8480650,8480600,50,42,utRho30
1159,pspA,2736076,2736158,2736076,82,0,utRho30
1160,pspF,2736080,2736080,2735824,256,44,utRho30
1161,pspG,8525632,8525680,8525632,48,10,utRho30
1162,pssA,5445156,5445454,5445156,298,974,utRho30
1163,pstB,7817112,7817112,7816732,380,142,utRho30
1164,pstC,7821084,7821084,7820796,288,44,utRho30
1165,pstS,23469408,23469408,23469150,258,438,utRho30
1166,psuG,4517114,4517114,4516734,380,3992,utRho30
1167,psuT,4514992,4514992,4514670,322,144,utRho30
1168,pth,2517084,2517084,2517026,58,182,utRho30
1169,ptrA,5918022,5918022,5917768,254,248,utRho30
1170,ptrB,3857730,3857730,3857678,52,232,utRho30
1171,ptsG,2315252,2315738,2315252,486,292,utRho30
1172,ptsH,5066996,5067528,5066996,532,566,utRho30
1173,purA,8809328,8809374,8809328,46,920,utRho30
1174,purC,5195562,5195562,5195236,326,134,utRho30
1175,purD,8411972,8411972,8411862,110,0,utRho30
1176,purE,1106284,1106284,1106200,84,24,utRho30
1177,purH,8415254,8415254,8415064,190,274,utRho30
1178,purL,5391178,5391178,5391086,92,1880,utRho30
1179,purM,5242306,5242394,5242306,88,248,utRho30
1180,purR,3475378,3475688,3475378,310,58,utRho30
1181,purT,3861438,3861762,3861438,324,388,utRho30
1182,purU,2577512,2577512,2577248,264,0,utRho30
1183,putA,2157850,2157850,2157764,86,64,utRho30
1184,putP,2158336,2158610,2158336,274,304,utRho30
1185,puuA,2721936,2721936,2721816,120,164,utRho30
1186,puuC,2725456,2725486,2725456,30,30,utRho30
1187,puuD,2722104,2722240,2722104,136,112,utRho30
1188,puuP,2718746,2718746,2718374,372,134,utRho30
1189,pykA,3874988,3875298,3874988,310,96,utRho30
1190,pykF,3510934,3511396,3510934,462,212,utRho30
1191,pyrC,2245286,2245286,2245214,72,0,utRho30
1192,pyrD,2009464,2009536,2009464,72,872,utRho30
1193,pyrE,7631970,7631970,7631536,434,218,utRho30
1194,pyrF,2683740,2683842,2683740,102,1606,utRho30
1195,pyrG,5819594,5819594,5819332,262,984,utRho30
1196,pyrH,383624,383710,383624,86,348,utRho30
1197,pyrL,8945490,8945490,8945066,424,800,utRho30
1198,qmcA,1031646,1031646,1031546,100,1162,utRho30
1199,qor,8528608,8528608,8528462,146,320,utRho30
1200,qseB,6339502,6339656,6339502,154,224,utRho30
1201,queA,849970,850022,849970,52,168,utRho30
1202,queE,5811212,5811212,5810836,376,328,utRho30
1203,queF,5850642,5850696,5850642,54,260,utRho30
1204,queG,8788184,8788184,8788134,50,2140,utRho30
1205,racC,2835630,2835630,2835526,104,0,utRho30
1206,racR,2840898,2840898,2840482,416,872,utRho30
1207,raiA,5474208,5474308,5474208,100,116,utRho30
1208,rarD,8008594,8008594,8008356,238,546,utRho30
1209,ravA,7862256,7862256,7862186,70,934,utRho30
1210,rayT,495088,495274,495088,186,126,utRho30
1211,rbn,4763162,4763216,4763162,54,0,utRho30
1212,rbsD,7866644,7866702,7866644,58,12,utRho30
1213,rcnA,4371654,4371834,4371654,180,374,utRho30
1214,rcnB,4373768,4373920,4373768,152,180,utRho30
1215,rcnR,4371806,4371806,4371592,214,642,utRho30
1216,rcsA,4047672,4047936,4047672,264,1142,utRho30
1217,rcsB,4631390,4632354,4631390,964,502,utRho30
1218,rcsC,4640162,4640162,4639656,506,192,utRho30
1219,rcsD,4626904,4626976,4626904,72,280,utRho30
1220,rdgB,6193240,6193362,6193240,122,336,utRho30
1221,rdlA,2538646,2538646,2538646,0,0,utRho30
1222,rdlB,2539712,2539716,2539712,4,0,utRho30
1223,rdlC,2540782,2540786,2540782,4,0,utRho30
1224,rdlD,7400272,7400272,7400272,0,0,utRho30
1225,rdoA,8084782,8084830,8084782,48,160,utRho30
1226,recA,11295276,11295276,11295076,200,696,utRho30
1227,recC,5925014,5925014,5924856,158,16,utRho30
1228,recF,7763722,7763722,7762442,1280,1106,utRho30
1229,recN,5503518,5503590,5503518,72,0,utRho30
1230,recQ,8011666,8011728,8011666,62,208,utRho30
1231,relA,5828554,5828554,5827302,1252,904,utRho30
1232,relB,3291806,3291806,3291744,62,0,utRho30
1233,rem,3289950,3289950,3289804,146,78,utRho30
1234,rep,7921294,7921354,7921294,60,114,utRho30
1235,rfaD,7587730,7587974,7587730,244,1970,utRho30
1236,rfaE,6393852,6393852,6393506,346,276,utRho30
1237,rfaH,8049930,8049930,8049642,288,2124,utRho30
1238,rfbX,4219436,4219436,4219168,268,898,utRho30
1239,rfe,7935600,7935832,7935600,232,1434,utRho30
1240,rhaB,8194944,8194944,8194896,48,56,utRho30
1241,rhaD,8188770,8188770,8188544,226,18,utRho30
1242,rhaS,8195422,8195472,8195422,50,34,utRho30
1243,rhaT,8201132,8201132,8201050,82,296,utRho30
1244,rhlE,1661566,1661744,1661566,178,22,utRho30
1245,rhoL,47593944,47594772,47593944,828,5916,utRho30
1246,rhsB,7238006,7238384,7238006,378,436,utRho30
1247,rhsC,1458758,1459166,1458758,408,52,utRho30
1248,rhsD,1046132,1046522,1046132,390,334,utRho30
1249,rhtA,1700608,1700608,1700194,414,2028,utRho30
1250,rhtC,8015478,8015514,8015478,36,310,utRho30
1251,ribA,2678468,2678468,2678320,148,144,utRho30
1252,ribC,3486916,3486916,3486484,432,1362,utRho30
1253,ribE,869008,869294,869008,286,8908,utRho30
1254,ribF,42766,42814,42766,48,134,utRho30
1255,ridA,8941892,8941892,8941826,66,28,utRho30
1256,rihA,1369204,1369204,1368824,380,988,utRho30
1257,rihB,4510504,4510504,4510372,132,336,utRho30
1258,rimJ,2251044,2251124,2251044,80,182,utRho30
1259,rimK,1783752,1783934,1783752,182,88,utRho30
1260,rimL,2997486,2997876,2997486,390,238,utRho30
1261,rimO,1756140,1756140,1756070,70,90,utRho30
1262,rimP,6636350,6636350,6636012,338,448,utRho30
1263,rlmA,3814172,3814172,3814120,52,66,utRho30
1264,rlmD,5830086,5830086,5830000,86,0,utRho30
1265,rlmE,6655520,6655520,6655328,192,1092,utRho30
1266,rlmF,1684384,1684664,1684384,280,1078,utRho30
1267,rlmG,6471784,6471784,6471750,34,52,utRho30
1268,rlmI,2060002,2060002,2059938,64,336,utRho30
1269,rlmJ,7290700,7290770,7290700,70,98,utRho30
1270,rlmL,2015344,2015688,2015344,344,654,utRho30
1271,rlpA,1330444,1330444,1330380,64,32,utRho30
1272,rluA,120900,120900,120692,208,908,utRho30
1273,rluF,8460324,8460708,8460324,384,72,utRho30
1274,rmf,2031006,2031430,2031006,424,584,utRho30
1275,rna,1290068,1290068,1290006,62,0,utRho30
1276,rnb,2698258,2698258,2697824,434,308,utRho30
1277,rnc,10816892,10816892,10816252,640,88188,utRho30
1278,rnd,3776122,3776122,3775982,140,0,utRho30
1279,rne,2289746,2289746,2288734,1012,1018,utRho30
1280,rnhA,472082,472082,472004,78,1256,utRho30
1281,rnk,1288360,1288360,1287934,426,138,utRho30
1282,rnlA,5531788,5531836,5531788,48,890,utRho30
1283,rnlB,5533414,5533968,5533414,554,2144,utRho30
1284,rnpB,19623552,19623552,19623552,0,0,utRho30
1285,rob,9270706,9270706,9270620,86,364,utRho30
1286,rodZ,5285868,5285868,5285688,180,146,utRho30
1287,rpe,7030306,7030306,7030118,188,174,utRho30
1288,rph,15266320,15266320,15266196,124,288,utRho30
1289,rpiA,6118706,6118706,6118650,56,362,utRho30
1290,rpiB,8626514,8626700,8626514,186,770,utRho30
1291,rpiR,8626274,8626274,8625982,292,34,utRho30
1292,rplJ,8359246,8359992,8359246,746,3938,utRho30
1293,rplK,8356708,8356894,8356708,186,208,utRho30
1294,rplM,6757344,6757344,6757302,42,1388,utRho30
1295,rplN,6896444,6896444,6896298,146,688,utRho30
1296,rplS,5489284,5489284,5489060,224,6092,utRho30
1297,rplT,7199052,7199052,7198996,56,276,utRho30
1298,rplU,6667036,6667036,6666902,134,280,utRho30
1299,rplY,4564866,4565034,4564866,168,162,utRho30
1300,rpmA,6666450,6666450,6666238,212,298,utRho30
1301,rpmB,15247980,15247980,15246696,1284,23648,utRho30
1302,rpmE,8253816,8254026,8253816,210,1372,utRho30
1303,rpmF,2294676,2294734,2294676,58,5070,utRho30
1304,rpmH,7768130,7768672,7768130,542,1268,utRho30
1305,rpmI,3600854,3600854,3599998,856,5064,utRho30
1306,rpoB,8362126,8362490,8362126,364,320,utRho30
1307,rpoD,6424946,6426094,6424946,1148,71912,utRho30
1308,rpoE,5420372,5420372,5420024,348,0,utRho30
1309,rpoH,7202006,7202006,7201566,440,2526,utRho30
1310,rpoN,6689324,6689434,6689324,110,166,utRho30
1311,rpoS,5736236,5736236,5735102,1134,1910,utRho30
1312,rpoZ,7644154,7644212,7644154,58,30,utRho30
1313,rppH,5937986,5937986,5937954,32,496,utRho30
1314,rprA,3540744,3540744,3540744,0,0,utRho30
1315,rpsA,1923434,1923990,1923434,556,8922,utRho30
1316,rpsF,8850050,8850236,8850050,186,5012,utRho30
1317,rpsI,6756580,6756580,6756414,166,3598,utRho30
1318,rpsJ,6906884,6906884,6906540,344,922,utRho30
1319,rpsL,6949242,6949242,6949104,138,3638,utRho30
1320,rpsM,6885130,6885130,6884942,188,556,utRho30
1321,rpsO,13247144,13247144,13246736,408,100,utRho30
1322,rpsP,5492508,5492508,5492370,138,28,utRho30
1323,rpsT,42420,42420,42156,264,450,utRho30
1324,rpsU,12842584,12843124,12842584,540,4280,utRho30
1325,rraA,8238716,8238716,8238660,56,782,utRho30
1326,rraB,8956768,8956946,8956768,178,100,utRho30
1327,rrsA,8070478,8071062,8070478,584,1262,utRho30
1328,rrsB,16665468,16666636,16665468,1168,3152,utRho30
1329,rrsC,7883032,7883616,7883032,584,764,utRho30
1330,rrsD,6858094,6858094,6857524,570,246,utRho30
1331,rrsE,8415726,8416294,8415726,568,568,utRho30
1332,rrsG,5462896,5462896,5462314,582,1086,utRho30
1333,rrsH,446970,447542,446970,572,504,utRho30
1334,rsd,8393908,8393908,8393616,292,218,utRho30
1335,rseA,5419264,5419264,5418808,456,924,utRho30
1336,rseP,392940,393092,392940,152,418,utRho30
1337,rseX,4067298,4067298,4067298,0,0,utRho30
1338,rsfS,1338144,1338144,1338072,72,256,utRho30
1339,rsgA,8783132,8783132,8783018,114,72,utRho30
1340,rsmA,105176,105176,104860,316,612,utRho30
1341,rsmB,6869982,6870414,6869982,432,114,utRho30
1342,rsmC,9215736,9215736,9215400,336,16,utRho30
1343,rsmD,7208594,7208786,7208594,192,156,utRho30
1344,rsmE,6182036,6182268,6182036,232,326,utRho30
1345,rsmG,7847512,7847512,7847360,152,44,utRho30
1346,rsmH,180020,180188,180020,168,92,utRho30
1347,rsmI,6587106,6587106,6586670,436,830,utRho30
1348,rssA,2578212,2578412,2578212,200,196,utRho30
1349,rssB,2580440,2580484,2580440,44,410,utRho30
1350,rstA,3364276,3364300,3364276,24,0,utRho30
1351,rsuA,4561096,4561096,4560966,130,104,utRho30
1352,rsxA,3411510,3411534,3411510,24,198,utRho30
1353,rtcA,7114004,7114004,7113698,306,1356,utRho30
1354,rtcB,7116214,7116214,7116158,56,114,utRho30
1355,rtn,4541356,4541452,4541356,96,66,utRho30
1356,rutA,2148052,2148052,2148022,30,58,utRho30
1357,rutG,2140090,2140090,2139678,412,104,utRho30
1358,rutR,2148226,2148484,2148226,258,456,utRho30
1359,ruvA,7784096,7784096,7783904,192,172,utRho30
1360,ruvB,7782176,7782176,7781424,752,616,utRho30
1361,ruvC,3894878,3894878,3894752,126,0,utRho30
1362,rybB,1776114,1776114,1776114,0,0,utRho30
1363,rydB,3529860,3529860,3529322,538,222,utRho30
1364,rydC,2983012,2983012,2983012,0,0,utRho30
1365,ryfA,5307398,5307710,5307398,312,14,utRho30
1366,ryfD,5468590,5468590,5468590,0,0,utRho30
1367,ryhB,7162032,7162032,7162032,0,0,utRho30
1368,ryjA,8556132,8556132,8556132,0,0,utRho30
1369,ryjB,9055954,9055954,9055954,0,0,utRho30
1370,sad,3229598,3229598,3229406,192,540,utRho30
1371,safA,3168056,3168056,3167918,138,376,utRho30
1372,sanA,4465368,4465756,4465368,388,0,utRho30
1373,sapF,2705314,2705314,2705268,46,66,utRho30
1374,sbcB,4165456,4165512,4165456,56,108,utRho30
1375,sbcC,831694,831694,831506,188,64,utRho30
1376,sbcD,833954,833954,833904,50,1038,utRho30
1377,sbmA,793106,793278,793106,172,1564,utRho30
1378,sbmC,4162650,4162650,4162524,126,110,utRho30
1379,sdaA,3793618,3793864,3793618,246,1786,utRho30
1380,sdaC,5856070,5856458,5856070,388,49186,utRho30
1381,sdhC,1509916,1510354,1509916,438,4962,utRho30
1382,sdhD,1510808,1511120,1510808,312,366,utRho30
1383,sdiA,3993834,3993834,3993664,170,346,utRho30
1384,secE,8354354,8354716,8354354,362,1226,utRho30
1385,secG,6645180,6645180,6645010,170,528,utRho30
1386,selA,7522594,7522594,7522498,96,406,utRho30
1387,selB,7519850,7519850,7519722,128,266,utRho30
1388,selC,7672396,7672444,7672396,48,102,utRho30
1389,selD,3696058,3696058,3696016,42,756,utRho30
1390,seqA,1425884,1425974,1425884,90,54,utRho30
1391,serA,6117098,6117098,6116820,278,100,utRho30
1392,serB,9249712,9249790,9249712,78,112,utRho30
1393,serC,3830380,3830612,3830380,232,36,utRho30
1394,serS,1878730,1878856,1878730,126,890,utRho30
1395,serT,2063438,2063438,2063424,14,24,utRho30
1396,serU,4087124,4087124,4087114,10,26,utRho30
1397,serV,5637394,5637394,5637290,104,18,utRho30
1398,serW,1852014,1852014,1851942,72,268,utRho30
1399,serX,2195352,2195352,2195304,48,10,utRho30
1400,setB,4527426,4527726,4527426,300,72,utRho30
1401,setC,7673488,7673906,7673488,418,498,utRho30
1402,sfmA,1116124,1116424,1116124,300,318,utRho30
1403,sfmC,1117606,1117948,1117606,342,56,utRho30
1404,sfsA,323030,323030,322972,58,56,utRho30
1405,sfsB,6669592,6669818,6669592,226,94,utRho30
1406,sgrR,154676,154676,154598,78,470,utRho30
1407,sgrS,154734,154734,154734,0,0,utRho30
1408,shiA,4107068,4107286,4107068,218,0,utRho30
1409,sibA,4306622,4306622,4306622,0,0,utRho30
1410,sibB,4307292,4307292,4307292,0,0,utRho30
1411,sibC,6113702,6113702,6113702,0,0,utRho30
1412,sibD,6389730,6389730,6389730,0,0,utRho30
1413,sibE,6390480,6390480,6390480,0,0,utRho30
1414,sixA,4913998,4913998,4913624,374,176,utRho30
1415,slp,7307872,7307922,7307872,50,164,utRho30
1416,slt,9261400,9261466,9261400,66,0,utRho30
1417,slyA,3442028,3442028,3441648,380,12,utRho30
1418,slyB,3439496,3439752,3439496,256,204,utRho30
1419,slyD,6957398,6957398,6956994,404,544,utRho30
1420,slyX,6954862,6955280,6954862,418,9782,utRho30
1421,smf,6867372,6867372,6867120,252,716,utRho30
1422,smpB,5509534,5509792,5509534,258,2284,utRho30
1423,smrA,2811872,2811958,2811872,86,1358,utRho30
1424,smrB,4896872,4897212,4896872,340,778,utRho30
1425,smtA,1946808,1947074,1946808,266,58,utRho30
1426,sodA,8201518,8201620,8201518,102,480,utRho30
1427,sodB,3470646,3470756,3470646,110,34,utRho30
1428,sodC,3449358,3449358,3449310,48,112,utRho30
1429,sohB,2658568,2658664,2658568,96,148,utRho30
1430,sokB,2984232,2984238,2984232,6,108,utRho30
1431,solA,2241218,2241218,2241172,46,214,utRho30
1432,soxR,8554894,8554938,8554894,44,0,utRho30
1433,soxS,8554846,8554846,8554766,80,0,utRho30
1434,speA,6172096,6172096,6171822,274,1268,utRho30
1435,speB,6167892,6167892,6167594,298,344,utRho30
1436,speC,6218350,6218350,6218310,40,0,utRho30
1437,spf,8099798,8099798,8099798,0,0,utRho30
1438,sppA,3697422,3697674,3697422,252,900,utRho30
1439,spy,3651376,3651376,3651250,126,80,utRho30
1440,sra,3112092,3112092,3111926,166,88,utRho30
1441,sraB,2293178,2293178,2293178,0,0,utRho30
1442,sraC,3846132,3846132,3846132,0,0,utRho30
1443,srlA,5651582,5651664,5651582,82,590,utRho30
1444,srlR,5657720,5658094,5657720,374,1906,utRho30
1445,srmB,5425752,5425792,5425752,40,214,utRho30
1446,sroA,151216,151216,151216,0,0,utRho30
1447,sroG,6369436,6369436,6369436,0,0,utRho30
1448,sroH,8380974,8380974,8380974,0,0,utRho30
1449,ssb,8548022,8548250,8548022,228,136,utRho30
1450,sseA,5304782,5304988,5304782,206,2044,utRho30
1451,sspA,6755138,6755138,6754840,298,170,utRho30
1452,ssrA,5511014,5511186,5511014,172,766,utRho30
1453,ssrS,12223036,12223932,12223036,896,1984,utRho30
1454,sstT,6479726,6479888,6479726,162,132,utRho30
1455,ssuB,1988282,1988282,1988088,194,952,utRho30
1456,ssuE,1995126,1995126,1995024,102,298,utRho30
1457,sthA,8321604,8321604,8321580,24,348,utRho30
1458,stpA,5597156,5597156,5596990,166,192,utRho30
1459,sucA,3034344,3034824,3034344,480,288,utRho30
1460,sufA,3528836,3528836,3528772,64,48,utRho30
1461,sufE,3518962,3518962,3518580,382,336,utRho30
1462,sugE,8753588,8753750,8753588,162,290,utRho30
1463,sulA,2041894,2041894,2041838,56,30834,utRho30
1464,syd,5850738,5850738,5850560,178,356,utRho30
1465,symE,9159834,9159834,9159680,154,0,utRho30
1466,symR,9159670,9159670,9159670,0,0,utRho30
1467,tabA,8949566,8949724,8949566,158,0,utRho30
1468,talA,5157140,5157332,5157140,192,122,utRho30
1469,talB,16382,16476,16382,94,1918,utRho30
1470,tam,3214442,3214692,3214442,250,1110,utRho30
1471,tamA,8884540,8884764,8884540,224,3054,utRho30
1472,tar,3945432,3945432,3945382,50,12,utRho30
1473,tas,5943138,5943194,5943138,56,112,utRho30
1474,tatA,16087636,16087780,16087636,144,1032,utRho30
1475,tatE,1317742,1317894,1317742,152,58,utRho30
1476,tauA,770410,770464,770410,54,38,utRho30
1477,tdcA,6534186,6534186,6534130,56,230,utRho30
1478,tdcG,6519652,6519652,6519298,354,506,utRho30
1479,tdcR,6534380,6534760,6534380,380,294,utRho30
1480,tdk,2586986,2587054,2586986,68,242,utRho30
1481,tehA,3001072,3001146,3001072,74,80,utRho30
1482,tesA,1039898,1039898,1039530,368,838,utRho30
1483,tesB,950402,950402,950322,80,0,utRho30
1484,tfaE,2418532,2418532,2418238,294,766,utRho30
1485,tfaQ,3269912,3269912,3269770,142,226,utRho30
1486,tff,379424,379256,379424,168,686,utRho30
1487,tgt,852110,852274,852110,164,46,utRho30
1488,thiD,4369346,4369346,4369032,314,256,utRho30
1489,thiI,882936,883098,882936,162,106,utRho30
1490,thiM,4370902,4370902,4370602,300,916,utRho30
1491,thiQ,146170,146170,145854,316,6380,utRho30
1492,thrL,592,760,592,168,1568,utRho30
1493,thrS,7210932,7210932,7210280,652,2516,utRho30
1494,thrU,8350762,8350776,8350762,14,692,utRho30
1495,thrV,6847414,6847414,6847310,104,101318,utRho30
1496,thrW,525682,525742,525682,60,68,utRho30
1497,thyA,5930696,5930696,5930310,386,1028,utRho30
1498,tig,909986,910266,909986,280,372,utRho30
1499,tisB,7706674,7707106,7706674,432,2050,utRho30
1500,tktA,6163414,6163414,6163270,144,342,utRho30
1501,tktB,5158616,5159272,5158616,656,1082,utRho30
1502,tldD,6784368,6784368,6784056,312,94,utRho30
1503,tmcA,5191876,5191876,5191718,158,188,utRho30
1504,tnaC,15553644,15553740,15553644,96,528,utRho30
1505,tolB,1555074,1555480,1555074,406,564,utRho30
1506,tolC,6356008,6356230,6356008,222,66,utRho30
1507,tomB,961588,961588,961416,172,604,utRho30
1508,tonB,2622108,2622178,2622108,70,90,utRho30
1509,topA,2661578,2662096,2661578,518,894,utRho30
1510,torC,2116112,2116168,2116112,56,606,utRho30
1511,torR,2115968,2115968,2115908,60,546,utRho30
1512,torS,2112364,2112364,2112356,8,30,utRho30
1513,torT,2112414,2112522,2112414,108,60,utRho30
1514,tpiA,8223138,8223138,8223014,124,18,utRho30
1515,tppB,3425342,3425538,3425342,196,792,utRho30
1516,tpr,2574376,2574376,2574376,0,0,utRho30
1517,tpx,2777688,2777688,2777622,66,1430,utRho30
1518,tqsA,3347780,3347826,3347780,46,2,utRho30
1519,treA,2494850,2494850,2494752,98,152,utRho30
1520,treB,8932420,8932420,8932360,60,210,utRho30
1521,treF,7339102,7339184,7339102,82,92,utRho30
1522,treR,8934694,8934694,8934492,202,372,utRho30
1523,trg,2984878,2984940,2984878,62,56,utRho30
1524,trkG,2847342,2847564,2847342,222,1614,utRho30
1525,trmA,8326590,8326590,8326540,50,56,utRho30
1526,trpA,2634678,2634678,2634444,234,328,utRho30
1527,trpC,2639888,2639888,2639570,318,0,utRho30
1528,trpL,5292432,5292432,5292328,104,36,utRho30
1529,trpR,9265408,9265520,9265408,112,22,utRho30
1530,trpS,7027394,7027394,7027276,118,348,utRho30
1531,trpT,7893560,7893914,7893560,354,51318,utRho30
1532,trxA,7931294,7931522,7931294,228,3678,utRho30
1533,trxB,1864156,1864156,1864100,56,140,utRho30
1534,trxC,5437350,5437470,5437350,120,592,utRho30
1535,tsaD,6421256,6421256,6421086,170,4270,utRho30
1536,tsgA,6985038,6985136,6985038,98,364,utRho30
1537,tsr,9182824,9183314,9182824,490,1510,utRho30
1538,tsx,864490,864490,864026,464,1226,utRho30
1539,ttcA,2823970,2823970,2823896,74,1858,utRho30
1540,ttdA,6412848,6412926,6412848,78,66,utRho30
1541,ttdR,6412760,6412760,6412512,248,1362,utRho30
1542,tufA,6943448,6943448,6942658,790,25080,utRho30
1543,tus,3368346,3368518,3368346,172,20,utRho30
1544,tusA,7218040,7218040,7217992,48,1240,utRho30
1545,tusB,6950218,6950218,6949930,288,190,utRho30
1546,tynA,2902996,2902996,2902698,298,68,utRho30
1547,typA,8116460,8116814,8116460,354,600,utRho30
1548,tyrB,8534164,8534228,8534164,64,246,utRho30
1549,tyrP,3979004,3979362,3979004,358,32,utRho30
1550,tyrR,2773384,2773440,2773384,56,68,utRho30
1551,tyrS,3434566,3434566,3434444,122,0,utRho30
1552,tyrT,2575330,2575330,2575244,86,6,utRho30
1553,uacT,6062378,6062734,6062378,356,550,utRho30
1554,ubiC,8504886,8505012,8504886,126,64,utRho30
1555,ubiD,8049618,8049976,8049618,358,2150,utRho30
1556,ubiE,8037494,8037710,8037494,216,258,utRho30
1557,ubiG,4679078,4679134,4679078,56,0,utRho30
1558,ucpA,5089342,5089342,5089246,96,484,utRho30
1559,udp,8032782,8032862,8032782,80,464,utRho30
1560,ugd,4199470,4199470,4199226,244,136,utRho30
1561,ugpB,7184852,7184852,7184650,202,2684,utRho30
1562,ugpQ,7176600,7176600,7176226,374,108,utRho30
1563,uhpT,7694396,7694396,7694334,62,68,utRho30
1564,uidA,3392304,3392304,3392142,162,10,utRho30
1565,uidC,3386012,3386012,3385702,310,0,utRho30
1566,uidR,3394150,3394150,3394104,46,0,utRho30
1567,ulaA,8839854,8839960,8839854,106,522,utRho30
1568,ulaG,8839350,8839350,8839250,100,350,utRho30
1569,ulaR,8837124,8837124,8836906,218,0,utRho30
1570,umpG,5741372,5741372,5740548,824,168,utRho30
1571,umpH,1400704,1400704,1400652,52,60,utRho30
1572,umuD,2461476,2461534,2461476,58,34,utRho30
1573,ung,5433476,5433508,5433476,32,126,utRho30
1574,uof,2843316,2843316,2842900,416,712,utRho30
1575,upp,5241818,5241818,5241744,74,116,utRho30
1576,usg,4873780,4873780,4873298,482,744,utRho30
1577,ushA,1009772,1009828,1009772,56,776,utRho30
1578,uspA,7279966,7280222,7279966,256,682,utRho30
1579,uspB,7279696,7279696,7279440,256,728,utRho30
1580,uspC,3959172,3959506,3959172,334,46,utRho30
1581,uspE,2797318,2797318,2797244,74,2,utRho30
1582,uspF,2871282,2871282,2871238,44,2,utRho30
1583,uspG,1283806,1283806,1283734,72,472,utRho30
1584,uvrA,8547872,8547872,8547742,130,236,utRho30
1585,uvrB,1626304,1627052,1626304,748,430,utRho30
1586,uvrC,3989758,3989758,3989412,346,16,utRho30
1587,uvrD,7995814,7995966,7995814,152,16,utRho30
1588,uvrY,3990812,3990812,3990718,94,70,utRho30
1589,uxaB,3221474,3221474,3221360,114,594,utRho30
1590,uxaC,6489714,6489714,6489482,232,70,utRho30
1591,uxuA,9103036,9103272,9103036,236,1016,utRho30
1592,uxuR,9108916,9109152,9108916,236,76,utRho30
1593,valS,8967854,8967854,8967674,180,706,utRho30
1594,valU,5041848,5041862,5041848,14,80,utRho30
1595,valV,3492830,3492870,3492830,40,42,utRho30
1596,ves,3649968,3649968,3649874,94,64,utRho30
1597,waaA,7616512,7617080,7616512,568,2918,utRho30
1598,waaH,7580298,7580298,7580162,136,66,utRho30
1599,waaQ,7616476,7616476,7616196,280,2130,utRho30
1600,waaU,7598996,7598996,7598624,372,256,utRho30
1601,waaY,7602272,7602272,7601930,342,10024,utRho30
1602,wbbH,4214888,4214888,4214452,436,2214,utRho30
1603,wbbK,4209212,4209212,4209018,194,152,utRho30
1604,wcaM,4231868,4231868,4231792,76,68,utRho30
1605,wrbA,2135516,2135516,2135416,100,72,utRho30
1606,wza,4275166,4275166,4274486,680,448,utRho30
1607,wzxC,4240674,4240674,4240316,358,224,utRho30
1608,wzzB,4196950,4196950,4196602,348,72,utRho30
1609,xanP,7657642,7657890,7657642,248,278,utRho30
1610,xanQ,6048520,6048702,6048520,182,0,utRho30
1611,xapA,5049820,5049820,5049756,64,20,utRho30
1612,xapR,10090252,10090252,10089908,344,0,utRho30
1613,xdhA,6000514,6000690,6000514,176,540,utRho30
1614,xerD,6079702,6079702,6079486,216,172,utRho30
1615,xseA,5268394,5268464,5268394,70,202,utRho30
1616,xseB,882746,882746,882686,60,62,utRho30
1617,xthA,3664798,3664856,3664798,58,0,utRho30
1618,xylA,7461614,7461614,7461530,84,4032,utRho30
1619,xylE,8484540,8484540,8484508,32,0,utRho30
1620,xylF,7462138,7462262,7462138,124,1508,utRho30
1621,xylR,7469812,7469958,7469812,146,0,utRho30
1622,yaaA,13230,13230,12918,312,148,utRho30
1623,yaaI,23876,23876,23572,304,384,utRho30
1624,yaaJ,16034,16034,15918,116,150,utRho30
1625,yaaU,91184,91614,91184,430,1736,utRho30
1626,yaaW,23084,23084,22712,372,370,utRho30
1627,yaaX,10060,10468,10060,408,174,utRho30
1628,yabI,142542,142702,142542,160,124,utRho30
1629,yacC,273880,273880,273834,46,556,utRho30
1630,yacH,262932,262932,262520,412,222,utRho30
1631,yacL,268678,268776,268678,98,376,utRho30
1632,yadD,293796,293936,293796,140,288,utRho30
1633,yadE,289930,290162,289930,232,246,utRho30
1634,yadN,314110,314110,313766,344,134,utRho30
1635,yadS,355572,355572,355248,324,710,utRho30
1636,yadV,312470,312470,312402,68,500,utRho30
1637,yaeF,434270,434270,434006,264,236,utRho30
1638,yaeP,428374,428374,428250,124,264,utRho30
1639,yaeQ,428176,428582,428176,406,370,utRho30
1640,yaeR,423716,423754,423716,38,24,utRho30
1641,yafC,462166,462166,461762,404,738,utRho30
1642,yafD,462128,462244,462128,116,860,utRho30
1643,yafK,491986,491986,491610,376,376,utRho30
1644,yafL,493282,493424,493282,142,160,utRho30
1645,yafN,503938,504010,503938,72,152,utRho30
1646,yafS,469568,469632,469568,64,494,utRho30
1647,yafT,474470,474670,474470,200,228,utRho30
1648,yafV,480432,480432,480378,54,0,utRho30
1649,yafZ,536052,536052,536010,42,2,utRho30
1650,yagE,564446,564556,564446,110,278,utRho30
1651,yagG,570414,570790,570414,376,364,utRho30
1652,yagI,578384,578384,578324,60,72,utRho30
1653,yagK,586236,586236,585896,340,1940,utRho30
1654,yagL,588062,588062,587836,226,338,utRho30
1655,yagN,591342,591342,591158,184,186,utRho30
1656,yahA,663746,664742,663746,996,6992,utRho30
1657,yahC,670136,670136,670044,92,728,utRho30
1658,yahE,671478,671850,671478,372,484,utRho30
1659,yahM,690504,690808,690504,304,876,utRho30
1660,yahN,692872,692872,692674,198,1678,utRho30
1661,yahO,692864,692968,692864,104,944,utRho30
1662,yaiE,816296,816354,816296,58,72,utRho30
1663,yaiI,811396,811528,811396,132,74,utRho30
1664,yaiO,761946,761946,761684,262,418,utRho30
1665,yaiP,767970,767970,767870,100,78,utRho30
1666,yaiS,769660,769660,769232,428,656,utRho30
1667,yaiV,788922,788922,788922,0,0,utRho30
1668,yaiY,799094,799094,798666,428,698,utRho30
1669,yaiZ,798888,799186,798888,298,324,utRho30
1670,yajC,854410,854574,854410,164,286,utRho30
1671,yajD,860938,861210,860938,272,110,utRho30
1672,yajI,866068,866068,865702,366,308,utRho30
1673,yajL,887496,887496,887282,214,88,utRho30
1674,yajQ,889316,889366,889316,50,22,utRho30
1675,yajR,893374,893374,893332,42,244,utRho30
1676,ybaB,987418,988152,987418,734,776,utRho30
1677,ybaL,1006590,1006590,1006476,114,326,utRho30
1678,ybaM,980648,980648,980542,106,392,utRho30
1679,ybaN,981436,981764,981436,328,808,utRho30
1680,ybaO,936704,936766,936704,62,0,utRho30
1681,ybaP,1016568,1016568,1016160,408,686,utRho30
1682,ybaQ,1016348,1016436,1016348,88,130,utRho30
1683,ybaS,1023146,1023282,1023146,136,2474,utRho30
1684,ybaV,927504,927874,927504,370,54,utRho30
1685,ybaY,950490,950758,950490,268,56,utRho30
1686,ybbB,1062724,1062724,1062452,272,232,utRho30
1687,ybbJ,1030154,1030154,1029718,436,824,utRho30
1688,ybbL,1031784,1031838,1031784,54,62,utRho30
1689,ybbN,1037136,1037136,1036558,578,1228,utRho30
1690,ybbO,1038658,1038658,1038298,360,560,utRho30
1691,ybbY,1080718,1081130,1080718,412,400,utRho30
1692,ybcH,1176140,1176140,1175962,178,68,utRho30
1693,ybcI,1113264,1113264,1113106,158,556,utRho30
1694,ybcJ,1114050,1114050,1113746,304,188,utRho30
1695,ybcK,1137502,1137804,1137502,302,180,utRho30
1696,ybcL,1141690,1141786,1141690,96,8,utRho30
1697,ybcN,1144628,1144932,1144628,304,8,utRho30
1698,ybcQ,1147548,1147912,1147548,364,240,utRho30
1699,ybcW,1159610,1159760,1159610,150,6,utRho30
1700,ybdD,1263982,1264364,1263982,382,796,utRho30
1701,ybdF,1212106,1212106,1211772,334,210,utRho30
1702,ybdH,1267048,1267048,1266954,94,190,utRho30
1703,ybdJ,1212822,1212822,1212398,424,8,utRho30
1704,ybdK,1215122,1215122,1214766,356,274,utRho30
1705,ybdL,1267114,1267172,1267114,58,0,utRho30
1706,ybdM,1271110,1271110,1270752,358,612,utRho30
1707,ybdN,1273372,1273372,1273138,234,64,utRho30
1708,ybdR,1283844,1284176,1283844,332,638,utRho30
1709,ybeD,1325412,1325412,1325284,128,1528,utRho30
1710,ybeF,1323090,1323090,1322756,334,3452,utRho30
1711,ybeL,1349986,1350036,1349986,50,158,utRho30
1712,ybeQ,1353412,1353412,1353094,318,82,utRho30
1713,ybeR,1353120,1353422,1353120,302,82,utRho30
1714,ybeT,1358832,1358832,1358812,20,168,utRho30
1715,ybeU,1358924,1359016,1358924,92,378,utRho30
1716,ybeZ,1386938,1386938,1386834,104,700,utRho30
1717,ybfA,1458074,1458268,1458074,194,1584,utRho30
1718,ybfE,1423878,1423878,1423796,82,160,utRho30
1719,ybfF,1425692,1425692,1425604,88,192,utRho30
1720,ybfH,1433282,1433282,1433194,88,194,utRho30
1721,ybgA,1477840,1478002,1477840,162,4,utRho30
1722,ybgC,1549288,1549504,1549288,216,242,utRho30
1723,ybgD,1505916,1505916,1505590,326,16942,utRho30
1724,ybgI,1485238,1485654,1485238,416,0,utRho30
1725,ybgO,1498370,1498370,1497964,406,532,utRho30
1726,ybgS,1570992,1570992,1570634,358,32,utRho30
1727,ybhA,1597184,1597184,1596862,322,270,utRho30
1728,ybhB,1616070,1616070,1615818,252,110,utRho30
1729,ybhC,1614642,1614642,1614562,80,90,utRho30
1730,ybhD,1601418,1601418,1601276,142,12,utRho30
1731,ybhH,1601104,1601518,1601104,414,28,utRho30
1732,ybhK,1633384,1633384,1633294,90,4,utRho30
1733,ybhM,1641556,1641586,1641556,30,216,utRho30
1734,ybhN,1645296,1645296,1644996,300,178,utRho30
1735,ybhQ,1649202,1649260,1649202,58,28,utRho30
1736,ybiA,1665920,1665920,1665900,20,0,utRho30
1737,ybiI,1676968,1676968,1676912,56,478,utRho30
1738,ybiO,1691328,1691328,1690960,368,850,utRho30
1739,ybiP,1705252,1705252,1705194,58,124,utRho30
1740,ybiS,1711572,1711572,1711488,84,62,utRho30
1741,ybiT,1711894,1711926,1711894,32,0,utRho30
1742,ybiU,1718212,1718212,1718122,90,22,utRho30
1743,ybiV,1720176,1720176,1720056,120,0,utRho30
1744,ybiW,1725566,1725566,1725212,354,3290,utRho30
1745,ybiX,1678548,1678548,1678414,134,750,utRho30
1746,ybjC,1781784,1781826,1781784,42,0,utRho30
1747,ybjE,1830154,1830154,1829714,440,2364,utRho30
1748,ybjG,1767016,1767016,1766776,240,988,utRho30
1749,ybjL,1779882,1779882,1779638,244,86,utRho30
1750,ybjM,1779770,1780178,1779770,408,726,utRho30
1751,ybjO,1795704,1795978,1795704,274,156,utRho30
1752,ybjP,1809046,1809046,1808934,112,0,utRho30
1753,ybjQ,1809034,1809186,1809034,152,0,utRho30
1754,ybjS,1813796,1813796,1813506,290,218,utRho30
1755,ybjX,1838206,1838206,1838168,38,64,utRho30
1756,ycaD,1891438,1891742,1891438,304,20,utRho30
1757,ycaI,1928210,1928640,1928210,430,320,utRho30
1758,ycaK,1899094,1899336,1899094,242,208,utRho30
1759,ycaL,1920264,1920528,1920264,264,238,utRho30
1760,ycaM,1894240,1894458,1894240,218,350,utRho30
1761,ycaR,1941284,1941346,1941284,62,346,utRho30
1762,ycbB,1961862,1962094,1961862,232,636,utRho30
1763,ycbJ,1943344,1943504,1943344,160,4,utRho30
1764,ycbK,1966046,1966150,1966046,104,10,utRho30
1765,ycbZ,2036920,2036920,2036598,322,88,utRho30
1766,yccA,2062886,2062886,2062836,50,818,utRho30
1767,yccF,2048730,2048730,2048696,34,178,utRho30
1768,yccS,2047988,2047988,2047766,222,2386,utRho30
1769,yccT,2055674,2055674,2055546,128,692,utRho30
1770,yccX,2059960,2060128,2059960,168,718,utRho30
1771,ycdT,2185682,2185752,2185682,70,60,utRho30
1772,ycdU,2191266,2191686,2191266,420,654,utRho30
1773,ycdZ,2200504,2200592,2200504,88,42,utRho30
1774,yceA,2233544,2233614,2233544,70,130,utRho30
1775,yceD,2293298,2293588,2293298,290,1360,utRho30
1776,yceF,2293522,2293522,2293190,332,890,utRho30
1777,yceH,2252154,2252314,2252154,160,562,utRho30
1778,yceI,2237282,2237282,2236952,330,372,utRho30
1779,yceJ,2238142,2238142,2238092,50,848,utRho30
1780,yceM,2253208,2253612,2253208,404,122,utRho30
1781,yceO,2239264,2239264,2238894,370,792,utRho30
1782,yceQ,2288760,2289004,2288760,244,866,utRho30
1783,ycfD,2376540,2376540,2376480,60,158,utRho30
1784,ycfJ,2334814,2335198,2334814,384,84,utRho30
1785,ycfS,2340834,2340834,2340748,86,22,utRho30
1786,ycfT,2350658,2350658,2350330,328,196,utRho30
1787,ycfZ,2362760,2362760,2362534,226,774,utRho30
1788,ycgB,2474570,2474570,2474482,88,16,utRho30
1789,ycgG,2434614,2434656,2434614,42,604,utRho30
1790,ycgJ,2452956,2453200,2452956,244,378,utRho30
1791,ycgL,2455218,2455362,2455218,144,52,utRho30
1792,ycgN,2457366,2457660,2457366,294,132,utRho30
1793,ycgR,2489112,2489112,2489054,58,50,utRho30
1794,ycgV,2512222,2512222,2511904,318,886,utRho30
1795,ycgX,2426568,2426568,2426214,354,4368,utRho30
1796,ycgY,2490166,2490320,2490166,154,714,utRho30
1797,ycgZ,2431504,2431578,2431504,74,288,utRho30
1798,ychE,2596904,2597196,2596904,292,132,utRho30
1799,ychF,2515764,2515764,2515624,140,2,utRho30
1800,ychH,2517476,2517582,2517476,106,1314,utRho30
1801,ychJ,2578354,2578354,2578264,90,62,utRho30
1802,ychN,2547310,2547310,2547198,112,38,utRho30
1803,ychO,2547520,2547850,2547520,330,490,utRho30
1804,ychQ,2533798,2533848,2533798,50,0,utRho30
1805,yciA,2624828,2624828,2624492,336,60,utRho30
1806,yciB,2626110,2626110,2625780,330,600,utRho30
1807,yciC,2627396,2627396,2627326,70,42,utRho30
1808,yciE,2630794,2630794,2630448,346,186,utRho30
1809,yciG,5264368,5264368,5264140,228,0,utRho30
1810,yciI,2621784,2621784,2621730,54,282,utRho30
1811,yciN,2661606,2661606,2661336,270,228,utRho30
1812,yciS,2680270,2680486,2680270,216,102,utRho30
1813,yciT,2689088,2689088,2688692,396,400,utRho30
1814,yciU,2614718,2614718,2614300,418,358,utRho30
1815,yciV,2646376,2646440,2646376,64,14,utRho30
1816,yciW,2700472,2700472,2700214,258,102,utRho30
1817,yciZ,2689276,2689276,2689218,58,310,utRho30
1818,ycjD,2703792,2703792,2703520,272,0,utRho30
1819,ycjG,2777748,2777860,2777748,112,154,utRho30
1820,ycjM,2740006,2740432,2740006,426,152,utRho30
1821,ycjW,2767982,2767982,2767922,60,108,utRho30
1822,ycjX,2768138,2768234,2768138,96,266,utRho30
1823,ycjY,5568288,5568288,5567460,828,1816,utRho30
1824,ydaE,2836438,2836438,2836016,422,274,utRho30
1825,ydaN,2816048,2816100,2816048,52,204,utRho30
1826,ydaS,2840340,2840730,2840340,390,1276,utRho30
1827,ydbC,2948376,2948442,2948376,66,62,utRho30
1828,ydbD,2950132,2950288,2950132,156,100,utRho30
1829,ydbH,2885800,2886102,2885800,302,8078,utRho30
1830,ydbJ,2881712,2882116,2881712,404,1472,utRho30
1831,ydbK,2881692,2881692,2881568,124,388,utRho30
1832,ydcA,2983294,2983354,2983294,60,298,utRho30
1833,ydcF,2974404,2974470,2974404,66,0,utRho30
1834,ydcI,2990268,2990268,2990142,126,0,utRho30
1835,ydcJ,2990266,2990576,2990266,310,0,utRho30
1836,ydcK,3001280,3001280,3000898,382,494,utRho30
1837,ydcL,3004646,3004914,3004646,268,54,utRho30
1838,ydcN,3012308,3012344,3012308,36,160,utRho30
1839,ydcP,3013508,3013562,3013508,54,18,utRho30
1840,ydcR,3019956,3020006,3019956,50,52,utRho30
1841,ydcS,3022906,3023308,3022906,402,136,utRho30
1842,ydcX,3034442,3034778,3034442,336,342,utRho30
1843,ydcY,3035220,3035296,3035220,76,94,utRho30
1844,ydcZ,3036750,3036750,3036662,88,812,utRho30
1845,yddB,3155332,3155332,3155238,94,116,utRho30
1846,yddE,3071738,3071738,3071716,22,10,utRho30
1847,yddG,3094410,3094410,3094338,72,42,utRho30
1848,yddJ,3089732,3089732,3089438,294,1434,utRho30
1849,yddW,3137704,3137704,3137646,58,0,utRho30
1850,ydeA,3233910,3234056,3233910,146,3886,utRho30
1851,ydeE,3242528,3242664,3242528,136,928,utRho30
1852,ydeI,3249118,3249118,3248994,124,58,utRho30
1853,ydeJ,3249376,3249546,3249376,170,64,utRho30
1854,ydeN,3165458,3165458,3165048,410,46,utRho30
1855,ydeP,3173328,3173328,3172972,356,512,utRho30
1856,ydeR,3176596,3176596,3176592,4,124,utRho30
1857,ydfA,3296872,3297016,3296872,144,4,utRho30
1858,ydfG,3254982,3255034,3254982,52,180,utRho30
1859,ydfH,3256652,3256704,3256652,52,0,utRho30
1860,ydfK,3265446,3266144,3265446,698,1662,utRho30
1861,ydgA,3379588,3379704,3379588,116,2,utRho30
1862,ydgC,3364124,3364124,3364060,64,82,utRho30
1863,ydgD,3343906,3343920,3343906,14,14,utRho30
1864,ydgH,3356754,3356854,3356754,100,122,utRho30
1865,ydgJ,3408798,3408798,3408616,182,510,utRho30
1866,ydgK,3410414,3410500,3410414,86,488,utRho30
1867,ydhB,3479618,3479618,3479596,22,0,utRho30
1868,ydhC,3479698,3479822,3479698,124,0,utRho30
1869,ydhF,3451310,3451310,3451264,46,0,utRho30
1870,ydhI,3441996,3442050,3441996,54,0,utRho30
1871,ydhL,3451864,3451864,3451840,24,434,utRho30
1872,ydhQ,3492404,3492404,3492254,150,0,utRho30
1873,ydhS,3494136,3494262,3494136,126,338,utRho30
1874,ydhT,3499138,3499138,3499118,20,126,utRho30
1875,ydhY,3509284,3509284,3508954,330,408,utRho30
1876,ydhZ,3510418,3510418,3510282,136,336,utRho30
1877,ydiE,3579206,3579226,3579206,20,0,utRho30
1878,ydiH,3530582,3530582,3530406,176,0,utRho30
1879,ydiM,3541852,3542142,3541852,290,84,utRho30
1880,ydiN,3544818,3545024,3544818,206,72,utRho30
1881,ydiP,3558656,3558656,3558602,54,310,utRho30
1882,ydiU,3582508,3582508,3582488,20,158,utRho30
1883,ydiV,3584174,3584174,3584040,134,142,utRho30
1884,ydiY,3612500,3612500,3612166,334,818,utRho30
1885,ydjA,3697400,3697400,3697352,48,394,utRho30
1886,ydjE,3708082,3708082,3707958,124,46,utRho30
1887,ydjF,3709848,3709848,3709708,140,204,utRho30
1888,ydjM,3620340,3620422,3620340,82,0,utRho30
1889,ydjO,3626696,3626696,3626288,408,0,utRho30
1890,ydjX,3666434,3666802,3666434,368,556,utRho30
1891,yeaE,3731448,3731448,3731272,176,310,utRho30
1892,yeaG,3733530,3733816,3733530,286,336,utRho30
1893,yeaI,3740486,3740770,3740486,284,78,utRho30
1894,yeaJ,3743874,3744082,3743874,208,532,utRho30
1895,yeaL,3748646,3748704,3748646,58,440,utRho30
1896,yeaM,3751296,3751296,3751152,144,0,utRho30
1897,yeaN,3750926,3751346,3750926,420,40,utRho30
1898,yeaO,3753554,3753818,3753554,264,64,utRho30
1899,yeaP,3755314,3755430,3755314,116,286,utRho30
1900,yeaQ,3758780,3758780,3758510,270,246,utRho30
1901,yeaR,3759988,3759988,3759896,92,70,utRho30
1902,yeaY,3781122,3781122,3781064,58,54,utRho30
1903,yebB,3892220,3892502,3892220,282,482,utRho30
1904,yebC,3896370,3896370,3896302,68,112,utRho30
1905,yebE,3859464,3859464,3859414,50,312,utRho30
1906,yebG,3861530,3861530,3861494,36,20,utRho30
1907,yebK,3873180,3873304,3873180,124,22,utRho30
1908,yebQ,3820314,3820552,3820314,238,110,utRho30
1909,yebS,3832238,3832516,3832238,278,0,utRho30
1910,yebV,3843430,3843560,3843430,130,0,utRho30
1911,yebW,3843914,3844242,3843914,328,1524,utRho30
1912,yecC,3995646,3995646,3995628,18,0,utRho30
1913,yecD,3901272,3901664,3901272,392,100,utRho30
1914,yecF,3991434,3991636,3991434,202,280,utRho30
1915,yecH,3979304,3979304,3978980,324,92,utRho30
1916,yecJ,3975604,3975604,3975516,88,0,utRho30
1917,yecM,3919968,3919968,3919692,276,734,utRho30
1918,yecR,3976400,3976444,3976400,44,206,utRho30
1919,yecT,3923862,3923944,3923862,82,44,utRho30
1920,yedD,4016522,4016522,4016180,342,314,utRho30
1921,yedE,4016310,4016554,4016310,244,282,utRho30
1922,yedI,4058922,4058922,4058732,190,554,utRho30
1923,yedJ,4066446,4066446,4066158,288,362,utRho30
1924,yedV,4076404,4076404,4076304,100,360,utRho30
1925,yedX,4077680,4077912,4077680,232,146,utRho30
1926,yedY,4078572,4078956,4078572,384,110,utRho30
1927,yeeA,4161322,4161322,4161182,140,72,utRho30
1928,yeeE,4171104,4171104,4171050,54,1106,utRho30
1929,yeeJ,4089526,4089822,4089526,296,32,utRho30
1930,yeeN,4113508,4113716,4113508,208,366,utRho30
1931,yeeO,4119444,4119444,4119692,248,274,utRho30
1932,yeeX,4158834,4158834,4158722,112,338,utRho30
1933,yeeZ,4178422,4178422,4178256,166,192,utRho30
1934,yefM,4179466,4179466,4179426,40,76,utRho30
1935,yegD,4295288,4295348,4295288,60,276,utRho30
1936,yegH,4275726,4275804,4275726,78,520,utRho30
1937,yegI,4302154,4302154,4301970,184,192,utRho30
1938,yegJ,4302032,4302370,4302032,338,334,utRho30
1939,yegQ,4331182,4331336,4331182,154,128,utRho30
1940,yegR,4336698,4336698,4336612,86,2296,utRho30
1941,yegS,4337086,4337424,4337086,338,774,utRho30
1942,yegT,4357562,4357642,4357562,80,138,utRho30
1943,yegX,4367640,4367640,4367302,338,112,utRho30
1944,yehA,4376944,4376944,4376828,116,292,utRho30
1945,yehE,4385818,4385818,4385592,226,122,utRho30
1946,yehK,4407568,4407944,4407568,376,172,utRho30
1947,yehL,4408804,4409192,4408804,388,0,utRho30
1948,yeiB,4486146,4486146,4485934,212,114,utRho30
1949,yeiE,4499422,4499422,4499236,186,84,utRho30
1950,yeiG,4487776,4487820,4487776,44,36,utRho30
1951,yeiH,4499332,4499434,4499332,102,292,utRho30
1952,yeiI,4503306,4503400,4503306,94,36,utRho30
1953,yeiL,4510580,4510710,4510580,130,76,utRho30
1954,yeiP,4530834,4530900,4530834,66,262,utRho30
1955,yeiQ,4532328,4532490,4532328,162,114,utRho30
1956,yeiR,4535484,4535658,4535484,174,202,utRho30
1957,yeiW,4530840,4530840,4530590,250,342,utRho30
1958,yejA,4544624,4544728,4544624,104,0,utRho30
1959,yejG,4556892,4556892,4556474,418,3058,utRho30
1960,yejH,4561244,4561264,4561244,20,242,utRho30
1961,yejK,4568218,4568218,4567894,324,204,utRho30
1962,yejO,4578352,4578352,4577800,552,296,utRho30
1963,yfaD,4713380,4713808,4713380,428,472,utRho30
1964,yfaE,4696676,4697028,4696676,352,498,utRho30
1965,yfaL,4688568,4688568,4688338,230,308,utRho30
1966,yfaP,4656398,4656398,4656286,112,134,utRho30
1967,yfaU,4717892,4717892,4717690,202,0,utRho30
1968,yfaY,4727310,4727310,4727266,44,1176,utRho30
1969,yfaZ,4728744,4728744,4728550,194,692,utRho30
1970,yfbK,4771810,4771810,4771444,366,1778,utRho30
1971,yfbL,4771500,4771720,4771500,220,1616,utRho30
1972,yfbN,4777174,4777174,4776852,322,2210,utRho30
1973,yfbO,4776916,4777162,4776916,246,2112,utRho30
1974,yfbP,4777990,4778232,4777990,242,1504,utRho30
1975,yfbR,4817662,4817724,4817662,62,48,utRho30
1976,yfcI,4847424,4847424,4847078,346,548,utRho30
1977,yfcJ,4880482,4880482,4880240,242,20,utRho30
1978,yfcL,4888502,4888502,4888338,164,58,utRho30
1979,yfcV,4911642,4911642,4911292,350,558,utRho30
1980,yfcZ,4921958,4921958,4921868,90,80,utRho30
1981,yfdF,4925604,4926024,4925604,420,4200,utRho30
1982,yfdG,4935474,4935710,4935474,236,210,utRho30
1983,yfdP,4946844,4947040,4946844,196,120,utRho30
1984,yfdX,4988866,4988866,4988804,62,284,utRho30
1985,yfdY,4990672,4990672,4990584,88,1404,utRho30
1986,yfeA,5035784,5035784,5035664,120,878,utRho30
1987,yfeC,5036668,5036934,5036668,266,168,utRho30
1988,yfeH,5053818,5053892,5053818,74,40,utRho30
1989,yfeK,5074630,5074684,5074630,54,50,utRho30
1990,yfeO,5018906,5019260,5018906,354,296,utRho30
1991,yfeR,5054078,5054078,5053712,366,80,utRho30
1992,yfeX,5101356,5101356,5101090,266,6,utRho30
1993,yfeY,5102486,5102486,5102432,54,0,utRho30
1994,yfeZ,5103842,5103842,5103452,390,1158,utRho30
1995,yffO,5123804,5124222,5123804,418,910,utRho30
1996,yffQ,5126778,5127154,5126778,376,956,utRho30
1997,yffS,5128800,5128986,5128800,186,88,utRho30
1998,yfgC,5232052,5232188,5232052,136,0,utRho30
1999,yfgF,5258062,5258062,5257876,186,1376,utRho30
2000,yfgG,5258170,5258580,5258170,410,2208,utRho30
2001,yfgH,5259344,5259584,5259344,240,34,utRho30
2002,yfgM,5278866,5278866,5278566,300,658,utRho30
2003,yfhH,5397414,5397518,5397414,104,490,utRho30
2004,yfhM,5304648,5304648,5304574,74,68,utRho30
2005,yfhR,5328408,5328726,5328408,318,286,utRho30
2006,yfiC,5425610,5425610,5425528,82,404,utRho30
2007,yfiE,5430688,5430688,5430640,48,542,utRho30
2008,yfiL,5482630,5482720,5482630,90,20,utRho30
2009,yfiM,5448066,5448358,5448066,292,1436,utRho30
2010,yfiR,5483354,5483750,5483354,396,462,utRho30
2011,yfjH,5517326,5517326,5517200,126,138,utRho30
2012,yfjI,5517710,5517970,5517710,260,292,utRho30
2013,yfjJ,5521014,5521094,5521014,80,206,utRho30
2014,yfjM,5531970,5531970,5531552,418,3954,utRho30
2015,yfjP,5535080,5535420,5535080,340,5642,utRho30
2016,yfjW,5546570,5546636,5546570,66,8,utRho30
2017,yfjX,5551776,5551838,5551776,62,70,utRho30
2018,ygaC,5601180,5601180,5599988,1192,19780,utRho30
2019,ygaM,5600242,5600292,5600242,50,5926,utRho30
2020,ygaU,5593628,5593628,5593572,56,172,utRho30
2021,ygaZ,5619190,5619234,5619190,44,38,utRho30
2022,ygbA,5713656,5713656,5713612,44,122,utRho30
2023,ygbE,5746784,5746784,5746674,110,154,utRho30
2024,ygbI,5722882,5722882,5722528,354,302,utRho30
2025,ygbK,5724394,5724670,5724394,276,590,utRho30
2026,ygbL,5727074,5727186,5727074,112,46,utRho30
2027,ygbN,5729814,5730202,5729814,388,678,utRho30
2028,ygcG,5811210,5811422,5811210,212,184,utRho30
2029,ygcN,5785144,5785314,5785144,170,202,utRho30
2030,ygcU,5799214,5799214,5798836,378,740,utRho30
2031,ygcW,5800942,5800942,5800546,396,160,utRho30
2032,ygdD,5883442,5883442,5883262,180,1602,utRho30
2033,ygdG,5861746,5861930,5861746,184,346,utRho30
2034,ygdI,5886526,5886526,5886290,236,0,utRho30
2035,ygdQ,5940784,5940840,5940784,56,182,utRho30
2036,ygdR,5942494,5942542,5942494,48,64,utRho30
2037,ygeA,5961606,5961606,5961270,336,394,utRho30
2038,ygeH,5983758,5984188,5983758,430,172,utRho30
2039,ygeI,5987162,5987276,5987162,114,746,utRho30
2040,ygeR,6000078,6000078,5999782,296,1196,utRho30
2041,ygeV,6011694,6011694,6011572,122,0,utRho30
2042,ygeW,6012234,6012524,6012234,290,2062,utRho30
2043,ygfB,6110946,6110946,6110888,58,22,utRho30
2044,ygfK,6031984,6032120,6031984,136,156,utRho30
2045,ygfS,6058328,6058328,6058024,304,228,utRho30
2046,ygfZ,6082564,6082626,6082564,62,44,utRho30
2047,yggC,6149512,6149512,6149378,134,128,utRho30
2048,yggE,6136370,6136370,6136160,210,522,utRho30
2049,yggI,6179176,6179510,6179176,334,112,utRho30
2050,yggL,6204508,6204508,6204266,242,266,utRho30
2051,yggM,6199514,6199514,6199130,384,318,utRho30
2052,yggN,6203596,6203596,6203246,350,128,utRho30
2053,yggX,18623958,18624558,18623958,600,342,utRho30
2054,yghA,6298966,6299324,6298966,358,144,utRho30
2055,yghB,6307058,6307126,6307058,68,460,utRho30
2056,yghD,6222614,6222614,6222252,362,320,utRho30
2057,yghF,6225798,6225798,6225840,42,2,utRho30
2058,yghJ,6238640,6238640,6238224,416,24,utRho30
2059,yghQ,6265186,6265186,6264816,370,460,utRho30
2060,yghT,6267830,6268262,6267830,432,1552,utRho30
2061,yghU,6277400,6277454,6277400,54,422,utRho30
2062,yghW,6293506,6293506,6293474,32,224,utRho30
2063,yghZ,6295562,6295794,6295562,232,0,utRho30
2064,ygiD,6365122,6365122,6364868,254,366,utRho30
2065,ygiH,6409066,6409388,6409066,322,6110,utRho30
2066,ygiL,6370622,6370828,6370622,206,0,utRho30
2067,ygiM,6402084,6402414,6402084,330,712,utRho30
2068,ygiN,6346156,6346284,6346156,128,414,utRho30
2069,ygiQ,6322620,6322620,6322292,328,130,utRho30
2070,ygiS,6335462,6335462,6335436,26,0,utRho30
2071,ygiV,6338582,6338582,6338462,120,74,utRho30
2072,ygiW,6339774,6339774,6339352,422,1002,utRho30
2073,ygiZ,6344506,6344506,6344422,84,46,utRho30
2074,ygjH,6442528,6442528,6442494,34,24,utRho30
2075,ygjI,6452140,6452468,6452140,328,52,utRho30
2076,ygjQ,6472730,6473080,6472730,350,1304,utRho30
2077,ygjR,6474564,6474586,6474564,22,50,utRho30
2078,ygjV,6483638,6483638,6483488,150,2,utRho30
2079,yhaB,6535632,6535708,6535632,76,540,utRho30
2080,yhaH,6504498,6504608,6504498,110,1322,utRho30
2081,yhaI,6505400,6505822,6505400,422,366,utRho30
2082,yhaJ,6508560,6508560,6508428,132,38,utRho30
2083,yhaK,6508538,6508638,6508538,100,18,utRho30
2084,yhbQ,6599878,6599932,6599878,54,492,utRho30
2085,yhbT,6602736,6602736,6602552,184,1302,utRho30
2086,yhbU,6602558,6602970,6602558,412,1830,utRho30
2087,yhbX,6643302,6643302,6643226,76,396,utRho30
2088,yhbY,6655518,6655580,6655518,62,370,utRho30
2089,yhcA,6723956,6724224,6723956,268,178,utRho30
2090,yhcB,6760364,6760382,6760364,18,140,utRho30
2091,yhcC,6708470,6708470,6708100,370,752,utRho30
2092,yhcF,6733440,6733852,6733440,412,504,utRho30
2093,yhcH,6739124,6739124,6738956,168,890,utRho30
2094,yhcM,6760312,6760312,6759994,318,362,utRho30
2095,yhcN,6770812,6771076,6770812,264,502,utRho30
2096,yhcO,6772606,6772606,6772258,348,6,utRho30
2097,yhdH,6806560,6806968,6806560,408,1206,utRho30
2098,yhdJ,6823234,6823306,6823234,72,0,utRho30
2099,yhdN,6879092,6879092,6879018,74,970,utRho30
2100,yhdT,6814702,6814750,6814702,48,112,utRho30
2101,yhdU,6824994,6825242,6824994,248,474,utRho30
2102,yhdV,6836392,6836780,6836392,388,696,utRho30
2103,yhdW,6837944,6838298,6837944,354,92,utRho30
2104,yheO,6953082,6953082,6952880,202,92,utRho30
2105,yheV,6957970,6957970,6957584,386,110,utRho30
2106,yhfA,6971902,6971902,6971636,266,1440,utRho30
2107,yhfG,6983294,6983294,6983240,54,94,utRho30
2108,yhfL,6998622,6998896,6998622,274,646,utRho30
2109,yhfY,7023244,7023244,7022844,400,378,utRho30
2110,yhgA,7086294,7086334,7086294,40,0,utRho30
2111,yhgE,7065176,7065176,7064878,298,3192,utRho30
2112,yhgF,7074352,7074770,7074352,418,4280,utRho30
2113,yhhA,7173458,7173886,7173458,428,1198,utRho30
2114,yhhI,7248346,7248756,7248346,410,240,utRho30
2115,yhhJ,7253696,7253696,7253606,90,184,utRho30
2116,yhhM,7211588,7211588,7211220,368,1696,utRho30
2117,yhhN,7211150,7211502,7211150,352,1014,utRho30
2118,yhhQ,7218238,7218434,7218238,196,558,utRho30
2119,yhhT,7223682,7223730,7223682,48,184,utRho30
2120,yhhX,7162032,7162032,7161610,422,168,utRho30
2121,yhhY,7162222,7162276,7162222,54,162,utRho30
2122,yhhZ,7163516,7163726,7163516,210,1198,utRho30
2123,yhiD,7312220,7312220,7311804,416,9064,utRho30
2124,yhiJ,7265190,7265190,7265180,10,124,utRho30
2125,yhiM,7269270,7269682,7269270,412,4584,utRho30
2126,yhiN,7275000,7275000,7274820,180,854,utRho30
2127,yhjA,7338522,7338522,7338376,146,262,utRho30
2128,yhjB,7344090,7344090,7343788,302,1298,utRho30
2129,yhjC,7344272,7344684,7344272,412,250,utRho30
2130,yhjD,7346660,7346724,7346660,64,118,utRho30
2131,yhjE,7349274,7349572,7349274,298,1532,utRho30
2132,yhjG,7356824,7356824,7356730,94,12,utRho30
2133,yhjH,7358458,7358458,7358374,84,424,utRho30
2134,yhjJ,7364032,7364032,7363880,152,184,utRho30
2135,yhjK,7371296,7371296,7371158,138,568,utRho30
2136,yhjR,7392750,7392750,7392370,380,282,utRho30
2137,yhjV,7400796,7401126,7400796,330,580,utRho30
2138,yhjX,7424194,7424194,7424014,180,58,utRho30
2139,yhjY,7425966,7425966,7425868,98,84,utRho30
2140,yiaB,7455654,7455654,7455496,158,378,utRho30
2141,yiaD,7432712,7433094,7432712,382,242,utRho30
2142,yiaF,7438194,7438194,7438088,106,970,utRho30
2143,yiaG,7438862,7438956,7438862,94,1236,utRho30
2144,yiaJ,7485236,7485236,7485064,172,378,utRho30
2145,yiaK,7485348,7485466,7485348,118,260,utRho30
2146,yiaT,7503924,7503924,7503736,188,4,utRho30
2147,yiaU,7503792,7503984,7503792,192,4,utRho30
2148,yiaY,7515856,7515856,7515654,202,998,utRho30
2149,yibF,7523950,7523950,7523910,40,220,utRho30
2150,yibG,7536128,7536354,7536128,226,2158,utRho30
2151,yibL,7553194,7553330,7553194,136,470,utRho30
2152,yibN,7570112,7570112,7570030,82,324,utRho30
2153,yibT,7552848,7552848,7552760,88,1996,utRho30
2154,yicC,7633290,7633352,7633290,62,256,utRho30
2155,yicH,7660862,7660914,7660862,52,204,utRho30
2156,yicJ,7673328,7673328,7671858,1470,17290,utRho30
2157,yicN,7685018,7685018,7684804,214,876,utRho30
2158,yicO,7687914,7687914,7687578,336,278,utRho30
2159,yicR,15250308,15250308,15250236,72,0,utRho30
2160,yidB,7755230,7755230,7754930,300,2284,utRho30
2161,yidE,7732780,7732780,7732546,234,108,utRho30
2162,yidF,7711580,7711580,7711222,358,176,utRho30
2163,yidQ,7735088,7735456,7735088,368,1158,utRho30
2164,yidR,7738824,7738824,7738618,206,4,utRho30
2165,yieE,7787658,7787738,7787658,80,1096,utRho30
2166,yieH,7793314,7793548,7793314,234,162,utRho30
2167,yieK,7798928,7798928,7798786,142,66,utRho30
2168,yifB,7900350,7900350,7899998,352,484,utRho30
2169,yifL,7988984,7989044,7988984,60,160,utRho30
2170,yigF,8005750,8005750,8005598,152,3458,utRho30
2171,yigI,8009448,8009448,8009394,54,216,utRho30
2172,yigM,8022100,8022152,8022100,52,1062,utRho30
2173,yihA,8101970,8101970,8101458,512,76,utRho30
2174,yihD,8084098,8084138,8084098,40,144,utRho30
2175,yihF,8088110,8088398,8088110,288,762,utRho30
2176,yihG,8093304,8093304,8093204,100,138,utRho30
2177,yihI,8102616,8102694,8102616,78,8,utRho30
2178,yihL,8120506,8120894,8120506,388,1830,utRho30
2179,yihN,8124332,8124494,8124332,162,3094,utRho30
2180,yihO,8131942,8131942,8131532,410,346,utRho30
2181,yihQ,8138892,8138892,8138552,340,48,utRho30
2182,yihV,8147064,8147478,8147064,414,530,utRho30
2183,yihX,8151096,8151106,8151096,10,218,utRho30
2184,yiiE,8158192,8158582,8158192,390,730,utRho30
2185,yiiF,8159124,8159502,8159124,378,310,utRho30
2186,yiiG,8173762,8174004,8173762,242,36,utRho30
2187,yiiM,8205506,8205644,8205506,138,1144,utRho30
2188,yiiQ,8224624,8224624,8224428,196,104,utRho30
2189,yiiS,8225738,8225934,8225738,196,172,utRho30
2190,yijE,8272178,8272216,8272178,38,62,utRho30
2191,yijF,8275728,8275728,8275314,414,1144,utRho30
2192,yijO,8296858,8296858,8296634,224,156,utRho30
2193,yjaA,8426240,8426468,8426240,228,48508,utRho30
2194,yjaB,8428312,8428312,8428246,66,40,utRho30
2195,yjaG,8398746,8399008,8398746,262,424,utRho30
2196,yjaH,8401022,8401132,8401022,110,32,utRho30
2197,yjaZ,8379506,8379572,8379506,66,62,utRho30
2198,yjbB,8455204,8455462,8455204,258,58,utRho30
2199,yjbE,16943432,16943624,16943432,192,404,utRho30
2200,yjbL,8520318,8520642,8520318,324,426,utRho30
2201,yjbQ,8540428,8540476,8540428,48,6,utRho30
2202,yjcB,8550328,8550328,8550082,246,660,utRho30
2203,yjcC,8550836,8550942,8550836,106,206,utRho30
2204,yjcD,8556628,8556958,8556628,330,526,utRho30
2205,yjcE,8559658,8559960,8559658,302,492,utRho30
2206,yjcF,8566212,8566212,8566150,62,82,utRho30
2207,yjcO,8594660,8594660,8594250,410,212,utRho30
2208,yjdA,8654128,8654270,8654128,142,0,utRho30
2209,yjdC,8726660,8726660,8726616,44,278,utRho30
2210,yjdK,8704780,8705168,8704780,388,1964,utRho30
2211,yjdL,8713034,8713034,8712822,212,72,utRho30
2212,yjdM,8653672,8653672,8653468,204,2828,utRho30
2213,yjeF,8787354,8788132,8787354,778,5026,utRho30
2214,yjeI,8745522,8745618,8745522,96,106,utRho30
2215,yjeJ,8748806,8748806,8748468,338,2392,utRho30
2216,yjeV,8785472,8785784,8785472,312,138,utRho30
2217,yjfP,8833512,8833904,8833512,392,302,utRho30
2218,yjfY,8849656,8849656,8849582,74,152,utRho30
2219,yjfZ,8855052,8855052,8854844,208,440,utRho30
2220,yjgA,8916162,8916162,8915730,432,148,utRho30
2221,yjgL,8950802,8950874,8950802,72,140,utRho30
2222,yjgM,8959342,8959342,8959074,268,12,utRho30
2223,yjgN,8959132,8959460,8959132,328,76,utRho30
2224,yjgR,8980170,8980170,8980126,44,364,utRho30
2225,yjgZ,9002116,9002520,9002116,404,1932,utRho30
2226,yjhB,9007764,9008116,9007764,352,1160,utRho30
2227,yjhG,9048452,9048452,9048188,264,1930,utRho30
2228,yjhU,9041080,9041080,9040648,432,3088,utRho30
2229,yjiA,9178096,9178096,9177730,366,506,utRho30
2230,yjiJ,9125364,9125364,9125350,14,0,utRho30
2231,yjiK,9127270,9127270,9127422,152,378,utRho30
2232,yjiL,9129604,9129604,9129378,226,88,utRho30
2233,yjiS,9143410,9143502,9143410,92,346,utRho30
2234,yjiY,9182734,9182734,9182558,176,506,utRho30
2235,yjjA,9200674,9200674,9200378,296,622,utRho30
2236,yjjB,18408708,18408708,18407800,908,1760,utRho30
2237,yjjJ,9243314,9243538,9243314,224,18,utRho30
2238,yjjK,9261132,9261132,9261044,88,404,utRho30
2239,yjjL,9189764,9189764,9189444,320,170,utRho30
2240,yjjM,9191894,9191894,9191702,192,1102,utRho30
2241,yjjP,9206068,9206068,9205716,352,1180,utRho30
2242,yjjQ,9206638,9206954,9206638,316,1374,utRho30
2243,yjjX,9267798,9267798,9267490,308,456,utRho30
2244,yjjY,9280716,9280804,9280716,88,426,utRho30
2245,yjjZ,9211554,9211608,9211554,54,876,utRho30
2246,yjtD,9281676,9281884,9281676,208,1212,utRho30
2247,ykfB,532454,532454,532174,280,652,utRho30
2248,ykfI,527636,527636,527338,298,852,utRho30
2249,ykgB,637050,637050,636638,412,18,utRho30
2250,ykgC,640430,640430,640002,428,142,utRho30
2251,ykgD,640232,640454,640232,222,220,utRho30
2252,ykgE,642962,643216,642962,254,3550,utRho30
2253,ykgJ,608524,608524,608364,160,46,utRho30
2254,ykgL,623878,624224,623878,346,460,utRho30
2255,ykgM,625610,625610,625554,56,122,utRho30
2256,ykgR,626570,626570,626484,86,164,utRho30
2257,ylaC,958576,958576,958502,74,300,utRho30
2258,yliE,1745938,1745958,1745938,20,0,utRho30
2259,ymcE,2103660,2103694,2103660,34,2,utRho30
2260,ymdA,2210450,2210828,2210450,378,228,utRho30
2261,ymdB,2211428,2211640,2211428,212,0,utRho30
2262,ymfD,2395322,2395322,2395064,258,890,utRho30
2263,ymfI,2402880,2402994,2402880,114,0,utRho30
2264,ymfJ,2404518,2404518,2404168,350,54,utRho30
2265,ymfK,2406176,2406176,2405866,310,140,utRho30
2266,ymfT,2405766,2406048,2405766,282,118,utRho30
2267,ymgE,2489110,2489456,2489110,346,1232,utRho30
2268,ymgF,2437628,2437966,2437628,338,582,utRho30
2269,ymiA,2670112,2670320,2670112,208,200,utRho30
2270,ymjA,2715620,2715620,2715336,284,506,utRho30
2271,ynaI,2791946,2791946,2791844,102,324,utRho30
2272,ynaK,2850438,2850754,2850438,316,294,utRho30
2273,ynbA,2954924,2955242,2954924,318,480,utRho30
2274,yncD,3046552,3046552,3046130,422,170,utRho30
2275,yncE,3046454,3046614,3046454,160,156,utRho30
2276,yncG,3052456,3052494,3052456,38,648,utRho30
2277,yncL,3034492,3034492,3034388,104,284,utRho30
2278,yneE,3218364,3218364,3218044,320,0,utRho30
2279,yneF,3223748,3223748,3223708,40,1058,utRho30
2280,yneJ,3229560,3229608,3229560,48,210,utRho30
2281,yneK,3231100,3231526,3231100,426,392,utRho30
2282,yneM,3245176,3245292,3245176,116,232,utRho30
2283,ynfA,3311398,3311398,3311346,52,46,utRho30
2284,ynfB,3311418,3311616,3311418,198,206,utRho30
2285,ynfC,3315094,3315094,3314914,180,0,utRho30
2286,ynfD,3314828,3315130,3314828,302,10,utRho30
2287,ynfE,3316006,3316138,3316006,132,30,utRho30
2288,ynfK,3334670,3334670,3334438,232,322,utRho30
2289,ynfL,3339304,3339304,3339184,120,0,utRho30
2290,ynfM,3339260,3339398,3339260,138,0,utRho30
2291,ynfN,3276598,3276598,3276218,380,14,utRho30
2292,ynfO,3273454,3273512,3273454,58,26,utRho30
2293,ynhG,3517890,3517890,3517450,440,270,utRho30
2294,yniA,3615158,3615592,3615158,434,296,utRho30
2295,yniB,3618526,3618526,3618466,60,100,utRho30
2296,yniC,3618652,3618760,3618652,108,142,utRho30
2297,yniD,3610202,3610330,3610202,128,370,utRho30
2298,ynjE,3678880,3678934,3678880,54,90,utRho30
2299,ynjF,3683222,3683222,3682806,416,226,utRho30
2300,ynjH,3684376,3684376,3684270,106,218,utRho30
2301,ynjI,3690022,3690022,3689742,280,414,utRho30
2302,yoaB,3786642,3786734,3786642,92,258,utRho30
2303,yoaC,3787932,3788146,3787932,214,226,utRho30
2304,yoaE,3803544,3803544,3803170,374,582,utRho30
2305,yoaF,3755444,3755444,3755064,380,342,utRho30
2306,yoaH,3789866,3789866,3789462,404,512,utRho30
2307,yobB,3850418,3850880,3850418,462,132,utRho30
2308,yobF,3815586,3815586,3815182,404,840,utRho30
2309,yobH,3817800,3817850,3817800,50,192,utRho30
2310,yodB,4084352,4084736,4084352,384,458,utRho30
2311,yodC,4057008,4057008,4056740,268,302,utRho30
2312,yohC,4451358,4451358,4451262,96,210,utRho30
2313,yohD,4451526,4451602,4451526,76,232,utRho30
2314,yohJ,4460986,4461248,4460986,262,800,utRho30
2315,yohO,4431172,4431314,4431172,142,92,utRho30
2316,yojI,4617282,4617282,4617230,52,98,utRho30
2317,ypdI,4988988,4989396,4988988,408,460,utRho30
2318,ypfG,5165786,5165786,5165554,232,176,utRho30
2319,ypfM,5182140,5182140,5181732,408,678,utRho30
2320,yphB,5349590,5349590,5349376,214,8,utRho30
2321,ypjA,5565644,5565644,5565452,192,2420,utRho30
2322,ypjB,5569636,5569636,5568858,778,568,utRho30
2323,ypjD,5495860,5495774,5495860,86,122,utRho30
2324,yqaE,5594170,5594170,5594056,114,494,utRho30
2325,yqcA,5846100,5846100,5845968,132,48,utRho30
2326,yqcE,5800944,5801184,5800944,240,0,utRho30
2327,yqeC,6030468,6030468,6030114,354,104,utRho30
2328,yqeF,5971618,5971618,5971184,434,2966,utRho30
2329,yqeG,5971438,5971694,5971438,256,2732,utRho30
2330,yqeH,5975016,5975072,5975016,56,2004,utRho30
2331,yqeI,5976688,5977004,5976688,316,174,utRho30
2332,yqeK,5981140,5981140,5980720,420,3614,utRho30
2333,yqfA,6086728,6086728,6086296,432,186,utRho30
2334,yqgA,6219042,6219106,6219042,64,106,utRho30
2335,yqgB,6172500,6172500,6172102,398,688,utRho30
2336,yqgE,6185768,6185874,6185768,106,26,utRho30
2337,yqhA,6299150,6299150,6298942,208,4,utRho30
2338,yqhC,6310768,6310768,6310436,332,210,utRho30
2339,yqhD,6310604,6310710,6310604,106,148,utRho30
2340,yqhH,6316842,6317254,6316842,412,860,utRho30
2341,yqiC,6369662,6369680,6369662,18,266,utRho30
2342,yqiJ,6384108,6384416,6384108,308,1844,utRho30
2343,yqjA,6495096,6495546,6495096,450,368,utRho30
2344,yqjF,6500932,6501124,6500932,192,526,utRho30
2345,yqjG,6501948,6502048,6501948,100,12,utRho30
2346,yqjH,6433078,6433078,6432982,96,6,utRho30
2347,yqjI,6433506,6433558,6433506,52,0,utRho30
2348,yraH,6574552,6574852,6574552,300,504,utRho30
2349,yraP,6592144,6592818,6592144,674,300,utRho30
2350,yraQ,6596414,6596414,6596276,138,48,utRho30
2351,yraR,6598024,6598024,6597692,332,1400,utRho30
2352,yrbG,13360844,13361100,13360844,256,512,utRho30
2353,yrbL,6696842,6696904,6696842,62,1200,utRho30
2354,yrbN,6616172,6616172,6615866,306,80,utRho30
2355,yrdB,6860176,6860176,6860046,130,386,utRho30
2356,yrfF,7052548,7052938,7052548,390,782,utRho30
2357,yrhB,7169440,7169518,7169440,78,162,utRho30
2358,ysaB,7451804,7451804,7451424,380,324,utRho30
2359,ysgA,8032686,8032686,8032338,348,346,utRho30
2360,ytfB,8857638,8857638,8857434,204,980,utRho30
2361,ytfE,8864018,8864018,8863966,52,310,utRho30
2362,ytfF,8866296,8866296,8866130,166,1342,utRho30
2363,ytfH,8868164,8868226,8868164,62,260,utRho30
2364,ytfI,8875234,8875414,8875234,180,82,utRho30
2365,ytfJ,8878572,8878572,8878524,48,100,utRho30
2366,ytfK,8879022,8879174,8879022,152,290,utRho30
2367,ytfL,8882642,8882642,8882430,212,118,utRho30
2368,ytfQ,8899634,8899924,8899634,290,516,utRho30
2369,ytjB,9249598,9249598,9249578,20,6,utRho30
2370,yzfA,8896588,8896588,8896490,98,154,utRho30
2371,zapA,6111102,6111224,6111102,122,326,utRho30
2372,zapB,8236772,8237030,8236772,258,462,utRho30
2373,zapC,2011700,2011904,2011700,204,144,utRho30
2374,zinT,4082692,4082750,4082692,58,4,utRho30
2375,zipA,5062814,5062814,5062466,348,160,utRho30
2376,zitB,1569716,1569716,1569646,70,92,utRho30
2377,zntA,7212844,7212902,7212844,58,4,utRho30
2378,zntR,6878336,6878336,6878260,76,114,utRho30
2379,znuA,3885322,3885322,3885166,156,62,utRho30
2380,znuC,3885268,3885324,3885268,56,60,utRho30
2381,zraP,8403424,8403424,8403376,48,2,utRho30
2382,zraS,8403810,8403852,8403810,42,82,utRho30
2383,zupT,6364866,6365100,6364866,234,366,utRho30
2384,zur,8520282,8520282,8520006,276,628,utRho30
2385,zwf,3872752,3872752,3872628,124,70,utRho30
